AnnoMese,Postazione,Giorno,N Giorno Settimana,Strada,Transiti - Totale,Transiti - Non Classificato,Transiti - Leggeri,Transiti - Pesanti,Transiti - Diurno,Transiti - Notturno,Transiti - Feriali,Transiti - Festivi
2019/01,6,01/01/2019,2,SS 12 tra Fiumalbo e Abetone,5153,00,5144,9,3941,1212,0,5153
2019/01,6,02/01/2019,3,SS 12 tra Fiumalbo e Abetone,3609,00,3567,42,3110,499,3609,0
2019/01,6,03/01/2019,4,SS 12 tra Fiumalbo e Abetone,3129,00,3083,46,2652,477,3129,0
2019/01,6,04/01/2019,5,SS 12 tra Fiumalbo e Abetone,3061,00,3005,56,2557,504,3061,0
2019/01,6,05/01/2019,6,SS 12 tra Fiumalbo e Abetone,3050,00,3024,26,2404,646,0,3050
2019/01,6,06/01/2019,7,SS 12 tra Fiumalbo e Abetone,2470,00,2466,4,2129,341,0,2470
2019/01,6,07/01/2019,1,SS 12 tra Fiumalbo e Abetone,1272,10,1231,40,1145,127,1272,0
2019/01,6,08/01/2019,2,SS 12 tra Fiumalbo e Abetone,1240,00,1207,33,1070,170,1240,0
2019/01,6,09/01/2019,3,SS 12 tra Fiumalbo e Abetone,1226,00,1183,43,1065,161,1226,0
2019/01,6,10/01/2019,4,SS 12 tra Fiumalbo e Abetone,1260,00,1228,32,1052,208,1260,0
2019/01,6,11/01/2019,5,SS 12 tra Fiumalbo e Abetone,1636,00,1595,41,1258,378,1636,0
2019/01,6,12/01/2019,6,SS 12 tra Fiumalbo e Abetone,2190,00,2164,26,1752,438,0,2190
2019/01,6,13/01/2019,7,SS 12 tra Fiumalbo e Abetone,2084,00,2076,8,1755,329,0,2084
2019/01,6,14/01/2019,1,SS 12 tra Fiumalbo e Abetone,1369,00,1329,40,1183,186,1369,0
2019/01,7,01/01/2019,2,SS 64 tra Porretta Terme e Sambuca Pistoiese,5878,10,5861,16,4520,1358,0,5878
2019/01,7,02/01/2019,3,SS 64 tra Porretta Terme e Sambuca Pistoiese,7100,00,6941,159,5982,1118,7100,0
2019/01,7,03/01/2019,4,SS 64 tra Porretta Terme e Sambuca Pistoiese,6884,10,6688,195,5760,1124,6884,0
2019/01,7,04/01/2019,5,SS 64 tra Porretta Terme e Sambuca Pistoiese,7160,10,6931,228,5803,1357,7160,0
2019/01,7,05/01/2019,6,SS 64 tra Porretta Terme e Sambuca Pistoiese,7387,10,7294,92,6027,1360,0,7387
2019/01,7,06/01/2019,7,SS 64 tra Porretta Terme e Sambuca Pistoiese,5772,00,5745,27,4725,1047,0,5772
2019/01,7,07/01/2019,1,SS 64 tra Porretta Terme e Sambuca Pistoiese,6588,00,6359,229,5539,1049,6588,0
2019/01,7,08/01/2019,2,SS 64 tra Porretta Terme e Sambuca Pistoiese,6375,10,6145,229,5306,1069,6375,0
2019/01,7,09/01/2019,3,SS 64 tra Porretta Terme e Sambuca Pistoiese,6561,00,6297,264,5511,1050,6561,0
2019/01,7,10/01/2019,4,SS 64 tra Porretta Terme e Sambuca Pistoiese,6314,00,6060,254,5214,1100,6314,0
2019/01,7,11/01/2019,5,SS 64 tra Porretta Terme e Sambuca Pistoiese,7228,00,6978,250,5862,1366,7228,0
2019/01,7,12/01/2019,6,SS 64 tra Porretta Terme e Sambuca Pistoiese,7040,00,6935,105,5747,1293,0,7040
2019/01,7,13/01/2019,7,SS 64 tra Porretta Terme e Sambuca Pistoiese,5685,00,5657,28,4576,1109,0,5685
2019/01,7,14/01/2019,1,SS 64 tra Porretta Terme e Sambuca Pistoiese,6610,00,6351,259,5510,1100,6610,0
2019/01,9,01/01/2019,2,SS 67 tra Rocca San Casciano e Portico San Benedetto,1585,00,1573,12,1305,280,0,1585
2019/01,9,02/01/2019,3,SS 67 tra Rocca San Casciano e Portico San Benedetto,1264,00,1226,38,1043,221,1264,0
2019/01,9,03/01/2019,4,SS 67 tra Rocca San Casciano e Portico San Benedetto,1275,00,1232,43,1016,259,1275,0
2019/01,9,04/01/2019,5,SS 67 tra Rocca San Casciano e Portico San Benedetto,1217,00,1167,50,1006,211,1217,0
2019/01,9,05/01/2019,6,SS 67 tra Rocca San Casciano e Portico San Benedetto,1340,10,1299,40,1051,289,0,1340
2019/01,9,06/01/2019,7,SS 67 tra Rocca San Casciano e Portico San Benedetto,1398,00,1394,4,1177,221,0,1398
2019/01,9,07/01/2019,1,SS 67 tra Rocca San Casciano e Portico San Benedetto,1021,00,958,63,856,165,1021,0
2019/01,9,08/01/2019,2,SS 67 tra Rocca San Casciano e Portico San Benedetto,1046,00,964,82,887,159,1046,0
2019/01,9,09/01/2019,3,SS 67 tra Rocca San Casciano e Portico San Benedetto,1152,00,1079,73,966,186,1152,0
2019/01,9,10/01/2019,4,SS 67 tra Rocca San Casciano e Portico San Benedetto,1061,10,962,98,897,164,1061,0
2019/01,9,11/01/2019,5,SS 67 tra Rocca San Casciano e Portico San Benedetto,1108,00,977,131,940,168,1108,0
2019/01,9,12/01/2019,6,SS 67 tra Rocca San Casciano e Portico San Benedetto,1064,00,1020,44,850,214,0,1064
2019/01,9,13/01/2019,7,SS 67 tra Rocca San Casciano e Portico San Benedetto,1219,00,1215,4,1049,170,0,1219
2019/01,9,14/01/2019,1,SS 67 tra Rocca San Casciano e Portico San Benedetto,1041,00,975,66,880,161,1041,0
2019/01,12,01/01/2019,2,SS 16 al Confine regionale (Marche),12675,00,12602,73,7784,4891,0,12675
2019/01,12,02/01/2019,3,SS 16 al Confine regionale (Marche),13271,00,12997,274,10536,2735,13271,0
2019/01,12,03/01/2019,4,SS 16 al Confine regionale (Marche),14800,00,14484,316,11672,3128,14800,0
2019/01,12,04/01/2019,5,SS 16 al Confine regionale (Marche),14219,00,13891,328,10985,3234,14219,0
2019/01,12,05/01/2019,6,SS 16 al Confine regionale (Marche),14580,00,14412,168,10607,3973,0,14580
2019/01,12,06/01/2019,7,SS 16 al Confine regionale (Marche),12689,10,12640,48,9098,3591,0,12689
2019/01,12,07/01/2019,1,SS 16 al Confine regionale (Marche),15407,20,14856,549,12387,3020,15407,0
2019/01,12,08/01/2019,2,SS 16 al Confine regionale (Marche),15091,00,14511,580,12136,2955,15091,0
2019/01,12,09/01/2019,3,SS 16 al Confine regionale (Marche),15431,10,14850,580,12273,3158,15431,0
2019/01,12,10/01/2019,4,SS 16 al Confine regionale (Marche),15845,20,15234,609,12667,3178,15845,0
2019/01,12,11/01/2019,5,SS 16 al Confine regionale (Marche),16584,00,15927,657,12853,3731,16584,0
2019/01,12,12/01/2019,6,SS 16 al Confine regionale (Marche),16104,10,15892,211,11804,4300,0,16104
2019/01,12,13/01/2019,7,SS 16 al Confine regionale (Marche),13632,20,13574,56,9804,3828,0,13632
2019/01,12,14/01/2019,1,SS 16 al Confine regionale (Marche),15574,10,14955,618,12482,3092,15574,0
2019/01,16,01/01/2019,2,SP 69 in località Pilastri al Confine regionale,887,00,878,9,576,311,0,887
2019/01,16,02/01/2019,3,SP 69 in località Pilastri al Confine regionale,1146,00,1087,59,898,248,1146,0
2019/01,16,03/01/2019,4,SP 69 in località Pilastri al Confine regionale,1171,00,1092,79,955,216,1171,0
2019/01,16,04/01/2019,5,SP 69 in località Pilastri al Confine regionale,1261,00,1191,70,1004,257,1261,0
2019/01,16,05/01/2019,6,SP 69 in località Pilastri al Confine regionale,1213,00,1181,32,902,311,0,1213
2019/01,16,06/01/2019,7,SP 69 in località Pilastri al Confine regionale,1225,00,1215,10,885,340,0,1225
2019/01,16,07/01/2019,1,SP 69 in località Pilastri al Confine regionale,1294,10,1166,127,1078,216,1294,0
2019/01,16,08/01/2019,2,SP 69 in località Pilastri al Confine regionale,1249,00,1134,115,1057,192,1249,0
2019/01,16,09/01/2019,3,SP 69 in località Pilastri al Confine regionale,1260,00,1152,108,1048,212,1260,0
2019/01,16,10/01/2019,4,SP 69 in località Pilastri al Confine regionale,1322,00,1212,110,1105,217,1322,0
2019/01,16,11/01/2019,5,SP 69 in località Pilastri al Confine regionale,1398,00,1272,126,1113,285,1398,0
2019/01,16,12/01/2019,6,SP 69 in località Pilastri al Confine regionale,1174,00,1137,37,859,315,0,1174
2019/01,16,13/01/2019,7,SP 69 in località Pilastri al Confine regionale,1250,00,1235,15,884,366,0,1250
2019/01,16,14/01/2019,1,SP 69 in località Pilastri al Confine regionale,1440,00,1303,137,1191,249,1440,0
2019/01,17,01/01/2019,2,SS 12 al Confine regionale (Lombardia),3958,00,3922,36,2395,1563,0,3958
2019/01,17,02/01/2019,3,SS 12 al Confine regionale (Lombardia),7255,00,6725,530,5871,1384,7255,0
2019/01,17,03/01/2019,4,SS 12 al Confine regionale (Lombardia),8083,10,7505,577,6458,1625,8083,0
2019/01,17,04/01/2019,5,SS 12 al Confine regionale (Lombardia),8372,00,7795,577,6509,1863,8372,0
2019/01,17,05/01/2019,6,SS 12 al Confine regionale (Lombardia),7862,00,7702,160,5802,2060,0,7862
2019/01,17,06/01/2019,7,SS 12 al Confine regionale (Lombardia),6393,00,6352,41,4618,1775,0,6393
2019/01,17,07/01/2019,1,SS 12 al Confine regionale (Lombardia),9825,00,8960,865,7865,1960,9825,0
2019/01,17,08/01/2019,2,SS 12 al Confine regionale (Lombardia),9517,00,8513,1004,7712,1805,9517,0
2019/01,17,09/01/2019,3,SS 12 al Confine regionale (Lombardia),10224,00,9134,1090,8202,2022,10224,0
2019/01,17,10/01/2019,4,SS 12 al Confine regionale (Lombardia),10512,20,9429,1081,8329,2183,10512,0
2019/01,17,11/01/2019,5,SS 12 al Confine regionale (Lombardia),10982,00,9903,1079,8593,2389,10982,0
2019/01,17,12/01/2019,6,SS 12 al Confine regionale (Lombardia),9231,10,9009,221,6859,2372,0,9231
2019/01,17,13/01/2019,7,SS 12 al Confine regionale (Lombardia),7871,00,7816,55,5767,2104,0,7871
2019/01,17,14/01/2019,1,SS 12 al Confine regionale (Lombardia),10562,00,9539,1023,8426,2136,10562,0
2019/01,19,01/01/2019,2,SP 343R tra Colorno e Casalmaggiore,390,00,385,5,327,63,0,390
2019/01,19,02/01/2019,3,SP 343R tra Colorno e Casalmaggiore,620,00,587,33,531,89,620,0
2019/01,19,03/01/2019,4,SP 343R tra Colorno e Casalmaggiore,778,00,698,80,677,101,778,0
2019/01,19,04/01/2019,5,SP 343R tra Colorno e Casalmaggiore,784,00,722,62,649,135,784,0
2019/01,19,05/01/2019,6,SP 343R tra Colorno e Casalmaggiore,658,00,649,9,544,114,0,658
2019/01,19,06/01/2019,7,SP 343R tra Colorno e Casalmaggiore,553,00,549,4,464,89,0,553
2019/01,19,07/01/2019,1,SP 343R tra Colorno e Casalmaggiore,936,00,847,89,809,127,936,0
2019/01,19,08/01/2019,2,SP 343R tra Colorno e Casalmaggiore,919,00,819,100,798,121,919,0
2019/01,19,09/01/2019,3,SP 343R tra Colorno e Casalmaggiore,987,00,839,148,844,143,987,0
2019/01,19,10/01/2019,4,SP 343R tra Colorno e Casalmaggiore,1031,00,924,107,872,159,1031,0
2019/01,19,11/01/2019,5,SP 343R tra Colorno e Casalmaggiore,1052,00,892,160,909,143,1052,0
2019/01,19,12/01/2019,6,SP 343R tra Colorno e Casalmaggiore,749,00,730,19,640,109,0,749
2019/01,19,13/01/2019,7,SP 343R tra Colorno e Casalmaggiore,576,00,568,8,492,84,0,576
2019/01,19,14/01/2019,1,SP 343R tra Colorno e Casalmaggiore,1103,00,910,193,969,134,1103,0
2019/01,25,01/01/2019,2,SS 9 tra San Prospero (Case Crostolo) e Sant'Ilario d'Enza,15495,00,15406,89,8183,7312,0,15495
2019/01,25,02/01/2019,3,SS 9 tra San Prospero (Case Crostolo) e Sant'Ilario d'Enza,23586,20,22465,1119,18007,5579,23586,0
2019/01,25,03/01/2019,4,SS 9 tra San Prospero (Case Crostolo) e Sant'Ilario d'Enza,25425,00,23988,1437,19262,6163,25425,0
2019/01,25,04/01/2019,5,SS 9 tra San Prospero (Case Crostolo) e Sant'Ilario d'Enza,26880,20,25429,1449,19725,7155,26880,0
2019/01,25,05/01/2019,6,SS 9 tra San Prospero (Case Crostolo) e Sant'Ilario d'Enza,27179,00,26705,474,18842,8337,0,27179
2019/01,25,06/01/2019,7,SS 9 tra San Prospero (Case Crostolo) e Sant'Ilario d'Enza,22561,00,22454,107,15495,7066,0,22561
2019/01,25,07/01/2019,1,SS 9 tra San Prospero (Case Crostolo) e Sant'Ilario d'Enza,27942,10,26087,1854,21556,6386,27942,0
2019/01,25,08/01/2019,2,SS 9 tra San Prospero (Case Crostolo) e Sant'Ilario d'Enza,27967,30,26049,1915,21740,6227,27967,0
2019/01,25,09/01/2019,3,SS 9 tra San Prospero (Case Crostolo) e Sant'Ilario d'Enza,29399,40,27416,1979,22494,6905,29399,0
2019/01,25,10/01/2019,4,SS 9 tra San Prospero (Case Crostolo) e Sant'Ilario d'Enza,28646,110,26610,2025,21465,7181,28646,0
2019/01,25,11/01/2019,5,SS 9 tra San Prospero (Case Crostolo) e Sant'Ilario d'Enza,31673,10,29630,2042,23104,8569,31673,0
2019/01,25,12/01/2019,6,SS 9 tra San Prospero (Case Crostolo) e Sant'Ilario d'Enza,30809,20,30285,522,20922,9887,0,30809
2019/01,25,13/01/2019,7,SS 9 tra San Prospero (Case Crostolo) e Sant'Ilario d'Enza,25504,10,25369,134,17307,8197,0,25504
2019/01,25,14/01/2019,1,SS 9 tra San Prospero (Case Crostolo) e Sant'Ilario d'Enza,28999,50,26937,2057,22303,6696,28999,0
2019/01,29,01/01/2019,2,SS 9 tra Modena e Rubiera,12269,10,12184,84,6334,5935,0,12269
2019/01,29,02/01/2019,3,SS 9 tra Modena e Rubiera,19798,10,18791,1006,15338,4460,19798,0
2019/01,29,03/01/2019,4,SS 9 tra Modena e Rubiera,21135,30,19815,1317,16111,5024,21135,0
2019/01,29,04/01/2019,5,SS 9 tra Modena e Rubiera,22010,10,20739,1270,16154,5856,22010,0
2019/01,29,05/01/2019,6,SS 9 tra Modena e Rubiera,24203,00,23872,331,16874,7329,0,24203
2019/01,29,06/01/2019,7,SS 9 tra Modena e Rubiera,21475,00,21365,110,14983,6492,0,21475
2019/01,29,07/01/2019,1,SS 9 tra Modena e Rubiera,22683,40,20884,1795,17458,5225,22683,0
2019/01,29,08/01/2019,2,SS 9 tra Modena e Rubiera,22662,30,20629,2030,17757,4905,22662,0
2019/01,29,09/01/2019,3,SS 9 tra Modena e Rubiera,23564,10,21405,2158,18047,5517,23564,0
2019/01,29,10/01/2019,4,SS 9 tra Modena e Rubiera,24457,10,22023,2433,18680,5777,24457,0
2019/01,29,11/01/2019,5,SS 9 tra Modena e Rubiera,25429,10,23208,2220,18646,6783,25429,0
2019/01,29,12/01/2019,6,SS 9 tra Modena e Rubiera,25780,10,25378,401,18052,7728,0,25780
2019/01,29,13/01/2019,7,SS 9 tra Modena e Rubiera,24450,00,24337,113,17673,6777,0,24450
2019/01,29,14/01/2019,1,SS 9 tra Modena e Rubiera,24098,00,21869,2229,18318,5780,24098,0
2019/01,52,01/01/2019,2,SP 253 tra Sesto Imolese e Medicina,3104,00,3078,26,1974,1130,0,3104
2019/01,52,02/01/2019,3,SP 253 tra Sesto Imolese e Medicina,5128,00,4694,434,4200,928,5128,0
2019/01,52,03/01/2019,4,SP 253 tra Sesto Imolese e Medicina,4915,00,4502,413,3884,1031,4915,0
2019/01,52,04/01/2019,5,SP 253 tra Sesto Imolese e Medicina,5055,00,4650,405,3911,1144,5055,0
2019/01,52,05/01/2019,6,SP 253 tra Sesto Imolese e Medicina,4309,00,4191,118,3196,1113,0,4309
2019/01,52,06/01/2019,7,SP 253 tra Sesto Imolese e Medicina,3863,00,3822,41,2918,945,0,3863
2019/01,52,07/01/2019,1,SP 253 tra Sesto Imolese e Medicina,5820,00,5253,567,4689,1131,5820,0
2019/01,52,08/01/2019,2,SP 253 tra Sesto Imolese e Medicina,5636,00,5104,532,4484,1152,5636,0
2019/01,52,09/01/2019,3,SP 253 tra Sesto Imolese e Medicina,5770,00,5182,588,4624,1146,5770,0
2019/01,52,10/01/2019,4,SP 253 tra Sesto Imolese e Medicina,5892,00,5295,597,4680,1212,5892,0
2019/01,52,11/01/2019,5,SP 253 tra Sesto Imolese e Medicina,6111,00,5484,627,4729,1382,6111,0
2019/01,52,12/01/2019,6,SP 253 tra Sesto Imolese e Medicina,4715,10,4577,137,3484,1231,0,4715
2019/01,52,13/01/2019,7,SP 253 tra Sesto Imolese e Medicina,4154,00,4120,34,3097,1057,0,4154
2019/01,52,14/01/2019,1,SP 253 tra Sesto Imolese e Medicina,6000,00,5396,604,4738,1262,6000,0
2019/01,53,01/01/2019,2,SS 309 a San Giuseppe di Comacchio,6578,00,6402,176,4504,2074,0,6578
2019/01,53,02/01/2019,3,SS 309 a San Giuseppe di Comacchio,8502,00,6943,1559,6661,1841,8502,0
2019/01,53,03/01/2019,4,SS 309 a San Giuseppe di Comacchio,8562,00,6540,2022,6830,1732,8562,0
2019/01,53,04/01/2019,5,SS 309 a San Giuseppe di Comacchio,8699,00,6752,1947,6609,2090,8699,0
2019/01,53,05/01/2019,6,SS 309 a San Giuseppe di Comacchio,8347,00,7527,820,6042,2305,0,8347
2019/01,53,06/01/2019,7,SS 309 a San Giuseppe di Comacchio,8244,00,7859,385,5944,2300,0,8244
2019/01,53,07/01/2019,1,SS 309 a San Giuseppe di Comacchio,8602,00,5758,2844,6637,1965,8602,0
2019/01,53,08/01/2019,2,SS 309 a San Giuseppe di Comacchio,9001,00,5474,3527,7094,1907,9001,0
2019/01,53,09/01/2019,3,SS 309 a San Giuseppe di Comacchio,9073,00,5547,3526,7037,2036,9073,0
2019/01,53,10/01/2019,4,SS 309 a San Giuseppe di Comacchio,9298,00,5796,3502,7189,2109,9298,0
2019/01,53,11/01/2019,5,SS 309 a San Giuseppe di Comacchio,9643,10,6444,3198,7289,2354,9643,0
2019/01,53,12/01/2019,6,SS 309 a San Giuseppe di Comacchio,7707,00,6667,1040,5611,2096,0,7707
2019/01,53,13/01/2019,7,SS 309 a San Giuseppe di Comacchio,7940,00,7543,397,5735,2205,0,7940
2019/01,53,14/01/2019,1,SS 309 a San Giuseppe di Comacchio,9548,00,5954,3594,7344,2204,9548,0
2019/01,95,01/01/2019,2,SP 10R tra Castel San Giovanni e Sarmato,,,,,,,,
2019/01,95,02/01/2019,3,SP 10R tra Castel San Giovanni e Sarmato,,,,,,,,
2019/01,95,03/01/2019,4,SP 10R tra Castel San Giovanni e Sarmato,,,,,,,,
2019/01,95,04/01/2019,5,SP 10R tra Castel San Giovanni e Sarmato,,,,,,,,
2019/01,95,05/01/2019,6,SP 10R tra Castel San Giovanni e Sarmato,,,,,,,,
2019/01,95,06/01/2019,7,SP 10R tra Castel San Giovanni e Sarmato,,,,,,,,
2019/01,95,07/01/2019,1,SP 10R tra Castel San Giovanni e Sarmato,,,,,,,,
2019/01,95,08/01/2019,2,SP 10R tra Castel San Giovanni e Sarmato,,,,,,,,
2019/01,95,09/01/2019,3,SP 10R tra Castel San Giovanni e Sarmato,,,,,,,,
2019/01,95,10/01/2019,4,SP 10R tra Castel San Giovanni e Sarmato,,,,,,,,
2019/01,95,11/01/2019,5,SP 10R tra Castel San Giovanni e Sarmato,,,,,,,,
2019/01,95,12/01/2019,6,SP 10R tra Castel San Giovanni e Sarmato,,,,,,,,
2019/01,95,13/01/2019,7,SP 10R tra Castel San Giovanni e Sarmato,,,,,,,,
2019/01,95,14/01/2019,1,SP 10R tra Castel San Giovanni e Sarmato,,,,,,,,
2019/01,98,01/01/2019,2,SP 302R tra Brisighella e Marradi,2517,00,2507,10,1788,729,0,2517
2019/01,98,02/01/2019,3,SP 302R tra Brisighella e Marradi,2708,10,2638,69,2146,562,2708,0
2019/01,98,03/01/2019,4,SP 302R tra Brisighella e Marradi,2796,00,2718,78,2229,567,2796,0
2019/01,98,04/01/2019,5,SP 302R tra Brisighella e Marradi,2879,00,2801,78,2314,565,2879,0
2019/01,98,05/01/2019,6,SP 302R tra Brisighella e Marradi,2869,00,2836,33,2177,692,0,2869
2019/01,98,06/01/2019,7,SP 302R tra Brisighella e Marradi,2824,00,2809,15,2277,547,0,2824
2019/01,98,07/01/2019,1,SP 302R tra Brisighella e Marradi,2858,00,2764,94,2286,572,2858,0
2019/01,98,08/01/2019,2,SP 302R tra Brisighella e Marradi,2798,00,2700,98,2208,590,2798,0
2019/01,98,09/01/2019,3,SP 302R tra Brisighella e Marradi,2850,00,2736,114,2227,623,2850,0
2019/01,98,10/01/2019,4,SP 302R tra Brisighella e Marradi,2923,00,2805,118,2276,647,2923,0
2019/01,98,11/01/2019,5,SP 302R tra Brisighella e Marradi,3055,00,2949,106,2360,695,3055,0
2019/01,98,12/01/2019,6,SP 302R tra Brisighella e Marradi,2984,00,2947,37,2238,746,0,2984
2019/01,98,13/01/2019,7,SP 302R tra Brisighella e Marradi,2892,00,2884,8,2222,670,0,2892
2019/01,98,14/01/2019,1,SP 302R tra Brisighella e Marradi,2878,00,2756,122,2272,606,2878,0
2019/01,100,11/01/2019,5,SP 258R tra Villa Verucchio ed ex Confine regionale (località Dogana),15150,10,14081,1068,12008,3142,15150,0
2019/01,100,12/01/2019,6,SP 258R tra Villa Verucchio ed ex Confine regionale (località Dogana),13276,00,13010,266,10076,3200,0,13276
2019/01,100,13/01/2019,7,SP 258R tra Villa Verucchio ed ex Confine regionale (località Dogana),11297,00,11249,48,8684,2613,0,11297
2019/01,100,14/01/2019,1,SP 258R tra Villa Verucchio ed ex Confine regionale (località Dogana),14075,00,13012,1063,11420,2655,14075,0
2019/01,104,01/01/2019,2,SP 10 nuovo ponte sul Po tra innesto variante Zibello e confine regionale (Lombardia),2024,00,1981,43,1348,676,0,2024
2019/01,104,02/01/2019,3,SP 10 nuovo ponte sul Po tra innesto variante Zibello e confine regionale (Lombardia),3266,00,2559,707,2599,667,3266,0
2019/01,104,03/01/2019,4,SP 10 nuovo ponte sul Po tra innesto variante Zibello e confine regionale (Lombardia),3830,00,2966,864,3100,730,3830,0
2019/01,104,04/01/2019,5,SP 10 nuovo ponte sul Po tra innesto variante Zibello e confine regionale (Lombardia),3803,10,2859,943,3011,792,3803,0
2019/01,104,05/01/2019,6,SP 10 nuovo ponte sul Po tra innesto variante Zibello e confine regionale (Lombardia),3572,20,3310,260,2775,797,0,3572
2019/01,104,06/01/2019,7,SP 10 nuovo ponte sul Po tra innesto variante Zibello e confine regionale (Lombardia),3330,00,3256,74,2531,799,0,3330
2019/01,104,07/01/2019,1,SP 10 nuovo ponte sul Po tra innesto variante Zibello e confine regionale (Lombardia),3920,00,2895,1025,3145,775,3920,0
2019/01,104,08/01/2019,2,SP 10 nuovo ponte sul Po tra innesto variante Zibello e confine regionale (Lombardia),3740,00,2657,1083,2991,749,3740,0
2019/01,104,09/01/2019,3,SP 10 nuovo ponte sul Po tra innesto variante Zibello e confine regionale (Lombardia),4056,10,2928,1127,3225,831,4056,0
2019/01,104,10/01/2019,4,SP 10 nuovo ponte sul Po tra innesto variante Zibello e confine regionale (Lombardia),4113,00,2970,1143,3272,841,4113,0
2019/01,104,11/01/2019,5,SP 10 nuovo ponte sul Po tra innesto variante Zibello e confine regionale (Lombardia),4469,10,3299,1169,3468,1001,4469,0
2019/01,104,12/01/2019,6,SP 10 nuovo ponte sul Po tra innesto variante Zibello e confine regionale (Lombardia),3439,00,3176,263,2583,856,0,3439
2019/01,104,13/01/2019,7,SP 10 nuovo ponte sul Po tra innesto variante Zibello e confine regionale (Lombardia),3398,00,3332,66,2541,857,0,3398
2019/01,104,14/01/2019,1,SP 10 nuovo ponte sul Po tra innesto variante Zibello e confine regionale (Lombardia),4203,00,3051,1152,3366,837,4203,0
2019/01,107,01/01/2019,2,SP 85 tra Rubiera e bivio SP 13MO (c/o Campogalliano),4351,00,4313,38,2654,1697,0,4351
2019/01,107,02/01/2019,3,SP 85 tra Rubiera e bivio SP 13MO (c/o Campogalliano),7026,00,6613,413,5606,1420,7026,0
2019/01,107,03/01/2019,4,SP 85 tra Rubiera e bivio SP 13MO (c/o Campogalliano),7281,00,6843,438,5690,1591,7281,0
2019/01,107,04/01/2019,5,SP 85 tra Rubiera e bivio SP 13MO (c/o Campogalliano),7408,00,6984,424,5685,1723,7408,0
2019/01,107,05/01/2019,6,SP 85 tra Rubiera e bivio SP 13MO (c/o Campogalliano),7438,00,7330,108,5471,1967,0,7438
2019/01,107,06/01/2019,7,SP 85 tra Rubiera e bivio SP 13MO (c/o Campogalliano),6410,00,6376,34,4793,1617,0,6410
2019/01,107,07/01/2019,1,SP 85 tra Rubiera e bivio SP 13MO (c/o Campogalliano),8509,00,7708,801,6859,1650,8509,0
2019/01,107,08/01/2019,2,SP 85 tra Rubiera e bivio SP 13MO (c/o Campogalliano),8362,00,7506,856,6788,1574,8362,0
2019/01,107,09/01/2019,3,SP 85 tra Rubiera e bivio SP 13MO (c/o Campogalliano),8922,00,8056,866,7072,1850,8922,0
2019/01,107,10/01/2019,4,SP 85 tra Rubiera e bivio SP 13MO (c/o Campogalliano),9058,00,8140,918,7058,2000,9058,0
2019/01,107,11/01/2019,5,SP 85 tra Rubiera e bivio SP 13MO (c/o Campogalliano),9501,00,8596,905,7382,2119,9501,0
2019/01,107,12/01/2019,6,SP 85 tra Rubiera e bivio SP 13MO (c/o Campogalliano),7971,00,7838,133,5837,2134,0,7971
2019/01,107,13/01/2019,7,SP 85 tra Rubiera e bivio SP 13MO (c/o Campogalliano),6846,00,6805,41,5168,1678,0,6846
2019/01,107,14/01/2019,1,SP 85 tra Rubiera e bivio SP 13MO (c/o Campogalliano),8652,00,7762,890,6882,1770,8652,0
2019/01,108,01/01/2019,2,SP 412R tra Castel San Giovanni (Casello A 21) e ponte fiume Po,5653,00,5643,10,3693,1960,0,5653
2019/01,108,02/01/2019,3,SP 412R tra Castel San Giovanni (Casello A 21) e ponte fiume Po,9971,20,9810,159,7566,2405,9971,0
2019/01,108,03/01/2019,4,SP 412R tra Castel San Giovanni (Casello A 21) e ponte fiume Po,10812,20,10575,235,8123,2689,10812,0
2019/01,108,04/01/2019,5,SP 412R tra Castel San Giovanni (Casello A 21) e ponte fiume Po,10749,60,10525,218,7948,2801,10749,0
2019/01,108,05/01/2019,6,SP 412R tra Castel San Giovanni (Casello A 21) e ponte fiume Po,9952,00,9877,75,7508,2444,0,9952
2019/01,108,06/01/2019,7,SP 412R tra Castel San Giovanni (Casello A 21) e ponte fiume Po,8988,00,8954,34,6960,2028,0,8988
2019/01,108,07/01/2019,1,SP 412R tra Castel San Giovanni (Casello A 21) e ponte fiume Po,10655,20,10402,251,7941,2714,10655,0
2019/01,108,08/01/2019,2,SP 412R tra Castel San Giovanni (Casello A 21) e ponte fiume Po,11012,120,10690,310,8179,2833,11012,0
2019/01,108,09/01/2019,3,SP 412R tra Castel San Giovanni (Casello A 21) e ponte fiume Po,11378,130,11049,316,8458,2920,11378,0
2019/01,108,10/01/2019,4,SP 412R tra Castel San Giovanni (Casello A 21) e ponte fiume Po,11929,180,11553,358,8960,2969,11929,0
2019/01,108,11/01/2019,5,SP 412R tra Castel San Giovanni (Casello A 21) e ponte fiume Po,12322,130,11916,393,9155,3167,12322,0
2019/01,108,12/01/2019,6,SP 412R tra Castel San Giovanni (Casello A 21) e ponte fiume Po,10621,60,10508,107,8012,2609,0,10621
2019/01,108,13/01/2019,7,SP 412R tra Castel San Giovanni (Casello A 21) e ponte fiume Po,9857,00,9821,36,7500,2357,0,9857
2019/01,108,14/01/2019,1,SP 412R tra Castel San Giovanni (Casello A 21) e ponte fiume Po,11333,110,10973,349,8478,2855,11333,0
2019/01,112,01/01/2019,2,SP 111 tra Boretto e Viadana sul ponte Po,9115,00,9025,90,5563,3552,0,9115
2019/01,112,02/01/2019,3,SP 111 tra Boretto e Viadana sul ponte Po,14093,00,12781,1312,11035,3058,14093,0
2019/01,112,03/01/2019,4,SP 111 tra Boretto e Viadana sul ponte Po,15993,10,14468,1524,12656,3337,15993,0
2019/01,112,04/01/2019,5,SP 111 tra Boretto e Viadana sul ponte Po,17080,30,15413,1664,13180,3900,17080,0
2019/01,112,05/01/2019,6,SP 111 tra Boretto e Viadana sul ponte Po,16525,00,16060,465,12191,4334,0,16525
2019/01,112,06/01/2019,7,SP 111 tra Boretto e Viadana sul ponte Po,13910,00,13775,135,10145,3765,0,13910
2019/01,112,07/01/2019,1,SP 111 tra Boretto e Viadana sul ponte Po,18737,10,16357,2379,14827,3910,18737,0
2019/01,112,08/01/2019,2,SP 111 tra Boretto e Viadana sul ponte Po,18206,50,15519,2682,14531,3675,18206,0
2019/01,112,09/01/2019,3,SP 111 tra Boretto e Viadana sul ponte Po,19465,10,16879,2585,15341,4124,19465,0
2019/01,112,10/01/2019,4,SP 111 tra Boretto e Viadana sul ponte Po,19987,30,17330,2654,15652,4335,19987,0
2019/01,112,11/01/2019,5,SP 111 tra Boretto e Viadana sul ponte Po,21140,40,18536,2600,16355,4785,21140,0
2019/01,112,12/01/2019,6,SP 111 tra Boretto e Viadana sul ponte Po,18317,00,17750,567,13549,4768,0,18317
2019/01,112,13/01/2019,7,SP 111 tra Boretto e Viadana sul ponte Po,14643,00,14489,154,10543,4100,0,14643
2019/01,112,14/01/2019,1,SP 111 tra Boretto e Viadana sul ponte Po,19265,30,16663,2599,15092,4173,19265,0
2019/01,115,01/01/2019,2,SP 68 ad Ariano Polesine al Confine regionale (Veneto),1500,00,1491,9,945,555,0,1500
2019/01,115,02/01/2019,3,SP 68 ad Ariano Polesine al Confine regionale (Veneto),2130,10,1949,180,1673,457,2130,0
2019/01,115,03/01/2019,4,SP 68 ad Ariano Polesine al Confine regionale (Veneto),2306,00,2108,198,1839,467,2306,0
2019/01,115,04/01/2019,5,SP 68 ad Ariano Polesine al Confine regionale (Veneto),2475,00,2280,195,1921,554,2475,0
2019/01,115,05/01/2019,6,SP 68 ad Ariano Polesine al Confine regionale (Veneto),2252,00,2205,47,1710,542,0,2252
2019/01,115,06/01/2019,7,SP 68 ad Ariano Polesine al Confine regionale (Veneto),1840,00,1814,26,1290,550,0,1840
2019/01,115,07/01/2019,1,SP 68 ad Ariano Polesine al Confine regionale (Veneto),2498,00,2258,240,1993,505,2498,0
2019/01,115,08/01/2019,2,SP 68 ad Ariano Polesine al Confine regionale (Veneto),2340,00,2165,175,1883,457,2340,0
2019/01,115,09/01/2019,3,SP 68 ad Ariano Polesine al Confine regionale (Veneto),2427,00,2233,194,1941,486,2427,0
2019/01,115,10/01/2019,4,SP 68 ad Ariano Polesine al Confine regionale (Veneto),2511,00,2274,237,1968,543,2511,0
2019/01,115,11/01/2019,5,SP 68 ad Ariano Polesine al Confine regionale (Veneto),2731,00,2466,265,2034,697,2731,0
2019/01,115,12/01/2019,6,SP 68 ad Ariano Polesine al Confine regionale (Veneto),2305,00,2253,52,1723,582,0,2305
2019/01,115,13/01/2019,7,SP 68 ad Ariano Polesine al Confine regionale (Veneto),2095,00,2076,19,1509,586,0,2095
2019/01,115,14/01/2019,1,SP 68 ad Ariano Polesine al Confine regionale (Veneto),2634,00,2318,316,2103,531,2634,0
2019/01,116,01/01/2019,2,SP 138 tra SPiero in Bagno (E 45) e Bagno di Romagna,5300,00,5265,35,3895,1405,0,5300
2019/01,116,02/01/2019,3,SP 138 tra SPiero in Bagno (E 45) e Bagno di Romagna,5283,00,5157,126,4286,997,5283,0
2019/01,116,03/01/2019,4,SP 138 tra SPiero in Bagno (E 45) e Bagno di Romagna,4990,00,4842,148,3989,1001,4990,0
2019/01,116,04/01/2019,5,SP 138 tra SPiero in Bagno (E 45) e Bagno di Romagna,5277,00,5128,149,4109,1168,5277,0
2019/01,116,05/01/2019,6,SP 138 tra SPiero in Bagno (E 45) e Bagno di Romagna,5183,10,5093,89,3865,1318,0,5183
2019/01,116,06/01/2019,7,SP 138 tra SPiero in Bagno (E 45) e Bagno di Romagna,4836,00,4804,32,3766,1070,0,4836
2019/01,116,07/01/2019,1,SP 138 tra SPiero in Bagno (E 45) e Bagno di Romagna,5030,00,4822,208,4146,884,5030,0
2019/01,116,08/01/2019,2,SP 138 tra SPiero in Bagno (E 45) e Bagno di Romagna,5046,00,4798,248,4206,840,5046,0
2019/01,116,09/01/2019,3,SP 138 tra SPiero in Bagno (E 45) e Bagno di Romagna,5065,10,4844,220,4158,907,5065,0
2019/01,116,10/01/2019,4,SP 138 tra SPiero in Bagno (E 45) e Bagno di Romagna,4969,00,4749,220,4119,850,4969,0
2019/01,116,11/01/2019,5,SP 138 tra SPiero in Bagno (E 45) e Bagno di Romagna,5363,00,5198,165,4346,1017,5363,0
2019/01,116,12/01/2019,6,SP 138 tra SPiero in Bagno (E 45) e Bagno di Romagna,5136,10,5034,101,3955,1181,0,5136
2019/01,116,13/01/2019,7,SP 138 tra SPiero in Bagno (E 45) e Bagno di Romagna,4791,00,4778,13,3776,1015,0,4791
2019/01,116,14/01/2019,1,SP 138 tra SPiero in Bagno (E 45) e Bagno di Romagna,5025,00,4798,227,4198,827,5025,0
2019/01,117,01/01/2019,2,SS 63 tra Collagna e Sassalbo (Passo del Cerreto),1264,00,1260,4,936,328,0,1264
2019/01,117,02/01/2019,3,SS 63 tra Collagna e Sassalbo (Passo del Cerreto),721,00,694,27,642,79,721,0
2019/01,117,03/01/2019,4,SS 63 tra Collagna e Sassalbo (Passo del Cerreto),682,00,663,19,620,62,682,0
2019/01,117,04/01/2019,5,SS 63 tra Collagna e Sassalbo (Passo del Cerreto),736,00,705,31,651,85,736,0
2019/01,117,05/01/2019,6,SS 63 tra Collagna e Sassalbo (Passo del Cerreto),724,00,704,20,612,112,0,724
2019/01,117,06/01/2019,7,SS 63 tra Collagna e Sassalbo (Passo del Cerreto),902,00,902,0,807,95,0,902
2019/01,117,07/01/2019,1,SS 63 tra Collagna e Sassalbo (Passo del Cerreto),455,00,430,25,401,54,455,0
2019/01,117,08/01/2019,2,SS 63 tra Collagna e Sassalbo (Passo del Cerreto),333,00,314,19,295,38,333,0
2019/01,117,09/01/2019,3,SS 63 tra Collagna e Sassalbo (Passo del Cerreto),409,00,384,25,352,57,409,0
2019/01,117,10/01/2019,4,SS 63 tra Collagna e Sassalbo (Passo del Cerreto),383,00,360,23,334,49,383,0
2019/01,117,11/01/2019,5,SS 63 tra Collagna e Sassalbo (Passo del Cerreto),450,00,420,30,381,69,450,0
2019/01,117,12/01/2019,6,SS 63 tra Collagna e Sassalbo (Passo del Cerreto),592,00,578,14,534,58,0,592
2019/01,117,13/01/2019,7,SS 63 tra Collagna e Sassalbo (Passo del Cerreto),764,00,759,5,681,83,0,764
2019/01,117,14/01/2019,1,SS 63 tra Collagna e Sassalbo (Passo del Cerreto),374,00,338,36,330,44,374,0
2019/01,122,01/01/2019,2,SP 10R tra Piacenza (ponte fiume Trebbia) e San Nicolo',13199,00,13171,28,7595,5604,0,13199
2019/01,122,02/01/2019,3,SP 10R tra Piacenza (ponte fiume Trebbia) e San Nicolo',20781,30,20215,563,16147,4634,20781,0
2019/01,122,03/01/2019,4,SP 10R tra Piacenza (ponte fiume Trebbia) e San Nicolo',22192,20,21580,610,16994,5198,22192,0
2019/01,122,04/01/2019,5,SP 10R tra Piacenza (ponte fiume Trebbia) e San Nicolo',22990,30,22365,622,17186,5804,22990,0
2019/01,122,05/01/2019,6,SP 10R tra Piacenza (ponte fiume Trebbia) e San Nicolo',22543,10,22258,284,15657,6886,0,22543
2019/01,122,06/01/2019,7,SP 10R tra Piacenza (ponte fiume Trebbia) e San Nicolo',17322,00,17275,47,12353,4969,0,17322
2019/01,122,07/01/2019,1,SP 10R tra Piacenza (ponte fiume Trebbia) e San Nicolo',25388,60,24372,1010,19719,5669,25388,0
2019/01,122,08/01/2019,2,SP 10R tra Piacenza (ponte fiume Trebbia) e San Nicolo',25401,30,24293,1105,19969,5432,25401,0
2019/01,122,09/01/2019,3,SP 10R tra Piacenza (ponte fiume Trebbia) e San Nicolo',26911,80,25816,1087,20600,6311,26911,0
2019/01,122,10/01/2019,4,SP 10R tra Piacenza (ponte fiume Trebbia) e San Nicolo',26278,80,25204,1066,20229,6049,26278,0
2019/01,122,11/01/2019,5,SP 10R tra Piacenza (ponte fiume Trebbia) e San Nicolo',28814,40,27738,1072,21532,7282,28814,0
2019/01,122,12/01/2019,6,SP 10R tra Piacenza (ponte fiume Trebbia) e San Nicolo',25431,20,25106,323,17979,7452,0,25431
2019/01,122,13/01/2019,7,SP 10R tra Piacenza (ponte fiume Trebbia) e San Nicolo',18598,10,18540,57,12732,5866,0,18598
2019/01,122,14/01/2019,1,SP 10R tra Piacenza (ponte fiume Trebbia) e San Nicolo',26341,90,25214,1118,20514,5827,26341,0
2019/01,124,01/01/2019,2,SS 45 tra Piacenza e Settima,8961,00,8939,22,5727,3234,0,8961
2019/01,124,02/01/2019,3,SS 45 tra Piacenza e Settima,12638,10,12288,349,10096,2542,12638,0
2019/01,124,03/01/2019,4,SS 45 tra Piacenza e Settima,14482,00,14080,402,11546,2936,14482,0
2019/01,124,04/01/2019,5,SS 45 tra Piacenza e Settima,14700,00,14298,402,11291,3409,14700,0
2019/01,124,05/01/2019,6,SS 45 tra Piacenza e Settima,14425,00,14256,169,10608,3817,0,14425
2019/01,124,06/01/2019,7,SS 45 tra Piacenza e Settima,12124,10,12087,36,9200,2924,0,12124
2019/01,124,07/01/2019,1,SS 45 tra Piacenza e Settima,15665,00,15006,659,12433,3232,15665,0
2019/01,124,08/01/2019,2,SS 45 tra Piacenza e Settima,15061,00,14461,600,12052,3009,15061,0
2019/01,124,09/01/2019,3,SS 45 tra Piacenza e Settima,16037,10,15368,668,12704,3333,16037,0
2019/01,124,10/01/2019,4,SS 45 tra Piacenza e Settima,15551,00,14932,619,12289,3262,15551,0
2019/01,124,11/01/2019,5,SS 45 tra Piacenza e Settima,15255,00,14703,552,11169,4086,15255,0
2019/01,124,12/01/2019,6,SS 45 tra Piacenza e Settima,15274,00,15076,198,11160,4114,0,15274
2019/01,124,13/01/2019,7,SS 45 tra Piacenza e Settima,12594,00,12553,41,9262,3332,0,12594
2019/01,124,14/01/2019,1,SS 45 tra Piacenza e Settima,15485,10,14639,845,12329,3156,15485,0
2019/01,125,01/01/2019,2,SP 654R tra Piacenza (Tangenziale Sud) e Turro,9635,00,9591,44,6179,3456,0,9635
2019/01,125,02/01/2019,3,SP 654R tra Piacenza (Tangenziale Sud) e Turro,17976,00,17462,514,15008,2968,17976,0
2019/01,125,03/01/2019,4,SP 654R tra Piacenza (Tangenziale Sud) e Turro,17336,00,16816,520,14033,3303,17336,0
2019/01,125,04/01/2019,5,SP 654R tra Piacenza (Tangenziale Sud) e Turro,19432,10,18788,643,15803,3629,19432,0
2019/01,125,05/01/2019,6,SP 654R tra Piacenza (Tangenziale Sud) e Turro,17147,10,16900,246,13375,3772,0,17147
2019/01,125,06/01/2019,7,SP 654R tra Piacenza (Tangenziale Sud) e Turro,14653,00,14590,63,11204,3449,0,14653
2019/01,125,07/01/2019,1,SP 654R tra Piacenza (Tangenziale Sud) e Turro,22799,20,21868,929,18982,3817,22799,0
2019/01,125,08/01/2019,2,SP 654R tra Piacenza (Tangenziale Sud) e Turro,22531,10,21494,1036,18583,3948,22531,0
2019/01,126,01/01/2019,2,SP 6 tra Piacenza (Tangenziale Sud) e bivio SP 42/ponte fiume Nure in località San Giorgio Piacentino,8186,10,8170,15,4954,3232,0,8186
2019/01,126,02/01/2019,3,SP 6 tra Piacenza (Tangenziale Sud) e bivio SP 42/ponte fiume Nure in località San Giorgio Piacentino,11887,00,11522,365,9529,2358,11887,0
2019/01,126,03/01/2019,4,SP 6 tra Piacenza (Tangenziale Sud) e bivio SP 42/ponte fiume Nure in località San Giorgio Piacentino,13573,20,13132,439,10983,2590,13573,0
2019/01,126,04/01/2019,5,SP 6 tra Piacenza (Tangenziale Sud) e bivio SP 42/ponte fiume Nure in località San Giorgio Piacentino,13416,00,13040,376,10345,3071,13416,0
2019/01,126,05/01/2019,6,SP 6 tra Piacenza (Tangenziale Sud) e bivio SP 42/ponte fiume Nure in località San Giorgio Piacentino,12865,00,12632,233,9477,3388,0,12865
2019/01,126,06/01/2019,7,SP 6 tra Piacenza (Tangenziale Sud) e bivio SP 42/ponte fiume Nure in località San Giorgio Piacentino,10796,00,10746,50,8087,2709,0,10796
2019/01,126,07/01/2019,1,SP 6 tra Piacenza (Tangenziale Sud) e bivio SP 42/ponte fiume Nure in località San Giorgio Piacentino,14381,00,13856,525,11506,2875,14381,0
2019/01,126,08/01/2019,2,SP 6 tra Piacenza (Tangenziale Sud) e bivio SP 42/ponte fiume Nure in località San Giorgio Piacentino,14542,10,13942,599,11765,2777,14542,0
2019/01,126,09/01/2019,3,SP 6 tra Piacenza (Tangenziale Sud) e bivio SP 42/ponte fiume Nure in località San Giorgio Piacentino,15227,00,14592,635,12111,3116,15227,0
2019/01,126,10/01/2019,4,SP 6 tra Piacenza (Tangenziale Sud) e bivio SP 42/ponte fiume Nure in località San Giorgio Piacentino,15410,00,14733,677,12164,3246,15410,0
2019/01,126,11/01/2019,5,SP 6 tra Piacenza (Tangenziale Sud) e bivio SP 42/ponte fiume Nure in località San Giorgio Piacentino,16664,00,15995,669,12785,3879,16664,0
2019/01,126,12/01/2019,6,SP 6 tra Piacenza (Tangenziale Sud) e bivio SP 42/ponte fiume Nure in località San Giorgio Piacentino,14917,10,14696,220,10967,3950,0,14917
2019/01,126,13/01/2019,7,SP 6 tra Piacenza (Tangenziale Sud) e bivio SP 42/ponte fiume Nure in località San Giorgio Piacentino,11061,00,11023,38,8175,2886,0,11061
2019/01,126,14/01/2019,1,SP 6 tra Piacenza (Tangenziale Sud) e bivio SP 42/ponte fiume Nure in località San Giorgio Piacentino,15491,10,14888,602,12414,3077,15491,0
2019/01,128,01/01/2019,2,SP 10R tra Piacenza (Casello A 1/A 21) e il bivio SP 10R e SP 587R,7138,00,7093,45,4286,2852,0,7138
2019/01,128,02/01/2019,3,SP 10R tra Piacenza (Casello A 1/A 21) e il bivio SP 10R e SP 587R,13027,00,11979,1048,10137,2890,13027,0
2019/01,128,03/01/2019,4,SP 10R tra Piacenza (Casello A 1/A 21) e il bivio SP 10R e SP 587R,13696,00,12376,1320,10674,3022,13696,0
2019/01,128,04/01/2019,5,SP 10R tra Piacenza (Casello A 1/A 21) e il bivio SP 10R e SP 587R,14367,00,13140,1227,10881,3486,14367,0
2019/01,128,05/01/2019,6,SP 10R tra Piacenza (Casello A 1/A 21) e il bivio SP 10R e SP 587R,12133,00,11803,330,8486,3647,0,12133
2019/01,128,06/01/2019,7,SP 10R tra Piacenza (Casello A 1/A 21) e il bivio SP 10R e SP 587R,10308,00,10243,65,7359,2949,0,10308
2019/01,128,07/01/2019,1,SP 10R tra Piacenza (Casello A 1/A 21) e il bivio SP 10R e SP 587R,15973,00,14257,1716,12815,3158,15973,0
2019/01,128,08/01/2019,2,SP 10R tra Piacenza (Casello A 1/A 21) e il bivio SP 10R e SP 587R,16080,00,14146,1934,12835,3245,16080,0
2019/01,128,09/01/2019,3,SP 10R tra Piacenza (Casello A 1/A 21) e il bivio SP 10R e SP 587R,17124,00,15156,1968,13446,3678,17124,0
2019/01,128,10/01/2019,4,SP 10R tra Piacenza (Casello A 1/A 21) e il bivio SP 10R e SP 587R,17213,00,15190,2023,13434,3779,17213,0
2019/01,128,11/01/2019,5,SP 10R tra Piacenza (Casello A 1/A 21) e il bivio SP 10R e SP 587R,18107,00,16214,1893,13686,4421,18107,0
2019/01,128,12/01/2019,6,SP 10R tra Piacenza (Casello A 1/A 21) e il bivio SP 10R e SP 587R,13674,00,13257,417,9552,4122,0,13674
2019/01,128,13/01/2019,7,SP 10R tra Piacenza (Casello A 1/A 21) e il bivio SP 10R e SP 587R,10333,00,10258,75,7344,2989,0,10333
2019/01,128,14/01/2019,1,SP 10R tra Piacenza (Casello A 1/A 21) e il bivio SP 10R e SP 587R,17175,00,15297,1878,13660,3515,17175,0
2019/01,129,01/01/2019,2,SS 9Var tra Parma e ponte fiume Taro (Tangenziale nord di Parma),,,,,,,,
2019/01,129,02/01/2019,3,SS 9Var tra Parma e ponte fiume Taro (Tangenziale nord di Parma),,,,,,,,
2019/01,129,03/01/2019,4,SS 9Var tra Parma e ponte fiume Taro (Tangenziale nord di Parma),,,,,,,,
2019/01,129,04/01/2019,5,SS 9Var tra Parma e ponte fiume Taro (Tangenziale nord di Parma),,,,,,,,
2019/01,129,05/01/2019,6,SS 9Var tra Parma e ponte fiume Taro (Tangenziale nord di Parma),,,,,,,,
2019/01,129,06/01/2019,7,SS 9Var tra Parma e ponte fiume Taro (Tangenziale nord di Parma),,,,,,,,
2019/01,129,07/01/2019,1,SS 9Var tra Parma e ponte fiume Taro (Tangenziale nord di Parma),,,,,,,,
2019/01,129,08/01/2019,2,SS 9Var tra Parma e ponte fiume Taro (Tangenziale nord di Parma),,,,,,,,
2019/01,129,09/01/2019,3,SS 9Var tra Parma e ponte fiume Taro (Tangenziale nord di Parma),,,,,,,,
2019/01,129,10/01/2019,4,SS 9Var tra Parma e ponte fiume Taro (Tangenziale nord di Parma),,,,,,,,
2019/01,129,11/01/2019,5,SS 9Var tra Parma e ponte fiume Taro (Tangenziale nord di Parma),,,,,,,,
2019/01,129,12/01/2019,6,SS 9Var tra Parma e ponte fiume Taro (Tangenziale nord di Parma),,,,,,,,
2019/01,129,13/01/2019,7,SS 9Var tra Parma e ponte fiume Taro (Tangenziale nord di Parma),,,,,,,,
2019/01,129,14/01/2019,1,SS 9Var tra Parma e ponte fiume Taro (Tangenziale nord di Parma),,,,,,,,
2019/01,130,01/01/2019,2,SS 62 tra Parma e Collecchio,10674,00,10631,43,6259,4415,0,10674
2019/01,130,02/01/2019,3,SS 62 tra Parma e Collecchio,16416,10,15841,574,12959,3457,16416,0
2019/01,130,03/01/2019,4,SS 62 tra Parma e Collecchio,17946,00,17259,687,14200,3746,17946,0
2019/01,130,04/01/2019,5,SS 62 tra Parma e Collecchio,18984,00,18149,835,14622,4362,18984,0
2019/01,130,05/01/2019,6,SS 62 tra Parma e Collecchio,16852,00,16614,238,12067,4785,0,16852
2019/01,130,06/01/2019,7,SS 62 tra Parma e Collecchio,14196,00,14120,76,9980,4216,0,14196
2019/01,130,07/01/2019,1,SS 62 tra Parma e Collecchio,20163,00,19076,1087,15998,4165,20163,0
2019/01,130,08/01/2019,2,SS 62 tra Parma e Collecchio,21036,20,19921,1113,16723,4313,21036,0
2019/01,130,09/01/2019,3,SS 62 tra Parma e Collecchio,21423,00,20241,1182,16832,4591,21423,0
2019/01,130,10/01/2019,4,SS 62 tra Parma e Collecchio,21707,00,20579,1128,16970,4737,21707,0
2019/01,130,11/01/2019,5,SS 62 tra Parma e Collecchio,22618,00,21346,1272,17533,5085,22618,0
2019/01,130,12/01/2019,6,SS 62 tra Parma e Collecchio,18772,00,18438,334,13529,5243,0,18772
2019/01,130,13/01/2019,7,SS 62 tra Parma e Collecchio,14793,00,14709,84,10300,4493,0,14793
2019/01,130,14/01/2019,1,SS 62 tra Parma e Collecchio,20889,10,19696,1192,16397,4492,20889,0
2019/01,131,01/01/2019,2,SP 665R tra Parma e Corcagnano,10908,00,10868,40,6601,4307,0,10908
2019/01,131,02/01/2019,3,SP 665R tra Parma e Corcagnano,16038,40,15347,687,12666,3372,16038,0
2019/01,131,03/01/2019,4,SP 665R tra Parma e Corcagnano,17326,60,16477,843,13841,3485,17326,0
2019/01,131,04/01/2019,5,SP 665R tra Parma e Corcagnano,17993,20,17124,867,13885,4108,17993,0
2019/01,131,05/01/2019,6,SP 665R tra Parma e Corcagnano,16720,30,16495,222,12311,4409,0,16720
2019/01,131,06/01/2019,7,SP 665R tra Parma e Corcagnano,13830,00,13774,56,10171,3659,0,13830
2019/01,131,07/01/2019,1,SP 665R tra Parma e Corcagnano,19375,00,18365,1010,15638,3737,19375,0
2019/01,131,08/01/2019,2,SP 665R tra Parma e Corcagnano,19888,00,18870,1018,15895,3993,19888,0
2019/01,131,09/01/2019,3,SP 665R tra Parma e Corcagnano,20147,40,19047,1096,16078,4069,20147,0
2019/01,131,10/01/2019,4,SP 665R tra Parma e Corcagnano,20674,40,19563,1107,16459,4215,20674,0
2019/01,131,11/01/2019,5,SP 665R tra Parma e Corcagnano,21393,10,20227,1165,16713,4680,21393,0
2019/01,131,12/01/2019,6,SP 665R tra Parma e Corcagnano,19008,10,18722,285,14015,4993,0,19008
2019/01,131,13/01/2019,7,SP 665R tra Parma e Corcagnano,14579,00,14520,59,10674,3905,0,14579
2019/01,131,14/01/2019,1,SP 665R tra Parma e Corcagnano,20042,30,18943,1096,16125,3917,20042,0
2019/01,132,01/01/2019,2,SP 513R tra Parma e Pilastrello,9838,00,9801,37,5898,3940,0,9838
2019/01,132,02/01/2019,3,SP 513R tra Parma e Pilastrello,15808,10,15252,555,12636,3172,15808,0
2019/01,132,03/01/2019,4,SP 513R tra Parma e Pilastrello,17284,00,16744,540,13725,3559,17284,0
2019/01,132,04/01/2019,5,SP 513R tra Parma e Pilastrello,18088,00,17411,677,14037,4051,18088,0
2019/01,132,05/01/2019,6,SP 513R tra Parma e Pilastrello,16708,00,16500,208,12437,4271,0,16708
2019/01,132,06/01/2019,7,SP 513R tra Parma e Pilastrello,14352,00,14286,66,10896,3456,0,14352
2019/01,132,07/01/2019,1,SP 513R tra Parma e Pilastrello,19149,00,18422,727,15426,3723,19149,0
2019/01,132,08/01/2019,2,SP 513R tra Parma e Pilastrello,19708,00,18850,858,15847,3861,19708,0
2019/01,132,09/01/2019,3,SP 513R tra Parma e Pilastrello,20240,10,19407,832,16085,4155,20240,0
2019/01,132,10/01/2019,4,SP 513R tra Parma e Pilastrello,20841,10,19930,910,16561,4280,20841,0
2019/01,132,11/01/2019,5,SP 513R tra Parma e Pilastrello,21465,00,20553,912,16670,4795,21465,0
2019/01,132,12/01/2019,6,SP 513R tra Parma e Pilastrello,18230,00,17994,236,13634,4596,0,18230
2019/01,132,13/01/2019,7,SP 513R tra Parma e Pilastrello,14607,00,14544,63,10952,3655,0,14607
2019/01,132,14/01/2019,1,SP 513R tra Parma e Pilastrello,20027,20,19206,819,16091,3936,20027,0
2019/01,133,01/01/2019,2,SP 62R tra Parma (viadotto A 1) e Sorbolo,9759,00,9683,76,5606,4153,0,9759
2019/01,133,02/01/2019,3,SP 62R tra Parma (viadotto A 1) e Sorbolo,15086,10,13930,1155,11702,3384,15086,0
2019/01,133,03/01/2019,4,SP 62R tra Parma (viadotto A 1) e Sorbolo,15804,10,14513,1290,12344,3460,15804,0
2019/01,133,04/01/2019,5,SP 62R tra Parma (viadotto A 1) e Sorbolo,16653,00,15330,1323,12564,4089,16653,0
2019/01,133,05/01/2019,6,SP 62R tra Parma (viadotto A 1) e Sorbolo,17135,00,16676,459,12528,4607,0,17135
2019/01,133,06/01/2019,7,SP 62R tra Parma (viadotto A 1) e Sorbolo,14923,10,14817,105,10740,4183,0,14923
2019/01,133,07/01/2019,1,SP 62R tra Parma (viadotto A 1) e Sorbolo,17956,00,16153,1803,14016,3940,17956,0
2019/01,133,08/01/2019,2,SP 62R tra Parma (viadotto A 1) e Sorbolo,17971,00,15913,2058,14068,3903,17971,0
2019/01,133,09/01/2019,3,SP 62R tra Parma (viadotto A 1) e Sorbolo,18284,00,16215,2069,14265,4019,18284,0
2019/01,133,10/01/2019,4,SP 62R tra Parma (viadotto A 1) e Sorbolo,18747,00,16680,2067,14494,4253,18747,0
2019/01,133,11/01/2019,5,SP 62R tra Parma (viadotto A 1) e Sorbolo,19677,20,17557,2118,14840,4837,19677,0
2019/01,133,12/01/2019,6,SP 62R tra Parma (viadotto A 1) e Sorbolo,17865,10,17415,449,12832,5033,0,17865
2019/01,133,13/01/2019,7,SP 62R tra Parma (viadotto A 1) e Sorbolo,15855,10,15738,116,11213,4642,0,15855
2019/01,133,14/01/2019,1,SP 62R tra Parma (viadotto A 1) e Sorbolo,18728,20,16629,2097,14665,4063,18728,0
2019/01,134,01/01/2019,2,SP 343R tra Parma e San Polo,6533,00,6435,98,3665,2868,0,6533
2019/01,134,02/01/2019,3,SP 343R tra Parma e San Polo,12584,00,11473,1111,9722,2862,12584,0
2019/01,134,03/01/2019,4,SP 343R tra Parma e San Polo,14572,20,13199,1371,11322,3250,14572,0
2019/01,134,04/01/2019,5,SP 343R tra Parma e San Polo,14666,10,13178,1487,11288,3378,14666,0
2019/01,134,05/01/2019,6,SP 343R tra Parma e San Polo,12478,00,12036,442,9208,3270,0,12478
2019/01,134,06/01/2019,7,SP 343R tra Parma e San Polo,9463,10,9354,108,6651,2812,0,9463
2019/01,134,07/01/2019,1,SP 343R tra Parma e San Polo,17700,00,15655,2045,13947,3753,17700,0
2019/01,134,08/01/2019,2,SP 343R tra Parma e San Polo,17597,10,15470,2126,13948,3649,17597,0
2019/01,134,09/01/2019,3,SP 343R tra Parma e San Polo,15555,00,13545,2010,11533,4022,15555,0
2019/01,134,10/01/2019,4,SP 343R tra Parma e San Polo,18473,00,16169,2304,14380,4093,18473,0
2019/01,134,11/01/2019,5,SP 343R tra Parma e San Polo,18825,00,16512,2313,14553,4272,18825,0
2019/01,134,12/01/2019,6,SP 343R tra Parma e San Polo,14159,00,13700,459,10344,3815,0,14159
2019/01,134,13/01/2019,7,SP 343R tra Parma e San Polo,10200,00,10062,138,7238,2962,0,10200
2019/01,134,14/01/2019,1,SP 343R tra Parma e San Polo,18510,00,16240,2270,14605,3905,18510,0
2019/01,135,01/01/2019,2,SP 10 tra Parma (Tangenziale) e Viarolo,,,,,,,,
2019/01,135,02/01/2019,3,SP 10 tra Parma (Tangenziale) e Viarolo,,,,,,,,
2019/01,135,03/01/2019,4,SP 10 tra Parma (Tangenziale) e Viarolo,,,,,,,,
2019/01,135,04/01/2019,5,SP 10 tra Parma (Tangenziale) e Viarolo,,,,,,,,
2019/01,135,05/01/2019,6,SP 10 tra Parma (Tangenziale) e Viarolo,,,,,,,,
2019/01,135,06/01/2019,7,SP 10 tra Parma (Tangenziale) e Viarolo,,,,,,,,
2019/01,135,07/01/2019,1,SP 10 tra Parma (Tangenziale) e Viarolo,,,,,,,,
2019/01,135,08/01/2019,2,SP 10 tra Parma (Tangenziale) e Viarolo,,,,,,,,
2019/01,135,09/01/2019,3,SP 10 tra Parma (Tangenziale) e Viarolo,,,,,,,,
2019/01,135,10/01/2019,4,SP 10 tra Parma (Tangenziale) e Viarolo,,,,,,,,
2019/01,135,11/01/2019,5,SP 10 tra Parma (Tangenziale) e Viarolo,,,,,,,,
2019/01,135,12/01/2019,6,SP 10 tra Parma (Tangenziale) e Viarolo,,,,,,,,
2019/01,135,13/01/2019,7,SP 10 tra Parma (Tangenziale) e Viarolo,,,,,,,,
2019/01,135,14/01/2019,1,SP 10 tra Parma (Tangenziale) e Viarolo,,,,,,,,
2019/01,138,01/01/2019,2,SS 63 tra Reggio Emilia e Puianello,7977,10,7942,34,5148,2829,0,7977
2019/01,138,02/01/2019,3,SS 63 tra Reggio Emilia e Puianello,10363,20,10094,267,8168,2195,10363,0
2019/01,138,03/01/2019,4,SS 63 tra Reggio Emilia e Puianello,10859,00,10518,341,8399,2460,10859,0
2019/01,138,04/01/2019,5,SS 63 tra Reggio Emilia e Puianello,11749,30,11416,330,8942,2807,11749,0
2019/01,138,05/01/2019,6,SS 63 tra Reggio Emilia e Puianello,11364,00,11218,146,8278,3086,0,11364
2019/01,138,06/01/2019,7,SS 63 tra Reggio Emilia e Puianello,9799,10,9767,31,7285,2514,0,9799
2019/01,138,07/01/2019,1,SS 63 tra Reggio Emilia e Puianello,11086,20,10721,363,8628,2458,11086,0
2019/01,138,08/01/2019,2,SS 63 tra Reggio Emilia e Puianello,11434,10,11007,426,8922,2512,11434,0
2019/01,138,09/01/2019,3,SS 63 tra Reggio Emilia e Puianello,11605,00,11233,372,8870,2735,11605,0
2019/01,138,10/01/2019,4,SS 63 tra Reggio Emilia e Puianello,11952,20,11571,379,9026,2926,11952,0
2019/01,138,11/01/2019,5,SS 63 tra Reggio Emilia e Puianello,12458,10,12079,378,9319,3139,12458,0
2019/01,138,12/01/2019,6,SS 63 tra Reggio Emilia e Puianello,12971,00,12807,164,9134,3837,0,12971
2019/01,138,13/01/2019,7,SS 63 tra Reggio Emilia e Puianello,10706,00,10684,22,7700,3006,0,10706
2019/01,138,14/01/2019,1,SS 63 tra Reggio Emilia e Puianello,11591,00,11174,417,8959,2632,11591,0
2019/01,140,01/01/2019,2,SS 9 tra Masone e Rubiera,13103,00,13008,95,6947,6156,0,13103
2019/01,140,02/01/2019,3,SS 9 tra Masone e Rubiera,19328,00,18139,1189,14843,4485,19328,0
2019/01,140,03/01/2019,4,SS 9 tra Masone e Rubiera,20788,20,19107,1679,15597,5191,20788,0
2019/01,140,04/01/2019,5,SS 9 tra Masone e Rubiera,22182,20,20576,1604,16230,5952,22182,0
2019/01,140,05/01/2019,6,SS 9 tra Masone e Rubiera,22361,10,21896,464,14966,7395,0,22361
2019/01,140,06/01/2019,7,SS 9 tra Masone e Rubiera,19122,00,18992,130,12915,6207,0,19122
2019/01,140,07/01/2019,1,SS 9 tra Masone e Rubiera,22838,10,20710,2127,17531,5307,22838,0
2019/01,140,08/01/2019,2,SS 9 tra Masone e Rubiera,23882,10,21421,2460,18384,5498,23882,0
2019/01,140,09/01/2019,3,SS 9 tra Masone e Rubiera,24678,30,22174,2501,18608,6070,24678,0
2019/01,140,10/01/2019,4,SS 9 tra Masone e Rubiera,25350,30,22530,2817,18913,6437,25350,0
2019/01,140,11/01/2019,5,SS 9 tra Masone e Rubiera,26783,20,24152,2629,19468,7315,26783,0
2019/01,140,12/01/2019,6,SS 9 tra Masone e Rubiera,24601,20,23970,629,17207,7394,0,24601
2019/01,140,13/01/2019,7,SS 9 tra Masone e Rubiera,21138,10,20999,138,14447,6691,0,21138
2019/01,140,14/01/2019,1,SS 9 tra Masone e Rubiera,24639,00,22026,2613,18763,5876,24639,0
2019/01,143,01/01/2019,2,SP 63R tra Sesso e Cadelbosco di Sopra (bivio SP 358R),10219,00,10185,34,5759,4460,0,10219
2019/01,143,02/01/2019,3,SP 63R tra Sesso e Cadelbosco di Sopra (bivio SP 358R),18061,00,17430,631,14308,3753,18061,0
2019/01,143,03/01/2019,4,SP 63R tra Sesso e Cadelbosco di Sopra (bivio SP 358R),19641,00,18865,776,15463,4178,19641,0
2019/01,143,04/01/2019,5,SP 63R tra Sesso e Cadelbosco di Sopra (bivio SP 358R),21388,00,20543,845,16501,4887,21388,0
2019/01,143,05/01/2019,6,SP 63R tra Sesso e Cadelbosco di Sopra (bivio SP 358R),19514,00,19232,282,14060,5454,0,19514
2019/01,143,06/01/2019,7,SP 63R tra Sesso e Cadelbosco di Sopra (bivio SP 358R),15988,10,15914,73,11216,4772,0,15988
2019/01,143,07/01/2019,1,SP 63R tra Sesso e Cadelbosco di Sopra (bivio SP 358R),23472,10,22288,1183,18936,4536,23472,0
2019/01,143,08/01/2019,2,SP 63R tra Sesso e Cadelbosco di Sopra (bivio SP 358R),23903,00,22626,1277,19384,4519,23903,0
2019/01,143,09/01/2019,3,SP 63R tra Sesso e Cadelbosco di Sopra (bivio SP 358R),24907,00,23609,1298,19842,5065,24907,0
2019/01,143,10/01/2019,4,SP 63R tra Sesso e Cadelbosco di Sopra (bivio SP 358R),24807,10,23482,1324,19646,5161,24807,0
2019/01,143,11/01/2019,5,SP 63R tra Sesso e Cadelbosco di Sopra (bivio SP 358R),25917,00,24554,1363,19972,5945,25917,0
2019/01,143,12/01/2019,6,SP 63R tra Sesso e Cadelbosco di Sopra (bivio SP 358R),22309,00,21950,359,16087,6222,0,22309
2019/01,143,13/01/2019,7,SP 63R tra Sesso e Cadelbosco di Sopra (bivio SP 358R),16775,00,16694,81,11724,5051,0,16775
2019/01,143,14/01/2019,1,SP 63R tra Sesso e Cadelbosco di Sopra (bivio SP 358R),24987,00,23595,1392,20026,4961,24987,0
2019/01,146,01/01/2019,2,SS 12 tra Montale e Modena,11225,10,11166,58,6552,4673,0,11225
2019/01,146,02/01/2019,3,SS 12 tra Montale e Modena,15473,30,14781,689,12230,3243,15473,0
2019/01,146,03/01/2019,4,SS 12 tra Montale e Modena,17134,30,16334,797,13481,3653,17134,0
2019/01,146,04/01/2019,5,SS 12 tra Montale e Modena,17603,10,16794,808,13585,4018,17603,0
2019/01,146,05/01/2019,6,SS 12 tra Montale e Modena,15961,00,15669,292,11395,4566,0,15961
2019/01,146,06/01/2019,7,SS 12 tra Montale e Modena,14743,20,14669,72,10837,3906,0,14743
2019/01,146,07/01/2019,1,SS 12 tra Montale e Modena,19336,00,18244,1092,15261,4075,19336,0
2019/01,146,08/01/2019,2,SS 12 tra Montale e Modena,19974,20,18834,1138,15834,4140,19974,0
2019/01,146,09/01/2019,3,SS 12 tra Montale e Modena,20447,00,19230,1217,16108,4339,20447,0
2019/01,146,10/01/2019,4,SS 12 tra Montale e Modena,20975,10,19792,1182,16265,4710,20975,0
2019/01,146,11/01/2019,5,SS 12 tra Montale e Modena,21821,20,20594,1225,16567,5254,21821,0
2019/01,146,12/01/2019,6,SS 12 tra Montale e Modena,18785,10,18470,314,13284,5501,0,18785
2019/01,146,13/01/2019,7,SS 12 tra Montale e Modena,15587,00,15502,85,11268,4319,0,15587
2019/01,146,14/01/2019,1,SS 12 tra Montale e Modena,20775,20,19531,1242,16316,4459,20775,0
2019/01,147,01/01/2019,2,SP 623 tra Modena Sud/casello A 1 e Spilamberto,9858,00,9750,108,6101,3757,0,9858
2019/01,147,02/01/2019,3,SP 623 tra Modena Sud/casello A 1 e Spilamberto,14195,00,12701,1494,11161,3034,14195,0
2019/01,147,03/01/2019,4,SP 623 tra Modena Sud/casello A 1 e Spilamberto,15311,10,13505,1805,12023,3288,15311,0
2019/01,147,04/01/2019,5,SP 623 tra Modena Sud/casello A 1 e Spilamberto,16021,00,14137,1884,12133,3888,16021,0
2019/01,147,05/01/2019,6,SP 623 tra Modena Sud/casello A 1 e Spilamberto,14225,00,13801,424,10093,4132,0,14225
2019/01,147,06/01/2019,7,SP 623 tra Modena Sud/casello A 1 e Spilamberto,12782,00,12624,158,9360,3422,0,12782
2019/01,147,07/01/2019,1,SP 623 tra Modena Sud/casello A 1 e Spilamberto,16891,10,14365,2525,13291,3600,16891,0
2019/01,147,08/01/2019,2,SP 623 tra Modena Sud/casello A 1 e Spilamberto,18017,00,15056,2961,14137,3880,18017,0
2019/01,147,09/01/2019,3,SP 623 tra Modena Sud/casello A 1 e Spilamberto,18639,10,15687,2951,14547,4092,18639,0
2019/01,147,10/01/2019,4,SP 623 tra Modena Sud/casello A 1 e Spilamberto,18674,00,15639,3035,14502,4172,18674,0
2019/01,147,11/01/2019,5,SP 623 tra Modena Sud/casello A 1 e Spilamberto,20329,00,17221,3108,15667,4662,20329,0
2019/01,147,12/01/2019,6,SP 623 tra Modena Sud/casello A 1 e Spilamberto,15942,00,15373,569,11408,4534,0,15942
2019/01,147,13/01/2019,7,SP 623 tra Modena Sud/casello A 1 e Spilamberto,13871,00,13712,159,10006,3865,0,13871
2019/01,147,14/01/2019,1,SP 623 tra Modena Sud/casello A 1 e Spilamberto,18782,00,15638,3144,14733,4049,18782,0
2019/01,149,01/01/2019,2,SP 255 tra Modena e Navicello,14701,00,14626,75,8306,6395,0,14701
2019/01,149,02/01/2019,3,SP 255 tra Modena e Navicello,24777,50,23330,1442,19583,5194,24777,0
2019/01,149,03/01/2019,4,SP 255 tra Modena e Navicello,27576,20,25854,1720,21685,5891,27576,0
2019/01,149,04/01/2019,5,SP 255 tra Modena e Navicello,29057,20,27273,1782,22133,6924,29057,0
2019/01,149,05/01/2019,6,SP 255 tra Modena e Navicello,25079,00,24632,447,17769,7310,0,25079
2019/01,149,06/01/2019,7,SP 255 tra Modena e Navicello,21530,10,21418,111,15239,6291,0,21530
2019/01,149,07/01/2019,1,SP 255 tra Modena e Navicello,33252,270,30587,2638,26189,7063,33252,0
2019/01,149,08/01/2019,2,SP 255 tra Modena e Navicello,33268,360,30311,2921,26430,6838,33268,0
2019/01,149,09/01/2019,3,SP 255 tra Modena e Navicello,34540,400,31558,2942,26910,7630,34540,0
2019/01,149,10/01/2019,4,SP 255 tra Modena e Navicello,35548,380,32277,3233,27576,7972,35548,0
2019/01,149,11/01/2019,5,SP 255 tra Modena e Navicello,38243,620,35119,3062,29296,8947,38243,0
2019/01,149,12/01/2019,6,SP 255 tra Modena e Navicello,30047,10,29462,584,21477,8570,0,30047
2019/01,149,13/01/2019,7,SP 255 tra Modena e Navicello,23217,10,23117,99,16396,6821,0,23217
2019/01,149,14/01/2019,1,SP 255 tra Modena e Navicello,34960,610,31803,3096,27499,7461,34960,0
2019/01,150,01/01/2019,2,SS 12 tra Modena e Bastiglia,10487,00,10456,31,5783,4704,0,10487
2019/01,150,02/01/2019,3,SS 12 tra Modena e Bastiglia,16469,00,15571,898,12829,3640,16469,0
2019/01,150,03/01/2019,4,SS 12 tra Modena e Bastiglia,18286,00,17223,1063,14232,4054,18286,0
2019/01,150,04/01/2019,5,SS 12 tra Modena e Bastiglia,19119,00,18084,1035,14376,4743,19119,0
2019/01,150,05/01/2019,6,SS 12 tra Modena e Bastiglia,17294,00,17042,252,11832,5462,0,17294
2019/01,150,06/01/2019,7,SS 12 tra Modena e Bastiglia,14949,00,14919,30,10298,4651,0,14949
2019/01,150,07/01/2019,1,SS 12 tra Modena e Bastiglia,22168,00,20508,1660,17627,4541,22168,0
2019/01,150,08/01/2019,2,SS 12 tra Modena e Bastiglia,21722,40,19905,1813,17398,4324,21722,0
2019/01,150,09/01/2019,3,SS 12 tra Modena e Bastiglia,22882,30,21018,1861,18234,4648,22882,0
2019/01,150,10/01/2019,4,SS 12 tra Modena e Bastiglia,23476,00,21537,1939,18596,4880,23476,0
2019/01,150,11/01/2019,5,SS 12 tra Modena e Bastiglia,24647,00,22752,1895,18816,5831,24647,0
2019/01,150,12/01/2019,6,SS 12 tra Modena e Bastiglia,20668,00,20346,322,14389,6279,0,20668
2019/01,150,13/01/2019,7,SS 12 tra Modena e Bastiglia,16882,00,16829,53,11599,5283,0,16882
2019/01,150,14/01/2019,1,SS 12 tra Modena e Bastiglia,23553,10,21643,1909,18662,4891,23553,0
2019/01,152,01/01/2019,2,SP 569 tra Innesto tangenziale Bologna e uscita Zola Predosa (Gesso/Rivabella),28567,00,28473,94,16938,11629,0,28567
2019/01,152,02/01/2019,3,SP 569 tra Innesto tangenziale Bologna e uscita Zola Predosa (Gesso/Rivabella),50561,00,49516,1045,40627,9934,50561,0
2019/01,152,03/01/2019,4,SP 569 tra Innesto tangenziale Bologna e uscita Zola Predosa (Gesso/Rivabella),55102,30,53740,1359,44183,10919,55102,0
2019/01,152,04/01/2019,5,SP 569 tra Innesto tangenziale Bologna e uscita Zola Predosa (Gesso/Rivabella),54603,00,53263,1340,42528,12075,54603,0
2019/01,152,05/01/2019,6,SP 569 tra Innesto tangenziale Bologna e uscita Zola Predosa (Gesso/Rivabella),54030,10,53564,465,40645,13385,0,54030
2019/01,152,06/01/2019,7,SP 569 tra Innesto tangenziale Bologna e uscita Zola Predosa (Gesso/Rivabella),46041,10,45871,169,34168,11873,0,46041
2019/01,152,07/01/2019,1,SP 569 tra Innesto tangenziale Bologna e uscita Zola Predosa (Gesso/Rivabella),60213,10,58181,2031,48284,11929,60213,0
2019/01,152,08/01/2019,2,SP 569 tra Innesto tangenziale Bologna e uscita Zola Predosa (Gesso/Rivabella),61693,30,59219,2471,49314,12379,61693,0
2019/01,152,09/01/2019,3,SP 569 tra Innesto tangenziale Bologna e uscita Zola Predosa (Gesso/Rivabella),62605,40,60051,2550,49303,13302,62605,0
2019/01,152,10/01/2019,4,SP 569 tra Innesto tangenziale Bologna e uscita Zola Predosa (Gesso/Rivabella),63706,30,61295,2408,50335,13371,63706,0
2019/01,152,11/01/2019,5,SP 569 tra Innesto tangenziale Bologna e uscita Zola Predosa (Gesso/Rivabella),66535,20,64141,2392,51209,15326,66535,0
2019/01,152,12/01/2019,6,SP 569 tra Innesto tangenziale Bologna e uscita Zola Predosa (Gesso/Rivabella),56860,00,56341,519,41811,15049,0,56860
2019/01,152,13/01/2019,7,SP 569 tra Innesto tangenziale Bologna e uscita Zola Predosa (Gesso/Rivabella),49780,00,49622,158,37790,11990,0,49780
2019/01,152,14/01/2019,1,SP 569 tra Innesto tangenziale Bologna e uscita Zola Predosa (Gesso/Rivabella),62421,20,59840,2579,49544,12877,62421,0
2019/01,153,01/01/2019,2,Via Porrettana (ex SS 64) tra Bologna e Pontecchio Marconi,7099,10,7080,18,4283,2816,0,7099
2019/01,153,02/01/2019,3,Via Porrettana (ex SS 64) tra Bologna e Pontecchio Marconi,9640,10,9471,168,7705,1935,9640,0
2019/01,153,03/01/2019,4,Via Porrettana (ex SS 64) tra Bologna e Pontecchio Marconi,9488,00,9316,172,7316,2172,9488,0
2019/01,153,04/01/2019,5,Via Porrettana (ex SS 64) tra Bologna e Pontecchio Marconi,9959,00,9789,170,7667,2292,9959,0
2019/01,153,05/01/2019,6,Via Porrettana (ex SS 64) tra Bologna e Pontecchio Marconi,10007,00,9882,125,7505,2502,0,10007
2019/01,153,06/01/2019,7,Via Porrettana (ex SS 64) tra Bologna e Pontecchio Marconi,7757,00,7732,25,5690,2067,0,7757
2019/01,153,07/01/2019,1,Via Porrettana (ex SS 64) tra Bologna e Pontecchio Marconi,11194,00,10938,256,8929,2265,11194,0
2019/01,153,08/01/2019,2,Via Porrettana (ex SS 64) tra Bologna e Pontecchio Marconi,11686,00,11411,275,9196,2490,11686,0
2019/01,153,09/01/2019,3,Via Porrettana (ex SS 64) tra Bologna e Pontecchio Marconi,11546,00,11243,303,8992,2554,11546,0
2019/01,153,10/01/2019,4,Via Porrettana (ex SS 64) tra Bologna e Pontecchio Marconi,11485,00,11217,268,8908,2577,11485,0
2019/01,153,11/01/2019,5,Via Porrettana (ex SS 64) tra Bologna e Pontecchio Marconi,12340,00,12057,283,9420,2920,12340,0
2019/01,153,12/01/2019,6,Via Porrettana (ex SS 64) tra Bologna e Pontecchio Marconi,11316,00,11202,114,8497,2819,0,11316
2019/01,153,13/01/2019,7,Via Porrettana (ex SS 64) tra Bologna e Pontecchio Marconi,8395,00,8372,23,6149,2246,0,8395
2019/01,153,14/01/2019,1,Via Porrettana (ex SS 64) tra Bologna e Pontecchio Marconi,11642,00,11374,268,9107,2535,11642,0
2019/01,155,01/01/2019,2,Via Emilia tra San Lazzaro e Idice,8764,10,8701,62,5036,3728,0,8764
2019/01,155,02/01/2019,3,Via Emilia tra San Lazzaro e Idice,13000,10,12646,353,10543,2457,13000,0
2019/01,155,03/01/2019,4,Via Emilia tra San Lazzaro e Idice,13040,00,12681,359,10360,2680,13040,0
2019/01,155,04/01/2019,5,Via Emilia tra San Lazzaro e Idice,13474,10,13091,382,10461,3013,13474,0
2019/01,155,05/01/2019,6,Via Emilia tra San Lazzaro e Idice,12661,10,12424,236,9362,3299,0,12661
2019/01,155,06/01/2019,7,Via Emilia tra San Lazzaro e Idice,10051,10,9986,64,7248,2803,0,10051
2019/01,155,07/01/2019,1,Via Emilia tra San Lazzaro e Idice,13978,10,13505,472,11225,2753,13978,0
2019/01,155,08/01/2019,2,Via Emilia tra San Lazzaro e Idice,14696,00,14229,467,11642,3054,14696,0
2019/01,155,09/01/2019,3,Via Emilia tra San Lazzaro e Idice,15158,10,14676,481,11839,3319,15158,0
2019/01,155,10/01/2019,4,Via Emilia tra San Lazzaro e Idice,15137,10,14658,478,11942,3195,15137,0
2019/01,155,11/01/2019,5,Via Emilia tra San Lazzaro e Idice,15469,10,14971,497,11957,3512,15469,0
2019/01,155,12/01/2019,6,Via Emilia tra San Lazzaro e Idice,14470,20,14194,274,10748,3722,0,14470
2019/01,155,13/01/2019,7,Via Emilia tra San Lazzaro e Idice,10764,00,10692,72,7733,3031,0,10764
2019/01,155,14/01/2019,1,Via Emilia tra San Lazzaro e Idice,14198,00,13724,474,11322,2876,14198,0
2019/01,156,01/01/2019,2,SP 253 tra la località Villanova e inizio variante Castenaso,9583,00,9560,23,5805,3778,0,9583
2019/01,156,02/01/2019,3,SP 253 tra la località Villanova e inizio variante Castenaso,17361,10,17023,337,14131,3230,17361,0
2019/01,156,03/01/2019,4,SP 253 tra la località Villanova e inizio variante Castenaso,18199,00,17832,367,14424,3775,18199,0
2019/01,156,04/01/2019,5,SP 253 tra la località Villanova e inizio variante Castenaso,19228,00,18827,401,15024,4204,19228,0
2019/01,156,05/01/2019,6,SP 253 tra la località Villanova e inizio variante Castenaso,17612,00,17479,133,13403,4209,0,17612
2019/01,156,06/01/2019,7,SP 253 tra la località Villanova e inizio variante Castenaso,13455,00,13417,38,10191,3264,0,13455
2019/01,156,07/01/2019,1,SP 253 tra la località Villanova e inizio variante Castenaso,20544,00,19921,623,16566,3978,20544,0
2019/01,156,08/01/2019,2,SP 253 tra la località Villanova e inizio variante Castenaso,21028,00,20348,680,16894,4134,21028,0
2019/01,156,09/01/2019,3,SP 253 tra la località Villanova e inizio variante Castenaso,21480,10,20843,636,17097,4383,21480,0
2019/01,156,10/01/2019,4,SP 253 tra la località Villanova e inizio variante Castenaso,21591,00,20915,676,17132,4459,21591,0
2019/01,156,11/01/2019,5,SP 253 tra la località Villanova e inizio variante Castenaso,22130,00,21433,697,17333,4797,22130,0
2019/01,156,12/01/2019,6,SP 253 tra la località Villanova e inizio variante Castenaso,19672,00,19536,136,14931,4741,0,19672
2019/01,156,13/01/2019,7,SP 253 tra la località Villanova e inizio variante Castenaso,14087,00,14055,32,10403,3684,0,14087
2019/01,156,14/01/2019,1,SP 253 tra la località Villanova e inizio variante Castenaso,21192,20,20540,650,17006,4186,21192,0
2019/01,157,01/01/2019,2,Via San Donato (ex SP 5) tra Granarolo dell'Emilia e Quarto Inferiore,6274,00,6248,26,3817,2457,0,6274
2019/01,157,02/01/2019,3,Via San Donato (ex SP 5) tra Granarolo dell'Emilia e Quarto Inferiore,8978,00,8805,173,7286,1692,8978,0
2019/01,157,03/01/2019,4,Via San Donato (ex SP 5) tra Granarolo dell'Emilia e Quarto Inferiore,9674,00,9484,190,7721,1953,9674,0
2019/01,157,04/01/2019,5,Via San Donato (ex SP 5) tra Granarolo dell'Emilia e Quarto Inferiore,10105,00,9909,196,7787,2318,10105,0
2019/01,157,05/01/2019,6,Via San Donato (ex SP 5) tra Granarolo dell'Emilia e Quarto Inferiore,9526,10,9413,112,7063,2463,0,9526
2019/01,157,06/01/2019,7,Via San Donato (ex SP 5) tra Granarolo dell'Emilia e Quarto Inferiore,7710,00,7679,31,5580,2130,0,7710
2019/01,157,07/01/2019,1,Via San Donato (ex SP 5) tra Granarolo dell'Emilia e Quarto Inferiore,11241,10,10995,245,9055,2186,11241,0
2019/01,157,08/01/2019,2,Via San Donato (ex SP 5) tra Granarolo dell'Emilia e Quarto Inferiore,11554,00,11255,299,9314,2240,11554,0
2019/01,157,09/01/2019,3,Via San Donato (ex SP 5) tra Granarolo dell'Emilia e Quarto Inferiore,11769,00,11500,269,9270,2499,11769,0
2019/01,157,10/01/2019,4,Via San Donato (ex SP 5) tra Granarolo dell'Emilia e Quarto Inferiore,11757,00,11471,286,9297,2460,11757,0
2019/01,157,11/01/2019,5,Via San Donato (ex SP 5) tra Granarolo dell'Emilia e Quarto Inferiore,12314,20,12038,274,9537,2777,12314,0
2019/01,157,12/01/2019,6,Via San Donato (ex SP 5) tra Granarolo dell'Emilia e Quarto Inferiore,10989,00,10873,116,8241,2748,0,10989
2019/01,157,13/01/2019,7,Via San Donato (ex SP 5) tra Granarolo dell'Emilia e Quarto Inferiore,8120,00,8081,39,5900,2220,0,8120
2019/01,157,14/01/2019,1,Via San Donato (ex SP 5) tra Granarolo dell'Emilia e Quarto Inferiore,11750,10,11473,276,9470,2280,11750,0
2019/01,158,01/01/2019,2,SS 64 tra Bologna e Lovoleto,5181,00,5142,39,3098,2083,0,5181
2019/01,158,02/01/2019,3,SS 64 tra Bologna e Lovoleto,8301,00,7956,345,6531,1770,8301,0
2019/01,158,03/01/2019,4,SS 64 tra Bologna e Lovoleto,9305,20,8887,416,7253,2052,9305,0
2019/01,158,04/01/2019,5,SS 64 tra Bologna e Lovoleto,9547,20,9136,409,7292,2255,9547,0
2019/01,158,05/01/2019,6,SS 64 tra Bologna e Lovoleto,7883,00,7731,152,5657,2226,0,7883
2019/01,158,06/01/2019,7,SS 64 tra Bologna e Lovoleto,6586,20,6525,59,4682,1904,0,6586
2019/01,158,07/01/2019,1,SS 64 tra Bologna e Lovoleto,11045,20,10495,548,8777,2268,11045,0
2019/01,158,08/01/2019,2,SS 64 tra Bologna e Lovoleto,11062,10,10361,700,8832,2230,11062,0
2019/01,158,09/01/2019,3,SS 64 tra Bologna e Lovoleto,11291,10,10607,683,8923,2368,11291,0
2019/01,158,10/01/2019,4,SS 64 tra Bologna e Lovoleto,11404,10,10724,679,8952,2452,11404,0
2019/01,158,11/01/2019,5,SS 64 tra Bologna e Lovoleto,11855,00,11153,702,9154,2701,11855,0
2019/01,158,12/01/2019,6,SS 64 tra Bologna e Lovoleto,8942,00,8771,171,6487,2455,0,8942
2019/01,158,13/01/2019,7,SS 64 tra Bologna e Lovoleto,6923,00,6868,55,4905,2018,0,6923
2019/01,158,14/01/2019,1,SS 64 tra Bologna e Lovoleto,11538,10,10849,688,9098,2440,11538,0
2019/01,160,01/01/2019,2,SP 18 tra Bargellino e Calderara di Reno (c/o Variante SP18),6277,00,6246,31,3656,2621,0,6277
2019/01,160,02/01/2019,3,SP 18 tra Bargellino e Calderara di Reno (c/o Variante SP18),12101,00,11492,609,9649,2452,12101,0
2019/01,160,03/01/2019,4,SP 18 tra Bargellino e Calderara di Reno (c/o Variante SP18),13525,10,12695,829,10694,2831,13525,0
2019/01,160,04/01/2019,5,SP 18 tra Bargellino e Calderara di Reno (c/o Variante SP18),14283,00,13434,849,11206,3077,14283,0
2019/01,160,05/01/2019,6,SP 18 tra Bargellino e Calderara di Reno (c/o Variante SP18),11007,00,10774,233,8104,2903,0,11007
2019/01,160,06/01/2019,7,SP 18 tra Bargellino e Calderara di Reno (c/o Variante SP18),8499,00,8451,48,6362,2137,0,8499
2019/01,160,07/01/2019,1,SP 18 tra Bargellino e Calderara di Reno (c/o Variante SP18),17050,10,15751,1298,13847,3203,17050,0
2019/01,160,08/01/2019,2,SP 18 tra Bargellino e Calderara di Reno (c/o Variante SP18),18239,00,16643,1596,13862,4377,18239,0
2019/01,160,09/01/2019,3,SP 18 tra Bargellino e Calderara di Reno (c/o Variante SP18),17469,10,15942,1526,13897,3572,17469,0
2019/01,160,10/01/2019,4,SP 18 tra Bargellino e Calderara di Reno (c/o Variante SP18),18130,10,16505,1624,14471,3659,18130,0
2019/01,160,11/01/2019,5,SP 18 tra Bargellino e Calderara di Reno (c/o Variante SP18),18550,20,16964,1584,14538,4012,18550,0
2019/01,160,12/01/2019,6,SP 18 tra Bargellino e Calderara di Reno (c/o Variante SP18),12724,10,12337,386,9262,3462,0,12724
2019/01,160,13/01/2019,7,SP 18 tra Bargellino e Calderara di Reno (c/o Variante SP18),8795,00,8742,53,6482,2313,0,8795
2019/01,160,14/01/2019,1,SP 18 tra Bargellino e Calderara di Reno (c/o Variante SP18),17530,10,16045,1484,14165,3365,17530,0
2019/01,161,01/01/2019,2,SP 568 da Tavernelle all'intersezione della SP3,9742,00,9713,29,5707,4035,0,9742
2019/01,161,02/01/2019,3,SP 568 da Tavernelle all'intersezione della SP3,13779,00,13307,472,10637,3142,13779,0
2019/01,161,03/01/2019,4,SP 568 da Tavernelle all'intersezione della SP3,15208,00,14588,620,11744,3464,15208,0
2019/01,161,04/01/2019,5,SP 568 da Tavernelle all'intersezione della SP3,15739,00,15148,591,11668,4071,15739,0
2019/01,161,05/01/2019,6,SP 568 da Tavernelle all'intersezione della SP3,14899,10,14720,178,10467,4432,0,14899
2019/01,161,06/01/2019,7,SP 568 da Tavernelle all'intersezione della SP3,13107,00,13066,41,9262,3845,0,13107
2019/01,161,07/01/2019,1,SP 568 da Tavernelle all'intersezione della SP3,17434,00,16478,956,13575,3859,17434,0
2019/01,161,08/01/2019,2,SP 568 da Tavernelle all'intersezione della SP3,17562,00,16560,1002,13745,3817,17562,0
2019/01,161,09/01/2019,3,SP 568 da Tavernelle all'intersezione della SP3,18277,10,17297,979,14135,4142,18277,0
2019/01,161,10/01/2019,4,SP 568 da Tavernelle all'intersezione della SP3,18514,00,17469,1045,14220,4294,18514,0
2019/01,161,11/01/2019,5,SP 568 da Tavernelle all'intersezione della SP3,19488,00,18435,1053,14398,5090,19488,0
2019/01,161,12/01/2019,6,SP 568 da Tavernelle all'intersezione della SP3,16568,00,16360,208,11438,5130,0,16568
2019/01,161,13/01/2019,7,SP 568 da Tavernelle all'intersezione della SP3,13896,00,13831,65,9749,4147,0,13896
2019/01,161,14/01/2019,1,SP 568 da Tavernelle all'intersezione della SP3,18359,00,17336,1023,14274,4085,18359,0
2019/01,162,01/01/2019,2,SS 9 località Cavazzona,8731,10,8666,64,4896,3835,0,8731
2019/01,162,02/01/2019,3,SS 9 località Cavazzona,13042,00,12208,834,9417,3625,13042,0
2019/01,162,03/01/2019,4,SS 9 località Cavazzona,14516,10,13408,1107,10363,4153,14516,0
2019/01,162,04/01/2019,5,SS 9 località Cavazzona,15410,10,14318,1091,10588,4822,15410,0
2019/01,162,05/01/2019,6,SS 9 località Cavazzona,14767,10,14385,381,9642,5125,0,14767
2019/01,162,06/01/2019,7,SS 9 località Cavazzona,12476,10,12382,93,8329,4147,0,12476
2019/01,162,07/01/2019,1,SS 9 località Cavazzona,15728,10,14371,1356,11257,4471,15728,0
2019/01,162,08/01/2019,2,SS 9 località Cavazzona,15372,00,13839,1533,11169,4203,15372,0
2019/01,162,09/01/2019,3,SS 9 località Cavazzona,15976,00,14365,1611,11533,4443,15976,0
2019/01,162,10/01/2019,4,SS 9 località Cavazzona,16713,10,15040,1672,11832,4881,16713,0
2019/01,162,11/01/2019,5,SS 9 località Cavazzona,17594,00,15983,1611,12017,5577,17594,0
2019/01,162,12/01/2019,6,SS 9 località Cavazzona,15860,10,15419,440,10293,5567,0,15860
2019/01,162,13/01/2019,7,SS 9 località Cavazzona,13354,00,13240,114,8687,4667,0,13354
2019/01,162,14/01/2019,1,SS 9 località Cavazzona,17132,00,15306,1826,12265,4867,17132,0
2019/01,171,01/01/2019,2,SP 56 tra Forlì e bivio SS67 (Castrocaro Terme),5264,00,5254,10,3180,2084,0,5264
2019/01,171,02/01/2019,3,SP 56 tra Forlì e bivio SS67 (Castrocaro Terme),6004,00,5897,107,4742,1262,6004,0
2019/01,171,03/01/2019,4,SP 56 tra Forlì e bivio SS67 (Castrocaro Terme),6367,00,6259,108,5024,1343,6367,0
2019/01,171,04/01/2019,5,SP 56 tra Forlì e bivio SS67 (Castrocaro Terme),6394,00,6273,121,4945,1449,6394,0
2019/01,171,05/01/2019,6,SP 56 tra Forlì e bivio SS67 (Castrocaro Terme),6215,00,6160,55,4524,1691,0,6215
2019/01,171,06/01/2019,7,SP 56 tra Forlì e bivio SS67 (Castrocaro Terme),5236,00,5226,10,3872,1364,0,5236
2019/01,171,07/01/2019,1,SP 56 tra Forlì e bivio SS67 (Castrocaro Terme),6589,10,6437,151,5308,1281,6589,0
2019/01,171,08/01/2019,2,SP 56 tra Forlì e bivio SS67 (Castrocaro Terme),6462,00,6294,168,5174,1288,6462,0
2019/01,171,09/01/2019,3,SP 56 tra Forlì e bivio SS67 (Castrocaro Terme),6738,10,6538,199,5356,1382,6738,0
2019/01,171,10/01/2019,4,SP 56 tra Forlì e bivio SS67 (Castrocaro Terme),6748,00,6542,206,5309,1439,6748,0
2019/01,171,11/01/2019,5,SP 56 tra Forlì e bivio SS67 (Castrocaro Terme),6808,00,6595,213,5266,1542,6808,0
2019/01,171,12/01/2019,6,SP 56 tra Forlì e bivio SS67 (Castrocaro Terme),6629,00,6555,74,4982,1647,0,6629
2019/01,171,13/01/2019,7,SP 56 tra Forlì e bivio SS67 (Castrocaro Terme),5341,00,5324,17,4065,1276,0,5341
2019/01,171,14/01/2019,1,SP 56 tra Forlì e bivio SS67 (Castrocaro Terme),6655,00,6484,171,5319,1336,6655,0
2019/01,173,01/01/2019,2,SP 4 tra Ronco (SS9) e bivio SP 72 (Para),4065,00,4018,47,2478,1587,0,4065
2019/01,173,02/01/2019,3,SP 4 tra Ronco (SS9) e bivio SP 72 (Para),6655,00,6379,276,5362,1293,6655,0
2019/01,173,03/01/2019,4,SP 4 tra Ronco (SS9) e bivio SP 72 (Para),6836,00,6526,310,5385,1451,6836,0
2019/01,173,04/01/2019,5,SP 4 tra Ronco (SS9) e bivio SP 72 (Para),7044,20,6729,313,5618,1426,7044,0
2019/01,173,05/01/2019,6,SP 4 tra Ronco (SS9) e bivio SP 72 (Para),5840,00,5683,157,4333,1507,0,5840
2019/01,173,06/01/2019,7,SP 4 tra Ronco (SS9) e bivio SP 72 (Para),4655,00,4630,25,3522,1133,0,4655
2019/01,173,07/01/2019,1,SP 4 tra Ronco (SS9) e bivio SP 72 (Para),7719,00,7367,352,6332,1387,7719,0
2019/01,173,08/01/2019,2,SP 4 tra Ronco (SS9) e bivio SP 72 (Para),7734,00,7365,369,6330,1404,7734,0
2019/01,173,09/01/2019,3,SP 4 tra Ronco (SS9) e bivio SP 72 (Para),7976,00,7559,417,6382,1594,7976,0
2019/01,173,10/01/2019,4,SP 4 tra Ronco (SS9) e bivio SP 72 (Para),7942,10,7519,422,6414,1528,7942,0
2019/01,173,11/01/2019,5,SP 4 tra Ronco (SS9) e bivio SP 72 (Para),8208,00,7750,458,6517,1691,8208,0
2019/01,173,12/01/2019,6,SP 4 tra Ronco (SS9) e bivio SP 72 (Para),6297,10,6135,161,4703,1594,0,6297
2019/01,173,13/01/2019,7,SP 4 tra Ronco (SS9) e bivio SP 72 (Para),4718,10,4697,20,3544,1174,0,4718
2019/01,173,14/01/2019,1,SP 4 tra Ronco (SS9) e bivio SP 72 (Para),8078,20,7648,428,6579,1499,8078,0
2019/01,174,01/01/2019,2,SS 9 tra Ronco e Forlimpopoli,,,,,,,,
2019/01,174,02/01/2019,3,SS 9 tra Ronco e Forlimpopoli,,,,,,,,
2019/01,174,03/01/2019,4,SS 9 tra Ronco e Forlimpopoli,,,,,,,,
2019/01,174,04/01/2019,5,SS 9 tra Ronco e Forlimpopoli,,,,,,,,
2019/01,174,05/01/2019,6,SS 9 tra Ronco e Forlimpopoli,,,,,,,,
2019/01,174,06/01/2019,7,SS 9 tra Ronco e Forlimpopoli,,,,,,,,
2019/01,174,07/01/2019,1,SS 9 tra Ronco e Forlimpopoli,,,,,,,,
2019/01,174,08/01/2019,2,SS 9 tra Ronco e Forlimpopoli,,,,,,,,
2019/01,174,09/01/2019,3,SS 9 tra Ronco e Forlimpopoli,,,,,,,,
2019/01,174,10/01/2019,4,SS 9 tra Ronco e Forlimpopoli,,,,,,,,
2019/01,174,11/01/2019,5,SS 9 tra Ronco e Forlimpopoli,,,,,,,,
2019/01,174,12/01/2019,6,SS 9 tra Ronco e Forlimpopoli,,,,,,,,
2019/01,174,13/01/2019,7,SS 9 tra Ronco e Forlimpopoli,,,,,,,,
2019/01,174,14/01/2019,1,SS 9 tra Ronco e Forlimpopoli,,,,,,,,
2019/01,176,01/01/2019,2,SP 2 in località La Caserma al Confine Provinciale,9590,00,9572,18,6761,2829,0,9590
2019/01,176,02/01/2019,3,SP 2 in località La Caserma al Confine Provinciale,6220,00,5924,296,4899,1321,6220,0
2019/01,176,03/01/2019,4,SP 2 in località La Caserma al Confine Provinciale,7230,00,6876,354,5873,1357,7230,0
2019/01,176,04/01/2019,5,SP 2 in località La Caserma al Confine Provinciale,7215,00,6856,359,5595,1620,7215,0
2019/01,176,05/01/2019,6,SP 2 in località La Caserma al Confine Provinciale,7136,00,7024,112,5117,2019,0,7136
2019/01,176,06/01/2019,7,SP 2 in località La Caserma al Confine Provinciale,8587,00,8566,21,6698,1889,0,8587
2019/01,176,07/01/2019,1,SP 2 in località La Caserma al Confine Provinciale,7154,00,6685,469,5821,1333,7154,0
2019/01,176,08/01/2019,2,SP 2 in località La Caserma al Confine Provinciale,6996,10,6538,457,5693,1303,6996,0
2019/01,176,09/01/2019,3,SP 2 in località La Caserma al Confine Provinciale,7173,00,6697,476,5830,1343,7173,0
2019/01,176,10/01/2019,4,SP 2 in località La Caserma al Confine Provinciale,7418,00,6936,482,5981,1437,7418,0
2019/01,176,11/01/2019,5,SP 2 in località La Caserma al Confine Provinciale,7847,00,7349,498,6126,1721,7847,0
2019/01,176,12/01/2019,6,SP 2 in località La Caserma al Confine Provinciale,7972,00,7842,130,5687,2285,0,7972
2019/01,176,13/01/2019,7,SP 2 in località La Caserma al Confine Provinciale,9424,00,9383,41,7355,2069,0,9424
2019/01,176,14/01/2019,1,SP 2 in località La Caserma al Confine Provinciale,7288,10,6754,533,5894,1394,7288,0
2019/01,177,01/01/2019,2,NSA 313 - Prosecuzione tangenziale di Bologna complanare sud alla A 14 nel tratto San Lazzaro/Idice,7656,00,7634,22,4255,3401,0,7656
2019/01,177,02/01/2019,3,NSA 313 - Prosecuzione tangenziale di Bologna complanare sud alla A 14 nel tratto San Lazzaro/Idice,11572,00,11261,311,8784,2788,11572,0
2019/01,177,03/01/2019,4,NSA 313 - Prosecuzione tangenziale di Bologna complanare sud alla A 14 nel tratto San Lazzaro/Idice,12976,00,12594,382,9909,3067,12976,0
2019/01,177,04/01/2019,5,NSA 313 - Prosecuzione tangenziale di Bologna complanare sud alla A 14 nel tratto San Lazzaro/Idice,13296,00,12873,423,9875,3421,13296,0
2019/01,177,05/01/2019,6,NSA 313 - Prosecuzione tangenziale di Bologna complanare sud alla A 14 nel tratto San Lazzaro/Idice,12451,00,12314,137,8821,3630,0,12451
2019/01,177,06/01/2019,7,NSA 313 - Prosecuzione tangenziale di Bologna complanare sud alla A 14 nel tratto San Lazzaro/Idice,10891,10,10858,32,7434,3457,0,10891
2019/01,177,07/01/2019,1,NSA 313 - Prosecuzione tangenziale di Bologna complanare sud alla A 14 nel tratto San Lazzaro/Idice,15653,30,14952,698,12103,3550,15653,0
2019/01,177,08/01/2019,2,NSA 313 - Prosecuzione tangenziale di Bologna complanare sud alla A 14 nel tratto San Lazzaro/Idice,16079,10,15348,730,12591,3488,16079,0
2019/01,177,09/01/2019,3,NSA 313 - Prosecuzione tangenziale di Bologna complanare sud alla A 14 nel tratto San Lazzaro/Idice,16160,30,15421,736,12463,3697,16160,0
2019/01,177,10/01/2019,4,NSA 313 - Prosecuzione tangenziale di Bologna complanare sud alla A 14 nel tratto San Lazzaro/Idice,16737,10,15990,746,12866,3871,16737,0
2019/01,177,11/01/2019,5,NSA 313 - Prosecuzione tangenziale di Bologna complanare sud alla A 14 nel tratto San Lazzaro/Idice,17160,20,16360,798,13066,4094,17160,0
2019/01,177,12/01/2019,6,NSA 313 - Prosecuzione tangenziale di Bologna complanare sud alla A 14 nel tratto San Lazzaro/Idice,13246,00,13076,170,9250,3996,0,13246
2019/01,177,13/01/2019,7,NSA 313 - Prosecuzione tangenziale di Bologna complanare sud alla A 14 nel tratto San Lazzaro/Idice,11522,20,11487,33,7921,3601,0,11522
2019/01,177,14/01/2019,1,NSA 313 - Prosecuzione tangenziale di Bologna complanare sud alla A 14 nel tratto San Lazzaro/Idice,16430,00,15577,853,12692,3738,16430,0
2019/01,182,01/01/2019,2,SP 258R tra Rimini e A 14,11979,00,11924,55,7166,4813,0,11979
2019/01,182,02/01/2019,3,SP 258R tra Rimini e A 14,13128,10,12833,294,10209,2919,13128,0
2019/01,182,03/01/2019,4,SP 258R tra Rimini e A 14,14283,10,13965,317,11071,3212,14283,0
2019/01,182,04/01/2019,5,SP 258R tra Rimini e A 14,14178,00,13859,319,10746,3432,14178,0
2019/01,182,05/01/2019,6,SP 258R tra Rimini e A 14,13912,00,13738,174,9777,4135,0,13912
2019/01,182,06/01/2019,7,SP 258R tra Rimini e A 14,12376,00,12335,41,8729,3647,0,12376
2019/01,182,07/01/2019,1,SP 258R tra Rimini e A 14,15722,00,15123,599,12522,3200,15722,0
2019/01,182,08/01/2019,2,SP 258R tra Rimini e A 14,15878,10,15257,620,12613,3265,15878,0
2019/01,182,09/01/2019,3,SP 258R tra Rimini e A 14,16451,10,15850,600,12956,3495,16451,0
2019/01,182,10/01/2019,4,SP 258R tra Rimini e A 14,16486,20,15879,605,13037,3449,16486,0
2019/01,182,11/01/2019,5,SP 258R tra Rimini e A 14,17061,30,16396,662,13051,4010,17061,0
2019/01,182,12/01/2019,6,SP 258R tra Rimini e A 14,15665,00,15430,235,11115,4550,0,15665
2019/01,182,13/01/2019,7,SP 258R tra Rimini e A 14,13341,10,13289,51,9560,3781,0,13341
2019/01,182,14/01/2019,1,SP 258R tra Rimini e A 14,16417,10,15801,615,13072,3345,16417,0
2019/01,186,01/01/2019,2,SS 16 tra Rimini e Igea Marina-Viserba,20827,10,20652,174,13045,7782,0,20827
2019/01,186,02/01/2019,3,SS 16 tra Rimini e Igea Marina-Viserba,24793,20,24175,616,19708,5085,24793,0
2019/01,186,03/01/2019,4,SS 16 tra Rimini e Igea Marina-Viserba,25833,10,25123,709,20370,5463,25833,0
2019/01,186,04/01/2019,5,SS 16 tra Rimini e Igea Marina-Viserba,25331,10,24618,712,19121,6210,25331,0
2019/01,186,05/01/2019,6,SS 16 tra Rimini e Igea Marina-Viserba,26127,00,25800,327,19218,6909,0,26127
2019/01,186,06/01/2019,7,SS 16 tra Rimini e Igea Marina-Viserba,21870,30,21755,112,15756,6114,0,21870
2019/01,186,07/01/2019,1,SS 16 tra Rimini e Igea Marina-Viserba,25596,20,24623,971,20529,5067,25596,0
2019/01,186,08/01/2019,2,SS 16 tra Rimini e Igea Marina-Viserba,25548,30,24470,1075,20389,5159,25548,0
2019/01,186,09/01/2019,3,SS 16 tra Rimini e Igea Marina-Viserba,26746,10,25446,1299,21519,5227,26746,0
2019/01,186,10/01/2019,4,SS 16 tra Rimini e Igea Marina-Viserba,26687,00,25485,1202,21102,5585,26687,0
2019/01,186,11/01/2019,5,SS 16 tra Rimini e Igea Marina-Viserba,28197,20,26924,1271,21693,6504,28197,0
2019/01,186,12/01/2019,6,SS 16 tra Rimini e Igea Marina-Viserba,27381,10,26914,466,19962,7419,0,27381
2019/01,186,13/01/2019,7,SS 16 tra Rimini e Igea Marina-Viserba,24048,10,23885,162,17519,6529,0,24048
2019/01,186,14/01/2019,1,SS 16 tra Rimini e Igea Marina-Viserba,26788,40,25556,1228,21290,5498,26788,0
2019/01,188,01/01/2019,2,SS 9 tra Rimini e Santa Giustina,15470,00,15354,116,8756,6714,0,15470
2019/01,188,02/01/2019,3,SS 9 tra Rimini e Santa Giustina,21918,00,21314,604,17229,4689,21918,0
2019/01,188,03/01/2019,4,SS 9 tra Rimini e Santa Giustina,23446,10,22741,704,18218,5228,23446,0
2019/01,188,04/01/2019,5,SS 9 tra Rimini e Santa Giustina,23985,10,23228,756,18413,5572,23985,0
2019/01,188,05/01/2019,6,SS 9 tra Rimini e Santa Giustina,21541,20,21101,438,15420,6121,0,21541
2019/01,188,06/01/2019,7,SS 9 tra Rimini e Santa Giustina,18611,20,18455,154,13257,5354,0,18611
2019/01,188,07/01/2019,1,SS 9 tra Rimini e Santa Giustina,26293,10,25212,1080,21053,5240,26293,0
2019/01,188,08/01/2019,2,SS 9 tra Rimini e Santa Giustina,26763,20,25669,1092,21410,5353,26763,0
2019/01,188,09/01/2019,3,SS 9 tra Rimini e Santa Giustina,27646,00,26574,1072,21671,5975,27646,0
2019/01,188,10/01/2019,4,SS 9 tra Rimini e Santa Giustina,27489,30,26321,1165,21550,5939,27489,0
2019/01,188,11/01/2019,5,SS 9 tra Rimini e Santa Giustina,28704,10,27499,1204,22138,6566,28704,0
2019/01,188,12/01/2019,6,SS 9 tra Rimini e Santa Giustina,23654,00,23082,572,16989,6665,0,23654
2019/01,188,13/01/2019,7,SS 9 tra Rimini e Santa Giustina,18882,00,18723,159,13301,5581,0,18882
2019/01,188,14/01/2019,1,SS 9 tra Rimini e Santa Giustina,27311,10,26152,1158,21692,5619,27311,0
2019/01,215,01/01/2019,2,SP 3_1 tra accesso interporto Bologna e viadotto A 13,7355,00,7264,91,4223,3132,0,7355
2019/01,215,02/01/2019,3,SP 3_1 tra accesso interporto Bologna e viadotto A 13,16853,00,14327,2526,13333,3520,16853,0
2019/01,215,03/01/2019,4,SP 3_1 tra accesso interporto Bologna e viadotto A 13,19545,30,15871,3671,14978,4567,19545,0
2019/01,215,04/01/2019,5,SP 3_1 tra accesso interporto Bologna e viadotto A 13,20583,20,16600,3981,15400,5183,20583,0
2019/01,215,05/01/2019,6,SP 3_1 tra accesso interporto Bologna e viadotto A 13,12562,10,11692,869,8960,3602,0,12562
2019/01,215,06/01/2019,7,SP 3_1 tra accesso interporto Bologna e viadotto A 13,10205,00,10057,148,7576,2629,0,10205
2019/01,215,07/01/2019,1,SP 3_1 tra accesso interporto Bologna e viadotto A 13,24619,40,19595,5020,19256,5363,24619,0
2019/01,215,08/01/2019,2,SP 3_1 tra accesso interporto Bologna e viadotto A 13,26196,40,19784,6408,19875,6321,26196,0
2019/01,215,09/01/2019,3,SP 3_1 tra accesso interporto Bologna e viadotto A 13,27049,30,20410,6636,20345,6704,27049,0
2019/01,215,10/01/2019,4,SP 3_1 tra accesso interporto Bologna e viadotto A 13,28062,10,21269,6792,20901,7161,28062,0
2019/01,215,11/01/2019,5,SP 3_1 tra accesso interporto Bologna e viadotto A 13,28655,90,21922,6724,21244,7411,28655,0
2019/01,215,12/01/2019,6,SP 3_1 tra accesso interporto Bologna e viadotto A 13,14533,30,13032,1498,9916,4617,0,14533
2019/01,215,13/01/2019,7,SP 3_1 tra accesso interporto Bologna e viadotto A 13,11103,00,10965,138,8178,2925,0,11103
2019/01,215,14/01/2019,1,SP 3_1 tra accesso interporto Bologna e viadotto A 13,26678,70,20963,5708,20816,5862,26678,0
2019/01,218,01/01/2019,2,SP 10 tra Polesine e Roccabianca su variante Zibello,1061,10,1038,22,627,434,0,1061
2019/01,218,02/01/2019,3,SP 10 tra Polesine e Roccabianca su variante Zibello,1635,00,1442,193,1300,335,1635,0
2019/01,218,03/01/2019,4,SP 10 tra Polesine e Roccabianca su variante Zibello,1908,00,1676,232,1514,394,1908,0
2019/01,218,04/01/2019,5,SP 10 tra Polesine e Roccabianca su variante Zibello,1837,00,1620,217,1443,394,1837,0
2019/01,218,05/01/2019,6,SP 10 tra Polesine e Roccabianca su variante Zibello,1653,00,1585,68,1215,438,0,1653
2019/01,218,06/01/2019,7,SP 10 tra Polesine e Roccabianca su variante Zibello,1494,00,1473,21,1138,356,0,1494
2019/01,218,07/01/2019,1,SP 10 tra Polesine e Roccabianca su variante Zibello,2104,00,1820,284,1698,406,2104,0
2019/01,218,08/01/2019,2,SP 10 tra Polesine e Roccabianca su variante Zibello,2085,00,1751,334,1679,406,2085,0
2019/01,218,09/01/2019,3,SP 10 tra Polesine e Roccabianca su variante Zibello,2267,00,1919,348,1821,446,2267,0
2019/01,218,10/01/2019,4,SP 10 tra Polesine e Roccabianca su variante Zibello,2403,00,2038,365,1921,482,2403,0
2019/01,218,11/01/2019,5,SP 10 tra Polesine e Roccabianca su variante Zibello,2366,10,2005,360,1858,508,2366,0
2019/01,218,12/01/2019,6,SP 10 tra Polesine e Roccabianca su variante Zibello,1761,00,1660,101,1314,447,0,1761
2019/01,218,13/01/2019,7,SP 10 tra Polesine e Roccabianca su variante Zibello,1372,00,1348,24,1039,333,0,1372
2019/01,218,14/01/2019,1,SP 10 tra Polesine e Roccabianca su variante Zibello,2227,00,1909,318,1807,420,2227,0
2019/01,219,01/01/2019,2,SS 9 tra Fiorenzuola d'Arda e Pontenure,7014,10,6961,52,4399,2615,0,7014
2019/01,219,02/01/2019,3,SS 9 tra Fiorenzuola d'Arda e Pontenure,12323,30,11579,741,9823,2500,12323,0
2019/01,219,03/01/2019,4,SS 9 tra Fiorenzuola d'Arda e Pontenure,13739,20,12831,906,11061,2678,13739,0
2019/01,219,04/01/2019,5,SS 9 tra Fiorenzuola d'Arda e Pontenure,14000,100,13096,894,11005,2995,14000,0
2019/01,219,05/01/2019,6,SS 9 tra Fiorenzuola d'Arda e Pontenure,12606,100,12249,347,9333,3273,0,12606
2019/01,219,06/01/2019,7,SS 9 tra Fiorenzuola d'Arda e Pontenure,10194,40,10103,87,7492,2702,0,10194
2019/01,219,07/01/2019,1,SS 9 tra Fiorenzuola d'Arda e Pontenure,15696,80,14496,1192,12608,3088,15696,0
2019/01,219,08/01/2019,2,SS 9 tra Fiorenzuola d'Arda e Pontenure,15371,100,14117,1244,12594,2777,15371,0
2019/01,219,09/01/2019,3,SS 9 tra Fiorenzuola d'Arda e Pontenure,15880,90,14669,1202,12704,3176,15880,0
2019/01,219,10/01/2019,4,SS 9 tra Fiorenzuola d'Arda e Pontenure,16389,80,15123,1258,13209,3180,16389,0
2019/01,219,11/01/2019,5,SS 9 tra Fiorenzuola d'Arda e Pontenure,17043,90,15778,1256,13174,3869,17043,0
2019/01,219,12/01/2019,6,SS 9 tra Fiorenzuola d'Arda e Pontenure,13894,40,13443,447,10428,3466,0,13894
2019/01,219,13/01/2019,7,SS 9 tra Fiorenzuola d'Arda e Pontenure,10874,30,10787,84,8016,2858,0,10874
2019/01,219,14/01/2019,1,SS 9 tra Fiorenzuola d'Arda e Pontenure,16213,70,14932,1274,13049,3164,16213,0
2019/01,220,01/01/2019,2,SS 9 tra Fiorenzuola d'Arda e Fidenza al confine provinciale,6202,00,6168,34,3849,2353,0,6202
2019/01,220,02/01/2019,3,SS 9 tra Fiorenzuola d'Arda e Fidenza al confine provinciale,11029,00,10099,930,8897,2132,11029,0
2019/01,220,03/01/2019,4,SS 9 tra Fiorenzuola d'Arda e Fidenza al confine provinciale,11894,00,10840,1054,9694,2200,11894,0
2019/01,220,04/01/2019,5,SS 9 tra Fiorenzuola d'Arda e Fidenza al confine provinciale,,,,,,,,
2019/01,220,05/01/2019,6,SS 9 tra Fiorenzuola d'Arda e Fidenza al confine provinciale,,,,,,,,
2019/01,220,06/01/2019,7,SS 9 tra Fiorenzuola d'Arda e Fidenza al confine provinciale,10373,30,10295,75,8366,2007,0,10373
2019/01,220,07/01/2019,1,SS 9 tra Fiorenzuola d'Arda e Fidenza al confine provinciale,13061,00,11562,1499,10624,2437,13061,0
2019/01,220,08/01/2019,2,SS 9 tra Fiorenzuola d'Arda e Fidenza al confine provinciale,12264,10,10797,1466,10021,2243,12264,0
2019/01,220,09/01/2019,3,SS 9 tra Fiorenzuola d'Arda e Fidenza al confine provinciale,13144,00,11631,1513,10525,2619,13144,0
2019/01,220,10/01/2019,4,SS 9 tra Fiorenzuola d'Arda e Fidenza al confine provinciale,13495,310,11830,1634,10827,2668,13495,0
2019/01,220,11/01/2019,5,SS 9 tra Fiorenzuola d'Arda e Fidenza al confine provinciale,15352,2410,13290,1821,11317,4035,15352,0
2019/01,220,12/01/2019,6,SS 9 tra Fiorenzuola d'Arda e Fidenza al confine provinciale,,,,,,,,
2019/01,220,13/01/2019,7,SS 9 tra Fiorenzuola d'Arda e Fidenza al confine provinciale,,,,,,,,
2019/01,220,14/01/2019,1,SS 9 tra Fiorenzuola d'Arda e Fidenza al confine provinciale,12858,00,11306,1552,10244,2614,12858,0
2019/01,221,01/01/2019,2,SS 9 tra Fidenza e A 15,10090,00,9986,104,5970,4120,0,10090
2019/01,221,02/01/2019,3,SS 9 tra Fidenza e A 15,18508,10,16847,1660,14609,3899,18508,0
2019/01,221,03/01/2019,4,SS 9 tra Fidenza e A 15,20172,10,18226,1945,15736,4436,20172,0
2019/01,221,04/01/2019,5,SS 9 tra Fidenza e A 15,20906,00,18915,1991,16041,4865,20906,0
2019/01,221,05/01/2019,6,SS 9 tra Fidenza e A 15,20870,00,20236,634,15541,5329,0,20870
2019/01,221,06/01/2019,7,SS 9 tra Fidenza e A 15,17071,00,16922,149,12617,4454,0,17071
2019/01,221,07/01/2019,1,SS 9 tra Fidenza e A 15,23275,00,20694,2581,18517,4758,23275,0
2019/01,221,08/01/2019,2,SS 9 tra Fidenza e A 15,23008,00,20235,2773,18270,4738,23008,0
2019/01,221,09/01/2019,3,SS 9 tra Fidenza e A 15,24500,20,21528,2970,19273,5227,24500,0
2019/01,221,10/01/2019,4,SS 9 tra Fidenza e A 15,24584,20,21629,2953,19073,5511,24584,0
2019/01,221,11/01/2019,5,SS 9 tra Fidenza e A 15,25535,10,22659,2875,19366,6169,25535,0
2019/01,221,12/01/2019,6,SS 9 tra Fidenza e A 15,21152,00,20363,789,15390,5762,0,21152
2019/01,221,13/01/2019,7,SS 9 tra Fidenza e A 15,18222,00,18066,156,13324,4898,0,18222
2019/01,221,14/01/2019,1,SS 9 tra Fidenza e A 15,23749,50,20971,2773,18669,5080,23749,0
2019/01,223,01/01/2019,2,SP 357R tra SS 9 e Noceto,4500,00,4443,57,2668,1832,0,4500
2019/01,223,02/01/2019,3,SP 357R tra SS 9 e Noceto,8267,00,7617,650,6623,1644,8267,0
2019/01,223,03/01/2019,4,SP 357R tra SS 9 e Noceto,8788,00,7999,789,7028,1760,8788,0
2019/01,223,04/01/2019,5,SP 357R tra SS 9 e Noceto,9236,00,8473,763,7179,2057,9236,0
2019/01,223,05/01/2019,6,SP 357R tra SS 9 e Noceto,8317,00,8052,265,6113,2204,0,8317
2019/01,223,06/01/2019,7,SP 357R tra SS 9 e Noceto,6242,00,6174,68,4557,1685,0,6242
2019/01,223,07/01/2019,1,SP 357R tra SS 9 e Noceto,10365,00,9201,1164,8232,2133,10365,0
2019/01,223,08/01/2019,2,SP 357R tra SS 9 e Noceto,10698,00,9443,1255,8493,2205,10698,0
2019/01,223,09/01/2019,3,SP 357R tra SS 9 e Noceto,10789,00,9495,1294,8558,2231,10789,0
2019/01,223,10/01/2019,4,SP 357R tra SS 9 e Noceto,10911,00,9635,1276,8548,2363,10911,0
2019/01,223,11/01/2019,5,SP 357R tra SS 9 e Noceto,10967,00,9763,1204,8481,2486,10967,0
2019/01,223,12/01/2019,6,SP 357R tra SS 9 e Noceto,9175,00,8864,311,6770,2405,0,9175
2019/01,223,13/01/2019,7,SP 357R tra SS 9 e Noceto,6757,00,6671,86,4858,1899,0,6757
2019/01,223,14/01/2019,1,SP 357R tra SS 9 e Noceto,10813,00,9509,1304,8600,2213,10813,0
2019/01,226,01/01/2019,2,SP 32 dal bivio SP 16 (per Langhirano) al bivio SP 665R,5571,00,5493,78,3356,2215,0,5571
2019/01,226,02/01/2019,3,SP 32 dal bivio SP 16 (per Langhirano) al bivio SP 665R,8424,10,7940,483,6804,1620,8424,0
2019/01,226,03/01/2019,4,SP 32 dal bivio SP 16 (per Langhirano) al bivio SP 665R,9467,00,8893,574,7605,1862,9467,0
2019/01,226,04/01/2019,5,SP 32 dal bivio SP 16 (per Langhirano) al bivio SP 665R,9927,00,9253,674,7800,2127,9927,0
2019/01,226,05/01/2019,6,SP 32 dal bivio SP 16 (per Langhirano) al bivio SP 665R,8257,00,8051,206,6179,2078,0,8257
2019/01,226,06/01/2019,7,SP 32 dal bivio SP 16 (per Langhirano) al bivio SP 665R,7429,00,7341,88,5678,1751,0,7429
2019/01,226,07/01/2019,1,SP 32 dal bivio SP 16 (per Langhirano) al bivio SP 665R,10621,10,9882,738,8751,1870,10621,0
2019/01,226,08/01/2019,2,SP 32 dal bivio SP 16 (per Langhirano) al bivio SP 665R,11064,00,10286,778,9025,2039,11064,0
2019/01,226,09/01/2019,3,SP 32 dal bivio SP 16 (per Langhirano) al bivio SP 665R,11301,00,10546,755,9232,2069,11301,0
2019/01,226,10/01/2019,4,SP 32 dal bivio SP 16 (per Langhirano) al bivio SP 665R,11462,00,10645,817,9247,2215,11462,0
2019/01,226,11/01/2019,5,SP 32 dal bivio SP 16 (per Langhirano) al bivio SP 665R,11800,00,10963,837,9432,2368,11800,0
2019/01,226,12/01/2019,6,SP 32 dal bivio SP 16 (per Langhirano) al bivio SP 665R,8810,10,8560,249,6696,2114,0,8810
2019/01,226,13/01/2019,7,SP 32 dal bivio SP 16 (per Langhirano) al bivio SP 665R,7705,10,7622,82,5932,1773,0,7705
2019/01,226,14/01/2019,1,SP 32 dal bivio SP 16 (per Langhirano) al bivio SP 665R,11243,10,10437,805,9165,2078,11243,0
2019/01,228,01/01/2019,2,SP 62R tra Brescello (bivio SP 41) e Sorbolo (bivio SP 20),5707,10,5649,57,3528,2179,0,5707
2019/01,228,02/01/2019,3,SP 62R tra Brescello (bivio SP 41) e Sorbolo (bivio SP 20),8336,00,7389,947,6625,1711,8336,0
2019/01,228,03/01/2019,4,SP 62R tra Brescello (bivio SP 41) e Sorbolo (bivio SP 20),8955,10,7879,1075,7217,1738,8955,0
2019/01,228,04/01/2019,5,SP 62R tra Brescello (bivio SP 41) e Sorbolo (bivio SP 20),9310,20,8242,1066,7242,2068,9310,0
2019/01,228,05/01/2019,6,SP 62R tra Brescello (bivio SP 41) e Sorbolo (bivio SP 20),9896,10,9549,346,7334,2562,0,9896
2019/01,228,06/01/2019,7,SP 62R tra Brescello (bivio SP 41) e Sorbolo (bivio SP 20),8582,10,8509,72,6362,2220,0,8582
2019/01,228,07/01/2019,1,SP 62R tra Brescello (bivio SP 41) e Sorbolo (bivio SP 20),10230,40,8609,1617,8270,1960,10230,0
2019/01,228,08/01/2019,2,SP 62R tra Brescello (bivio SP 41) e Sorbolo (bivio SP 20),10135,10,8326,1808,8237,1898,10135,0
2019/01,228,09/01/2019,3,SP 62R tra Brescello (bivio SP 41) e Sorbolo (bivio SP 20),10848,20,8969,1877,8683,2165,10848,0
2019/01,228,10/01/2019,4,SP 62R tra Brescello (bivio SP 41) e Sorbolo (bivio SP 20),10836,40,9079,1753,8714,2122,10836,0
2019/01,228,11/01/2019,5,SP 62R tra Brescello (bivio SP 41) e Sorbolo (bivio SP 20),10580,20,8945,1633,8151,2429,10580,0
2019/01,228,12/01/2019,6,SP 62R tra Brescello (bivio SP 41) e Sorbolo (bivio SP 20),9687,00,9355,332,7181,2506,0,9687
2019/01,228,13/01/2019,7,SP 62R tra Brescello (bivio SP 41) e Sorbolo (bivio SP 20),8993,10,8890,102,6460,2533,0,8993
2019/01,228,14/01/2019,1,SP 62R tra Brescello (bivio SP 41) e Sorbolo (bivio SP 20),10778,40,8966,1808,8681,2097,10778,0
2019/01,229,01/01/2019,2,SP 111 tra bivio SP 1 (a nord di Poviglio) e Boretto (innesto variante),,,,,,,,
2019/01,229,02/01/2019,3,SP 111 tra bivio SP 1 (a nord di Poviglio) e Boretto (innesto variante),,,,,,,,
2019/01,229,03/01/2019,4,SP 111 tra bivio SP 1 (a nord di Poviglio) e Boretto (innesto variante),,,,,,,,
2019/01,229,04/01/2019,5,SP 111 tra bivio SP 1 (a nord di Poviglio) e Boretto (innesto variante),,,,,,,,
2019/01,229,05/01/2019,6,SP 111 tra bivio SP 1 (a nord di Poviglio) e Boretto (innesto variante),,,,,,,,
2019/01,229,06/01/2019,7,SP 111 tra bivio SP 1 (a nord di Poviglio) e Boretto (innesto variante),,,,,,,,
2019/01,229,07/01/2019,1,SP 111 tra bivio SP 1 (a nord di Poviglio) e Boretto (innesto variante),,,,,,,,
2019/01,229,08/01/2019,2,SP 111 tra bivio SP 1 (a nord di Poviglio) e Boretto (innesto variante),,,,,,,,
2019/01,229,09/01/2019,3,SP 111 tra bivio SP 1 (a nord di Poviglio) e Boretto (innesto variante),,,,,,,,
2019/01,229,10/01/2019,4,SP 111 tra bivio SP 1 (a nord di Poviglio) e Boretto (innesto variante),,,,,,,,
2019/01,229,11/01/2019,5,SP 111 tra bivio SP 1 (a nord di Poviglio) e Boretto (innesto variante),,,,,,,,
2019/01,229,12/01/2019,6,SP 111 tra bivio SP 1 (a nord di Poviglio) e Boretto (innesto variante),,,,,,,,
2019/01,229,13/01/2019,7,SP 111 tra bivio SP 1 (a nord di Poviglio) e Boretto (innesto variante),,,,,,,,
2019/01,229,14/01/2019,1,SP 111 tra bivio SP 1 (a nord di Poviglio) e Boretto (innesto variante),,,,,,,,
2019/01,230,01/01/2019,2,SP 62RVar Cispadana da Boretto (bivio Variante SP 358R) a Gualtieri (bivio SP 63R),5211,00,5148,63,3286,1925,0,5211
2019/01,230,02/01/2019,3,SP 62RVar Cispadana da Boretto (bivio Variante SP 358R) a Gualtieri (bivio SP 63R),8391,10,7204,1186,6599,1792,8391,0
2019/01,230,03/01/2019,4,SP 62RVar Cispadana da Boretto (bivio Variante SP 358R) a Gualtieri (bivio SP 63R),8598,00,7205,1393,6893,1705,8598,0
2019/01,230,04/01/2019,5,SP 62RVar Cispadana da Boretto (bivio Variante SP 358R) a Gualtieri (bivio SP 63R),9146,00,7673,1473,7079,2067,9146,0
2019/01,230,05/01/2019,6,SP 62RVar Cispadana da Boretto (bivio Variante SP 358R) a Gualtieri (bivio SP 63R),8559,00,8161,398,6387,2172,0,8559
2019/01,230,06/01/2019,7,SP 62RVar Cispadana da Boretto (bivio Variante SP 358R) a Gualtieri (bivio SP 63R),8073,00,7979,94,6016,2057,0,8073
2019/01,230,07/01/2019,1,SP 62RVar Cispadana da Boretto (bivio Variante SP 358R) a Gualtieri (bivio SP 63R),10027,00,7952,2075,8147,1880,10027,0
2019/01,230,08/01/2019,2,SP 62RVar Cispadana da Boretto (bivio Variante SP 358R) a Gualtieri (bivio SP 63R),10142,10,7768,2373,8272,1870,10142,0
2019/01,230,09/01/2019,3,SP 62RVar Cispadana da Boretto (bivio Variante SP 358R) a Gualtieri (bivio SP 63R),10545,10,8174,2370,8513,2032,10545,0
2019/01,230,10/01/2019,4,SP 62RVar Cispadana da Boretto (bivio Variante SP 358R) a Gualtieri (bivio SP 63R),10949,10,8510,2438,8851,2098,10949,0
2019/01,230,11/01/2019,5,SP 62RVar Cispadana da Boretto (bivio Variante SP 358R) a Gualtieri (bivio SP 63R),11470,10,9021,2448,8989,2481,11470,0
2019/01,230,12/01/2019,6,SP 62RVar Cispadana da Boretto (bivio Variante SP 358R) a Gualtieri (bivio SP 63R),8604,00,8172,432,6416,2188,0,8604
2019/01,230,13/01/2019,7,SP 62RVar Cispadana da Boretto (bivio Variante SP 358R) a Gualtieri (bivio SP 63R),8137,00,8014,123,5842,2295,0,8137
2019/01,230,14/01/2019,1,SP 62RVar Cispadana da Boretto (bivio Variante SP 358R) a Gualtieri (bivio SP 63R),10796,00,8482,2314,8708,2088,10796,0
2019/01,231,01/01/2019,2,SP 63R tra la località Santa Vittoria (c/o bivio SP 81) e la Cispadana,3037,00,3032,5,1860,1177,0,3037
2019/01,231,02/01/2019,3,SP 63R tra la località Santa Vittoria (c/o bivio SP 81) e la Cispadana,4696,10,4504,191,3828,868,4696,0
2019/01,231,03/01/2019,4,SP 63R tra la località Santa Vittoria (c/o bivio SP 81) e la Cispadana,5426,00,5230,196,4492,934,5426,0
2019/01,231,04/01/2019,5,SP 63R tra la località Santa Vittoria (c/o bivio SP 81) e la Cispadana,5823,00,5569,254,4657,1166,5823,0
2019/01,231,05/01/2019,6,SP 63R tra la località Santa Vittoria (c/o bivio SP 81) e la Cispadana,5220,00,5113,107,3952,1268,0,5220
2019/01,231,06/01/2019,7,SP 63R tra la località Santa Vittoria (c/o bivio SP 81) e la Cispadana,4424,00,4417,7,3290,1134,0,4424
2019/01,231,07/01/2019,1,SP 63R tra la località Santa Vittoria (c/o bivio SP 81) e la Cispadana,6419,00,6044,375,5352,1067,6419,0
2019/01,231,08/01/2019,2,SP 63R tra la località Santa Vittoria (c/o bivio SP 81) e la Cispadana,6401,20,5959,440,5333,1068,6401,0
2019/01,231,09/01/2019,3,SP 63R tra la località Santa Vittoria (c/o bivio SP 81) e la Cispadana,6944,00,6477,467,5711,1233,6944,0
2019/01,231,10/01/2019,4,SP 63R tra la località Santa Vittoria (c/o bivio SP 81) e la Cispadana,6732,00,6282,450,5508,1224,6732,0
2019/01,231,11/01/2019,5,SP 63R tra la località Santa Vittoria (c/o bivio SP 81) e la Cispadana,7070,00,6624,446,5755,1315,7070,0
2019/01,231,12/01/2019,6,SP 63R tra la località Santa Vittoria (c/o bivio SP 81) e la Cispadana,6284,10,6141,142,4874,1410,0,6284
2019/01,231,13/01/2019,7,SP 63R tra la località Santa Vittoria (c/o bivio SP 81) e la Cispadana,4985,00,4962,23,3747,1238,0,4985
2019/01,231,14/01/2019,1,SP 63R tra la località Santa Vittoria (c/o bivio SP 81) e la Cispadana,6933,00,6437,496,5741,1192,6933,0
2019/01,236,01/01/2019,2,SP 468 tra Casumaro e Reno Centese,2797,00,2785,12,1778,1019,0,2797
2019/01,236,02/01/2019,3,SP 468 tra Casumaro e Reno Centese,3978,00,3749,229,3317,661,3978,0
2019/01,236,03/01/2019,4,SP 468 tra Casumaro e Reno Centese,4436,00,4128,308,3648,788,4436,0
2019/01,236,04/01/2019,5,SP 468 tra Casumaro e Reno Centese,4701,00,4396,305,3728,973,4701,0
2019/01,236,05/01/2019,6,SP 468 tra Casumaro e Reno Centese,4456,00,4362,94,3341,1115,0,4456
2019/01,236,06/01/2019,7,SP 468 tra Casumaro e Reno Centese,3735,00,3728,7,2672,1063,0,3735
2019/01,236,07/01/2019,1,SP 468 tra Casumaro e Reno Centese,4930,00,4496,434,4043,887,4930,0
2019/01,236,08/01/2019,2,SP 468 tra Casumaro e Reno Centese,4668,00,4198,470,3875,793,4668,0
2019/01,236,09/01/2019,3,SP 468 tra Casumaro e Reno Centese,5170,00,4645,525,4294,876,5170,0
2019/01,236,10/01/2019,4,SP 468 tra Casumaro e Reno Centese,5307,00,4750,557,4302,1005,5307,0
2019/01,236,11/01/2019,5,SP 468 tra Casumaro e Reno Centese,5588,00,5067,521,4451,1137,5588,0
2019/01,236,12/01/2019,6,SP 468 tra Casumaro e Reno Centese,5080,00,4962,118,4040,1040,0,5080
2019/01,236,13/01/2019,7,SP 468 tra Casumaro e Reno Centese,3860,00,3848,12,2892,968,0,3860
2019/01,236,14/01/2019,1,SP 468 tra Casumaro e Reno Centese,5293,00,4747,546,4322,971,5293,0
2019/01,237,01/01/2019,2,SP 23 tra Quattro Castella e la Variante di Montecavolo (c/o bivio SP 21),6842,00,6811,31,4111,2731,0,6842
2019/01,237,02/01/2019,3,SP 23 tra Quattro Castella e la Variante di Montecavolo (c/o bivio SP 21),10108,00,9754,354,8229,1879,10108,0
2019/01,237,03/01/2019,4,SP 23 tra Quattro Castella e la Variante di Montecavolo (c/o bivio SP 21),11242,00,10838,404,8982,2260,11242,0
2019/01,237,04/01/2019,5,SP 23 tra Quattro Castella e la Variante di Montecavolo (c/o bivio SP 21),12196,00,11754,442,9374,2822,12196,0
2019/01,237,05/01/2019,6,SP 23 tra Quattro Castella e la Variante di Montecavolo (c/o bivio SP 21),11440,00,11291,149,8444,2996,0,11440
2019/01,237,06/01/2019,7,SP 23 tra Quattro Castella e la Variante di Montecavolo (c/o bivio SP 21),10163,00,10115,48,7786,2377,0,10163
2019/01,237,07/01/2019,1,SP 23 tra Quattro Castella e la Variante di Montecavolo (c/o bivio SP 21),13538,00,12887,651,10977,2561,13538,0
2019/01,237,08/01/2019,2,SP 23 tra Quattro Castella e la Variante di Montecavolo (c/o bivio SP 21),14323,00,13637,686,11607,2716,14323,0
2019/01,237,09/01/2019,3,SP 23 tra Quattro Castella e la Variante di Montecavolo (c/o bivio SP 21),13681,00,13039,642,10744,2937,13681,0
2019/01,237,10/01/2019,4,SP 23 tra Quattro Castella e la Variante di Montecavolo (c/o bivio SP 21),14850,00,14074,776,11762,3088,14850,0
2019/01,237,11/01/2019,5,SP 23 tra Quattro Castella e la Variante di Montecavolo (c/o bivio SP 21),15187,00,14394,793,11943,3244,15187,0
2019/01,237,12/01/2019,6,SP 23 tra Quattro Castella e la Variante di Montecavolo (c/o bivio SP 21),13105,00,12922,183,9758,3347,0,13105
2019/01,237,13/01/2019,7,SP 23 tra Quattro Castella e la Variante di Montecavolo (c/o bivio SP 21),10583,10,10544,38,7983,2600,0,10583
2019/01,237,14/01/2019,1,SP 23 tra Quattro Castella e la Variante di Montecavolo (c/o bivio SP 21),14223,00,13497,726,11566,2657,14223,0
2019/01,238,01/01/2019,2,SP 37 fra Albinea e Scandiano (bivio SP 7),5370,00,5338,32,3167,2203,0,5370
2019/01,238,02/01/2019,3,SP 37 fra Albinea e Scandiano (bivio SP 7),7317,00,7022,295,5847,1470,7317,0
2019/01,238,03/01/2019,4,SP 37 fra Albinea e Scandiano (bivio SP 7),8309,00,7951,358,6566,1743,8309,0
2019/01,238,04/01/2019,5,SP 37 fra Albinea e Scandiano (bivio SP 7),8755,00,8376,379,6694,2061,8755,0
2019/01,238,05/01/2019,6,SP 37 fra Albinea e Scandiano (bivio SP 7),7704,00,7593,111,5451,2253,0,7704
2019/01,238,06/01/2019,7,SP 37 fra Albinea e Scandiano (bivio SP 7),7069,00,7024,45,5261,1808,0,7069
2019/01,238,07/01/2019,1,SP 37 fra Albinea e Scandiano (bivio SP 7),10475,00,9991,484,8478,1997,10475,0
2019/01,238,08/01/2019,2,SP 37 fra Albinea e Scandiano (bivio SP 7),10308,00,9751,557,8388,1920,10308,0
2019/01,238,09/01/2019,3,SP 37 fra Albinea e Scandiano (bivio SP 7),11040,20,10445,593,8761,2279,11040,0
2019/01,238,10/01/2019,4,SP 37 fra Albinea e Scandiano (bivio SP 7),11236,60,10571,659,8829,2407,11236,0
2019/01,238,11/01/2019,5,SP 37 fra Albinea e Scandiano (bivio SP 7),11621,00,11005,616,8989,2632,11621,0
2019/01,238,12/01/2019,6,SP 37 fra Albinea e Scandiano (bivio SP 7),9410,10,9238,171,6880,2530,0,9410
2019/01,238,13/01/2019,7,SP 37 fra Albinea e Scandiano (bivio SP 7),7375,00,7341,34,5491,1884,0,7375
2019/01,238,14/01/2019,1,SP 37 fra Albinea e Scandiano (bivio SP 7),11000,00,10494,506,8960,2040,11000,0
2019/01,239,01/01/2019,2,SP 486R fra Sassuolo e Castellarano,11478,00,11416,62,7151,4327,0,11478
2019/01,239,02/01/2019,3,SP 486R fra Sassuolo e Castellarano,19301,10,18432,868,15702,3599,19301,0
2019/01,239,03/01/2019,4,SP 486R fra Sassuolo e Castellarano,20078,00,18967,1111,16202,3876,20078,0
2019/01,239,04/01/2019,5,SP 486R fra Sassuolo e Castellarano,21199,00,20093,1106,16708,4491,21199,0
2019/01,239,05/01/2019,6,SP 486R fra Sassuolo e Castellarano,18152,00,17857,295,13281,4871,0,18152
2019/01,239,06/01/2019,7,SP 486R fra Sassuolo e Castellarano,15191,00,15112,79,11122,4069,0,15191
2019/01,239,07/01/2019,1,SP 486R fra Sassuolo e Castellarano,24712,20,22282,2428,20203,4509,24712,0
2019/01,239,08/01/2019,2,SP 486R fra Sassuolo e Castellarano,25238,10,22333,2904,20795,4443,25238,0
2019/01,239,09/01/2019,3,SP 486R fra Sassuolo e Castellarano,25853,20,22706,3145,20959,4894,25853,0
2019/01,239,10/01/2019,4,SP 486R fra Sassuolo e Castellarano,26707,20,23321,3384,21417,5290,26707,0
2019/01,239,11/01/2019,5,SP 486R fra Sassuolo e Castellarano,27323,10,24233,3089,21555,5768,27323,0
2019/01,239,12/01/2019,6,SP 486R fra Sassuolo e Castellarano,20612,00,20230,382,15424,5188,0,20612
2019/01,239,13/01/2019,7,SP 486R fra Sassuolo e Castellarano,15962,00,15867,95,11852,4110,0,15962
2019/01,239,14/01/2019,1,SP 486R fra Sassuolo e Castellarano,26478,00,23588,2890,21406,5072,26478,0
2019/01,242,01/01/2019,2,SS 12 tra Maranello e Pavullo nel Frignano,10802,10,10760,41,7483,3319,0,10802
2019/01,242,02/01/2019,3,SS 12 tra Maranello e Pavullo nel Frignano,12569,20,11977,590,10105,2464,12569,0
2019/01,242,03/01/2019,4,SS 12 tra Maranello e Pavullo nel Frignano,12777,00,12045,732,10286,2491,12777,0
2019/01,242,04/01/2019,5,SS 12 tra Maranello e Pavullo nel Frignano,13087,00,12367,720,10131,2956,13087,0
2019/01,242,05/01/2019,6,SS 12 tra Maranello e Pavullo nel Frignano,12679,00,12434,245,9482,3197,0,12679
2019/01,242,06/01/2019,7,SS 12 tra Maranello e Pavullo nel Frignano,12917,00,12874,43,10047,2870,0,12917
2019/01,242,07/01/2019,1,SS 12 tra Maranello e Pavullo nel Frignano,13828,00,12722,1106,11012,2816,13828,0
2019/01,242,08/01/2019,2,SS 12 tra Maranello e Pavullo nel Frignano,13966,00,12746,1220,11132,2834,13966,0
2019/01,242,09/01/2019,3,SS 12 tra Maranello e Pavullo nel Frignano,14550,10,13261,1288,11366,3184,14550,0
2019/01,242,10/01/2019,4,SS 12 tra Maranello e Pavullo nel Frignano,14957,20,13658,1297,11769,3188,14957,0
2019/01,242,11/01/2019,5,SS 12 tra Maranello e Pavullo nel Frignano,15430,20,14105,1323,11780,3650,15430,0
2019/01,242,12/01/2019,6,SS 12 tra Maranello e Pavullo nel Frignano,14240,10,13978,261,10603,3637,0,14240
2019/01,242,13/01/2019,7,SS 12 tra Maranello e Pavullo nel Frignano,12980,00,12905,75,10010,2970,0,12980
2019/01,242,14/01/2019,1,SS 12 tra Maranello e Pavullo nel Frignano,14762,10,13560,1201,11649,3113,14762,0
2019/01,243,01/01/2019,2,SP 27 tra Ponte Samoggia e Muffa,4633,00,4591,42,2946,1687,0,4633
2019/01,243,02/01/2019,3,SP 27 tra Ponte Samoggia e Muffa,7241,00,6889,352,5923,1318,7241,0
2019/01,243,03/01/2019,4,SP 27 tra Ponte Samoggia e Muffa,7890,00,7515,375,6367,1523,7890,0
2019/01,243,04/01/2019,5,SP 27 tra Ponte Samoggia e Muffa,8389,00,7906,483,6615,1774,8389,0
2019/01,243,05/01/2019,6,SP 27 tra Ponte Samoggia e Muffa,7390,00,7214,176,5563,1827,0,7390
2019/01,243,06/01/2019,7,SP 27 tra Ponte Samoggia e Muffa,5815,00,5768,47,4358,1457,0,5815
2019/01,243,07/01/2019,1,SP 27 tra Ponte Samoggia e Muffa,10027,00,9338,689,8174,1853,10027,0
2019/01,243,08/01/2019,2,SP 27 tra Ponte Samoggia e Muffa,10342,00,9577,765,8355,1987,10342,0
2019/01,243,09/01/2019,3,SP 27 tra Ponte Samoggia e Muffa,10493,10,9776,716,8462,2031,10493,0
2019/01,243,10/01/2019,4,SP 27 tra Ponte Samoggia e Muffa,10646,00,9945,701,8476,2170,10646,0
2019/01,243,11/01/2019,5,SP 27 tra Ponte Samoggia e Muffa,11081,00,10289,792,8784,2297,11081,0
2019/01,243,12/01/2019,6,SP 27 tra Ponte Samoggia e Muffa,8350,10,8115,234,6337,2013,0,8350
2019/01,243,13/01/2019,7,SP 27 tra Ponte Samoggia e Muffa,6159,00,6096,63,4656,1503,0,6159
2019/01,243,14/01/2019,1,SP 27 tra Ponte Samoggia e Muffa,10917,00,10125,792,8814,2103,10917,0
2019/01,244,01/01/2019,2,SP 569 tra Pragatto e innesto variante Ponte Ronca,14752,00,14696,56,8990,5762,0,14752
2019/01,244,02/01/2019,3,SP 569 tra Pragatto e innesto variante Ponte Ronca,21562,00,20857,705,17234,4328,21562,0
2019/01,244,03/01/2019,4,SP 569 tra Pragatto e innesto variante Ponte Ronca,23717,10,22863,853,18970,4747,23717,0
2019/01,244,04/01/2019,5,SP 569 tra Pragatto e innesto variante Ponte Ronca,24732,10,23841,890,19292,5440,24732,0
2019/01,244,05/01/2019,6,SP 569 tra Pragatto e innesto variante Ponte Ronca,24615,00,24315,300,18396,6219,0,24615
2019/01,244,06/01/2019,7,SP 569 tra Pragatto e innesto variante Ponte Ronca,20743,00,20664,79,15716,5027,0,20743
2019/01,244,07/01/2019,1,SP 569 tra Pragatto e innesto variante Ponte Ronca,25983,10,24724,1258,20602,5381,25983,0
2019/01,244,08/01/2019,2,SP 569 tra Pragatto e innesto variante Ponte Ronca,26392,00,24869,1523,20869,5523,26392,0
2019/01,244,09/01/2019,3,SP 569 tra Pragatto e innesto variante Ponte Ronca,26839,00,25334,1505,21035,5804,26839,0
2019/01,244,10/01/2019,4,SP 569 tra Pragatto e innesto variante Ponte Ronca,27264,20,25795,1467,21423,5841,27264,0
2019/01,244,11/01/2019,5,SP 569 tra Pragatto e innesto variante Ponte Ronca,28882,00,27456,1426,22154,6728,28882,0
2019/01,244,12/01/2019,6,SP 569 tra Pragatto e innesto variante Ponte Ronca,26959,10,26611,347,20416,6543,0,26959
2019/01,244,13/01/2019,7,SP 569 tra Pragatto e innesto variante Ponte Ronca,21488,10,21403,84,16216,5272,0,21488
2019/01,244,14/01/2019,1,SP 569 tra Pragatto e innesto variante Ponte Ronca,26822,00,25284,1538,21157,5665,26822,0
2019/01,245,01/01/2019,2,SP 569 da intersezione Pedemontana a Savignano sul Panaro,5079,00,5041,38,3379,1700,0,5079
2019/01,245,02/01/2019,3,SP 569 da intersezione Pedemontana a Savignano sul Panaro,6316,00,6126,190,5125,1191,6316,0
2019/01,245,03/01/2019,4,SP 569 da intersezione Pedemontana a Savignano sul Panaro,6633,00,6391,242,5284,1349,6633,0
2019/01,245,04/01/2019,5,SP 569 da intersezione Pedemontana a Savignano sul Panaro,7099,00,6812,287,5506,1593,7099,0
2019/01,245,05/01/2019,6,SP 569 da intersezione Pedemontana a Savignano sul Panaro,7666,10,7548,117,5696,1970,0,7666
2019/01,245,06/01/2019,7,SP 569 da intersezione Pedemontana a Savignano sul Panaro,6389,10,6341,47,4904,1485,0,6389
2019/01,245,07/01/2019,1,SP 569 da intersezione Pedemontana a Savignano sul Panaro,6447,10,6148,298,5056,1391,6447,0
2019/01,245,08/01/2019,2,SP 569 da intersezione Pedemontana a Savignano sul Panaro,6618,00,6225,393,5218,1400,6618,0
2019/01,245,09/01/2019,3,SP 569 da intersezione Pedemontana a Savignano sul Panaro,6872,00,6479,393,5389,1483,6872,0
2019/01,245,10/01/2019,4,SP 569 da intersezione Pedemontana a Savignano sul Panaro,6955,00,6576,379,5445,1510,6955,0
2019/01,245,11/01/2019,5,SP 569 da intersezione Pedemontana a Savignano sul Panaro,7480,00,7106,374,5632,1848,7480,0
2019/01,245,12/01/2019,6,SP 569 da intersezione Pedemontana a Savignano sul Panaro,8006,10,7871,134,5925,2081,0,8006
2019/01,245,13/01/2019,7,SP 569 da intersezione Pedemontana a Savignano sul Panaro,6326,00,6278,48,4806,1520,0,6326
2019/01,245,14/01/2019,1,SP 569 da intersezione Pedemontana a Savignano sul Panaro,6833,00,6447,386,5347,1486,6833,0
2019/01,246,01/01/2019,2,SP 255 da Decima a San Giovanni in Persiceto,5856,00,5831,25,3509,2347,0,5856
2019/01,246,02/01/2019,3,SP 255 da Decima a San Giovanni in Persiceto,9688,00,9287,401,7697,1991,9688,0
2019/01,246,03/01/2019,4,SP 255 da Decima a San Giovanni in Persiceto,10605,00,10084,521,8366,2239,10605,0
2019/01,246,04/01/2019,5,SP 255 da Decima a San Giovanni in Persiceto,11320,00,10758,562,8656,2664,11320,0
2019/01,246,05/01/2019,6,SP 255 da Decima a San Giovanni in Persiceto,10152,00,10025,127,7186,2966,0,10152
2019/01,246,06/01/2019,7,SP 255 da Decima a San Giovanni in Persiceto,7946,00,7890,56,5469,2477,0,7946
2019/01,246,07/01/2019,1,SP 255 da Decima a San Giovanni in Persiceto,13308,00,12419,889,10606,2702,13308,0
2019/01,246,08/01/2019,2,SP 255 da Decima a San Giovanni in Persiceto,13352,00,12432,920,10697,2655,13352,0
2019/01,246,09/01/2019,3,SP 255 da Decima a San Giovanni in Persiceto,13486,00,12489,997,10505,2981,13486,0
2019/01,246,10/01/2019,4,SP 255 da Decima a San Giovanni in Persiceto,14299,00,13235,1064,11272,3027,14299,0
2019/01,246,11/01/2019,5,SP 255 da Decima a San Giovanni in Persiceto,15002,00,14002,1000,11399,3603,15002,0
2019/01,246,12/01/2019,6,SP 255 da Decima a San Giovanni in Persiceto,11613,00,11402,211,8418,3195,0,11613
2019/01,246,13/01/2019,7,SP 255 da Decima a San Giovanni in Persiceto,8790,00,8739,51,6175,2615,0,8790
2019/01,246,14/01/2019,1,SP 255 da Decima a San Giovanni in Persiceto,14099,00,13017,1082,11075,3024,14099,0
2019/01,247,01/01/2019,2,SP 255 fra Nonantola e Sant'Agata Bolognese,4118,00,4100,18,2344,1774,0,4118
2019/01,247,02/01/2019,3,SP 255 fra Nonantola e Sant'Agata Bolognese,6421,00,5805,616,5097,1324,6421,0
2019/01,247,03/01/2019,4,SP 255 fra Nonantola e Sant'Agata Bolognese,7083,00,6294,789,5525,1558,7083,0
2019/01,247,04/01/2019,5,SP 255 fra Nonantola e Sant'Agata Bolognese,7524,00,6685,839,5748,1776,7524,0
2019/01,247,05/01/2019,6,SP 255 fra Nonantola e Sant'Agata Bolognese,6929,00,6751,178,4652,2277,0,6929
2019/01,247,06/01/2019,7,SP 255 fra Nonantola e Sant'Agata Bolognese,5830,00,5802,28,4057,1773,0,5830
2019/01,247,07/01/2019,1,SP 255 fra Nonantola e Sant'Agata Bolognese,9263,00,8075,1188,7363,1900,9263,0
2019/01,247,08/01/2019,2,SP 255 fra Nonantola e Sant'Agata Bolognese,9371,00,8016,1355,7529,1842,9371,0
2019/01,247,09/01/2019,3,SP 255 fra Nonantola e Sant'Agata Bolognese,9820,00,8398,1422,7758,2062,9820,0
2019/01,247,10/01/2019,4,SP 255 fra Nonantola e Sant'Agata Bolognese,10193,00,8659,1534,7919,2274,10193,0
2019/01,247,11/01/2019,5,SP 255 fra Nonantola e Sant'Agata Bolognese,10678,00,9179,1499,8124,2554,10678,0
2019/01,247,12/01/2019,6,SP 255 fra Nonantola e Sant'Agata Bolognese,7330,00,7072,258,5098,2232,0,7330
2019/01,247,13/01/2019,7,SP 255 fra Nonantola e Sant'Agata Bolognese,6202,00,6168,34,4256,1946,0,6202
2019/01,247,14/01/2019,1,SP 255 fra Nonantola e Sant'Agata Bolognese,9967,00,8502,1465,7879,2088,9967,0
2019/01,251,01/01/2019,2,SP 610 tra Imola e Casalfiumanese in località Ca' Miseria,7748,00,7717,31,4804,2944,0,7748
2019/01,251,02/01/2019,3,SP 610 tra Imola e Casalfiumanese in località Ca' Miseria,10428,00,10180,248,8328,2100,10428,0
2019/01,251,03/01/2019,4,SP 610 tra Imola e Casalfiumanese in località Ca' Miseria,11155,10,10797,357,8818,2337,11155,0
2019/01,251,04/01/2019,5,SP 610 tra Imola e Casalfiumanese in località Ca' Miseria,11354,00,10963,391,8922,2432,11354,0
2019/01,251,05/01/2019,6,SP 610 tra Imola e Casalfiumanese in località Ca' Miseria,11009,20,10872,135,8210,2799,0,11009
2019/01,251,06/01/2019,7,SP 610 tra Imola e Casalfiumanese in località Ca' Miseria,9091,00,9056,35,6995,2096,0,9091
2019/01,251,07/01/2019,1,SP 610 tra Imola e Casalfiumanese in località Ca' Miseria,11940,10,11372,567,9452,2488,11940,0
2019/01,251,08/01/2019,2,SP 610 tra Imola e Casalfiumanese in località Ca' Miseria,12340,00,11745,595,9784,2556,12340,0
2019/01,251,09/01/2019,3,SP 610 tra Imola e Casalfiumanese in località Ca' Miseria,12703,00,12089,614,9867,2836,12703,0
2019/01,251,10/01/2019,4,SP 610 tra Imola e Casalfiumanese in località Ca' Miseria,12568,00,12023,545,9781,2787,12568,0
2019/01,251,11/01/2019,5,SP 610 tra Imola e Casalfiumanese in località Ca' Miseria,12965,20,12360,603,10108,2857,12965,0
2019/01,251,12/01/2019,6,SP 610 tra Imola e Casalfiumanese in località Ca' Miseria,12122,10,11983,138,9270,2852,0,12122
2019/01,251,13/01/2019,7,SP 610 tra Imola e Casalfiumanese in località Ca' Miseria,9708,10,9663,44,7419,2289,0,9708
2019/01,251,14/01/2019,1,SP 610 tra Imola e Casalfiumanese in località Ca' Miseria,12561,10,11900,660,9919,2642,12561,0
2019/01,252,01/01/2019,2,SP 3_2 tra Budrio e bivio SP 29 per Medicina,4061,00,4051,10,2581,1480,0,4061
2019/01,252,02/01/2019,3,SP 3_2 tra Budrio e bivio SP 29 per Medicina,7333,00,6851,482,6136,1197,7333,0
2019/01,252,03/01/2019,4,SP 3_2 tra Budrio e bivio SP 29 per Medicina,7017,00,6581,436,5664,1353,7017,0
2019/01,252,04/01/2019,5,SP 3_2 tra Budrio e bivio SP 29 per Medicina,7249,10,6799,449,5711,1538,7249,0
2019/01,252,05/01/2019,6,SP 3_2 tra Budrio e bivio SP 29 per Medicina,6828,00,6706,122,5264,1564,0,6828
2019/01,252,06/01/2019,7,SP 3_2 tra Budrio e bivio SP 29 per Medicina,6340,00,6315,25,4980,1360,0,6340
2019/01,252,07/01/2019,1,SP 3_2 tra Budrio e bivio SP 29 per Medicina,8811,00,8215,596,7241,1570,8811,0
2019/01,252,08/01/2019,2,SP 3_2 tra Budrio e bivio SP 29 per Medicina,8388,00,7718,670,6947,1441,8388,0
2019/01,252,09/01/2019,3,SP 3_2 tra Budrio e bivio SP 29 per Medicina,8627,00,7925,702,7098,1529,8627,0
2019/01,252,10/01/2019,4,SP 3_2 tra Budrio e bivio SP 29 per Medicina,9143,10,8433,709,7431,1712,9143,0
2019/01,252,11/01/2019,5,SP 3_2 tra Budrio e bivio SP 29 per Medicina,9321,00,8622,699,7455,1866,9321,0
2019/01,252,12/01/2019,6,SP 3_2 tra Budrio e bivio SP 29 per Medicina,6955,00,6817,138,5297,1658,0,6955
2019/01,252,13/01/2019,7,SP 3_2 tra Budrio e bivio SP 29 per Medicina,6277,00,6262,15,4865,1412,0,6277
2019/01,252,14/01/2019,1,SP 3_2 tra Budrio e bivio SP 29 per Medicina,8993,10,8260,732,7336,1657,8993,0
2019/01,255,01/01/2019,2,SS 9 tra Castel San Pietro e Imola,9635,00,9569,66,5464,4171,0,9635
2019/01,255,02/01/2019,3,SS 9 tra Castel San Pietro e Imola,16581,10,16204,376,13465,3116,16581,0
2019/01,255,03/01/2019,4,SS 9 tra Castel San Pietro e Imola,15849,30,15407,439,12432,3417,15849,0
2019/01,255,04/01/2019,5,SS 9 tra Castel San Pietro e Imola,17065,20,16632,431,13332,3733,17065,0
2019/01,255,05/01/2019,6,SS 9 tra Castel San Pietro e Imola,17086,10,16886,199,12826,4260,0,17086
2019/01,255,06/01/2019,7,SS 9 tra Castel San Pietro e Imola,13599,00,13553,46,10242,3357,0,13599
2019/01,255,07/01/2019,1,SS 9 tra Castel San Pietro e Imola,18997,00,18366,631,15134,3863,18997,0
2019/01,255,08/01/2019,2,SS 9 tra Castel San Pietro e Imola,18936,30,18243,690,15355,3581,18936,0
2019/01,255,09/01/2019,3,SS 9 tra Castel San Pietro e Imola,19260,30,18551,706,15307,3953,19260,0
2019/01,255,10/01/2019,4,SS 9 tra Castel San Pietro e Imola,19567,20,18857,708,15648,3919,19567,0
2019/01,255,11/01/2019,5,SS 9 tra Castel San Pietro e Imola,20419,20,19688,729,15989,4430,20419,0
2019/01,255,12/01/2019,6,SS 9 tra Castel San Pietro e Imola,17947,20,17734,211,13268,4679,0,17947
2019/01,255,13/01/2019,7,SS 9 tra Castel San Pietro e Imola,14218,00,14155,63,10607,3611,0,14218
2019/01,255,14/01/2019,1,SS 9 tra Castel San Pietro e Imola,19228,60,18527,695,15268,3960,19228,0
2019/01,257,01/01/2019,2,SP 302R tra Faenza e il bivio SP 4 (a sud di Russi),4147,00,4134,13,2637,1510,0,4147
2019/01,257,02/01/2019,3,SP 302R tra Faenza e il bivio SP 4 (a sud di Russi),5133,00,4995,138,4028,1105,5133,0
2019/01,257,03/01/2019,4,SP 302R tra Faenza e il bivio SP 4 (a sud di Russi),5619,00,5472,147,4399,1220,5619,0
2019/01,257,04/01/2019,5,SP 302R tra Faenza e il bivio SP 4 (a sud di Russi),5792,00,5629,163,4410,1382,5792,0
2019/01,257,05/01/2019,6,SP 302R tra Faenza e il bivio SP 4 (a sud di Russi),5512,00,5442,70,3876,1636,0,5512
2019/01,257,06/01/2019,7,SP 302R tra Faenza e il bivio SP 4 (a sud di Russi),4805,00,4787,18,3355,1450,0,4805
2019/01,257,07/01/2019,1,SP 302R tra Faenza e il bivio SP 4 (a sud di Russi),6122,00,5916,206,4936,1186,6122,0
2019/01,257,08/01/2019,2,SP 302R tra Faenza e il bivio SP 4 (a sud di Russi),6086,00,5874,212,4915,1171,6086,0
2019/01,257,09/01/2019,3,SP 302R tra Faenza e il bivio SP 4 (a sud di Russi),6386,00,6174,212,5097,1289,6386,0
2019/01,257,10/01/2019,4,SP 302R tra Faenza e il bivio SP 4 (a sud di Russi),6360,00,6159,201,5042,1318,6360,0
2019/01,257,11/01/2019,5,SP 302R tra Faenza e il bivio SP 4 (a sud di Russi),6649,00,6461,188,5110,1539,6649,0
2019/01,257,12/01/2019,6,SP 302R tra Faenza e il bivio SP 4 (a sud di Russi),6031,00,5951,80,4401,1630,0,6031
2019/01,257,13/01/2019,7,SP 302R tra Faenza e il bivio SP 4 (a sud di Russi),5093,00,5065,28,3803,1290,0,5093
2019/01,257,14/01/2019,1,SP 302R tra Faenza e il bivio SP 4 (a sud di Russi),6436,00,6239,197,5126,1310,6436,0
2019/01,258,01/01/2019,2,SS 9 tra Forlimpopoli e Cesena,13708,00,13526,182,7915,5793,0,13708
2019/01,258,02/01/2019,3,SS 9 tra Forlimpopoli e Cesena,19135,20,17933,1200,15010,4125,19135,0
2019/01,258,03/01/2019,4,SS 9 tra Forlimpopoli e Cesena,20123,10,18698,1424,15685,4438,20123,0
2019/01,258,04/01/2019,5,SS 9 tra Forlimpopoli e Cesena,21108,00,19664,1444,15834,5274,21108,0
2019/01,258,05/01/2019,6,SS 9 tra Forlimpopoli e Cesena,18976,20,18203,771,13398,5578,0,18976
2019/01,258,06/01/2019,7,SS 9 tra Forlimpopoli e Cesena,16005,00,15793,212,11342,4663,0,16005
2019/01,258,07/01/2019,1,SS 9 tra Forlimpopoli e Cesena,22913,30,21100,1810,18171,4742,22913,0
2019/01,258,08/01/2019,2,SS 9 tra Forlimpopoli e Cesena,23286,90,21348,1929,18414,4872,23286,0
2019/01,258,09/01/2019,3,SS 9 tra Forlimpopoli e Cesena,24036,90,21954,2073,18898,5138,24036,0
2019/01,258,10/01/2019,4,SS 9 tra Forlimpopoli e Cesena,23916,30,21827,2086,18800,5116,23916,0
2019/01,258,11/01/2019,5,SS 9 tra Forlimpopoli e Cesena,24419,90,22408,2002,18556,5863,24419,0
2019/01,258,12/01/2019,6,SS 9 tra Forlimpopoli e Cesena,20761,10,19944,816,15100,5661,0,20761
2019/01,258,13/01/2019,7,SS 9 tra Forlimpopoli e Cesena,16536,00,16364,172,11878,4658,0,16536
2019/01,258,14/01/2019,1,SS 9 tra Forlimpopoli e Cesena,23963,60,21881,2076,19029,4934,23963,0
2019/01,259,01/01/2019,2,SP 7 in località Calabrina al Confine Provinciale,9058,00,8924,134,6108,2950,0,9058
2019/01,259,02/01/2019,3,SP 7 in località Calabrina al Confine Provinciale,6710,00,6402,308,5371,1339,6710,0
2019/01,259,03/01/2019,4,SP 7 in località Calabrina al Confine Provinciale,7329,00,7054,275,5672,1657,7329,0
2019/01,259,04/01/2019,5,SP 7 in località Calabrina al Confine Provinciale,7354,00,7087,267,5413,1941,7354,0
2019/01,259,05/01/2019,6,SP 7 in località Calabrina al Confine Provinciale,7675,00,7547,128,5265,2410,0,7675
2019/01,259,06/01/2019,7,SP 7 in località Calabrina al Confine Provinciale,7531,00,7471,60,5583,1948,0,7531
2019/01,259,07/01/2019,1,SP 7 in località Calabrina al Confine Provinciale,6962,00,6573,389,5482,1480,6962,0
2019/01,259,08/01/2019,2,SP 7 in località Calabrina al Confine Provinciale,7202,00,6793,409,5718,1484,7202,0
2019/01,259,09/01/2019,3,SP 7 in località Calabrina al Confine Provinciale,7720,00,7254,466,6088,1632,7720,0
2019/01,259,10/01/2019,4,SP 7 in località Calabrina al Confine Provinciale,7631,00,7205,426,5916,1715,7631,0
2019/01,259,11/01/2019,5,SP 7 in località Calabrina al Confine Provinciale,8149,00,7734,415,6088,2061,8149,0
2019/01,259,12/01/2019,6,SP 7 in località Calabrina al Confine Provinciale,8116,00,7946,170,5684,2432,0,8116
2019/01,259,13/01/2019,7,SP 7 in località Calabrina al Confine Provinciale,7802,00,7772,30,5537,2265,0,7802
2019/01,259,14/01/2019,1,SP 7 in località Calabrina al Confine Provinciale,7074,00,6641,433,5606,1468,7074,0
2019/01,260,01/01/2019,2,SP 8 tra Cesena e A 14,8770,00,8744,26,5759,3011,0,8770
2019/01,260,02/01/2019,3,SP 8 tra Cesena e A 14,8960,00,8815,145,7141,1819,8960,0
2019/01,260,03/01/2019,4,SP 8 tra Cesena e A 14,9813,20,9636,175,7848,1965,9813,0
2019/01,260,04/01/2019,5,SP 8 tra Cesena e A 14,10280,00,10074,206,8044,2236,10280,0
2019/01,260,05/01/2019,6,SP 8 tra Cesena e A 14,9518,00,9444,74,6853,2665,0,9518
2019/01,260,06/01/2019,7,SP 8 tra Cesena e A 14,8718,00,8696,22,6500,2218,0,8718
2019/01,260,07/01/2019,1,SP 8 tra Cesena e A 14,10775,00,10504,271,8796,1979,10775,0
2019/01,260,08/01/2019,2,SP 8 tra Cesena e A 14,10938,00,10569,369,8922,2016,10938,0
2019/01,260,09/01/2019,3,SP 8 tra Cesena e A 14,11090,00,10695,395,8860,2230,11090,0
2019/01,260,10/01/2019,4,SP 8 tra Cesena e A 14,11052,10,10727,324,8930,2122,11052,0
2019/01,260,11/01/2019,5,SP 8 tra Cesena e A 14,11861,00,11483,378,9354,2507,11861,0
2019/01,260,12/01/2019,6,SP 8 tra Cesena e A 14,10682,00,10560,122,7849,2833,0,10682
2019/01,260,13/01/2019,7,SP 8 tra Cesena e A 14,8651,00,8641,10,6525,2126,0,8651
2019/01,260,14/01/2019,1,SP 8 tra Cesena e A 14,10766,00,10468,298,8815,1951,10766,0
2019/01,261,01/01/2019,2,SS 9 tra Cesena e Savignano sul Rubicone,14118,10,14016,101,8172,5946,0,14118
2019/01,261,02/01/2019,3,SS 9 tra Cesena e Savignano sul Rubicone,21502,00,19963,1539,16951,4551,21502,0
2019/01,261,03/01/2019,4,SS 9 tra Cesena e Savignano sul Rubicone,22949,00,21263,1686,17835,5114,22949,0
2019/01,261,04/01/2019,5,SS 9 tra Cesena e Savignano sul Rubicone,23763,00,21949,1814,18291,5472,23763,0
2019/01,261,05/01/2019,6,SS 9 tra Cesena e Savignano sul Rubicone,20266,00,19412,854,14329,5937,0,20266
2019/01,261,06/01/2019,7,SS 9 tra Cesena e Savignano sul Rubicone,16582,00,16442,140,11410,5172,0,16582
2019/01,261,07/01/2019,1,SS 9 tra Cesena e Savignano sul Rubicone,26948,30,24839,2106,21766,5182,26948,0
2019/01,261,08/01/2019,2,SS 9 tra Cesena e Savignano sul Rubicone,27141,10,24932,2208,21906,5235,27141,0
2019/01,261,09/01/2019,3,SS 9 tra Cesena e Savignano sul Rubicone,27999,00,25817,2182,22343,5656,27999,0
2019/01,261,10/01/2019,4,SS 9 tra Cesena e Savignano sul Rubicone,28420,00,26079,2341,22519,5901,28420,0
2019/01,261,11/01/2019,5,SS 9 tra Cesena e Savignano sul Rubicone,29345,10,27048,2296,22784,6561,29345,0
2019/01,261,12/01/2019,6,SS 9 tra Cesena e Savignano sul Rubicone,22651,10,21821,829,16325,6326,0,22651
2019/01,261,13/01/2019,7,SS 9 tra Cesena e Savignano sul Rubicone,16537,00,16421,116,11500,5037,0,16537
2019/01,261,14/01/2019,1,SS 9 tra Cesena e Savignano sul Rubicone,27934,00,25692,2242,22517,5417,27934,0
2019/01,262,01/01/2019,2,SS 9 tra Savignano sul Rubicone e Santarcangelo di Romagna,,,,,,,,
2019/01,262,02/01/2019,3,SS 9 tra Savignano sul Rubicone e Santarcangelo di Romagna,,,,,,,,
2019/01,262,03/01/2019,4,SS 9 tra Savignano sul Rubicone e Santarcangelo di Romagna,,,,,,,,
2019/01,262,04/01/2019,5,SS 9 tra Savignano sul Rubicone e Santarcangelo di Romagna,,,,,,,,
2019/01,262,05/01/2019,6,SS 9 tra Savignano sul Rubicone e Santarcangelo di Romagna,,,,,,,,
2019/01,262,06/01/2019,7,SS 9 tra Savignano sul Rubicone e Santarcangelo di Romagna,,,,,,,,
2019/01,262,07/01/2019,1,SS 9 tra Savignano sul Rubicone e Santarcangelo di Romagna,,,,,,,,
2019/01,262,08/01/2019,2,SS 9 tra Savignano sul Rubicone e Santarcangelo di Romagna,,,,,,,,
2019/01,262,09/01/2019,3,SS 9 tra Savignano sul Rubicone e Santarcangelo di Romagna,,,,,,,,
2019/01,262,10/01/2019,4,SS 9 tra Savignano sul Rubicone e Santarcangelo di Romagna,,,,,,,,
2019/01,262,11/01/2019,5,SS 9 tra Savignano sul Rubicone e Santarcangelo di Romagna,,,,,,,,
2019/01,262,12/01/2019,6,SS 9 tra Savignano sul Rubicone e Santarcangelo di Romagna,,,,,,,,
2019/01,262,13/01/2019,7,SS 9 tra Savignano sul Rubicone e Santarcangelo di Romagna,,,,,,,,
2019/01,262,14/01/2019,1,SS 9 tra Savignano sul Rubicone e Santarcangelo di Romagna,,,,,,,,
2019/01,263,01/01/2019,2,Via Adriatica (ex SS 16) tra Riccione e Misano Adriatico,14750,10,14671,78,8515,6235,0,14750
2019/01,263,02/01/2019,3,Via Adriatica (ex SS 16) tra Riccione e Misano Adriatico,15219,00,14999,220,11897,3322,15219,0
2019/01,263,03/01/2019,4,Via Adriatica (ex SS 16) tra Riccione e Misano Adriatico,15748,00,15504,244,12120,3628,15748,0
2019/01,263,04/01/2019,5,Via Adriatica (ex SS 16) tra Riccione e Misano Adriatico,15727,00,15445,282,11967,3760,15727,0
2019/01,263,05/01/2019,6,Via Adriatica (ex SS 16) tra Riccione e Misano Adriatico,16433,10,16316,116,11406,5027,0,16433
2019/01,263,06/01/2019,7,Via Adriatica (ex SS 16) tra Riccione e Misano Adriatico,13653,00,13618,35,9235,4418,0,13653
2019/01,263,07/01/2019,1,Via Adriatica (ex SS 16) tra Riccione e Misano Adriatico,16011,00,15654,357,12844,3167,16011,0
2019/01,263,08/01/2019,2,Via Adriatica (ex SS 16) tra Riccione e Misano Adriatico,16156,00,15788,368,12963,3193,16156,0
2019/01,263,09/01/2019,3,Via Adriatica (ex SS 16) tra Riccione e Misano Adriatico,16335,10,15958,376,12910,3425,16335,0
2019/01,263,10/01/2019,4,Via Adriatica (ex SS 16) tra Riccione e Misano Adriatico,16325,00,15917,408,12924,3401,16325,0
2019/01,263,11/01/2019,5,Via Adriatica (ex SS 16) tra Riccione e Misano Adriatico,16848,00,16472,376,12971,3877,16848,0
2019/01,263,12/01/2019,6,Via Adriatica (ex SS 16) tra Riccione e Misano Adriatico,16261,00,16107,154,11353,4908,0,16261
2019/01,263,13/01/2019,7,Via Adriatica (ex SS 16) tra Riccione e Misano Adriatico,14307,00,14268,39,9621,4686,0,14307
2019/01,263,14/01/2019,1,Via Adriatica (ex SS 16) tra Riccione e Misano Adriatico,15988,00,15677,311,12718,3270,15988,0
2019/01,269,01/01/2019,2,SS 12 a Medolla,7147,00,7104,43,4161,2986,0,7147
2019/01,269,02/01/2019,3,SS 12 a Medolla,12986,10,12130,855,10513,2473,12986,0
2019/01,269,03/01/2019,4,SS 12 a Medolla,14336,30,13304,1029,11575,2761,14336,0
2019/01,269,04/01/2019,5,SS 12 a Medolla,15137,00,14101,1036,11836,3301,15137,0
2019/01,269,05/01/2019,6,SS 12 a Medolla,13182,00,12942,240,9357,3825,0,13182
2019/01,269,06/01/2019,7,SS 12 a Medolla,11047,00,10987,60,7802,3245,0,11047
2019/01,269,07/01/2019,1,SS 12 a Medolla,17953,00,16284,1669,14725,3228,17953,0
2019/01,269,08/01/2019,2,SS 12 a Medolla,18075,00,16290,1785,14919,3156,18075,0
2019/01,269,09/01/2019,3,SS 12 a Medolla,18440,10,16589,1850,15073,3367,18440,0
2019/01,269,10/01/2019,4,SS 12 a Medolla,19304,00,17478,1826,15596,3708,19304,0
2019/01,269,11/01/2019,5,SS 12 a Medolla,19954,00,18110,1844,15661,4293,19954,0
2019/01,269,12/01/2019,6,SS 12 a Medolla,15225,00,14929,296,10883,4342,0,15225
2019/01,269,13/01/2019,7,SS 12 a Medolla,13216,00,13152,64,9444,3772,0,13216
2019/01,269,14/01/2019,1,SS 12 a Medolla,18963,20,17104,1857,15516,3447,18963,0
2019/01,275,01/01/2019,2,SP 5 dall'intersezione SP 3 a intersezione per Ca' de Fabbri,4457,00,4425,32,2631,1826,0,4457
2019/01,275,05/01/2019,6,SP 5 dall'intersezione SP 3 a intersezione per Ca' de Fabbri,7236,00,7120,116,5454,1782,0,7236
2019/01,275,07/01/2019,1,SP 5 dall'intersezione SP 3 a intersezione per Ca' de Fabbri,8662,00,8283,379,6985,1677,8662,0
2019/01,275,08/01/2019,2,SP 5 dall'intersezione SP 3 a intersezione per Ca' de Fabbri,7653,00,7322,331,5890,1763,7653,0
2019/01,275,11/01/2019,5,SP 5 dall'intersezione SP 3 a intersezione per Ca' de Fabbri,9365,00,8962,403,7135,2230,9365,0
2019/01,275,12/01/2019,6,SP 5 dall'intersezione SP 3 a intersezione per Ca' de Fabbri,8344,00,8206,138,6161,2183,0,8344
2019/01,275,13/01/2019,7,SP 5 dall'intersezione SP 3 a intersezione per Ca' de Fabbri,6490,00,6451,39,4778,1712,0,6490
2019/01,275,14/01/2019,1,SP 5 dall'intersezione SP 3 a intersezione per Ca' de Fabbri,10808,10,10316,491,8735,2073,10808,0
2019/01,276,01/01/2019,2,SP 3_2 tra intersezione SP 5 e ponte torrente Idice,4497,00,4452,45,2701,1796,0,4497
2019/01,276,02/01/2019,3,SP 3_2 tra intersezione SP 5 e ponte torrente Idice,8681,00,8059,622,7241,1440,8681,0
2019/01,276,03/01/2019,4,SP 3_2 tra intersezione SP 5 e ponte torrente Idice,8816,00,8181,635,7120,1696,8816,0
2019/01,276,04/01/2019,5,SP 3_2 tra intersezione SP 5 e ponte torrente Idice,9012,00,8390,622,7168,1844,9012,0
2019/01,276,05/01/2019,6,SP 3_2 tra intersezione SP 5 e ponte torrente Idice,7125,00,6953,172,5332,1793,0,7125
2019/01,276,06/01/2019,7,SP 3_2 tra intersezione SP 5 e ponte torrente Idice,6430,00,6395,35,4835,1595,0,6430
2019/01,276,07/01/2019,1,SP 3_2 tra intersezione SP 5 e ponte torrente Idice,11510,00,10651,859,9397,2113,11510,0
2019/01,276,08/01/2019,2,SP 3_2 tra intersezione SP 5 e ponte torrente Idice,11686,00,10763,923,9719,1967,11686,0
2019/01,276,09/01/2019,3,SP 3_2 tra intersezione SP 5 e ponte torrente Idice,11785,00,10742,1043,9600,2185,11785,0
2019/01,276,10/01/2019,4,SP 3_2 tra intersezione SP 5 e ponte torrente Idice,12245,00,11207,1038,9997,2248,12245,0
2019/01,276,11/01/2019,5,SP 3_2 tra intersezione SP 5 e ponte torrente Idice,11980,00,10969,1011,9470,2510,11980,0
2019/01,276,12/01/2019,6,SP 3_2 tra intersezione SP 5 e ponte torrente Idice,7610,00,7406,204,5603,2007,0,7610
2019/01,276,13/01/2019,7,SP 3_2 tra intersezione SP 5 e ponte torrente Idice,7229,00,7181,48,5430,1799,0,7229
2019/01,276,14/01/2019,1,SP 3_2 tra intersezione SP 5 e ponte torrente Idice,12128,00,11056,1072,9882,2246,12128,0
2019/01,278,01/01/2019,2,SP 6 tra Budrio e bivio SP 253,5791,00,5771,20,3402,2389,0,5791
2019/01,278,02/01/2019,3,SP 6 tra Budrio e bivio SP 253,10140,00,9828,312,8157,1983,10140,0
2019/01,278,03/01/2019,4,SP 6 tra Budrio e bivio SP 253,10897,00,10540,357,8674,2223,10897,0
2019/01,278,04/01/2019,5,SP 6 tra Budrio e bivio SP 253,11575,00,11230,345,9102,2473,11575,0
2019/01,278,05/01/2019,6,SP 6 tra Budrio e bivio SP 253,10224,00,10100,124,7579,2645,0,10224
2019/01,278,06/01/2019,7,SP 6 tra Budrio e bivio SP 253,8230,00,8194,36,6056,2174,0,8230
2019/01,278,07/01/2019,1,SP 6 tra Budrio e bivio SP 253,13132,10,12606,525,10601,2531,13132,0
2019/01,278,08/01/2019,2,SP 6 tra Budrio e bivio SP 253,13814,10,13162,651,11206,2608,13814,0
2019/01,278,09/01/2019,3,SP 6 tra Budrio e bivio SP 253,13972,00,13281,691,11075,2897,13972,0
2019/01,278,10/01/2019,4,SP 6 tra Budrio e bivio SP 253,13993,00,13325,668,11189,2804,13993,0
2019/01,278,11/01/2019,5,SP 6 tra Budrio e bivio SP 253,14320,00,13649,671,11210,3110,14320,0
2019/01,278,12/01/2019,6,SP 6 tra Budrio e bivio SP 253,11288,00,11122,166,8465,2823,0,11288
2019/01,278,13/01/2019,7,SP 6 tra Budrio e bivio SP 253,8418,10,8375,42,6199,2219,0,8418
2019/01,278,14/01/2019,1,SP 6 tra Budrio e bivio SP 253,13939,00,13281,658,11229,2710,13939,0
2019/01,279,01/01/2019,2,SP 31 dal bivio SP 28 per Castenaso a Ponte Rizzoli,4873,00,4831,42,3113,1760,0,4873
2019/01,279,02/01/2019,3,SP 31 dal bivio SP 28 per Castenaso a Ponte Rizzoli,12032,00,11509,523,10444,1588,12032,0
2019/01,279,03/01/2019,4,SP 31 dal bivio SP 28 per Castenaso a Ponte Rizzoli,10410,00,9979,431,8691,1719,10410,0
2019/01,279,04/01/2019,5,SP 31 dal bivio SP 28 per Castenaso a Ponte Rizzoli,10998,10,10576,421,9005,1993,10998,0
2019/01,279,05/01/2019,6,SP 31 dal bivio SP 28 per Castenaso a Ponte Rizzoli,10030,00,9909,121,7975,2055,0,10030
2019/01,279,06/01/2019,7,SP 31 dal bivio SP 28 per Castenaso a Ponte Rizzoli,8525,00,8488,37,6691,1834,0,8525
2019/01,279,07/01/2019,1,SP 31 dal bivio SP 28 per Castenaso a Ponte Rizzoli,13733,10,12915,817,11565,2168,13733,0
2019/01,279,08/01/2019,2,SP 31 dal bivio SP 28 per Castenaso a Ponte Rizzoli,13224,00,12275,949,11355,1869,13224,0
2019/01,279,09/01/2019,3,SP 31 dal bivio SP 28 per Castenaso a Ponte Rizzoli,13432,00,12494,938,11420,2012,13432,0
2019/01,279,10/01/2019,4,SP 31 dal bivio SP 28 per Castenaso a Ponte Rizzoli,14046,00,13077,969,11835,2211,14046,0
2019/01,279,11/01/2019,5,SP 31 dal bivio SP 28 per Castenaso a Ponte Rizzoli,14803,00,13820,983,12255,2548,14803,0
2019/01,279,12/01/2019,6,SP 31 dal bivio SP 28 per Castenaso a Ponte Rizzoli,10154,00,10007,147,8002,2152,0,10154
2019/01,279,13/01/2019,7,SP 31 dal bivio SP 28 per Castenaso a Ponte Rizzoli,8840,00,8793,47,6911,1929,0,8840
2019/01,279,14/01/2019,1,SP 31 dal bivio SP 28 per Castenaso a Ponte Rizzoli,14180,10,13143,1036,11954,2226,14180,0
2019/01,280,01/01/2019,2,SP 26 tra Gesso e Ponte Rivabella,11316,00,11293,23,6991,4325,0,11316
2019/01,280,02/01/2019,3,SP 26 tra Gesso e Ponte Rivabella,15875,00,15645,230,12581,3294,15875,0
2019/01,280,03/01/2019,4,SP 26 tra Gesso e Ponte Rivabella,17140,00,16885,255,13467,3673,17140,0
2019/01,280,04/01/2019,5,SP 26 tra Gesso e Ponte Rivabella,18224,00,17938,286,14169,4055,18224,0
2019/01,280,05/01/2019,6,SP 26 tra Gesso e Ponte Rivabella,17136,00,17007,129,12897,4239,0,17136
2019/01,280,06/01/2019,7,SP 26 tra Gesso e Ponte Rivabella,13719,00,13684,35,10279,3440,0,13719
2019/01,280,07/01/2019,1,SP 26 tra Gesso e Ponte Rivabella,20180,10,19710,469,16060,4120,20180,0
2019/01,280,08/01/2019,2,SP 26 tra Gesso e Ponte Rivabella,20568,00,19975,593,16309,4259,20568,0
2019/01,280,09/01/2019,3,SP 26 tra Gesso e Ponte Rivabella,20548,00,19974,574,16065,4483,20548,0
2019/01,280,10/01/2019,4,SP 26 tra Gesso e Ponte Rivabella,21002,00,20427,575,16445,4557,21002,0
2019/01,280,11/01/2019,5,SP 26 tra Gesso e Ponte Rivabella,21718,00,21122,596,16615,5103,21718,0
2019/01,280,12/01/2019,6,SP 26 tra Gesso e Ponte Rivabella,19188,00,18999,189,14386,4802,0,19188
2019/01,280,13/01/2019,7,SP 26 tra Gesso e Ponte Rivabella,14472,00,14432,40,10904,3568,0,14472
2019/01,280,14/01/2019,1,SP 26 tra Gesso e Ponte Rivabella,20665,00,20092,573,16354,4311,20665,0
2019/01,281,01/01/2019,2,SP 78_1 tra Bazzano e Intersezione SP 27 a Monteveglio,3549,00,3516,33,2278,1271,0,3549
2019/01,281,02/01/2019,3,SP 78_1 tra Bazzano e Intersezione SP 27 a Monteveglio,4846,00,4722,124,3925,921,4846,0
2019/01,281,03/01/2019,4,SP 78_1 tra Bazzano e Intersezione SP 27 a Monteveglio,5366,00,5224,142,4351,1015,5366,0
2019/01,281,04/01/2019,5,SP 78_1 tra Bazzano e Intersezione SP 27 a Monteveglio,5701,10,5549,151,4468,1233,5701,0
2019/01,281,05/01/2019,6,SP 78_1 tra Bazzano e Intersezione SP 27 a Monteveglio,5584,10,5516,67,4246,1338,0,5584
2019/01,281,06/01/2019,7,SP 78_1 tra Bazzano e Intersezione SP 27 a Monteveglio,4148,00,4116,32,3105,1043,0,4148
2019/01,281,07/01/2019,1,SP 78_1 tra Bazzano e Intersezione SP 27 a Monteveglio,6304,00,6100,204,5105,1199,6304,0
2019/01,281,08/01/2019,2,SP 78_1 tra Bazzano e Intersezione SP 27 a Monteveglio,6361,10,6168,192,5168,1193,6361,0
2019/01,281,09/01/2019,3,SP 78_1 tra Bazzano e Intersezione SP 27 a Monteveglio,6505,00,6305,200,5226,1279,6505,0
2019/01,281,10/01/2019,4,SP 78_1 tra Bazzano e Intersezione SP 27 a Monteveglio,6504,10,6291,212,5256,1248,6504,0
2019/01,281,11/01/2019,5,SP 78_1 tra Bazzano e Intersezione SP 27 a Monteveglio,6713,10,6506,206,5269,1444,6713,0
2019/01,281,12/01/2019,6,SP 78_1 tra Bazzano e Intersezione SP 27 a Monteveglio,6480,10,6401,78,4988,1492,0,6480
2019/01,281,13/01/2019,7,SP 78_1 tra Bazzano e Intersezione SP 27 a Monteveglio,4148,10,4113,34,3091,1057,0,4148
2019/01,281,14/01/2019,1,SP 78_1 tra Bazzano e Intersezione SP 27 a Monteveglio,6670,10,6468,201,5388,1282,6670,0
2019/01,282,01/01/2019,2,SS 9 tra Anzola dell'Emilia e Bologna,10000,10,9949,50,5953,4047,0,10000
2019/01,282,02/01/2019,3,SS 9 tra Anzola dell'Emilia e Bologna,15803,00,14743,1060,12221,3582,15803,0
2019/01,282,03/01/2019,4,SS 9 tra Anzola dell'Emilia e Bologna,18093,00,16703,1390,13843,4250,18093,0
2019/01,282,04/01/2019,5,SS 9 tra Anzola dell'Emilia e Bologna,19017,00,17535,1482,14151,4866,19017,0
2019/01,282,05/01/2019,6,SS 9 tra Anzola dell'Emilia e Bologna,15978,00,15491,487,11283,4695,0,15978
2019/01,282,06/01/2019,7,SS 9 tra Anzola dell'Emilia e Bologna,13740,00,13636,104,9772,3968,0,13740
2019/01,282,07/01/2019,1,SS 9 tra Anzola dell'Emilia e Bologna,22187,00,20187,2000,17266,4921,22187,0
2019/01,282,08/01/2019,2,SS 9 tra Anzola dell'Emilia e Bologna,22155,00,20062,2093,17213,4942,22155,0
2019/01,282,09/01/2019,3,SS 9 tra Anzola dell'Emilia e Bologna,22936,10,20784,2151,17609,5327,22936,0
2019/01,282,10/01/2019,4,SS 9 tra Anzola dell'Emilia e Bologna,23552,00,21330,2222,17873,5679,23552,0
2019/01,282,11/01/2019,5,SS 9 tra Anzola dell'Emilia e Bologna,24142,10,21900,2241,17921,6221,24142,0
2019/01,282,12/01/2019,6,SS 9 tra Anzola dell'Emilia e Bologna,17909,00,17364,545,12513,5396,0,17909
2019/01,282,13/01/2019,7,SS 9 tra Anzola dell'Emilia e Bologna,14419,00,14312,107,10172,4247,0,14419
2019/01,282,14/01/2019,1,SS 9 tra Anzola dell'Emilia e Bologna,23730,00,21428,2302,18159,5571,23730,0
2019/01,285,01/01/2019,2,SP 1 fra Crevalcore e Decima,2477,00,2466,11,1447,1030,0,2477
2019/01,285,02/01/2019,3,SP 1 fra Crevalcore e Decima,4299,00,4109,190,3456,843,4299,0
2019/01,285,03/01/2019,4,SP 1 fra Crevalcore e Decima,4880,10,4645,234,3861,1019,4880,0
2019/01,285,04/01/2019,5,SP 1 fra Crevalcore e Decima,5052,00,4818,234,3871,1181,5052,0
2019/01,285,05/01/2019,6,SP 1 fra Crevalcore e Decima,4592,00,4511,81,3218,1374,0,4592
2019/01,285,06/01/2019,7,SP 1 fra Crevalcore e Decima,3704,00,3684,20,2564,1140,0,3704
2019/01,285,07/01/2019,1,SP 1 fra Crevalcore e Decima,5743,00,5384,359,4612,1131,5743,0
2019/01,285,08/01/2019,2,SP 1 fra Crevalcore e Decima,5646,00,5267,379,4566,1080,5646,0
2019/01,285,09/01/2019,3,SP 1 fra Crevalcore e Decima,6204,00,5786,418,5026,1178,6204,0
2019/01,285,10/01/2019,4,SP 1 fra Crevalcore e Decima,6110,00,5694,416,4792,1318,6110,0
2019/01,285,11/01/2019,5,SP 1 fra Crevalcore e Decima,6293,00,5882,411,4821,1472,6293,0
2019/01,285,12/01/2019,6,SP 1 fra Crevalcore e Decima,5089,00,5002,87,3653,1436,0,5089
2019/01,285,13/01/2019,7,SP 1 fra Crevalcore e Decima,3606,00,3589,17,2527,1079,0,3606
2019/01,285,14/01/2019,1,SP 1 fra Crevalcore e Decima,5924,00,5535,389,4693,1231,5924,0
2019/01,287,01/01/2019,2,SP 6 fra Cento e Pilastrello,3784,00,3777,7,2167,1617,0,3784
2019/01,287,02/01/2019,3,SP 6 fra Cento e Pilastrello,5811,10,5595,215,4583,1228,5811,0
2019/01,287,04/01/2019,5,SP 6 fra Cento e Pilastrello,5971,00,5753,218,4639,1332,5971,0
2019/01,287,06/01/2019,7,SP 6 fra Cento e Pilastrello,5056,00,5040,16,3617,1439,0,5056
2019/01,287,07/01/2019,1,SP 6 fra Cento e Pilastrello,7256,00,6858,398,6023,1233,7256,0
2019/01,287,08/01/2019,2,SP 6 fra Cento e Pilastrello,6890,00,6475,415,5794,1096,6890,0
2019/01,287,10/01/2019,4,SP 6 fra Cento e Pilastrello,7872,00,7413,459,6435,1437,7872,0
2019/01,287,11/01/2019,5,SP 6 fra Cento e Pilastrello,8163,10,7695,467,6528,1635,8163,0
2019/01,287,12/01/2019,6,SP 6 fra Cento e Pilastrello,7169,00,7079,90,5130,2039,0,7169
2019/01,287,13/01/2019,7,SP 6 fra Cento e Pilastrello,5543,00,5522,21,3918,1625,0,5543
2019/01,287,14/01/2019,1,SP 6 fra Cento e Pilastrello,7840,10,7370,469,6394,1446,7840,0
2019/01,288,01/01/2019,2,SP 42 fra Pieve di Cento e Castello d'Argile,7705,00,7659,46,4346,3359,0,7705
2019/01,288,02/01/2019,3,SP 42 fra Pieve di Cento e Castello d'Argile,12400,00,12016,384,9813,2587,12400,0
2019/01,288,03/01/2019,4,SP 42 fra Pieve di Cento e Castello d'Argile,14143,00,13749,394,11096,3047,14143,0
2019/01,288,04/01/2019,5,SP 42 fra Pieve di Cento e Castello d'Argile,14440,00,14039,401,10989,3451,14440,0
2019/01,288,05/01/2019,6,SP 42 fra Pieve di Cento e Castello d'Argile,12006,00,11827,179,8492,3514,0,12006
2019/01,288,06/01/2019,7,SP 42 fra Pieve di Cento e Castello d'Argile,10048,00,9986,62,7065,2983,0,10048
2019/01,288,07/01/2019,1,SP 42 fra Pieve di Cento e Castello d'Argile,17269,00,16550,719,13692,3577,17269,0
2019/01,288,08/01/2019,2,SP 42 fra Pieve di Cento e Castello d'Argile,17378,00,16605,773,13788,3590,17378,0
2019/01,288,09/01/2019,3,SP 42 fra Pieve di Cento e Castello d'Argile,18328,00,17444,884,14411,3917,18328,0
2019/01,288,10/01/2019,4,SP 42 fra Pieve di Cento e Castello d'Argile,18881,00,17995,886,14826,4055,18881,0
2019/01,288,11/01/2019,5,SP 42 fra Pieve di Cento e Castello d'Argile,19012,00,18137,875,14585,4427,19012,0
2019/01,288,12/01/2019,6,SP 42 fra Pieve di Cento e Castello d'Argile,14213,00,14030,183,10215,3998,0,14213
2019/01,288,13/01/2019,7,SP 42 fra Pieve di Cento e Castello d'Argile,10087,00,10026,61,7054,3033,0,10087
2019/01,288,14/01/2019,1,SP 42 fra Pieve di Cento e Castello d'Argile,18364,10,17542,821,14494,3870,18364,0
2019/01,289,01/01/2019,2,SP 66 fra Cento e Sant'Agostino,6350,00,6329,21,3674,2676,0,6350
2019/01,289,02/01/2019,3,SP 66 fra Cento e Sant'Agostino,10809,00,10470,339,8754,2055,10809,0
2019/01,289,03/01/2019,4,SP 66 fra Cento e Sant'Agostino,11985,00,11604,381,9767,2218,11985,0
2019/01,289,04/01/2019,5,SP 66 fra Cento e Sant'Agostino,11938,00,11529,409,9476,2462,11938,0
2019/01,289,05/01/2019,6,SP 66 fra Cento e Sant'Agostino,11339,00,11173,166,8303,3036,0,11339
2019/01,289,06/01/2019,7,SP 66 fra Cento e Sant'Agostino,9023,00,8985,38,6432,2591,0,9023
2019/01,289,07/01/2019,1,SP 66 fra Cento e Sant'Agostino,13487,00,12871,616,11157,2330,13487,0
2019/01,289,08/01/2019,2,SP 66 fra Cento e Sant'Agostino,13240,00,12573,667,10998,2242,13240,0
2019/01,289,09/01/2019,3,SP 66 fra Cento e Sant'Agostino,13917,10,13121,795,11349,2568,13917,0
2019/01,289,10/01/2019,4,SP 66 fra Cento e Sant'Agostino,14308,10,13543,764,11645,2663,14308,0
2019/01,289,11/01/2019,5,SP 66 fra Cento e Sant'Agostino,14801,00,14052,749,11672,3129,14801,0
2019/01,289,12/01/2019,6,SP 66 fra Cento e Sant'Agostino,12455,00,12249,206,9225,3230,0,12455
2019/01,289,13/01/2019,7,SP 66 fra Cento e Sant'Agostino,9554,00,9502,52,6861,2693,0,9554
2019/01,289,14/01/2019,1,SP 66 fra Cento e Sant'Agostino,14437,10,13648,788,11826,2611,14437,0
2019/01,290,01/01/2019,2,SP 11 fra Pieve di Cento e San Pietro in Casale,3215,00,3202,13,1718,1497,0,3215
2019/01,290,02/01/2019,3,SP 11 fra Pieve di Cento e San Pietro in Casale,4422,00,4262,160,3488,934,4422,0
2019/01,290,03/01/2019,4,SP 11 fra Pieve di Cento e San Pietro in Casale,4821,00,4631,190,3795,1026,4821,0
2019/01,290,04/01/2019,5,SP 11 fra Pieve di Cento e San Pietro in Casale,5300,00,5101,199,3988,1312,5300,0
2019/01,290,05/01/2019,6,SP 11 fra Pieve di Cento e San Pietro in Casale,5082,00,4984,98,3441,1641,0,5082
2019/01,290,06/01/2019,7,SP 11 fra Pieve di Cento e San Pietro in Casale,3893,00,3884,9,2594,1299,0,3893
2019/01,290,07/01/2019,1,SP 11 fra Pieve di Cento e San Pietro in Casale,5754,00,5474,280,4681,1073,5754,0
2019/01,290,08/01/2019,2,SP 11 fra Pieve di Cento e San Pietro in Casale,5965,00,5634,331,4897,1068,5965,0
2019/01,290,09/01/2019,3,SP 11 fra Pieve di Cento e San Pietro in Casale,5976,00,5642,334,4826,1150,5976,0
2019/01,290,10/01/2019,4,SP 11 fra Pieve di Cento e San Pietro in Casale,6171,00,5813,358,4952,1219,6171,0
2019/01,290,11/01/2019,5,SP 11 fra Pieve di Cento e San Pietro in Casale,6570,00,6252,318,5051,1519,6570,0
2019/01,290,12/01/2019,6,SP 11 fra Pieve di Cento e San Pietro in Casale,5617,00,5514,103,3925,1692,0,5617
2019/01,290,13/01/2019,7,SP 11 fra Pieve di Cento e San Pietro in Casale,3975,00,3954,21,2603,1372,0,3975
2019/01,290,14/01/2019,1,SP 11 fra Pieve di Cento e San Pietro in Casale,6092,00,5742,350,4982,1110,6092,0
2019/01,291,01/01/2019,2,SP 4 tra San Pietro in Casale e San Vincenzo/San Venanzio,4594,00,4580,14,2695,1899,0,4594
2019/01,291,02/01/2019,3,SP 4 tra San Pietro in Casale e San Vincenzo/San Venanzio,7670,00,7498,172,6136,1534,7670,0
2019/01,291,03/01/2019,4,SP 4 tra San Pietro in Casale e San Vincenzo/San Venanzio,8410,00,8189,221,6724,1686,8410,0
2019/01,291,04/01/2019,5,SP 4 tra San Pietro in Casale e San Vincenzo/San Venanzio,8929,00,8675,254,6863,2066,8929,0
2019/01,291,05/01/2019,6,SP 4 tra San Pietro in Casale e San Vincenzo/San Venanzio,8640,00,8569,71,6471,2169,0,8640
2019/01,291,06/01/2019,7,SP 4 tra San Pietro in Casale e San Vincenzo/San Venanzio,6554,00,6527,27,4877,1677,0,6554
2019/01,291,07/01/2019,1,SP 4 tra San Pietro in Casale e San Vincenzo/San Venanzio,9954,00,9643,311,7807,2147,9954,0
2019/01,291,08/01/2019,2,SP 4 tra San Pietro in Casale e San Vincenzo/San Venanzio,10023,00,9659,364,7905,2118,10023,0
2019/01,291,09/01/2019,3,SP 4 tra San Pietro in Casale e San Vincenzo/San Venanzio,10203,00,9796,407,7974,2229,10203,0
2019/01,291,10/01/2019,4,SP 4 tra San Pietro in Casale e San Vincenzo/San Venanzio,10391,00,9977,414,8128,2263,10391,0
2019/01,291,11/01/2019,5,SP 4 tra San Pietro in Casale e San Vincenzo/San Venanzio,10766,00,10401,365,8226,2540,10766,0
2019/01,291,12/01/2019,6,SP 4 tra San Pietro in Casale e San Vincenzo/San Venanzio,8943,00,8836,107,6601,2342,0,8943
2019/01,291,13/01/2019,7,SP 4 tra San Pietro in Casale e San Vincenzo/San Venanzio,6890,00,6859,31,5082,1808,0,6890
2019/01,291,14/01/2019,1,SP 4 tra San Pietro in Casale e San Vincenzo/San Venanzio,10090,00,9714,376,7923,2167,10090,0
2019/01,292,01/01/2019,2,SP 4 tra San Giorgio di Piano e Intersezione SP 11 c/o San Pietro in Casale,7950,00,7938,12,4445,3505,0,7950
2019/01,292,02/01/2019,3,SP 4 tra San Giorgio di Piano e Intersezione SP 11 c/o San Pietro in Casale,12457,00,12189,268,9828,2629,12457,0
2019/01,292,03/01/2019,4,SP 4 tra San Giorgio di Piano e Intersezione SP 11 c/o San Pietro in Casale,13805,00,13454,351,10835,2970,13805,0
2019/01,292,04/01/2019,5,SP 4 tra San Giorgio di Piano e Intersezione SP 11 c/o San Pietro in Casale,14753,00,14353,400,11051,3702,14753,0
2019/01,292,05/01/2019,6,SP 4 tra San Giorgio di Piano e Intersezione SP 11 c/o San Pietro in Casale,12707,00,12562,145,9112,3595,0,12707
2019/01,292,06/01/2019,7,SP 4 tra San Giorgio di Piano e Intersezione SP 11 c/o San Pietro in Casale,9759,00,9732,27,6934,2825,0,9759
2019/01,292,07/01/2019,1,SP 4 tra San Giorgio di Piano e Intersezione SP 11 c/o San Pietro in Casale,16600,00,16099,501,13060,3540,16600,0
2019/01,292,08/01/2019,2,SP 4 tra San Giorgio di Piano e Intersezione SP 11 c/o San Pietro in Casale,17291,00,16678,613,13700,3591,17291,0
2019/01,292,09/01/2019,3,SP 4 tra San Giorgio di Piano e Intersezione SP 11 c/o San Pietro in Casale,17137,10,16526,610,13301,3836,17137,0
2019/01,292,10/01/2019,4,SP 4 tra San Giorgio di Piano e Intersezione SP 11 c/o San Pietro in Casale,17289,10,16642,646,13456,3833,17289,0
2019/01,292,11/01/2019,5,SP 4 tra San Giorgio di Piano e Intersezione SP 11 c/o San Pietro in Casale,18184,00,17567,617,13624,4560,18184,0
2019/01,292,12/01/2019,6,SP 4 tra San Giorgio di Piano e Intersezione SP 11 c/o San Pietro in Casale,14542,00,14376,166,10468,4074,0,14542
2019/01,292,13/01/2019,7,SP 4 tra San Giorgio di Piano e Intersezione SP 11 c/o San Pietro in Casale,11638,00,11607,31,8662,2976,0,11638
2019/01,292,14/01/2019,1,SP 4 tra San Giorgio di Piano e Intersezione SP 11 c/o San Pietro in Casale,17401,00,16826,575,13502,3899,17401,0
2019/01,295,01/01/2019,2,SP 9 fra Colorno e Torrile centro abitato di Bezze,1383,00,1349,34,813,570,0,1383
2019/01,295,02/01/2019,3,SP 9 fra Colorno e Torrile centro abitato di Bezze,2503,10,2259,243,2022,481,2503,0
2019/01,295,03/01/2019,4,SP 9 fra Colorno e Torrile centro abitato di Bezze,2779,10,2510,268,2269,510,2779,0
2019/01,295,04/01/2019,5,SP 9 fra Colorno e Torrile centro abitato di Bezze,2947,00,2675,272,2338,609,2947,0
2019/01,295,05/01/2019,6,SP 9 fra Colorno e Torrile centro abitato di Bezze,2219,00,2112,107,1659,560,0,2219
2019/01,295,06/01/2019,7,SP 9 fra Colorno e Torrile centro abitato di Bezze,1854,00,1803,51,1364,490,0,1854
2019/01,295,07/01/2019,1,SP 9 fra Colorno e Torrile centro abitato di Bezze,3413,10,3083,329,2830,583,3413,0
2019/01,295,08/01/2019,2,SP 9 fra Colorno e Torrile centro abitato di Bezze,3292,00,2936,356,2707,585,3292,0
2019/01,295,09/01/2019,3,SP 9 fra Colorno e Torrile centro abitato di Bezze,3517,00,3164,353,2878,639,3517,0
2019/01,295,10/01/2019,4,SP 9 fra Colorno e Torrile centro abitato di Bezze,3529,00,3164,365,2866,663,3529,0
2019/01,295,11/01/2019,5,SP 9 fra Colorno e Torrile centro abitato di Bezze,3789,00,3420,369,3031,758,3789,0
2019/01,295,12/01/2019,6,SP 9 fra Colorno e Torrile centro abitato di Bezze,2648,00,2536,112,2016,632,0,2648
2019/01,295,13/01/2019,7,SP 9 fra Colorno e Torrile centro abitato di Bezze,1995,00,1945,50,1493,502,0,1995
2019/01,295,14/01/2019,1,SP 9 fra Colorno e Torrile centro abitato di Bezze,3657,00,3256,401,2996,661,3657,0
2019/01,298,01/01/2019,2,SP 588R da Castione Marchesi (A 1) a Busseto,1330,00,1305,25,726,604,0,1330
2019/01,298,02/01/2019,3,SP 588R da Castione Marchesi (A 1) a Busseto,2011,10,1898,112,1637,374,2011,0
2019/01,298,03/01/2019,4,SP 588R da Castione Marchesi (A 1) a Busseto,2259,00,2164,95,1832,427,2259,0
2019/01,298,04/01/2019,5,SP 588R da Castione Marchesi (A 1) a Busseto,2324,00,2215,109,1821,503,2324,0
2019/01,298,05/01/2019,6,SP 588R da Castione Marchesi (A 1) a Busseto,2069,00,2026,43,1542,527,0,2069
2019/01,298,06/01/2019,7,SP 588R da Castione Marchesi (A 1) a Busseto,2142,00,2115,27,1510,632,0,2142
2019/01,298,07/01/2019,1,SP 588R da Castione Marchesi (A 1) a Busseto,2679,00,2525,154,2206,473,2679,0
2019/01,298,08/01/2019,2,SP 588R da Castione Marchesi (A 1) a Busseto,2737,00,2573,164,2294,443,2737,0
2019/01,298,09/01/2019,3,SP 588R da Castione Marchesi (A 1) a Busseto,2883,00,2693,190,2391,492,2883,0
2019/01,298,10/01/2019,4,SP 588R da Castione Marchesi (A 1) a Busseto,2968,00,2762,206,2423,545,2968,0
2019/01,298,11/01/2019,5,SP 588R da Castione Marchesi (A 1) a Busseto,3129,00,2941,188,2389,740,3129,0
2019/01,298,12/01/2019,6,SP 588R da Castione Marchesi (A 1) a Busseto,2533,00,2481,52,1852,681,0,2533
2019/01,298,13/01/2019,7,SP 588R da Castione Marchesi (A 1) a Busseto,1891,00,1868,23,1419,472,0,1891
2019/01,298,14/01/2019,1,SP 588R da Castione Marchesi (A 1) a Busseto,2783,00,2614,169,2274,509,2783,0
2019/01,300,01/01/2019,2,SP 462R fra Fiorenzuola d'Arda e Cortemaggiore,3526,00,3482,44,2218,1308,0,3526
2019/01,300,02/01/2019,3,SP 462R fra Fiorenzuola d'Arda e Cortemaggiore,5921,30,5344,574,4814,1107,5921,0
2019/01,300,03/01/2019,4,SP 462R fra Fiorenzuola d'Arda e Cortemaggiore,6673,10,5939,733,5365,1308,6673,0
2019/01,300,04/01/2019,5,SP 462R fra Fiorenzuola d'Arda e Cortemaggiore,6721,20,5930,789,5256,1465,6721,0
2019/01,300,05/01/2019,6,SP 462R fra Fiorenzuola d'Arda e Cortemaggiore,5908,00,5589,319,4488,1420,0,5908
2019/01,300,06/01/2019,7,SP 462R fra Fiorenzuola d'Arda e Cortemaggiore,4983,00,4934,49,3823,1160,0,4983
2019/01,300,07/01/2019,1,SP 462R fra Fiorenzuola d'Arda e Cortemaggiore,7747,10,6744,1002,6327,1420,7747,0
2019/01,300,08/01/2019,2,SP 462R fra Fiorenzuola d'Arda e Cortemaggiore,7784,10,6738,1045,6453,1331,7784,0
2019/01,300,09/01/2019,3,SP 462R fra Fiorenzuola d'Arda e Cortemaggiore,8045,10,7075,969,6471,1574,8045,0
2019/01,300,10/01/2019,4,SP 462R fra Fiorenzuola d'Arda e Cortemaggiore,8257,20,7217,1038,6687,1570,8257,0
2019/01,300,11/01/2019,5,SP 462R fra Fiorenzuola d'Arda e Cortemaggiore,8662,00,7594,1068,6657,2005,8662,0
2019/01,300,12/01/2019,6,SP 462R fra Fiorenzuola d'Arda e Cortemaggiore,6519,00,6181,338,5008,1511,0,6519
2019/01,300,13/01/2019,7,SP 462R fra Fiorenzuola d'Arda e Cortemaggiore,5139,00,5085,54,3920,1219,0,5139
2019/01,300,14/01/2019,1,SP 462R fra Fiorenzuola d'Arda e Cortemaggiore,8149,20,7050,1097,6641,1508,8149,0
2019/01,301,01/01/2019,2,SP 4 tra Fiorenzuola d'Arda (Tg Sud) e Castell'Arquato,4714,00,4701,13,3097,1617,0,4714
2019/01,301,02/01/2019,3,SP 4 tra Fiorenzuola d'Arda (Tg Sud) e Castell'Arquato,6381,10,6173,207,5124,1257,6381,0
2019/01,301,03/01/2019,4,SP 4 tra Fiorenzuola d'Arda (Tg Sud) e Castell'Arquato,6734,10,6508,225,5369,1365,6734,0
2019/01,301,04/01/2019,5,SP 4 tra Fiorenzuola d'Arda (Tg Sud) e Castell'Arquato,6833,00,6599,234,5408,1425,6833,0
2019/01,301,05/01/2019,6,SP 4 tra Fiorenzuola d'Arda (Tg Sud) e Castell'Arquato,6252,00,6155,97,4720,1532,0,6252
2019/01,301,06/01/2019,7,SP 4 tra Fiorenzuola d'Arda (Tg Sud) e Castell'Arquato,5429,00,5405,24,4023,1406,0,5429
2019/01,301,07/01/2019,1,SP 4 tra Fiorenzuola d'Arda (Tg Sud) e Castell'Arquato,7502,00,7082,420,6070,1432,7502,0
2019/01,301,08/01/2019,2,SP 4 tra Fiorenzuola d'Arda (Tg Sud) e Castell'Arquato,7368,00,6897,471,5984,1384,7368,0
2019/01,301,09/01/2019,3,SP 4 tra Fiorenzuola d'Arda (Tg Sud) e Castell'Arquato,7508,00,7081,427,6077,1431,7508,0
2019/01,301,10/01/2019,4,SP 4 tra Fiorenzuola d'Arda (Tg Sud) e Castell'Arquato,8062,00,7625,437,6456,1606,8062,0
2019/01,301,11/01/2019,5,SP 4 tra Fiorenzuola d'Arda (Tg Sud) e Castell'Arquato,8440,10,8010,429,6339,2101,8440,0
2019/01,301,12/01/2019,6,SP 4 tra Fiorenzuola d'Arda (Tg Sud) e Castell'Arquato,7157,00,7043,114,5538,1619,0,7157
2019/01,301,13/01/2019,7,SP 4 tra Fiorenzuola d'Arda (Tg Sud) e Castell'Arquato,5505,00,5476,29,4083,1422,0,5505
2019/01,301,14/01/2019,1,SP 4 tra Fiorenzuola d'Arda (Tg Sud) e Castell'Arquato,8011,10,7504,506,6533,1478,8011,0
2019/01,302,01/01/2019,2,SP 12 da Fidenza (Casello A 1) a Soragna,3344,00,3301,43,2002,1342,0,3344
2019/01,302,02/01/2019,3,SP 12 da Fidenza (Casello A 1) a Soragna,6279,00,5765,514,5170,1109,6279,0
2019/01,302,03/01/2019,4,SP 12 da Fidenza (Casello A 1) a Soragna,7144,10,6497,646,5934,1210,7144,0
2019/01,302,04/01/2019,5,SP 12 da Fidenza (Casello A 1) a Soragna,6985,00,6280,705,5625,1360,6985,0
2019/01,302,05/01/2019,6,SP 12 da Fidenza (Casello A 1) a Soragna,7199,00,7012,187,5633,1566,0,7199
2019/01,302,06/01/2019,7,SP 12 da Fidenza (Casello A 1) a Soragna,5881,00,5819,62,4471,1410,0,5881
2019/01,302,07/01/2019,1,SP 12 da Fidenza (Casello A 1) a Soragna,7418,00,6571,847,6190,1228,7418,0
2019/01,302,08/01/2019,2,SP 12 da Fidenza (Casello A 1) a Soragna,7329,00,6432,897,6105,1224,7329,0
2019/01,302,09/01/2019,3,SP 12 da Fidenza (Casello A 1) a Soragna,7812,00,6870,942,6450,1362,7812,0
2019/01,302,10/01/2019,4,SP 12 da Fidenza (Casello A 1) a Soragna,7931,00,6900,1031,6488,1443,7931,0
2019/01,302,11/01/2019,5,SP 12 da Fidenza (Casello A 1) a Soragna,8269,00,7390,879,6362,1907,8269,0
2019/01,302,12/01/2019,6,SP 12 da Fidenza (Casello A 1) a Soragna,7358,00,7105,253,5665,1693,0,7358
2019/01,302,13/01/2019,7,SP 12 da Fidenza (Casello A 1) a Soragna,6218,00,6161,57,4754,1464,0,6218
2019/01,302,14/01/2019,1,SP 12 da Fidenza (Casello A 1) a Soragna,7541,10,6650,890,6258,1283,7541,0
2019/01,303,01/01/2019,2,SP 11 fra Borgonovo e Gragnano,4432,00,4405,27,2766,1666,0,4432
2019/01,303,02/01/2019,3,SP 11 fra Borgonovo e Gragnano,6867,10,6618,248,5455,1412,6867,0
2019/01,303,03/01/2019,4,SP 11 fra Borgonovo e Gragnano,7371,10,7134,236,5848,1523,7371,0
2019/01,303,04/01/2019,5,SP 11 fra Borgonovo e Gragnano,7538,00,7282,256,5935,1603,7538,0
2019/01,303,05/01/2019,6,SP 11 fra Borgonovo e Gragnano,7197,00,7075,122,5291,1906,0,7197
2019/01,303,06/01/2019,7,SP 11 fra Borgonovo e Gragnano,6292,00,6260,32,4738,1554,0,6292
2019/01,303,07/01/2019,1,SP 11 fra Borgonovo e Gragnano,8430,00,8010,420,6830,1600,8430,0
2019/01,303,08/01/2019,2,SP 11 fra Borgonovo e Gragnano,8601,00,8158,443,7046,1555,8601,0
2019/01,303,09/01/2019,3,SP 11 fra Borgonovo e Gragnano,9076,10,8582,493,7411,1665,9076,0
2019/01,303,10/01/2019,4,SP 11 fra Borgonovo e Gragnano,9086,10,8546,539,7305,1781,9086,0
2019/01,303,11/01/2019,5,SP 11 fra Borgonovo e Gragnano,9436,00,8902,534,7488,1948,9436,0
2019/01,303,12/01/2019,6,SP 11 fra Borgonovo e Gragnano,8345,00,8168,177,6206,2139,0,8345
2019/01,303,13/01/2019,7,SP 11 fra Borgonovo e Gragnano,6227,00,6196,31,4596,1631,0,6227
2019/01,303,14/01/2019,1,SP 11 fra Borgonovo e Gragnano,9028,00,8524,504,7342,1686,9028,0
2019/01,304,01/01/2019,2,SP 42 fra Podenzano e bivio SP 6/ponte fiume Nure in località San Giorgio Piacentino,3471,00,3456,15,2208,1263,0,3471
2019/01,304,02/01/2019,3,SP 42 fra Podenzano e bivio SP 6/ponte fiume Nure in località San Giorgio Piacentino,4709,00,4535,174,3719,990,4709,0
2019/01,304,03/01/2019,4,SP 42 fra Podenzano e bivio SP 6/ponte fiume Nure in località San Giorgio Piacentino,5245,00,5063,182,4247,998,5245,0
2019/01,304,04/01/2019,5,SP 42 fra Podenzano e bivio SP 6/ponte fiume Nure in località San Giorgio Piacentino,5375,00,5151,224,4192,1183,5375,0
2019/01,304,05/01/2019,6,SP 42 fra Podenzano e bivio SP 6/ponte fiume Nure in località San Giorgio Piacentino,4518,00,4455,63,3330,1188,0,4518
2019/01,304,06/01/2019,7,SP 42 fra Podenzano e bivio SP 6/ponte fiume Nure in località San Giorgio Piacentino,4596,10,4577,18,3591,1005,0,4596
2019/01,304,07/01/2019,1,SP 42 fra Podenzano e bivio SP 6/ponte fiume Nure in località San Giorgio Piacentino,6020,10,5778,241,4917,1103,6020,0
2019/01,304,08/01/2019,2,SP 42 fra Podenzano e bivio SP 6/ponte fiume Nure in località San Giorgio Piacentino,6062,00,5689,373,4966,1096,6062,0
2019/01,304,09/01/2019,3,SP 42 fra Podenzano e bivio SP 6/ponte fiume Nure in località San Giorgio Piacentino,6514,00,6153,361,5180,1334,6514,0
2019/01,304,10/01/2019,4,SP 42 fra Podenzano e bivio SP 6/ponte fiume Nure in località San Giorgio Piacentino,6547,00,6213,334,5260,1287,6547,0
2019/01,304,11/01/2019,5,SP 42 fra Podenzano e bivio SP 6/ponte fiume Nure in località San Giorgio Piacentino,6934,00,6569,365,5345,1589,6934,0
2019/01,304,12/01/2019,6,SP 42 fra Podenzano e bivio SP 6/ponte fiume Nure in località San Giorgio Piacentino,5297,00,5190,107,3930,1367,0,5297
2019/01,304,13/01/2019,7,SP 42 fra Podenzano e bivio SP 6/ponte fiume Nure in località San Giorgio Piacentino,4506,00,4487,19,3441,1065,0,4506
2019/01,304,14/01/2019,1,SP 42 fra Podenzano e bivio SP 6/ponte fiume Nure in località San Giorgio Piacentino,6439,00,6111,328,5219,1220,6439,0
2019/01,306,01/01/2019,2,SP 654R fra Ponte dell'Olio e Bettola,3978,00,3973,5,2833,1145,0,3978
2019/01,306,02/01/2019,3,SP 654R fra Ponte dell'Olio e Bettola,4131,00,4000,131,3487,644,4131,0
2019/01,306,03/01/2019,4,SP 654R fra Ponte dell'Olio e Bettola,3912,00,3810,102,3248,664,3912,0
2019/01,306,04/01/2019,5,SP 654R fra Ponte dell'Olio e Bettola,4152,00,4036,116,3349,803,4152,0
2019/01,306,05/01/2019,6,SP 654R fra Ponte dell'Olio e Bettola,4071,00,4004,67,3215,856,0,4071
2019/01,306,06/01/2019,7,SP 654R fra Ponte dell'Olio e Bettola,4241,00,4228,13,3429,812,0,4241
2019/01,306,07/01/2019,1,SP 654R fra Ponte dell'Olio e Bettola,4357,00,4176,181,3563,794,4357,0
2019/01,306,08/01/2019,2,SP 654R fra Ponte dell'Olio e Bettola,4079,10,3898,180,3297,782,4079,0
2019/01,306,09/01/2019,3,SP 654R fra Ponte dell'Olio e Bettola,4139,20,3964,173,3395,744,4139,0
2019/01,306,10/01/2019,4,SP 654R fra Ponte dell'Olio e Bettola,4123,30,3966,154,3354,769,4123,0
2019/01,306,11/01/2019,5,SP 654R fra Ponte dell'Olio e Bettola,4496,10,4327,168,3509,987,4496,0
2019/01,306,12/01/2019,6,SP 654R fra Ponte dell'Olio e Bettola,4250,00,4143,107,3243,1007,0,4250
2019/01,306,13/01/2019,7,SP 654R fra Ponte dell'Olio e Bettola,4176,00,4155,21,3320,856,0,4176
2019/01,306,14/01/2019,1,SP 654R fra Ponte dell'Olio e Bettola,4414,20,4253,159,3628,786,4414,0
2019/01,307,01/01/2019,2,SS 45 tra Rivergaro e Perino,4157,00,4151,6,3184,973,0,4157
2019/01,307,02/01/2019,3,SS 45 tra Rivergaro e Perino,3897,00,3773,124,3242,655,3897,0
2019/01,307,03/01/2019,4,SS 45 tra Rivergaro e Perino,4097,00,3957,140,3369,728,4097,0
2019/01,307,04/01/2019,5,SS 45 tra Rivergaro e Perino,4132,00,3979,153,3328,804,4132,0
2019/01,307,05/01/2019,6,SS 45 tra Rivergaro e Perino,4517,00,4433,84,3567,950,0,4517
2019/01,307,06/01/2019,7,SS 45 tra Rivergaro e Perino,4891,00,4869,22,4043,848,0,4891
2019/01,307,07/01/2019,1,SS 45 tra Rivergaro e Perino,3654,00,3488,166,2944,710,3654,0
2019/01,307,08/01/2019,2,SS 45 tra Rivergaro e Perino,3633,20,3478,153,2942,691,3633,0
2019/01,307,09/01/2019,3,SS 45 tra Rivergaro e Perino,3807,00,3615,192,3054,753,3807,0
2019/01,307,10/01/2019,4,SS 45 tra Rivergaro e Perino,3736,10,3548,187,3054,682,3736,0
2019/01,307,11/01/2019,5,SS 45 tra Rivergaro e Perino,4327,00,4132,195,3394,933,4327,0
2019/01,307,12/01/2019,6,SS 45 tra Rivergaro e Perino,4479,00,4369,110,3542,937,0,4479
2019/01,307,13/01/2019,7,SS 45 tra Rivergaro e Perino,4938,00,4912,26,4092,846,0,4938
2019/01,307,14/01/2019,1,SS 45 tra Rivergaro e Perino,3742,10,3584,157,2983,759,3742,0
2019/01,309,01/01/2019,2,SP 10R fra Castelvetro Piacentino e Monticelli d'Ongina,5036,00,5026,10,3150,1886,0,5036
2019/01,309,02/01/2019,3,SP 10R fra Castelvetro Piacentino e Monticelli d'Ongina,9149,00,8811,338,7440,1709,9149,0
2019/01,309,03/01/2019,4,SP 10R fra Castelvetro Piacentino e Monticelli d'Ongina,9495,00,9097,398,7594,1901,9495,0
2019/01,309,04/01/2019,5,SP 10R fra Castelvetro Piacentino e Monticelli d'Ongina,10196,10,9756,439,8074,2122,10196,0
2019/01,309,05/01/2019,6,SP 10R fra Castelvetro Piacentino e Monticelli d'Ongina,10165,10,10010,154,7666,2499,0,10165
2019/01,309,06/01/2019,7,SP 10R fra Castelvetro Piacentino e Monticelli d'Ongina,8813,00,8762,51,6834,1979,0,8813
2019/01,309,07/01/2019,1,SP 10R fra Castelvetro Piacentino e Monticelli d'Ongina,10272,00,9795,477,8343,1929,10272,0
2019/01,309,08/01/2019,2,SP 10R fra Castelvetro Piacentino e Monticelli d'Ongina,10118,10,9648,469,8147,1971,10118,0
2019/01,309,09/01/2019,3,SP 10R fra Castelvetro Piacentino e Monticelli d'Ongina,10789,10,10272,516,8671,2118,10789,0
2019/01,309,10/01/2019,4,SP 10R fra Castelvetro Piacentino e Monticelli d'Ongina,11023,20,10502,519,8751,2272,11023,0
2019/01,309,11/01/2019,5,SP 10R fra Castelvetro Piacentino e Monticelli d'Ongina,11465,10,10956,508,9053,2412,11465,0
2019/01,309,12/01/2019,6,SP 10R fra Castelvetro Piacentino e Monticelli d'Ongina,10806,20,10629,175,8089,2717,0,10806
2019/01,309,13/01/2019,7,SP 10R fra Castelvetro Piacentino e Monticelli d'Ongina,9403,00,9354,49,7267,2136,0,9403
2019/01,309,14/01/2019,1,SP 10R fra Castelvetro Piacentino e Monticelli d'Ongina,10709,30,10221,485,8647,2062,10709,0
2019/01,310,01/01/2019,2,SP 358R fra Cadelbosco di Sopra e Castelnovo di Sotto,5983,00,5955,28,3395,2588,0,5983
2019/01,310,02/01/2019,3,SP 358R fra Cadelbosco di Sopra e Castelnovo di Sotto,10873,00,10404,469,8637,2236,10873,0
2019/01,310,03/01/2019,4,SP 358R fra Cadelbosco di Sopra e Castelnovo di Sotto,12189,10,11629,559,9761,2428,12189,0
2019/01,310,04/01/2019,5,SP 358R fra Cadelbosco di Sopra e Castelnovo di Sotto,12943,00,12385,558,10081,2862,12943,0
2019/01,310,05/01/2019,6,SP 358R fra Cadelbosco di Sopra e Castelnovo di Sotto,11777,10,11596,180,8447,3330,0,11777
2019/01,310,06/01/2019,7,SP 358R fra Cadelbosco di Sopra e Castelnovo di Sotto,9587,00,9541,46,6767,2820,0,9587
2019/01,310,07/01/2019,1,SP 358R fra Cadelbosco di Sopra e Castelnovo di Sotto,14619,00,13900,719,11800,2819,14619,0
2019/01,310,08/01/2019,2,SP 358R fra Cadelbosco di Sopra e Castelnovo di Sotto,14789,00,13985,804,12007,2782,14789,0
2019/01,310,09/01/2019,3,SP 358R fra Cadelbosco di Sopra e Castelnovo di Sotto,15356,00,14556,800,12216,3140,15356,0
2019/01,310,10/01/2019,4,SP 358R fra Cadelbosco di Sopra e Castelnovo di Sotto,15439,00,14624,815,12256,3183,15439,0
2019/01,310,11/01/2019,5,SP 358R fra Cadelbosco di Sopra e Castelnovo di Sotto,15998,10,15145,852,12457,3541,15998,0
2019/01,310,12/01/2019,6,SP 358R fra Cadelbosco di Sopra e Castelnovo di Sotto,13236,00,12980,256,9471,3765,0,13236
2019/01,310,13/01/2019,7,SP 358R fra Cadelbosco di Sopra e Castelnovo di Sotto,10120,00,10071,49,7141,2979,0,10120
2019/01,310,14/01/2019,1,SP 358R fra Cadelbosco di Sopra e Castelnovo di Sotto,16320,00,15380,940,13159,3161,16320,0
2019/01,311,01/01/2019,2,SP 62RVar tra la località San Giacomo (bivio SP 42) ed SP 2 (c/o Tagliata),5563,00,5505,58,3533,2030,0,5563
2019/01,311,02/01/2019,3,SP 62RVar tra la località San Giacomo (bivio SP 42) ed SP 2 (c/o Tagliata),8353,00,7145,1208,6650,1703,8353,0
2019/01,311,03/01/2019,4,SP 62RVar tra la località San Giacomo (bivio SP 42) ed SP 2 (c/o Tagliata),8503,10,7124,1378,6774,1729,8503,0
2019/01,311,04/01/2019,5,SP 62RVar tra la località San Giacomo (bivio SP 42) ed SP 2 (c/o Tagliata),8883,00,7409,1474,6860,2023,8883,0
2019/01,311,05/01/2019,6,SP 62RVar tra la località San Giacomo (bivio SP 42) ed SP 2 (c/o Tagliata),8237,00,7883,354,6088,2149,0,8237
2019/01,311,06/01/2019,7,SP 62RVar tra la località San Giacomo (bivio SP 42) ed SP 2 (c/o Tagliata),7967,00,7876,91,5901,2066,0,7967
2019/01,311,07/01/2019,1,SP 62RVar tra la località San Giacomo (bivio SP 42) ed SP 2 (c/o Tagliata),9990,00,7987,2003,8190,1800,9990,0
2019/01,311,08/01/2019,2,SP 62RVar tra la località San Giacomo (bivio SP 42) ed SP 2 (c/o Tagliata),10009,10,7651,2357,8221,1788,10009,0
2019/01,311,09/01/2019,3,SP 62RVar tra la località San Giacomo (bivio SP 42) ed SP 2 (c/o Tagliata),10479,10,8097,2381,8480,1999,10479,0
2019/01,311,10/01/2019,4,SP 62RVar tra la località San Giacomo (bivio SP 42) ed SP 2 (c/o Tagliata),10849,10,8382,2466,8774,2075,10849,0
2019/01,311,11/01/2019,5,SP 62RVar tra la località San Giacomo (bivio SP 42) ed SP 2 (c/o Tagliata),11363,00,8980,2383,9015,2348,11363,0
2019/01,311,12/01/2019,6,SP 62RVar tra la località San Giacomo (bivio SP 42) ed SP 2 (c/o Tagliata),8101,00,7650,451,5969,2132,0,8101
2019/01,311,13/01/2019,7,SP 62RVar tra la località San Giacomo (bivio SP 42) ed SP 2 (c/o Tagliata),7852,10,7740,111,5611,2241,0,7852
2019/01,311,14/01/2019,1,SP 62RVar tra la località San Giacomo (bivio SP 42) ed SP 2 (c/o Tagliata),10836,00,8558,2278,8769,2067,10836,0
2019/01,312,01/01/2019,2,SP 42 fra Novellara e San Giacomo (SP 62R),5885,00,5846,39,3471,2414,0,5885
2019/01,312,02/01/2019,3,SP 42 fra Novellara e San Giacomo (SP 62R),8882,00,8379,503,7037,1845,8882,0
2019/01,312,03/01/2019,4,SP 42 fra Novellara e San Giacomo (SP 62R),10585,00,9974,611,8492,2093,10585,0
2019/01,312,04/01/2019,5,SP 42 fra Novellara e San Giacomo (SP 62R),10815,00,10130,685,8274,2541,10815,0
2019/01,312,05/01/2019,6,SP 42 fra Novellara e San Giacomo (SP 62R),9625,00,9452,173,6897,2728,0,9625
2019/01,312,06/01/2019,7,SP 42 fra Novellara e San Giacomo (SP 62R),8764,00,8683,81,6499,2265,0,8764
2019/01,312,07/01/2019,1,SP 42 fra Novellara e San Giacomo (SP 62R),12549,00,11533,1016,10157,2392,12549,0
2019/01,312,08/01/2019,2,SP 42 fra Novellara e San Giacomo (SP 62R),12754,00,11649,1105,10427,2327,12754,0
2019/01,312,09/01/2019,3,SP 42 fra Novellara e San Giacomo (SP 62R),13662,00,12430,1232,10918,2744,13662,0
2019/01,312,10/01/2019,4,SP 42 fra Novellara e San Giacomo (SP 62R),13683,00,12476,1207,10954,2729,13683,0
2019/01,312,11/01/2019,5,SP 42 fra Novellara e San Giacomo (SP 62R),14176,00,12963,1213,11159,3017,14176,0
2019/01,312,12/01/2019,6,SP 42 fra Novellara e San Giacomo (SP 62R),11225,00,11031,194,8139,3086,0,11225
2019/01,312,13/01/2019,7,SP 42 fra Novellara e San Giacomo (SP 62R),9116,00,9044,72,6508,2608,0,9116
2019/01,312,14/01/2019,1,SP 42 fra Novellara e San Giacomo (SP 62R),13443,00,12242,1201,10897,2546,13443,0
2019/01,314,01/01/2019,2,SP 2 fra Reggiolo (bivio SP 2) e località Villarotta (SP 84),4075,00,4050,25,2356,1719,0,4075
2019/01,314,02/01/2019,3,SP 2 fra Reggiolo (bivio SP 2) e località Villarotta (SP 84),5989,00,5788,201,4770,1219,5989,0
2019/01,314,03/01/2019,4,SP 2 fra Reggiolo (bivio SP 2) e località Villarotta (SP 84),6793,00,6567,226,5490,1303,6793,0
2019/01,314,04/01/2019,5,SP 2 fra Reggiolo (bivio SP 2) e località Villarotta (SP 84),7259,00,7049,210,5605,1654,7259,0
2019/01,314,05/01/2019,6,SP 2 fra Reggiolo (bivio SP 2) e località Villarotta (SP 84),6197,00,6082,115,4469,1728,0,6197
2019/01,314,06/01/2019,7,SP 2 fra Reggiolo (bivio SP 2) e località Villarotta (SP 84),5721,00,5687,34,4070,1651,0,5721
2019/01,314,07/01/2019,1,SP 2 fra Reggiolo (bivio SP 2) e località Villarotta (SP 84),8000,00,7652,348,6483,1517,8000,0
2019/01,314,08/01/2019,2,SP 2 fra Reggiolo (bivio SP 2) e località Villarotta (SP 84),7859,00,7524,335,6424,1435,7859,0
2019/01,314,09/01/2019,3,SP 2 fra Reggiolo (bivio SP 2) e località Villarotta (SP 84),8514,00,8123,391,6871,1643,8514,0
2019/01,314,10/01/2019,4,SP 2 fra Reggiolo (bivio SP 2) e località Villarotta (SP 84),8504,00,8152,352,6775,1729,8504,0
2019/01,314,11/01/2019,5,SP 2 fra Reggiolo (bivio SP 2) e località Villarotta (SP 84),8980,00,8643,337,6998,1982,8980,0
2019/01,314,12/01/2019,6,SP 2 fra Reggiolo (bivio SP 2) e località Villarotta (SP 84),7357,00,7213,144,5346,2011,0,7357
2019/01,314,13/01/2019,7,SP 2 fra Reggiolo (bivio SP 2) e località Villarotta (SP 84),5737,00,5688,49,3899,1838,0,5737
2019/01,314,14/01/2019,1,SP 2 fra Reggiolo (bivio SP 2) e località Villarotta (SP 84),8612,00,8229,383,6943,1669,8612,0
2019/01,318,01/01/2019,2,SP 51 fra Sassuolo (bivio SP 467R) e Rubiera,4948,00,4925,23,2986,1962,0,4948
2019/01,318,02/01/2019,3,SP 51 fra Sassuolo (bivio SP 467R) e Rubiera,7892,00,7081,811,6173,1719,7892,0
2019/01,318,03/01/2019,4,SP 51 fra Sassuolo (bivio SP 467R) e Rubiera,8083,00,7014,1069,6273,1810,8083,0
2019/01,318,04/01/2019,5,SP 51 fra Sassuolo (bivio SP 467R) e Rubiera,8421,00,7481,940,6348,2073,8421,0
2019/01,318,05/01/2019,6,SP 51 fra Sassuolo (bivio SP 467R) e Rubiera,7588,00,7436,152,5287,2301,0,7588
2019/01,318,06/01/2019,7,SP 51 fra Sassuolo (bivio SP 467R) e Rubiera,6681,00,6635,46,4715,1966,0,6681
2019/01,318,07/01/2019,1,SP 51 fra Sassuolo (bivio SP 467R) e Rubiera,9677,20,7812,1863,7881,1796,9677,0
2019/01,318,08/01/2019,2,SP 51 fra Sassuolo (bivio SP 467R) e Rubiera,10143,10,7980,2162,8353,1790,10143,0
2019/01,318,09/01/2019,3,SP 51 fra Sassuolo (bivio SP 467R) e Rubiera,10763,00,8395,2368,8696,2067,10763,0
2019/01,318,10/01/2019,4,SP 51 fra Sassuolo (bivio SP 467R) e Rubiera,10875,10,8359,2515,8757,2118,10875,0
2019/01,318,11/01/2019,5,SP 51 fra Sassuolo (bivio SP 467R) e Rubiera,11090,10,8749,2340,8697,2393,11090,0
2019/01,318,12/01/2019,6,SP 51 fra Sassuolo (bivio SP 467R) e Rubiera,8180,10,7982,197,5690,2490,0,8180
2019/01,318,13/01/2019,7,SP 51 fra Sassuolo (bivio SP 467R) e Rubiera,6959,10,6907,51,5016,1943,0,6959
2019/01,318,14/01/2019,1,SP 51 fra Sassuolo (bivio SP 467R) e Rubiera,10465,10,8203,2261,8581,1884,10465,0
2019/01,319,01/01/2019,2,SP 15 tra Sassuolo e Magreta,,,,,,,,
2019/01,319,02/01/2019,3,SP 15 tra Sassuolo e Magreta,,,,,,,,
2019/01,319,03/01/2019,4,SP 15 tra Sassuolo e Magreta,,,,,,,,
2019/01,319,04/01/2019,5,SP 15 tra Sassuolo e Magreta,,,,,,,,
2019/01,319,05/01/2019,6,SP 15 tra Sassuolo e Magreta,,,,,,,,
2019/01,319,06/01/2019,7,SP 15 tra Sassuolo e Magreta,,,,,,,,
2019/01,319,07/01/2019,1,SP 15 tra Sassuolo e Magreta,,,,,,,,
2019/01,319,08/01/2019,2,SP 15 tra Sassuolo e Magreta,,,,,,,,
2019/01,319,09/01/2019,3,SP 15 tra Sassuolo e Magreta,,,,,,,,
2019/01,319,10/01/2019,4,SP 15 tra Sassuolo e Magreta,,,,,,,,
2019/01,319,11/01/2019,5,SP 15 tra Sassuolo e Magreta,,,,,,,,
2019/01,319,12/01/2019,6,SP 15 tra Sassuolo e Magreta,,,,,,,,
2019/01,319,13/01/2019,7,SP 15 tra Sassuolo e Magreta,,,,,,,,
2019/01,319,14/01/2019,1,SP 15 tra Sassuolo e Magreta,,,,,,,,
2019/01,321,01/01/2019,2,SP 467 tra SP 486 e confine provinciale,,,,,,,,
2019/01,321,02/01/2019,3,SP 467 tra SP 486 e confine provinciale,,,,,,,,
2019/01,321,03/01/2019,4,SP 467 tra SP 486 e confine provinciale,,,,,,,,
2019/01,321,04/01/2019,5,SP 467 tra SP 486 e confine provinciale,,,,,,,,
2019/01,321,05/01/2019,6,SP 467 tra SP 486 e confine provinciale,,,,,,,,
2019/01,321,06/01/2019,7,SP 467 tra SP 486 e confine provinciale,,,,,,,,
2019/01,321,07/01/2019,1,SP 467 tra SP 486 e confine provinciale,,,,,,,,
2019/01,321,08/01/2019,2,SP 467 tra SP 486 e confine provinciale,,,,,,,,
2019/01,321,09/01/2019,3,SP 467 tra SP 486 e confine provinciale,,,,,,,,
2019/01,321,10/01/2019,4,SP 467 tra SP 486 e confine provinciale,,,,,,,,
2019/01,321,11/01/2019,5,SP 467 tra SP 486 e confine provinciale,,,,,,,,
2019/01,321,12/01/2019,6,SP 467 tra SP 486 e confine provinciale,,,,,,,,
2019/01,321,13/01/2019,7,SP 467 tra SP 486 e confine provinciale,,,,,,,,
2019/01,321,14/01/2019,1,SP 467 tra SP 486 e confine provinciale,,,,,,,,
2019/01,323,01/01/2019,2,SP 467 fra SP 3 e SS 12,8264,00,8214,50,4944,3320,0,8264
2019/01,323,02/01/2019,3,SP 467 fra SP 3 e SS 12,15681,00,14533,1148,12753,2928,15681,0
2019/01,323,03/01/2019,4,SP 467 fra SP 3 e SS 12,17319,00,15953,1366,14112,3207,17319,0
2019/01,323,04/01/2019,5,SP 467 fra SP 3 e SS 12,18072,00,16522,1550,14242,3830,18072,0
2019/01,323,05/01/2019,6,SP 467 fra SP 3 e SS 12,14180,00,13810,370,10413,3767,0,14180
2019/01,323,06/01/2019,7,SP 467 fra SP 3 e SS 12,11531,00,11446,85,8495,3036,0,11531
2019/01,323,07/01/2019,1,SP 467 fra SP 3 e SS 12,22742,00,20187,2555,18551,4191,22742,0
2019/01,323,08/01/2019,2,SP 467 fra SP 3 e SS 12,23777,10,20785,2991,19361,4416,23777,0
2019/01,323,09/01/2019,3,SP 467 fra SP 3 e SS 12,24084,00,20892,3192,19325,4759,24084,0
2019/01,323,10/01/2019,4,SP 467 fra SP 3 e SS 12,24757,00,21489,3268,19831,4926,24757,0
2019/01,323,11/01/2019,5,SP 467 fra SP 3 e SS 12,25577,10,22360,3216,20278,5299,25577,0
2019/01,323,12/01/2019,6,SP 467 fra SP 3 e SS 12,16860,00,16405,455,12366,4494,0,16860
2019/01,323,13/01/2019,7,SP 467 fra SP 3 e SS 12,13272,00,13184,88,9778,3494,0,13272
2019/01,323,14/01/2019,1,SP 467 fra SP 3 e SS 12,25359,10,22222,3136,20273,5086,25359,0
2019/01,331,07/01/2019,1,SP 325 tra Casello A 1 (Sasso Marconi) e Vado,5364,10,5098,265,4197,1167,5364,0
2019/01,331,08/01/2019,2,SP 325 tra Casello A 1 (Sasso Marconi) e Vado,5804,00,5561,243,4283,1521,5804,0
2019/01,331,09/01/2019,3,SP 325 tra Casello A 1 (Sasso Marconi) e Vado,6151,00,5863,288,4646,1505,6151,0
2019/01,331,10/01/2019,4,SP 325 tra Casello A 1 (Sasso Marconi) e Vado,7169,00,6874,295,5600,1569,7169,0
2019/01,331,11/01/2019,5,SP 325 tra Casello A 1 (Sasso Marconi) e Vado,7450,00,7076,374,5744,1706,7450,0
2019/01,331,12/01/2019,6,SP 325 tra Casello A 1 (Sasso Marconi) e Vado,5790,00,5718,72,4290,1500,0,5790
2019/01,331,14/01/2019,1,SP 325 tra Casello A 1 (Sasso Marconi) e Vado,7138,00,6702,436,5596,1542,7138,0
2019/01,332,01/01/2019,2,SP 306R fra Castel Bolognese e Riolo Terme,5253,00,5234,19,3443,1810,0,5253
2019/01,332,02/01/2019,3,SP 306R fra Castel Bolognese e Riolo Terme,6626,10,6386,239,5256,1370,6626,0
2019/01,332,03/01/2019,4,SP 306R fra Castel Bolognese e Riolo Terme,7118,00,6902,216,5601,1517,7118,0
2019/01,332,04/01/2019,5,SP 306R fra Castel Bolognese e Riolo Terme,7464,30,7184,277,5812,1652,7464,0
2019/01,332,05/01/2019,6,SP 306R fra Castel Bolognese e Riolo Terme,6830,00,6702,128,5033,1797,0,6830
2019/01,332,06/01/2019,7,SP 306R fra Castel Bolognese e Riolo Terme,5973,00,5950,23,4501,1472,0,5973
2019/01,332,07/01/2019,1,SP 306R fra Castel Bolognese e Riolo Terme,7965,10,7458,506,6435,1530,7965,0
2019/01,332,08/01/2019,2,SP 306R fra Castel Bolognese e Riolo Terme,8222,20,7713,507,6547,1675,8222,0
2019/01,332,09/01/2019,3,SP 306R fra Castel Bolognese e Riolo Terme,8119,00,7659,460,6408,1711,8119,0
2019/01,332,10/01/2019,4,SP 306R fra Castel Bolognese e Riolo Terme,8271,00,7780,491,6584,1687,8271,0
2019/01,332,11/01/2019,5,SP 306R fra Castel Bolognese e Riolo Terme,8532,10,8043,488,6610,1922,8532,0
2019/01,332,12/01/2019,6,SP 306R fra Castel Bolognese e Riolo Terme,7733,10,7581,151,5749,1984,0,7733
2019/01,332,13/01/2019,7,SP 306R fra Castel Bolognese e Riolo Terme,6117,00,6090,27,4622,1495,0,6117
2019/01,332,14/01/2019,1,SP 306R fra Castel Bolognese e Riolo Terme,8049,30,7575,471,6371,1678,8049,0
2019/01,333,01/01/2019,2,SS 9 tra Castel Bolognese e Faenza,15036,00,14989,47,8309,6727,0,15036
2019/01,333,02/01/2019,3,SS 9 tra Castel Bolognese e Faenza,19136,10,18681,454,14623,4513,19136,0
2019/01,333,03/01/2019,4,SS 9 tra Castel Bolognese e Faenza,19349,00,18875,474,14660,4689,19349,0
2019/01,333,04/01/2019,5,SS 9 tra Castel Bolognese e Faenza,20611,00,20109,502,14944,5667,20611,0
2019/01,333,05/01/2019,6,SS 9 tra Castel Bolognese e Faenza,19958,00,19737,221,12952,7006,0,19958
2019/01,333,06/01/2019,7,SS 9 tra Castel Bolognese e Faenza,16719,00,16664,55,10957,5762,0,16719
2019/01,333,07/01/2019,1,SS 9 tra Castel Bolognese e Faenza,21496,00,20607,889,16867,4629,21496,0
2019/01,333,08/01/2019,2,SS 9 tra Castel Bolognese e Faenza,22137,00,21298,839,17334,4803,22137,0
2019/01,333,09/01/2019,3,SS 9 tra Castel Bolognese e Faenza,21820,10,20991,828,16928,4892,21820,0
2019/01,333,10/01/2019,4,SS 9 tra Castel Bolognese e Faenza,22551,10,21738,812,17475,5076,22551,0
2019/01,333,11/01/2019,5,SS 9 tra Castel Bolognese e Faenza,23814,00,22982,832,17486,6328,23814,0
2019/01,333,12/01/2019,6,SS 9 tra Castel Bolognese e Faenza,21787,10,21505,281,14641,7146,0,21787
2019/01,333,13/01/2019,7,SS 9 tra Castel Bolognese e Faenza,17033,00,16988,45,11629,5404,0,17033
2019/01,333,14/01/2019,1,SS 9 tra Castel Bolognese e Faenza,21936,10,21143,792,16954,4982,21936,0
2019/01,334,01/01/2019,2,SP 8 dal Casello A 1 (Faenza) a Cotignola,8313,00,8287,26,4941,3372,0,8313
2019/01,334,02/01/2019,3,SP 8 dal Casello A 1 (Faenza) a Cotignola,12618,00,12089,529,9877,2741,12618,0
2019/01,334,03/01/2019,4,SP 8 dal Casello A 1 (Faenza) a Cotignola,13105,00,12284,821,10242,2863,13105,0
2019/01,334,04/01/2019,5,SP 8 dal Casello A 1 (Faenza) a Cotignola,13389,00,12613,776,10062,3327,13389,0
2019/01,334,05/01/2019,6,SP 8 dal Casello A 1 (Faenza) a Cotignola,14137,00,13965,172,9757,4380,0,14137
2019/01,334,06/01/2019,7,SP 8 dal Casello A 1 (Faenza) a Cotignola,11375,00,11326,49,8028,3347,0,11375
2019/01,334,07/01/2019,1,SP 8 dal Casello A 1 (Faenza) a Cotignola,14035,00,12981,1054,11341,2694,14035,0
2019/01,334,08/01/2019,2,SP 8 dal Casello A 1 (Faenza) a Cotignola,14055,00,13086,969,11347,2708,14055,0
2019/01,334,09/01/2019,3,SP 8 dal Casello A 1 (Faenza) a Cotignola,14904,00,13964,940,12019,2885,14904,0
2019/01,334,10/01/2019,4,SP 8 dal Casello A 1 (Faenza) a Cotignola,14059,00,13185,874,11112,2947,14059,0
2019/01,334,11/01/2019,5,SP 8 dal Casello A 1 (Faenza) a Cotignola,15290,00,14409,881,11866,3424,15290,0
2019/01,334,12/01/2019,6,SP 8 dal Casello A 1 (Faenza) a Cotignola,13872,00,13624,248,9942,3930,0,13872
2019/01,334,13/01/2019,7,SP 8 dal Casello A 1 (Faenza) a Cotignola,12245,00,12215,30,9070,3175,0,12245
2019/01,334,14/01/2019,1,SP 8 dal Casello A 1 (Faenza) a Cotignola,13768,00,12808,960,11001,2767,13768,0
2019/01,335,01/01/2019,2,SP 7 tra l'A 14 (bivio SP 29) e l'A 14dir (Barbiano),3671,00,3662,9,2156,1515,0,3671
2019/01,335,02/01/2019,3,SP 7 tra l'A 14 (bivio SP 29) e l'A 14dir (Barbiano),4888,00,4694,194,3863,1025,4888,0
2019/01,335,03/01/2019,4,SP 7 tra l'A 14 (bivio SP 29) e l'A 14dir (Barbiano),5239,10,4964,274,4098,1141,5239,0
2019/01,335,04/01/2019,5,SP 7 tra l'A 14 (bivio SP 29) e l'A 14dir (Barbiano),5784,10,5475,308,4405,1379,5784,0
2019/01,335,05/01/2019,6,SP 7 tra l'A 14 (bivio SP 29) e l'A 14dir (Barbiano),4884,00,4787,97,3322,1562,0,4884
2019/01,335,06/01/2019,7,SP 7 tra l'A 14 (bivio SP 29) e l'A 14dir (Barbiano),4202,00,4174,28,2917,1285,0,4202
2019/01,335,07/01/2019,1,SP 7 tra l'A 14 (bivio SP 29) e l'A 14dir (Barbiano),6331,00,5878,453,5185,1146,6331,0
2019/01,335,08/01/2019,2,SP 7 tra l'A 14 (bivio SP 29) e l'A 14dir (Barbiano),6356,00,5905,451,5319,1037,6356,0
2019/01,335,09/01/2019,3,SP 7 tra l'A 14 (bivio SP 29) e l'A 14dir (Barbiano),6943,00,6459,484,5696,1247,6943,0
2019/01,335,10/01/2019,4,SP 7 tra l'A 14 (bivio SP 29) e l'A 14dir (Barbiano),6725,00,6245,480,5354,1371,6725,0
2019/01,335,11/01/2019,5,SP 7 tra l'A 14 (bivio SP 29) e l'A 14dir (Barbiano),7051,00,6541,510,5559,1492,7051,0
2019/01,335,12/01/2019,6,SP 7 tra l'A 14 (bivio SP 29) e l'A 14dir (Barbiano),5553,10,5446,106,3944,1609,0,5553
2019/01,335,13/01/2019,7,SP 7 tra l'A 14 (bivio SP 29) e l'A 14dir (Barbiano),4941,10,4924,16,3466,1475,0,4941
2019/01,335,14/01/2019,1,SP 7 tra l'A 14 (bivio SP 29) e l'A 14dir (Barbiano),6876,00,6347,529,5578,1298,6876,0
2019/01,336,01/01/2019,2,SP 253R tra Lugo (ponte fiume Senio) e Bagnacavallo,5697,00,5676,21,3598,2099,0,5697
2019/01,336,02/01/2019,3,SP 253R tra Lugo (ponte fiume Senio) e Bagnacavallo,8903,20,8566,335,7301,1602,8903,0
2019/01,336,03/01/2019,4,SP 253R tra Lugo (ponte fiume Senio) e Bagnacavallo,9198,10,8800,397,7365,1833,9198,0
2019/01,336,04/01/2019,5,SP 253R tra Lugo (ponte fiume Senio) e Bagnacavallo,9601,00,9135,466,7527,2074,9601,0
2019/01,336,05/01/2019,6,SP 253R tra Lugo (ponte fiume Senio) e Bagnacavallo,8136,00,7936,200,5938,2198,0,8136
2019/01,336,06/01/2019,7,SP 253R tra Lugo (ponte fiume Senio) e Bagnacavallo,6310,00,6191,119,4730,1580,0,6310
2019/01,336,07/01/2019,1,SP 253R tra Lugo (ponte fiume Senio) e Bagnacavallo,10683,00,9955,728,8767,1916,10683,0
2019/01,336,08/01/2019,2,SP 253R tra Lugo (ponte fiume Senio) e Bagnacavallo,10949,00,10195,754,9052,1897,10949,0
2019/01,336,09/01/2019,3,SP 253R tra Lugo (ponte fiume Senio) e Bagnacavallo,10981,10,10331,649,8947,2034,10981,0
2019/01,336,10/01/2019,4,SP 253R tra Lugo (ponte fiume Senio) e Bagnacavallo,11260,00,10569,691,9099,2161,11260,0
2019/01,336,11/01/2019,5,SP 253R tra Lugo (ponte fiume Senio) e Bagnacavallo,11672,00,11004,668,9291,2381,11672,0
2019/01,336,12/01/2019,6,SP 253R tra Lugo (ponte fiume Senio) e Bagnacavallo,9655,00,9478,177,7276,2379,0,9655
2019/01,336,13/01/2019,7,SP 253R tra Lugo (ponte fiume Senio) e Bagnacavallo,6703,00,6670,33,4945,1758,0,6703
2019/01,336,14/01/2019,1,SP 253R tra Lugo (ponte fiume Senio) e Bagnacavallo,11167,00,10435,732,9163,2004,11167,0
2019/01,337,01/01/2019,2,SP 14 fra Lugo (bivio SSPP 41/46) e Fusignano,5985,00,5958,27,3621,2364,0,5985
2019/01,337,02/01/2019,3,SP 14 fra Lugo (bivio SSPP 41/46) e Fusignano,9461,00,9168,293,7739,1722,9461,0
2019/01,337,03/01/2019,4,SP 14 fra Lugo (bivio SSPP 41/46) e Fusignano,9671,00,9338,333,7844,1827,9671,0
2019/01,337,04/01/2019,5,SP 14 fra Lugo (bivio SSPP 41/46) e Fusignano,9943,00,9584,359,7937,2006,9943,0
2019/01,337,05/01/2019,6,SP 14 fra Lugo (bivio SSPP 41/46) e Fusignano,8537,00,8411,126,6388,2149,0,8537
2019/01,337,06/01/2019,7,SP 14 fra Lugo (bivio SSPP 41/46) e Fusignano,6335,10,6313,21,4540,1795,0,6335
2019/01,337,07/01/2019,1,SP 14 fra Lugo (bivio SSPP 41/46) e Fusignano,11542,00,11005,537,9514,2028,11542,0
2019/01,337,08/01/2019,2,SP 14 fra Lugo (bivio SSPP 41/46) e Fusignano,11612,20,11052,558,9561,2051,11612,0
2019/01,337,09/01/2019,3,SP 14 fra Lugo (bivio SSPP 41/46) e Fusignano,11739,00,11185,554,9476,2263,11739,0
2019/01,337,10/01/2019,4,SP 14 fra Lugo (bivio SSPP 41/46) e Fusignano,11822,00,11304,518,9548,2274,11822,0
2019/01,337,11/01/2019,5,SP 14 fra Lugo (bivio SSPP 41/46) e Fusignano,12026,00,11443,583,9651,2375,12026,0
2019/01,337,12/01/2019,6,SP 14 fra Lugo (bivio SSPP 41/46) e Fusignano,9817,00,9663,154,7440,2377,0,9817
2019/01,337,13/01/2019,7,SP 14 fra Lugo (bivio SSPP 41/46) e Fusignano,6868,00,6840,28,5016,1852,0,6868
2019/01,337,14/01/2019,1,SP 14 fra Lugo (bivio SSPP 41/46) e Fusignano,11822,10,11300,521,9709,2113,11822,0
2019/01,339,01/01/2019,2,SP 3 tra San Lorenzo in Noceto e Predappio,5163,00,5145,18,3436,1727,0,5163
2019/01,339,02/01/2019,3,SP 3 tra San Lorenzo in Noceto e Predappio,6410,00,6225,185,5172,1238,6410,0
2019/01,339,03/01/2019,4,SP 3 tra San Lorenzo in Noceto e Predappio,6843,00,6622,221,5395,1448,6843,0
2019/01,339,04/01/2019,5,SP 3 tra San Lorenzo in Noceto e Predappio,7054,00,6829,225,5536,1518,7054,0
2019/01,339,05/01/2019,6,SP 3 tra San Lorenzo in Noceto e Predappio,6435,00,6328,107,4729,1706,0,6435
2019/01,339,06/01/2019,7,SP 3 tra San Lorenzo in Noceto e Predappio,6008,00,5989,19,4648,1360,0,6008
2019/01,339,07/01/2019,1,SP 3 tra San Lorenzo in Noceto e Predappio,7375,00,7069,306,5970,1405,7375,0
2019/01,339,08/01/2019,2,SP 3 tra San Lorenzo in Noceto e Predappio,7327,00,7000,327,5903,1424,7327,0
2019/01,339,09/01/2019,3,SP 3 tra San Lorenzo in Noceto e Predappio,7677,00,7350,327,6119,1558,7677,0
2019/01,339,10/01/2019,4,SP 3 tra San Lorenzo in Noceto e Predappio,7492,00,7136,356,5992,1500,7492,0
2019/01,339,11/01/2019,5,SP 3 tra San Lorenzo in Noceto e Predappio,7786,00,7456,330,6151,1635,7786,0
2019/01,339,12/01/2019,6,SP 3 tra San Lorenzo in Noceto e Predappio,7017,00,6937,80,5169,1848,0,7017
2019/01,339,13/01/2019,7,SP 3 tra San Lorenzo in Noceto e Predappio,5544,10,5521,22,4163,1381,0,5544
2019/01,339,14/01/2019,1,SP 3 tra San Lorenzo in Noceto e Predappio,7368,00,6989,379,5979,1389,7368,0
2019/01,340,01/01/2019,2,SP 72 tra San Martino in Strada e bivio ex SS 310R (Meldola),5662,00,5652,10,3348,2314,0,5662
2019/01,340,02/01/2019,3,SP 72 tra San Martino in Strada e bivio ex SS 310R (Meldola),8229,00,8017,212,6496,1733,8229,0
2019/01,340,03/01/2019,4,SP 72 tra San Martino in Strada e bivio ex SS 310R (Meldola),8533,00,8311,222,6696,1837,8533,0
2019/01,340,04/01/2019,5,SP 72 tra San Martino in Strada e bivio ex SS 310R (Meldola),9127,10,8847,279,7197,1930,9127,0
2019/01,340,05/01/2019,6,SP 72 tra San Martino in Strada e bivio ex SS 310R (Meldola),7875,00,7741,134,5690,2185,0,7875
2019/01,340,06/01/2019,7,SP 72 tra San Martino in Strada e bivio ex SS 310R (Meldola),6588,00,6561,27,4776,1812,0,6588
2019/01,340,07/01/2019,1,SP 72 tra San Martino in Strada e bivio ex SS 310R (Meldola),9567,00,9168,399,7801,1766,9567,0
2019/01,340,08/01/2019,2,SP 72 tra San Martino in Strada e bivio ex SS 310R (Meldola),9800,00,9380,420,8000,1800,9800,0
2019/01,340,09/01/2019,3,SP 72 tra San Martino in Strada e bivio ex SS 310R (Meldola),9921,00,9466,455,8065,1856,9921,0
2019/01,340,10/01/2019,4,SP 72 tra San Martino in Strada e bivio ex SS 310R (Meldola),9842,00,9434,408,7841,2001,9842,0
2019/01,340,11/01/2019,5,SP 72 tra San Martino in Strada e bivio ex SS 310R (Meldola),10264,00,9809,455,8129,2135,10264,0
2019/01,340,12/01/2019,6,SP 72 tra San Martino in Strada e bivio ex SS 310R (Meldola),8411,00,8259,152,6208,2203,0,8411
2019/01,340,13/01/2019,7,SP 72 tra San Martino in Strada e bivio ex SS 310R (Meldola),6771,00,6753,18,4983,1788,0,6771
2019/01,340,14/01/2019,1,SP 72 tra San Martino in Strada e bivio ex SS 310R (Meldola),9794,00,9362,432,7924,1870,9794,0
2019/01,342,01/01/2019,2,SP 33 in località Gatteo,10328,00,10251,77,6650,3678,0,10328
2019/01,342,02/01/2019,3,SP 33 in località Gatteo,14025,00,13072,953,11229,2796,14025,0
2019/01,342,03/01/2019,4,SP 33 in località Gatteo,15339,00,14163,1176,12216,3123,15339,0
2019/01,342,04/01/2019,5,SP 33 in località Gatteo,15372,00,14280,1092,12010,3362,15372,0
2019/01,342,05/01/2019,6,SP 33 in località Gatteo,13857,00,13433,424,10158,3699,0,13857
2019/01,342,06/01/2019,7,SP 33 in località Gatteo,11256,00,11168,88,8209,3047,0,11256
2019/01,342,07/01/2019,1,SP 33 in località Gatteo,16303,00,14857,1446,13273,3030,16303,0
2019/01,342,08/01/2019,2,SP 33 in località Gatteo,15907,00,14493,1414,12951,2956,15907,0
2019/01,342,09/01/2019,3,SP 33 in località Gatteo,16111,00,14682,1429,12906,3205,16111,0
2019/01,342,10/01/2019,4,SP 33 in località Gatteo,16421,10,14965,1455,12944,3477,16421,0
2019/01,342,11/01/2019,5,SP 33 in località Gatteo,17562,00,16143,1419,13610,3952,17562,0
2019/01,342,12/01/2019,6,SP 33 in località Gatteo,14743,00,14333,410,11013,3730,0,14743
2019/01,342,13/01/2019,7,SP 33 in località Gatteo,11682,10,11602,79,8459,3223,0,11682
2019/01,342,14/01/2019,1,SP 33 in località Gatteo,16538,10,15020,1517,13289,3249,16538,0
2019/01,343,01/01/2019,2,SP 4 tra Galeata e Santa Sofia,4001,00,3984,17,2779,1222,0,4001
2019/01,343,02/01/2019,3,SP 4 tra Galeata e Santa Sofia,5046,00,4796,250,3802,1244,5046,0
2019/01,343,03/01/2019,4,SP 4 tra Galeata e Santa Sofia,5129,10,4847,281,3976,1153,5129,0
2019/01,343,04/01/2019,5,SP 4 tra Galeata e Santa Sofia,5201,00,4901,300,4009,1192,5201,0
2019/01,343,05/01/2019,6,SP 4 tra Galeata e Santa Sofia,5229,00,5060,169,3748,1481,0,5229
2019/01,343,06/01/2019,7,SP 4 tra Galeata e Santa Sofia,4233,00,4194,39,3240,993,0,4233
2019/01,343,07/01/2019,1,SP 4 tra Galeata e Santa Sofia,5278,00,4936,342,4184,1094,5278,0
2019/01,343,08/01/2019,2,SP 4 tra Galeata e Santa Sofia,5165,00,4814,351,4070,1095,5165,0
2019/01,343,09/01/2019,3,SP 4 tra Galeata e Santa Sofia,5277,00,4927,350,4120,1157,5277,0
2019/01,343,10/01/2019,4,SP 4 tra Galeata e Santa Sofia,5221,00,4884,337,4065,1156,5221,0
2019/01,343,11/01/2019,5,SP 4 tra Galeata e Santa Sofia,5319,10,4961,357,4118,1201,5319,0
2019/01,343,12/01/2019,6,SP 4 tra Galeata e Santa Sofia,5185,00,5006,179,3822,1363,0,5185
2019/01,343,13/01/2019,7,SP 4 tra Galeata e Santa Sofia,4339,00,4309,30,3467,872,0,4339
2019/01,343,14/01/2019,1,SP 4 tra Galeata e Santa Sofia,5315,00,4952,363,4166,1149,5315,0
2019/01,344,01/01/2019,2,SS 3Bis/E 45 tra Borello e Mercato Saraceno,16726,20,16417,307,12566,4160,0,16726
2019/01,344,02/01/2019,3,SS 3Bis/E 45 tra Borello e Mercato Saraceno,20779,90,18540,2230,16559,4220,20779,0
2019/01,344,03/01/2019,4,SS 3Bis/E 45 tra Borello e Mercato Saraceno,17038,10,14540,2497,13671,3367,17038,0
2019/01,344,04/01/2019,5,SS 3Bis/E 45 tra Borello e Mercato Saraceno,17831,40,15480,2347,13790,4041,17831,0
2019/01,344,05/01/2019,6,SS 3Bis/E 45 tra Borello e Mercato Saraceno,17071,10,16104,966,12923,4148,0,17071
2019/01,344,06/01/2019,7,SS 3Bis/E 45 tra Borello e Mercato Saraceno,16311,00,15849,462,12583,3728,0,16311
2019/01,344,07/01/2019,1,SS 3Bis/E 45 tra Borello e Mercato Saraceno,17128,130,13825,3290,13439,3689,17128,0
2019/01,344,08/01/2019,2,SS 3Bis/E 45 tra Borello e Mercato Saraceno,16905,170,12937,3951,13184,3721,16905,0
2019/01,344,09/01/2019,3,SS 3Bis/E 45 tra Borello e Mercato Saraceno,17250,50,13338,3907,13431,3819,17250,0
2019/01,344,10/01/2019,4,SS 3Bis/E 45 tra Borello e Mercato Saraceno,17313,60,13302,4005,13422,3891,17313,0
2019/01,344,11/01/2019,5,SS 3Bis/E 45 tra Borello e Mercato Saraceno,18399,110,14776,3612,14019,4380,18399,0
2019/01,344,12/01/2019,6,SS 3Bis/E 45 tra Borello e Mercato Saraceno,15242,60,14057,1179,11462,3780,0,15242
2019/01,344,13/01/2019,7,SS 3Bis/E 45 tra Borello e Mercato Saraceno,14451,20,13948,501,10786,3665,0,14451
2019/01,344,14/01/2019,1,SS 3Bis/E 45 tra Borello e Mercato Saraceno,17682,60,13819,3857,13726,3956,17682,0
2019/01,348,01/01/2019,2,SP 10 dal bivio con SP 89 (San Mauro Pascoli) c/o A 14  al bivio SS 16 (San Mauro Mare),,,,,,,,
2019/01,348,02/01/2019,3,SP 10 dal bivio con SP 89 (San Mauro Pascoli) c/o A 14  al bivio SS 16 (San Mauro Mare),,,,,,,,
2019/01,348,03/01/2019,4,SP 10 dal bivio con SP 89 (San Mauro Pascoli) c/o A 14  al bivio SS 16 (San Mauro Mare),,,,,,,,
2019/01,348,04/01/2019,5,SP 10 dal bivio con SP 89 (San Mauro Pascoli) c/o A 14  al bivio SS 16 (San Mauro Mare),,,,,,,,
2019/01,348,05/01/2019,6,SP 10 dal bivio con SP 89 (San Mauro Pascoli) c/o A 14  al bivio SS 16 (San Mauro Mare),,,,,,,,
2019/01,348,06/01/2019,7,SP 10 dal bivio con SP 89 (San Mauro Pascoli) c/o A 14  al bivio SS 16 (San Mauro Mare),,,,,,,,
2019/01,348,07/01/2019,1,SP 10 dal bivio con SP 89 (San Mauro Pascoli) c/o A 14  al bivio SS 16 (San Mauro Mare),,,,,,,,
2019/01,348,08/01/2019,2,SP 10 dal bivio con SP 89 (San Mauro Pascoli) c/o A 14  al bivio SS 16 (San Mauro Mare),,,,,,,,
2019/01,348,09/01/2019,3,SP 10 dal bivio con SP 89 (San Mauro Pascoli) c/o A 14  al bivio SS 16 (San Mauro Mare),,,,,,,,
2019/01,348,10/01/2019,4,SP 10 dal bivio con SP 89 (San Mauro Pascoli) c/o A 14  al bivio SS 16 (San Mauro Mare),,,,,,,,
2019/01,348,11/01/2019,5,SP 10 dal bivio con SP 89 (San Mauro Pascoli) c/o A 14  al bivio SS 16 (San Mauro Mare),,,,,,,,
2019/01,348,12/01/2019,6,SP 10 dal bivio con SP 89 (San Mauro Pascoli) c/o A 14  al bivio SS 16 (San Mauro Mare),,,,,,,,
2019/01,348,13/01/2019,7,SP 10 dal bivio con SP 89 (San Mauro Pascoli) c/o A 14  al bivio SS 16 (San Mauro Mare),,,,,,,,
2019/01,348,14/01/2019,1,SP 10 dal bivio con SP 89 (San Mauro Pascoli) c/o A 14  al bivio SS 16 (San Mauro Mare),,,,,,,,
2019/01,349,01/01/2019,2,SS 16 tra Cervia e Cesenatico,21305,10,21119,185,14309,6996,0,21305
2019/01,349,02/01/2019,3,SS 16 tra Cervia e Cesenatico,18458,00,17500,958,14464,3994,18458,0
2019/01,349,03/01/2019,4,SS 16 tra Cervia e Cesenatico,19351,00,18174,1177,15137,4214,19351,0
2019/01,349,04/01/2019,5,SS 16 tra Cervia e Cesenatico,19682,00,18612,1070,14848,4834,19682,0
2019/01,349,05/01/2019,6,SS 16 tra Cervia e Cesenatico,21674,10,21203,470,15450,6224,0,21674
2019/01,349,06/01/2019,7,SS 16 tra Cervia e Cesenatico,20841,10,20687,153,15547,5294,0,20841
2019/01,349,07/01/2019,1,SS 16 tra Cervia e Cesenatico,17807,10,16222,1584,14079,3728,17807,0
2019/01,349,08/01/2019,2,SS 16 tra Cervia e Cesenatico,17761,40,15945,1812,14154,3607,17761,0
2019/01,349,09/01/2019,3,SS 16 tra Cervia e Cesenatico,18337,30,16480,1854,14515,3822,18337,0
2019/01,349,10/01/2019,4,SS 16 tra Cervia e Cesenatico,19136,20,17263,1871,15000,4136,19136,0
2019/01,349,11/01/2019,5,SS 16 tra Cervia e Cesenatico,20146,20,18362,1782,15065,5081,20146,0
2019/01,349,12/01/2019,6,SS 16 tra Cervia e Cesenatico,20735,00,20282,453,14435,6300,0,20735
2019/01,349,13/01/2019,7,SS 16 tra Cervia e Cesenatico,22377,00,22236,141,16241,6136,0,22377
2019/01,349,14/01/2019,1,SS 16 tra Cervia e Cesenatico,18250,10,16406,1843,14331,3919,18250,0
2019/01,351,01/01/2019,2,SS 72 tra Rimini e  San Marino,,,,,,,,
2019/01,351,02/01/2019,3,SS 72 tra Rimini e  San Marino,,,,,,,,
2019/01,351,03/01/2019,4,SS 72 tra Rimini e  San Marino,,,,,,,,
2019/01,351,04/01/2019,5,SS 72 tra Rimini e  San Marino,,,,,,,,
2019/01,351,05/01/2019,6,SS 72 tra Rimini e  San Marino,,,,,,,,
2019/01,351,06/01/2019,7,SS 72 tra Rimini e  San Marino,,,,,,,,
2019/01,351,07/01/2019,1,SS 72 tra Rimini e  San Marino,,,,,,,,
2019/01,351,08/01/2019,2,SS 72 tra Rimini e  San Marino,,,,,,,,
2019/01,351,09/01/2019,3,SS 72 tra Rimini e  San Marino,,,,,,,,
2019/01,351,10/01/2019,4,SS 72 tra Rimini e  San Marino,,,,,,,,
2019/01,351,11/01/2019,5,SS 72 tra Rimini e  San Marino,,,,,,,,
2019/01,351,12/01/2019,6,SS 72 tra Rimini e  San Marino,,,,,,,,
2019/01,351,13/01/2019,7,SS 72 tra Rimini e  San Marino,,,,,,,,
2019/01,351,14/01/2019,1,SS 72 tra Rimini e  San Marino,,,,,,,,
2019/01,354,01/01/2019,2,SP 31 tra Viadotto A 14 e Coriano,8384,00,8358,26,4935,3449,0,8384
2019/01,354,02/01/2019,3,SP 31 tra Viadotto A 14 e Coriano,10259,10,10062,196,7851,2408,10259,0
2019/01,354,03/01/2019,4,SP 31 tra Viadotto A 14 e Coriano,10837,10,10671,165,8257,2580,10837,0
2019/01,354,04/01/2019,5,SP 31 tra Viadotto A 14 e Coriano,10477,10,10305,171,7786,2691,10477,0
2019/01,354,05/01/2019,6,SP 31 tra Viadotto A 14 e Coriano,11151,00,11047,104,7758,3393,0,11151
2019/01,354,06/01/2019,7,SP 31 tra Viadotto A 14 e Coriano,9699,00,9663,36,6658,3041,0,9699
2019/01,354,07/01/2019,1,SP 31 tra Viadotto A 14 e Coriano,11961,10,11714,246,9672,2289,11961,0
2019/01,354,08/01/2019,2,SP 31 tra Viadotto A 14 e Coriano,12043,10,11746,296,9756,2287,12043,0
2019/01,354,09/01/2019,3,SP 31 tra Viadotto A 14 e Coriano,12256,10,11963,292,9832,2424,12256,0
2019/01,354,10/01/2019,4,SP 31 tra Viadotto A 14 e Coriano,12132,20,11830,300,9761,2371,12132,0
2019/01,354,11/01/2019,5,SP 31 tra Viadotto A 14 e Coriano,12676,10,12323,352,9903,2773,12676,0
2019/01,354,12/01/2019,6,SP 31 tra Viadotto A 14 e Coriano,11344,00,11190,154,8333,3011,0,11344
2019/01,354,13/01/2019,7,SP 31 tra Viadotto A 14 e Coriano,9809,10,9779,29,7078,2731,0,9809
2019/01,354,14/01/2019,1,SP 31 tra Viadotto A 14 e Coriano,12573,20,12245,326,10096,2477,12573,0
2019/01,355,01/01/2019,2,SP 17V tra San Giovanni in Marignano e Morciano di Romagna (variante),8264,00,8228,36,5210,3054,0,8264
2019/01,355,02/01/2019,3,SP 17V tra San Giovanni in Marignano e Morciano di Romagna (variante),12021,00,11727,294,9738,2283,12021,0
2019/01,355,03/01/2019,4,SP 17V tra San Giovanni in Marignano e Morciano di Romagna (variante),13000,00,12607,393,10595,2405,13000,0
2019/01,355,04/01/2019,5,SP 17V tra San Giovanni in Marignano e Morciano di Romagna (variante),12049,00,11749,300,9584,2465,12049,0
2019/01,355,05/01/2019,6,SP 17V tra San Giovanni in Marignano e Morciano di Romagna (variante),11562,00,11443,119,8619,2943,0,11562
2019/01,355,06/01/2019,7,SP 17V tra San Giovanni in Marignano e Morciano di Romagna (variante),9395,00,9359,36,6896,2499,0,9395
2019/01,355,07/01/2019,1,SP 17V tra San Giovanni in Marignano e Morciano di Romagna (variante),14844,00,14290,554,12242,2602,14844,0
2019/01,355,08/01/2019,2,SP 17V tra San Giovanni in Marignano e Morciano di Romagna (variante),14780,00,14130,650,12088,2692,14780,0
2019/01,355,09/01/2019,3,SP 17V tra San Giovanni in Marignano e Morciano di Romagna (variante),14937,00,14272,665,12199,2738,14937,0
2019/01,355,10/01/2019,4,SP 17V tra San Giovanni in Marignano e Morciano di Romagna (variante),15228,00,14541,687,12351,2877,15228,0
2019/01,355,11/01/2019,5,SP 17V tra San Giovanni in Marignano e Morciano di Romagna (variante),15809,00,15163,646,12711,3098,15809,0
2019/01,355,12/01/2019,6,SP 17V tra San Giovanni in Marignano e Morciano di Romagna (variante),12704,00,12560,144,9634,3070,0,12704
2019/01,355,13/01/2019,7,SP 17V tra San Giovanni in Marignano e Morciano di Romagna (variante),9553,00,9524,29,7151,2402,0,9553
2019/01,355,14/01/2019,1,SP 17V tra San Giovanni in Marignano e Morciano di Romagna (variante),15460,00,14812,648,12570,2890,15460,0
2019/01,356,01/01/2019,2,SP 2 fra Reggiolo c/o bivio variante nord e confine regionale,3132,00,3100,32,1765,1367,0,3132
2019/01,356,02/01/2019,3,SP 2 fra Reggiolo c/o bivio variante nord e confine regionale,4818,10,4482,335,3830,988,4818,0
2019/01,356,03/01/2019,4,SP 2 fra Reggiolo c/o bivio variante nord e confine regionale,5674,00,5264,410,4494,1180,5674,0
2019/01,356,04/01/2019,5,SP 2 fra Reggiolo c/o bivio variante nord e confine regionale,5865,00,5446,419,4496,1369,5865,0
2019/01,356,05/01/2019,6,SP 2 fra Reggiolo c/o bivio variante nord e confine regionale,5409,00,5210,199,3865,1544,0,5409
2019/01,356,06/01/2019,7,SP 2 fra Reggiolo c/o bivio variante nord e confine regionale,6271,00,6205,66,4678,1593,0,6271
2019/01,356,07/01/2019,1,SP 2 fra Reggiolo c/o bivio variante nord e confine regionale,6732,00,5911,821,5448,1284,6732,0
2019/01,356,08/01/2019,2,SP 2 fra Reggiolo c/o bivio variante nord e confine regionale,6394,00,5586,808,5238,1156,6394,0
2019/01,356,09/01/2019,3,SP 2 fra Reggiolo c/o bivio variante nord e confine regionale,6739,00,6050,689,5333,1406,6739,0
2019/01,356,10/01/2019,4,SP 2 fra Reggiolo c/o bivio variante nord e confine regionale,7270,00,6350,920,5798,1472,7270,0
2019/01,356,11/01/2019,5,SP 2 fra Reggiolo c/o bivio variante nord e confine regionale,7638,10,6747,890,5883,1755,7638,0
2019/01,356,12/01/2019,6,SP 2 fra Reggiolo c/o bivio variante nord e confine regionale,6291,00,6083,208,4510,1781,0,6291
2019/01,356,13/01/2019,7,SP 2 fra Reggiolo c/o bivio variante nord e confine regionale,4618,00,4568,50,3213,1405,0,4618
2019/01,356,14/01/2019,1,SP 2 fra Reggiolo c/o bivio variante nord e confine regionale,7098,00,6249,849,5700,1398,7098,0
2019/01,357,01/01/2019,2,SP 306R fra Casola Valsenio e bivio SP 65 c/o località Isola,2409,00,2405,4,1751,658,0,2409
2019/01,357,02/01/2019,3,SP 306R fra Casola Valsenio e bivio SP 65 c/o località Isola,2834,10,2692,141,2252,582,2834,0
2019/01,357,03/01/2019,4,SP 306R fra Casola Valsenio e bivio SP 65 c/o località Isola,2950,20,2784,164,2352,598,2950,0
2019/01,357,04/01/2019,5,SP 306R fra Casola Valsenio e bivio SP 65 c/o località Isola,3073,00,2842,231,2462,611,3073,0
2019/01,357,05/01/2019,6,SP 306R fra Casola Valsenio e bivio SP 65 c/o località Isola,2762,00,2699,63,2117,645,0,2762
2019/01,357,06/01/2019,7,SP 306R fra Casola Valsenio e bivio SP 65 c/o località Isola,2724,00,2714,10,2227,497,0,2724
2019/01,357,07/01/2019,1,SP 306R fra Casola Valsenio e bivio SP 65 c/o località Isola,3086,20,2739,345,2568,518,3086,0
2019/01,357,08/01/2019,2,SP 306R fra Casola Valsenio e bivio SP 65 c/o località Isola,3315,20,3002,311,2729,586,3315,0
2019/01,357,09/01/2019,3,SP 306R fra Casola Valsenio e bivio SP 65 c/o località Isola,3278,20,2894,382,2669,609,3278,0
2019/01,357,10/01/2019,4,SP 306R fra Casola Valsenio e bivio SP 65 c/o località Isola,3281,00,2903,378,2672,609,3281,0
2019/01,357,11/01/2019,5,SP 306R fra Casola Valsenio e bivio SP 65 c/o località Isola,3444,10,3129,314,2760,684,3444,0
2019/01,357,12/01/2019,6,SP 306R fra Casola Valsenio e bivio SP 65 c/o località Isola,2987,00,2880,107,2256,731,0,2987
2019/01,357,13/01/2019,7,SP 306R fra Casola Valsenio e bivio SP 65 c/o località Isola,2726,00,2712,14,2199,527,0,2726
2019/01,357,14/01/2019,1,SP 306R fra Casola Valsenio e bivio SP 65 c/o località Isola,3184,00,2848,336,2574,610,3184,0
2019/01,376,01/01/2019,2,SP 68 tra Portomaggiore e la Superstrada Ferrara-Mare,1542,00,1537,5,965,577,0,1542
2019/01,376,02/01/2019,3,SP 68 tra Portomaggiore e la Superstrada Ferrara-Mare,2370,00,2277,93,1929,441,2370,0
2019/01,376,03/01/2019,4,SP 68 tra Portomaggiore e la Superstrada Ferrara-Mare,2576,00,2446,130,2060,516,2576,0
2019/01,376,04/01/2019,5,SP 68 tra Portomaggiore e la Superstrada Ferrara-Mare,2645,00,2521,124,2112,533,2645,0
2019/01,376,05/01/2019,6,SP 68 tra Portomaggiore e la Superstrada Ferrara-Mare,2377,00,2318,59,1732,645,0,2377
2019/01,376,06/01/2019,7,SP 68 tra Portomaggiore e la Superstrada Ferrara-Mare,1896,00,1890,6,1441,455,0,1896
2019/01,376,07/01/2019,1,SP 68 tra Portomaggiore e la Superstrada Ferrara-Mare,2923,00,2762,161,2392,531,2923,0
2019/01,376,08/01/2019,2,SP 68 tra Portomaggiore e la Superstrada Ferrara-Mare,2853,00,2690,163,2355,498,2853,0
2019/01,376,09/01/2019,3,SP 68 tra Portomaggiore e la Superstrada Ferrara-Mare,2981,00,2823,158,2427,554,2981,0
2019/01,376,10/01/2019,4,SP 68 tra Portomaggiore e la Superstrada Ferrara-Mare,3057,00,2897,160,2479,578,3057,0
2019/01,376,11/01/2019,5,SP 68 tra Portomaggiore e la Superstrada Ferrara-Mare,3258,00,3093,165,2600,658,3258,0
2019/01,376,12/01/2019,6,SP 68 tra Portomaggiore e la Superstrada Ferrara-Mare,2566,00,2487,79,1935,631,0,2566
2019/01,376,13/01/2019,7,SP 68 tra Portomaggiore e la Superstrada Ferrara-Mare,2035,00,2023,12,1545,490,0,2035
2019/01,376,14/01/2019,1,SP 68 tra Portomaggiore e la Superstrada Ferrara-Mare,3001,00,2831,170,2436,565,3001,0
2019/01,377,01/01/2019,2,SP 18 tra Bondeno e il confine regionale (Lombardia),2711,00,2699,12,1647,1064,0,2711
2019/01,377,02/01/2019,3,SP 18 tra Bondeno e il confine regionale (Lombardia),3659,00,3487,172,2923,736,3659,0
2019/01,377,03/01/2019,4,SP 18 tra Bondeno e il confine regionale (Lombardia),3966,00,3740,226,3211,755,3966,0
2019/01,377,04/01/2019,5,SP 18 tra Bondeno e il confine regionale (Lombardia),4153,00,3938,215,3239,914,4153,0
2019/01,377,05/01/2019,6,SP 18 tra Bondeno e il confine regionale (Lombardia),3774,00,3709,65,2691,1083,0,3774
2019/01,377,06/01/2019,7,SP 18 tra Bondeno e il confine regionale (Lombardia),3252,00,3237,15,2386,866,0,3252
2019/01,377,07/01/2019,1,SP 18 tra Bondeno e il confine regionale (Lombardia),4676,00,4392,284,3816,860,4676,0
2019/01,377,08/01/2019,2,SP 18 tra Bondeno e il confine regionale (Lombardia),4540,00,4150,390,3777,763,4540,0
2019/01,377,09/01/2019,3,SP 18 tra Bondeno e il confine regionale (Lombardia),4806,00,4385,421,3886,920,4806,0
2019/01,377,10/01/2019,4,SP 18 tra Bondeno e il confine regionale (Lombardia),5043,00,4660,383,4092,951,5043,0
2019/01,377,11/01/2019,5,SP 18 tra Bondeno e il confine regionale (Lombardia),5083,00,4703,380,4024,1059,5083,0
2019/01,377,12/01/2019,6,SP 18 tra Bondeno e il confine regionale (Lombardia),4014,00,3945,69,3004,1010,0,4014
2019/01,377,13/01/2019,7,SP 18 tra Bondeno e il confine regionale (Lombardia),4861,00,4848,13,3888,973,0,4861
2019/01,377,14/01/2019,1,SP 18 tra Bondeno e il confine regionale (Lombardia),4893,00,4473,420,4010,883,4893,0
2019/01,383,01/01/2019,2,SS 722 Tangenziale nord di Reggio Emilia,11349,10,11233,115,6161,5188,0,11349
2019/01,383,02/01/2019,3,SS 722 Tangenziale nord di Reggio Emilia,22036,30,20317,1716,17715,4321,22036,0
2019/01,383,03/01/2019,4,SS 722 Tangenziale nord di Reggio Emilia,24180,50,21982,2193,19366,4814,24180,0
2019/01,383,04/01/2019,5,SS 722 Tangenziale nord di Reggio Emilia,25232,80,23064,2160,19522,5710,25232,0
2019/01,383,05/01/2019,6,SS 722 Tangenziale nord di Reggio Emilia,22321,00,21662,659,15877,6444,0,22321
2019/01,383,06/01/2019,7,SS 722 Tangenziale nord di Reggio Emilia,17982,00,17818,164,12541,5441,0,17982
2019/01,383,07/01/2019,1,SS 722 Tangenziale nord di Reggio Emilia,29844,50,26707,3132,24310,5534,29844,0
2019/01,383,08/01/2019,2,SS 722 Tangenziale nord di Reggio Emilia,30711,30,27217,3491,25163,5548,30711,0
2019/01,383,09/01/2019,3,SS 722 Tangenziale nord di Reggio Emilia,32311,110,28578,3722,26236,6075,32311,0
2019/01,383,10/01/2019,4,SS 722 Tangenziale nord di Reggio Emilia,32963,30,28910,4050,26489,6474,32963,0
2019/01,383,11/01/2019,5,SS 722 Tangenziale nord di Reggio Emilia,33588,20,29856,3730,26415,7173,33588,0
2019/01,383,12/01/2019,6,SS 722 Tangenziale nord di Reggio Emilia,25228,40,24465,759,18164,7064,0,25228
2019/01,383,13/01/2019,7,SS 722 Tangenziale nord di Reggio Emilia,19663,10,19484,178,13785,5878,0,19663
2019/01,383,14/01/2019,1,SS 722 Tangenziale nord di Reggio Emilia,32290,90,28626,3655,26023,6267,32290,0
2019/01,385,01/01/2019,2,SP 10R fra Castel San Giovanni e Confine regionale (Lombardia),4930,00,4894,36,2955,1975,0,4930
2019/01,385,02/01/2019,3,SP 10R fra Castel San Giovanni e Confine regionale (Lombardia),8917,00,8250,667,6869,2048,8917,0
2019/01,385,03/01/2019,4,SP 10R fra Castel San Giovanni e Confine regionale (Lombardia),9333,00,8620,713,7190,2143,9333,0
2019/01,385,04/01/2019,5,SP 10R fra Castel San Giovanni e Confine regionale (Lombardia),9863,00,9111,752,7461,2402,9863,0
2019/01,385,05/01/2019,6,SP 10R fra Castel San Giovanni e Confine regionale (Lombardia),9038,00,8812,226,6666,2372,0,9038
2019/01,385,06/01/2019,7,SP 10R fra Castel San Giovanni e Confine regionale (Lombardia),7490,10,7455,34,5485,2005,0,7490
2019/01,385,07/01/2019,1,SP 10R fra Castel San Giovanni e Confine regionale (Lombardia),11443,00,10379,1064,9055,2388,11443,0
2019/01,385,08/01/2019,2,SP 10R fra Castel San Giovanni e Confine regionale (Lombardia),11883,00,10723,1160,9330,2553,11883,0
2019/01,385,09/01/2019,3,SP 10R fra Castel San Giovanni e Confine regionale (Lombardia),12263,00,11044,1219,9598,2665,12263,0
2019/01,385,10/01/2019,4,SP 10R fra Castel San Giovanni e Confine regionale (Lombardia),12465,00,11128,1337,9679,2786,12465,0
2019/01,385,11/01/2019,5,SP 10R fra Castel San Giovanni e Confine regionale (Lombardia),13045,10,11668,1376,9992,3053,13045,0
2019/01,385,12/01/2019,6,SP 10R fra Castel San Giovanni e Confine regionale (Lombardia),10581,00,10271,310,7777,2804,0,10581
2019/01,385,13/01/2019,7,SP 10R fra Castel San Giovanni e Confine regionale (Lombardia),8136,00,8037,99,5901,2235,0,8136
2019/01,385,14/01/2019,1,SP 10R fra Castel San Giovanni e Confine regionale (Lombardia),12257,00,10894,1363,9526,2731,12257,0
2019/01,388,01/01/2019,2,SP 31 fra bivio SP 12 in località Castelnuovo Fogliani e il confine provinciale,2810,00,2797,13,1918,892,0,2810
2019/01,388,02/01/2019,3,SP 31 fra bivio SP 12 in località Castelnuovo Fogliani e il confine provinciale,3608,00,3509,99,2966,642,3608,0
2019/01,388,03/01/2019,4,SP 31 fra bivio SP 12 in località Castelnuovo Fogliani e il confine provinciale,3914,00,3825,89,3192,722,3914,0
2019/01,388,04/01/2019,5,SP 31 fra bivio SP 12 in località Castelnuovo Fogliani e il confine provinciale,4209,00,4082,127,3353,856,4209,0
2019/01,388,05/01/2019,6,SP 31 fra bivio SP 12 in località Castelnuovo Fogliani e il confine provinciale,4294,00,4206,88,3221,1073,0,4294
2019/01,388,06/01/2019,7,SP 31 fra bivio SP 12 in località Castelnuovo Fogliani e il confine provinciale,4193,00,4175,18,3011,1182,0,4193
2019/01,388,07/01/2019,1,SP 31 fra bivio SP 12 in località Castelnuovo Fogliani e il confine provinciale,4132,00,4022,110,3382,750,4132,0
2019/01,388,08/01/2019,2,SP 31 fra bivio SP 12 in località Castelnuovo Fogliani e il confine provinciale,3950,00,3824,126,3288,662,3950,0
2019/01,388,09/01/2019,3,SP 31 fra bivio SP 12 in località Castelnuovo Fogliani e il confine provinciale,4104,10,3984,119,3350,754,4104,0
2019/01,388,10/01/2019,4,SP 31 fra bivio SP 12 in località Castelnuovo Fogliani e il confine provinciale,4214,00,4083,131,3428,786,4214,0
2019/01,388,11/01/2019,5,SP 31 fra bivio SP 12 in località Castelnuovo Fogliani e il confine provinciale,4601,00,4460,141,3548,1053,4601,0
2019/01,388,12/01/2019,6,SP 31 fra bivio SP 12 in località Castelnuovo Fogliani e il confine provinciale,4599,00,4526,73,3380,1219,0,4599
2019/01,388,13/01/2019,7,SP 31 fra bivio SP 12 in località Castelnuovo Fogliani e il confine provinciale,3898,00,3882,16,3026,872,0,3898
2019/01,388,14/01/2019,1,SP 31 fra bivio SP 12 in località Castelnuovo Fogliani e il confine provinciale,4527,00,4328,199,3598,929,4527,0
2019/01,389,01/01/2019,2,SP 588R fra Villanova d’Arda e confine provinciale,1869,00,1846,23,1236,633,0,1869
2019/01,389,02/01/2019,3,SP 588R fra Villanova d’Arda e confine provinciale,2915,00,2729,186,2384,531,2915,0
2019/01,389,03/01/2019,4,SP 588R fra Villanova d’Arda e confine provinciale,3075,00,2881,194,2493,582,3075,0
2019/01,389,04/01/2019,5,SP 588R fra Villanova d’Arda e confine provinciale,3304,10,3085,218,2617,687,3304,0
2019/01,389,05/01/2019,6,SP 588R fra Villanova d’Arda e confine provinciale,3313,10,3233,79,2587,726,0,3313
2019/01,389,06/01/2019,7,SP 588R fra Villanova d’Arda e confine provinciale,2823,00,2788,35,2124,699,0,2823
2019/01,389,07/01/2019,1,SP 588R fra Villanova d’Arda e confine provinciale,3572,10,3261,310,2971,601,3572,0
2019/01,389,08/01/2019,2,SP 588R fra Villanova d’Arda e confine provinciale,3554,00,3215,339,2967,587,3554,0
2019/01,389,09/01/2019,3,SP 588R fra Villanova d’Arda e confine provinciale,3881,00,3530,351,3173,708,3881,0
2019/01,389,10/01/2019,4,SP 588R fra Villanova d’Arda e confine provinciale,3956,00,3588,368,3233,723,3956,0
2019/01,389,11/01/2019,5,SP 588R fra Villanova d’Arda e confine provinciale,3958,00,3629,329,3151,807,3958,0
2019/01,389,12/01/2019,6,SP 588R fra Villanova d’Arda e confine provinciale,3449,00,3363,86,2595,854,0,3449
2019/01,389,13/01/2019,7,SP 588R fra Villanova d’Arda e confine provinciale,2949,10,2914,34,2213,736,0,2949
2019/01,389,14/01/2019,1,SP 588R fra Villanova d’Arda e confine provinciale,3779,00,3425,354,3121,658,3779,0
2019/01,390,01/01/2019,2,SP 462R dal bivio SP 10R in località Monticelli a Cortemaggiore,1513,00,1504,9,922,591,0,1513
2019/01,390,02/01/2019,3,SP 462R dal bivio SP 10R in località Monticelli a Cortemaggiore,2208,00,2121,87,1779,429,2208,0
2019/01,390,03/01/2019,4,SP 462R dal bivio SP 10R in località Monticelli a Cortemaggiore,2401,00,2286,115,1914,487,2401,0
2019/01,390,04/01/2019,5,SP 462R dal bivio SP 10R in località Monticelli a Cortemaggiore,2691,00,2574,117,2110,581,2691,0
2019/01,390,05/01/2019,6,SP 462R dal bivio SP 10R in località Monticelli a Cortemaggiore,2664,00,2607,57,1988,676,0,2664
2019/01,390,06/01/2019,7,SP 462R dal bivio SP 10R in località Monticelli a Cortemaggiore,2568,00,2543,25,2005,563,0,2568
2019/01,390,07/01/2019,1,SP 462R dal bivio SP 10R in località Monticelli a Cortemaggiore,2624,00,2516,108,2139,485,2624,0
2019/01,390,08/01/2019,2,SP 462R dal bivio SP 10R in località Monticelli a Cortemaggiore,2543,00,2416,127,2113,430,2543,0
2019/01,390,09/01/2019,3,SP 462R dal bivio SP 10R in località Monticelli a Cortemaggiore,2842,00,2694,148,2270,572,2842,0
2019/01,390,10/01/2019,4,SP 462R dal bivio SP 10R in località Monticelli a Cortemaggiore,2814,00,2689,125,2247,567,2814,0
2019/01,390,11/01/2019,5,SP 462R dal bivio SP 10R in località Monticelli a Cortemaggiore,2994,00,2829,165,2316,678,2994,0
2019/01,390,12/01/2019,6,SP 462R dal bivio SP 10R in località Monticelli a Cortemaggiore,2754,00,2700,54,2050,704,0,2754
2019/01,390,13/01/2019,7,SP 462R dal bivio SP 10R in località Monticelli a Cortemaggiore,2663,00,2636,27,2071,592,0,2663
2019/01,390,14/01/2019,1,SP 462R dal bivio SP 10R in località Monticelli a Cortemaggiore,2747,00,2621,126,2234,513,2747,0
2019/01,391,01/01/2019,2,SP 10R fra Castelvetro Piacentino e confine regionale (Lombardia),10866,00,10836,30,6650,4216,0,10866
2019/01,391,02/01/2019,3,SP 10R fra Castelvetro Piacentino e confine regionale (Lombardia),15917,00,15587,330,12366,3551,15917,0
2019/01,391,03/01/2019,4,SP 10R fra Castelvetro Piacentino e confine regionale (Lombardia),16844,00,16483,361,13113,3731,16844,0
2019/01,391,04/01/2019,5,SP 10R fra Castelvetro Piacentino e confine regionale (Lombardia),18137,00,17755,382,13745,4392,18137,0
2019/01,391,05/01/2019,6,SP 10R fra Castelvetro Piacentino e confine regionale (Lombardia),20034,00,19829,205,14518,5516,0,20034
2019/01,391,06/01/2019,7,SP 10R fra Castelvetro Piacentino e confine regionale (Lombardia),17219,00,17132,87,12838,4381,0,17219
2019/01,391,07/01/2019,1,SP 10R fra Castelvetro Piacentino e confine regionale (Lombardia),18488,00,18022,466,14771,3717,18488,0
2019/01,391,08/01/2019,2,SP 10R fra Castelvetro Piacentino e confine regionale (Lombardia),18197,00,17681,516,14561,3636,18197,0
2019/01,391,09/01/2019,3,SP 10R fra Castelvetro Piacentino e confine regionale (Lombardia),19569,20,19008,559,15460,4109,19569,0
2019/01,391,10/01/2019,4,SP 10R fra Castelvetro Piacentino e confine regionale (Lombardia),20087,00,19571,516,15740,4347,20087,0
2019/01,391,11/01/2019,5,SP 10R fra Castelvetro Piacentino e confine regionale (Lombardia),21180,00,20663,517,16115,5065,21180,0
2019/01,391,12/01/2019,6,SP 10R fra Castelvetro Piacentino e confine regionale (Lombardia),20702,10,20495,206,14752,5950,0,20702
2019/01,391,13/01/2019,7,SP 10R fra Castelvetro Piacentino e confine regionale (Lombardia),18237,00,18172,65,13480,4757,0,18237
2019/01,391,14/01/2019,1,SP 10R fra Castelvetro Piacentino e confine regionale (Lombardia),19365,10,18894,470,15324,4041,19365,0
2019/01,393,01/01/2019,2,SP 10R fra Caorso e Roncaglia,4437,00,4400,37,2693,1744,0,4437
2019/01,393,02/01/2019,3,SP 10R fra Caorso e Roncaglia,8267,00,7410,857,6502,1765,8267,0
2019/01,393,03/01/2019,4,SP 10R fra Caorso e Roncaglia,8862,10,7755,1106,6927,1935,8862,0
2019/01,393,04/01/2019,5,SP 10R fra Caorso e Roncaglia,9256,00,8262,994,7063,2193,9256,0
2019/01,393,05/01/2019,6,SP 10R fra Caorso e Roncaglia,7777,10,7542,234,5499,2278,0,7777
2019/01,393,06/01/2019,7,SP 10R fra Caorso e Roncaglia,6737,20,6678,57,4970,1767,0,6737
2019/01,393,07/01/2019,1,SP 10R fra Caorso e Roncaglia,10270,20,8921,1347,8225,2045,10270,0
2019/01,393,08/01/2019,2,SP 10R fra Caorso e Roncaglia,10383,00,8940,1443,8314,2069,10383,0
2019/01,393,09/01/2019,3,SP 10R fra Caorso e Roncaglia,10798,30,9246,1549,8478,2320,10798,0
2019/01,393,10/01/2019,4,SP 10R fra Caorso e Roncaglia,10997,10,9485,1511,8565,2432,10997,0
2019/01,393,11/01/2019,5,SP 10R fra Caorso e Roncaglia,11514,10,10038,1475,8799,2715,11514,0
2019/01,393,12/01/2019,6,SP 10R fra Caorso e Roncaglia,8547,00,8239,308,6073,2474,0,8547
2019/01,393,13/01/2019,7,SP 10R fra Caorso e Roncaglia,6715,00,6645,70,4870,1845,0,6715
2019/01,393,14/01/2019,1,SP 10R fra Caorso e Roncaglia,11010,10,9518,1491,8750,2260,11010,0
2019/01,394,01/01/2019,2,SP 523R da Roccamurata (bivio SP 308R) a Borgo Val di Taro,2504,00,2489,15,1765,739,0,2504
2019/01,394,02/01/2019,3,SP 523R da Roccamurata (bivio SP 308R) a Borgo Val di Taro,3822,00,3587,235,3082,740,3822,0
2019/01,394,03/01/2019,4,SP 523R da Roccamurata (bivio SP 308R) a Borgo Val di Taro,3809,00,3546,263,3045,764,3809,0
2019/01,394,04/01/2019,5,SP 523R da Roccamurata (bivio SP 308R) a Borgo Val di Taro,3960,00,3641,319,3133,827,3960,0
2019/01,394,05/01/2019,6,SP 523R da Roccamurata (bivio SP 308R) a Borgo Val di Taro,3375,00,3266,109,2659,716,0,3375
2019/01,394,06/01/2019,7,SP 523R da Roccamurata (bivio SP 308R) a Borgo Val di Taro,3017,00,2991,26,2261,756,0,3017
2019/01,394,07/01/2019,1,SP 523R da Roccamurata (bivio SP 308R) a Borgo Val di Taro,4407,00,4044,363,3540,867,4407,0
2019/01,394,08/01/2019,2,SP 523R da Roccamurata (bivio SP 308R) a Borgo Val di Taro,4121,00,3727,394,3255,866,4121,0
2019/01,394,09/01/2019,3,SP 523R da Roccamurata (bivio SP 308R) a Borgo Val di Taro,4351,00,3958,393,3504,847,4351,0
2019/01,394,10/01/2019,4,SP 523R da Roccamurata (bivio SP 308R) a Borgo Val di Taro,4309,00,3940,369,3379,930,4309,0
2019/01,394,11/01/2019,5,SP 523R da Roccamurata (bivio SP 308R) a Borgo Val di Taro,4679,00,4283,396,3658,1021,4679,0
2019/01,394,12/01/2019,6,SP 523R da Roccamurata (bivio SP 308R) a Borgo Val di Taro,3527,00,3417,110,2754,773,0,3527
2019/01,394,13/01/2019,7,SP 523R da Roccamurata (bivio SP 308R) a Borgo Val di Taro,3133,00,3095,38,2358,775,0,3133
2019/01,394,14/01/2019,1,SP 523R da Roccamurata (bivio SP 308R) a Borgo Val di Taro,4762,00,4359,403,3821,941,4762,0
2019/01,395,01/01/2019,2,SP 308R da Fornovo di Taro (bivio SS 62) a Solignano,2353,00,2342,11,1594,759,0,2353
2019/01,395,02/01/2019,3,SP 308R da Fornovo di Taro (bivio SS 62) a Solignano,3487,00,3358,129,2842,645,3487,0
2019/01,395,03/01/2019,4,SP 308R da Fornovo di Taro (bivio SS 62) a Solignano,3673,10,3511,161,2939,734,3673,0
2019/01,395,04/01/2019,5,SP 308R da Fornovo di Taro (bivio SS 62) a Solignano,3711,00,3532,179,2954,757,3711,0
2019/01,395,05/01/2019,6,SP 308R da Fornovo di Taro (bivio SS 62) a Solignano,3339,00,3252,87,2578,761,0,3339
2019/01,395,06/01/2019,7,SP 308R da Fornovo di Taro (bivio SS 62) a Solignano,3033,00,3016,17,2346,687,0,3033
2019/01,395,07/01/2019,1,SP 308R da Fornovo di Taro (bivio SS 62) a Solignano,4093,00,3887,206,3293,800,4093,0
2019/01,395,08/01/2019,2,SP 308R da Fornovo di Taro (bivio SS 62) a Solignano,4059,10,3827,231,3243,816,4059,0
2019/01,395,09/01/2019,3,SP 308R da Fornovo di Taro (bivio SS 62) a Solignano,4102,00,3885,217,3303,799,4102,0
2019/01,395,10/01/2019,4,SP 308R da Fornovo di Taro (bivio SS 62) a Solignano,4021,00,3802,219,3162,859,4021,0
2019/01,395,11/01/2019,5,SP 308R da Fornovo di Taro (bivio SS 62) a Solignano,4284,10,4048,235,3338,946,4284,0
2019/01,395,12/01/2019,6,SP 308R da Fornovo di Taro (bivio SS 62) a Solignano,3494,00,3411,83,2745,749,0,3494
2019/01,395,13/01/2019,7,SP 308R da Fornovo di Taro (bivio SS 62) a Solignano,2944,00,2923,21,2262,682,0,2944
2019/01,395,14/01/2019,1,SP 308R da Fornovo di Taro (bivio SS 62) a Solignano,4113,00,3917,196,3284,829,4113,0
2019/01,396,01/01/2019,2,SP 28 fra Fornovo di Taro e Varano de Melegari centro abitato Viazzano,3685,00,3674,11,2505,1180,0,3685
2019/01,396,02/01/2019,3,SP 28 fra Fornovo di Taro e Varano de Melegari centro abitato Viazzano,5917,00,5750,167,4915,1002,5917,0
2019/01,396,03/01/2019,4,SP 28 fra Fornovo di Taro e Varano de Melegari centro abitato Viazzano,6245,00,6056,189,5106,1139,6245,0
2019/01,396,04/01/2019,5,SP 28 fra Fornovo di Taro e Varano de Melegari centro abitato Viazzano,6675,10,6460,214,5356,1319,6675,0
2019/01,396,05/01/2019,6,SP 28 fra Fornovo di Taro e Varano de Melegari centro abitato Viazzano,5475,00,5379,96,4267,1208,0,5475
2019/01,396,06/01/2019,7,SP 28 fra Fornovo di Taro e Varano de Melegari centro abitato Viazzano,5083,00,5039,44,4060,1023,0,5083
2019/01,396,07/01/2019,1,SP 28 fra Fornovo di Taro e Varano de Melegari centro abitato Viazzano,7180,00,6882,298,5984,1196,7180,0
2019/01,396,08/01/2019,2,SP 28 fra Fornovo di Taro e Varano de Melegari centro abitato Viazzano,7251,00,6934,317,6024,1227,7251,0
2019/01,396,09/01/2019,3,SP 28 fra Fornovo di Taro e Varano de Melegari centro abitato Viazzano,7354,00,7043,311,6068,1286,7354,0
2019/01,396,10/01/2019,4,SP 28 fra Fornovo di Taro e Varano de Melegari centro abitato Viazzano,7480,00,7165,315,6099,1381,7480,0
2019/01,396,11/01/2019,5,SP 28 fra Fornovo di Taro e Varano de Melegari centro abitato Viazzano,7804,00,7485,319,6353,1451,7804,0
2019/01,396,12/01/2019,6,SP 28 fra Fornovo di Taro e Varano de Melegari centro abitato Viazzano,6068,10,5948,119,4845,1223,0,6068
2019/01,396,13/01/2019,7,SP 28 fra Fornovo di Taro e Varano de Melegari centro abitato Viazzano,5230,00,5201,29,4109,1121,0,5230
2019/01,396,14/01/2019,1,SP 28 fra Fornovo di Taro e Varano de Melegari centro abitato Viazzano,7269,00,6969,300,6024,1245,7269,0
2019/01,398,01/01/2019,2,SP 11 tra Fontevivo e Cispadana (tangenziale),,,,,,,,
2019/01,398,02/01/2019,3,SP 11 tra Fontevivo e Cispadana (tangenziale),,,,,,,,
2019/01,398,03/01/2019,4,SP 11 tra Fontevivo e Cispadana (tangenziale),,,,,,,,
2019/01,398,04/01/2019,5,SP 11 tra Fontevivo e Cispadana (tangenziale),,,,,,,,
2019/01,398,05/01/2019,6,SP 11 tra Fontevivo e Cispadana (tangenziale),,,,,,,,
2019/01,398,06/01/2019,7,SP 11 tra Fontevivo e Cispadana (tangenziale),,,,,,,,
2019/01,398,07/01/2019,1,SP 11 tra Fontevivo e Cispadana (tangenziale),,,,,,,,
2019/01,398,08/01/2019,2,SP 11 tra Fontevivo e Cispadana (tangenziale),,,,,,,,
2019/01,398,09/01/2019,3,SP 11 tra Fontevivo e Cispadana (tangenziale),,,,,,,,
2019/01,398,10/01/2019,4,SP 11 tra Fontevivo e Cispadana (tangenziale),,,,,,,,
2019/01,398,11/01/2019,5,SP 11 tra Fontevivo e Cispadana (tangenziale),,,,,,,,
2019/01,398,12/01/2019,6,SP 11 tra Fontevivo e Cispadana (tangenziale),,,,,,,,
2019/01,398,13/01/2019,7,SP 11 tra Fontevivo e Cispadana (tangenziale),,,,,,,,
2019/01,398,14/01/2019,1,SP 11 tra Fontevivo e Cispadana (tangenziale),,,,,,,,
2019/01,401,01/01/2019,2,SP 513R fra Traversetolo e confine provinciale,3376,00,3354,22,2236,1140,0,3376
2019/01,401,02/01/2019,3,SP 513R fra Traversetolo e confine provinciale,5477,10,5197,279,4476,1001,5477,0
2019/01,401,03/01/2019,4,SP 513R fra Traversetolo e confine provinciale,5932,00,5598,334,4858,1074,5932,0
2019/01,401,04/01/2019,5,SP 513R fra Traversetolo e confine provinciale,5999,10,5640,358,4815,1184,5999,0
2019/01,401,05/01/2019,6,SP 513R fra Traversetolo e confine provinciale,5919,00,5803,116,4594,1325,0,5919
2019/01,401,06/01/2019,7,SP 513R fra Traversetolo e confine provinciale,6416,10,6376,39,5317,1099,0,6416
2019/01,401,07/01/2019,1,SP 513R fra Traversetolo e confine provinciale,6400,00,5888,512,5242,1158,6400,0
2019/01,401,08/01/2019,2,SP 513R fra Traversetolo e confine provinciale,6610,00,6068,542,5452,1158,6610,0
2019/01,401,09/01/2019,3,SP 513R fra Traversetolo e confine provinciale,7084,10,6482,601,5829,1255,7084,0
2019/01,401,10/01/2019,4,SP 513R fra Traversetolo e confine provinciale,6927,60,6410,511,5664,1263,6927,0
2019/01,401,11/01/2019,5,SP 513R fra Traversetolo e confine provinciale,7239,00,6718,521,5828,1411,7239,0
2019/01,401,12/01/2019,6,SP 513R fra Traversetolo e confine provinciale,6202,00,6063,139,4835,1367,0,6202
2019/01,401,13/01/2019,7,SP 513R fra Traversetolo e confine provinciale,6850,30,6799,48,5769,1081,0,6850
2019/01,401,14/01/2019,1,SP 513R fra Traversetolo e confine provinciale,6887,00,6307,580,5693,1194,6887,0
2019/01,402,01/01/2019,2,SP 18 da Pilastrello (bivio SP 513R) al bivio per la Pedemontana,6191,00,6177,14,3838,2353,0,6191
2019/01,402,02/01/2019,3,SP 18 da Pilastrello (bivio SP 513R) al bivio per la Pedemontana,10435,00,10263,172,8501,1934,10435,0
2019/01,402,03/01/2019,4,SP 18 da Pilastrello (bivio SP 513R) al bivio per la Pedemontana,11356,00,11192,164,9167,2189,11356,0
2019/01,402,04/01/2019,5,SP 18 da Pilastrello (bivio SP 513R) al bivio per la Pedemontana,11945,00,11754,191,9455,2490,11945,0
2019/01,402,05/01/2019,6,SP 18 da Pilastrello (bivio SP 513R) al bivio per la Pedemontana,11059,00,10975,84,8416,2643,0,11059
2019/01,402,06/01/2019,7,SP 18 da Pilastrello (bivio SP 513R) al bivio per la Pedemontana,8627,00,8601,26,6497,2130,0,8627
2019/01,402,07/01/2019,1,SP 18 da Pilastrello (bivio SP 513R) al bivio per la Pedemontana,12829,00,12573,256,10513,2316,12829,0
2019/01,402,08/01/2019,2,SP 18 da Pilastrello (bivio SP 513R) al bivio per la Pedemontana,13039,00,12719,320,10593,2446,13039,0
2019/01,402,09/01/2019,3,SP 18 da Pilastrello (bivio SP 513R) al bivio per la Pedemontana,13356,00,13060,296,10778,2578,13356,0
2019/01,402,10/01/2019,4,SP 18 da Pilastrello (bivio SP 513R) al bivio per la Pedemontana,14108,00,13760,348,11355,2753,14108,0
2019/01,402,11/01/2019,5,SP 18 da Pilastrello (bivio SP 513R) al bivio per la Pedemontana,13981,20,13719,260,10973,3008,13981,0
2019/01,402,12/01/2019,6,SP 18 da Pilastrello (bivio SP 513R) al bivio per la Pedemontana,11932,00,11826,106,9072,2860,0,11932
2019/01,402,13/01/2019,7,SP 18 da Pilastrello (bivio SP 513R) al bivio per la Pedemontana,8796,00,8774,22,6447,2349,0,8796
2019/01,402,14/01/2019,1,SP 18 da Pilastrello (bivio SP 513R) al bivio per la Pedemontana,13236,00,12932,304,10852,2384,13236,0
2019/01,404,01/01/2019,2,exSP 32 (via Dante Alighieri) da Felino a Pilastro,3595,30,3572,20,2202,1393,0,3595
2019/01,404,02/01/2019,3,exSP 32 (via Dante Alighieri) da Felino a Pilastro,6199,30,6067,129,5018,1181,6199,0
2019/01,404,03/01/2019,4,exSP 32 (via Dante Alighieri) da Felino a Pilastro,6443,10,6294,148,5134,1309,6443,0
2019/01,404,04/01/2019,5,exSP 32 (via Dante Alighieri) da Felino a Pilastro,7230,30,7056,171,5800,1430,7230,0
2019/01,404,05/01/2019,6,exSP 32 (via Dante Alighieri) da Felino a Pilastro,5936,00,5874,62,4604,1332,0,5936
2019/01,404,06/01/2019,7,exSP 32 (via Dante Alighieri) da Felino a Pilastro,4715,30,4685,27,3646,1069,0,4715
2019/01,404,07/01/2019,1,exSP 32 (via Dante Alighieri) da Felino a Pilastro,6822,10,6660,161,5550,1272,6822,0
2019/01,404,08/01/2019,2,exSP 32 (via Dante Alighieri) da Felino a Pilastro,7006,20,6842,162,5713,1293,7006,0
2019/01,404,09/01/2019,3,exSP 32 (via Dante Alighieri) da Felino a Pilastro,7183,10,6972,210,5754,1429,7183,0
2019/01,404,10/01/2019,4,exSP 32 (via Dante Alighieri) da Felino a Pilastro,7141,10,6961,179,5727,1414,7141,0
2019/01,404,11/01/2019,5,exSP 32 (via Dante Alighieri) da Felino a Pilastro,7225,40,7030,191,5761,1464,7225,0
2019/01,404,12/01/2019,6,exSP 32 (via Dante Alighieri) da Felino a Pilastro,5990,20,5913,75,4661,1329,0,5990
2019/01,404,13/01/2019,7,exSP 32 (via Dante Alighieri) da Felino a Pilastro,4728,20,4696,30,3655,1073,0,4728
2019/01,404,14/01/2019,1,exSP 32 (via Dante Alighieri) da Felino a Pilastro,7039,00,6859,180,5739,1300,7039,0
2019/01,405,01/01/2019,2,SP 15 fra SS62 e Sala Baganza,4602,00,4588,14,2712,1890,0,4602
2019/01,405,02/01/2019,3,SP 15 fra SS62 e Sala Baganza,7758,00,7316,442,6243,1515,7758,0
2019/01,405,03/01/2019,4,SP 15 fra SS62 e Sala Baganza,8525,00,8030,495,6876,1649,8525,0
2019/01,405,04/01/2019,5,SP 15 fra SS62 e Sala Baganza,8835,00,8304,531,6962,1873,8835,0
2019/01,405,05/01/2019,6,SP 15 fra SS62 e Sala Baganza,7402,00,7263,139,5417,1985,0,7402
2019/01,405,06/01/2019,7,SP 15 fra SS62 e Sala Baganza,5855,00,5837,18,4384,1471,0,5855
2019/01,405,07/01/2019,1,SP 15 fra SS62 e Sala Baganza,10149,00,9491,658,8308,1841,10149,0
2019/01,405,08/01/2019,2,SP 15 fra SS62 e Sala Baganza,10412,00,9675,737,8447,1965,10412,0
2019/01,405,09/01/2019,3,SP 15 fra SS62 e Sala Baganza,10488,00,9785,703,8450,2038,10488,0
2019/01,405,10/01/2019,4,SP 15 fra SS62 e Sala Baganza,10620,00,9821,799,8535,2085,10620,0
2019/01,405,11/01/2019,5,SP 15 fra SS62 e Sala Baganza,10712,00,9976,736,8547,2165,10712,0
2019/01,405,12/01/2019,6,SP 15 fra SS62 e Sala Baganza,8312,00,8133,179,6213,2099,0,8312
2019/01,405,13/01/2019,7,SP 15 fra SS62 e Sala Baganza,6419,00,6382,37,4861,1558,0,6419
2019/01,405,14/01/2019,1,SP 15 fra SS62 e Sala Baganza,10459,00,9677,782,8522,1937,10459,0
2019/01,410,01/01/2019,2,SP 54 fra Pomposa e Codigoro,2731,00,2730,1,1612,1119,0,2731
2019/01,410,02/01/2019,3,SP 54 fra Pomposa e Codigoro,3296,00,3150,146,2701,595,3296,0
2019/01,410,03/01/2019,4,SP 54 fra Pomposa e Codigoro,3603,00,3440,163,3007,596,3603,0
2019/01,410,04/01/2019,5,SP 54 fra Pomposa e Codigoro,3752,00,3585,167,3068,684,3752,0
2019/01,410,05/01/2019,6,SP 54 fra Pomposa e Codigoro,3389,00,3303,86,2468,921,0,3389
2019/01,410,06/01/2019,7,SP 54 fra Pomposa e Codigoro,2850,00,2836,14,1953,897,0,2850
2019/01,410,07/01/2019,1,SP 54 fra Pomposa e Codigoro,3812,00,3593,219,3190,622,3812,0
2019/01,410,08/01/2019,2,SP 54 fra Pomposa e Codigoro,3955,00,3741,214,3337,618,3955,0
2019/01,410,09/01/2019,3,SP 54 fra Pomposa e Codigoro,3867,00,3618,249,3267,600,3867,0
2019/01,410,10/01/2019,4,SP 54 fra Pomposa e Codigoro,4307,00,4101,206,3565,742,4307,0
2019/01,410,11/01/2019,5,SP 54 fra Pomposa e Codigoro,4459,00,4185,274,3674,785,4459,0
2019/01,410,12/01/2019,6,SP 54 fra Pomposa e Codigoro,3913,00,3811,102,2974,939,0,3913
2019/01,410,13/01/2019,7,SP 54 fra Pomposa e Codigoro,3282,00,3272,10,2336,946,0,3282
2019/01,410,14/01/2019,1,SP 54 fra Pomposa e Codigoro,4157,00,3915,242,3485,672,4157,0
2019/01,411,01/01/2019,2,SP 53 fra Codigoro e Marozzo,2501,00,2497,4,1474,1027,0,2501
2019/01,411,02/01/2019,3,SP 53 fra Codigoro e Marozzo,4122,00,4074,48,3365,757,4122,0
2019/01,411,03/01/2019,4,SP 53 fra Codigoro e Marozzo,4390,00,4340,50,3562,828,4390,0
2019/01,411,04/01/2019,5,SP 53 fra Codigoro e Marozzo,4330,00,4262,68,3502,828,4330,0
2019/01,411,05/01/2019,6,SP 53 fra Codigoro e Marozzo,3648,00,3616,32,2665,983,0,3648
2019/01,411,06/01/2019,7,SP 53 fra Codigoro e Marozzo,3017,00,3010,7,2125,892,0,3017
2019/01,411,07/01/2019,1,SP 53 fra Codigoro e Marozzo,5097,00,5018,79,4164,933,5097,0
2019/01,411,08/01/2019,2,SP 53 fra Codigoro e Marozzo,4895,00,4832,63,4099,796,4895,0
2019/01,411,09/01/2019,3,SP 53 fra Codigoro e Marozzo,5018,00,4942,76,4131,887,5018,0
2019/01,411,10/01/2019,4,SP 53 fra Codigoro e Marozzo,5202,00,5120,82,4211,991,5202,0
2019/01,411,11/01/2019,5,SP 53 fra Codigoro e Marozzo,5445,00,5374,71,4359,1086,5445,0
2019/01,411,12/01/2019,6,SP 53 fra Codigoro e Marozzo,4282,00,4241,41,3254,1028,0,4282
2019/01,411,13/01/2019,7,SP 53 fra Codigoro e Marozzo,3163,00,3148,15,2301,862,0,3163
2019/01,411,14/01/2019,1,SP 53 fra Codigoro e Marozzo,5369,00,5275,94,4426,943,5369,0
2019/01,426,01/01/2019,2,SS 63 tra Casina e Vezzano sul Crostolo,9357,00,9313,44,6395,2962,0,9357
2019/01,426,02/01/2019,3,SS 63 tra Casina e Vezzano sul Crostolo,11782,00,11495,287,9429,2353,11782,0
2019/01,426,03/01/2019,4,SS 63 tra Casina e Vezzano sul Crostolo,12370,00,12038,332,9738,2632,12370,0
2019/01,426,04/01/2019,5,SS 63 tra Casina e Vezzano sul Crostolo,13077,00,12771,306,10118,2959,13077,0
2019/01,426,05/01/2019,6,SS 63 tra Casina e Vezzano sul Crostolo,12476,00,12296,180,9313,3163,0,12476
2019/01,426,06/01/2019,7,SS 63 tra Casina e Vezzano sul Crostolo,11370,00,11322,48,8781,2589,0,11370
2019/01,426,07/01/2019,1,SS 63 tra Casina e Vezzano sul Crostolo,13153,00,12715,438,10410,2743,13153,0
2019/01,426,08/01/2019,2,SS 63 tra Casina e Vezzano sul Crostolo,13235,10,12784,450,10492,2743,13235,0
2019/01,426,09/01/2019,3,SS 63 tra Casina e Vezzano sul Crostolo,13840,00,13395,445,10916,2924,13840,0
2019/01,426,10/01/2019,4,SS 63 tra Casina e Vezzano sul Crostolo,14143,00,13708,435,10971,3172,14143,0
2019/01,426,11/01/2019,5,SS 63 tra Casina e Vezzano sul Crostolo,14715,00,14243,472,11241,3474,14715,0
2019/01,426,12/01/2019,6,SS 63 tra Casina e Vezzano sul Crostolo,14151,00,13948,203,10285,3866,0,14151
2019/01,426,13/01/2019,7,SS 63 tra Casina e Vezzano sul Crostolo,12338,00,12286,52,9092,3246,0,12338
2019/01,426,14/01/2019,1,SS 63 tra Casina e Vezzano sul Crostolo,13859,00,13372,487,10993,2866,13859,0
2019/01,428,02/01/2019,3,SP 19 fra Colombaia (bivio SP 76) e il Bivio SP 486R al confine provinciale,2944,00,2744,200,2423,521,2944,0
2019/01,428,03/01/2019,4,SP 19 fra Colombaia (bivio SP 76) e il Bivio SP 486R al confine provinciale,2476,00,2350,126,1946,530,2476,0
2019/01,428,04/01/2019,5,SP 19 fra Colombaia (bivio SP 76) e il Bivio SP 486R al confine provinciale,3003,00,2830,173,2392,611,3003,0
2019/01,428,05/01/2019,6,SP 19 fra Colombaia (bivio SP 76) e il Bivio SP 486R al confine provinciale,2602,00,2543,59,2214,388,0,2602
2019/01,428,06/01/2019,7,SP 19 fra Colombaia (bivio SP 76) e il Bivio SP 486R al confine provinciale,2783,00,2766,17,2203,580,0,2783
2019/01,428,07/01/2019,1,SP 19 fra Colombaia (bivio SP 76) e il Bivio SP 486R al confine provinciale,3247,00,2952,295,2625,622,3247,0
2019/01,428,08/01/2019,2,SP 19 fra Colombaia (bivio SP 76) e il Bivio SP 486R al confine provinciale,3366,00,3013,353,2679,687,3366,0
2019/01,428,09/01/2019,3,SP 19 fra Colombaia (bivio SP 76) e il Bivio SP 486R al confine provinciale,3427,00,3022,405,2703,724,3427,0
2019/01,428,10/01/2019,4,SP 19 fra Colombaia (bivio SP 76) e il Bivio SP 486R al confine provinciale,3628,00,3197,431,2888,740,3628,0
2019/01,428,11/01/2019,5,SP 19 fra Colombaia (bivio SP 76) e il Bivio SP 486R al confine provinciale,3762,00,3358,404,2944,818,3762,0
2019/01,428,12/01/2019,6,SP 19 fra Colombaia (bivio SP 76) e il Bivio SP 486R al confine provinciale,3147,00,3084,63,2389,758,0,3147
2019/01,428,13/01/2019,7,SP 19 fra Colombaia (bivio SP 76) e il Bivio SP 486R al confine provinciale,2864,00,2839,25,2263,601,0,2864
2019/01,428,14/01/2019,1,SP 19 fra Colombaia (bivio SP 76) e il Bivio SP 486R al confine provinciale,3614,00,3190,424,2888,726,3614,0
2019/01,429,01/01/2019,2,SP 12 fra San Polo d'Enza e Montecchio Emilia (variante a sud abitato),3873,00,3821,52,2535,1338,0,3873
2019/01,429,02/01/2019,3,SP 12 fra San Polo d'Enza e Montecchio Emilia (variante a sud abitato),5801,00,5520,281,4702,1099,5801,0
2019/01,429,03/01/2019,4,SP 12 fra San Polo d'Enza e Montecchio Emilia (variante a sud abitato),6290,00,5925,365,5160,1130,6290,0
2019/01,429,04/01/2019,5,SP 12 fra San Polo d'Enza e Montecchio Emilia (variante a sud abitato),6543,10,6133,409,5214,1329,6543,0
2019/01,429,05/01/2019,6,SP 12 fra San Polo d'Enza e Montecchio Emilia (variante a sud abitato),5904,00,5774,130,4519,1385,0,5904
2019/01,429,06/01/2019,7,SP 12 fra San Polo d'Enza e Montecchio Emilia (variante a sud abitato),5137,00,5086,51,3929,1208,0,5137
2019/01,429,07/01/2019,1,SP 12 fra San Polo d'Enza e Montecchio Emilia (variante a sud abitato),7594,00,6974,620,6319,1275,7594,0
2019/01,429,08/01/2019,2,SP 12 fra San Polo d'Enza e Montecchio Emilia (variante a sud abitato),7537,00,6821,716,6248,1289,7537,0
2019/01,429,09/01/2019,3,SP 12 fra San Polo d'Enza e Montecchio Emilia (variante a sud abitato),7818,10,7098,719,6403,1415,7818,0
2019/01,429,10/01/2019,4,SP 12 fra San Polo d'Enza e Montecchio Emilia (variante a sud abitato),7863,10,7160,702,6399,1464,7863,0
2019/01,429,11/01/2019,5,SP 12 fra San Polo d'Enza e Montecchio Emilia (variante a sud abitato),8161,00,7424,737,6617,1544,8161,0
2019/01,429,12/01/2019,6,SP 12 fra San Polo d'Enza e Montecchio Emilia (variante a sud abitato),6813,00,6649,164,5261,1552,0,6813
2019/01,429,13/01/2019,7,SP 12 fra San Polo d'Enza e Montecchio Emilia (variante a sud abitato),5630,00,5554,76,4287,1343,0,5630
2019/01,429,14/01/2019,1,SP 12 fra San Polo d'Enza e Montecchio Emilia (variante a sud abitato),7815,00,7057,758,6451,1364,7815,0
2019/01,430,01/01/2019,2,SP 28 tra Montecchio Emilia e bivio circonvallazione,3380,00,3350,30,1910,1470,0,3380
2019/01,430,02/01/2019,3,SP 28 tra Montecchio Emilia e bivio circonvallazione,7312,00,7047,265,6022,1290,7312,0
2019/01,430,03/01/2019,4,SP 28 tra Montecchio Emilia e bivio circonvallazione,7865,10,7559,305,6410,1455,7865,0
2019/01,430,04/01/2019,5,SP 28 tra Montecchio Emilia e bivio circonvallazione,8477,00,8108,369,6717,1760,8477,0
2019/01,430,05/01/2019,6,SP 28 tra Montecchio Emilia e bivio circonvallazione,7101,00,6986,115,5262,1839,0,7101
2019/01,430,06/01/2019,7,SP 28 tra Montecchio Emilia e bivio circonvallazione,5354,00,5320,34,3771,1583,0,5354
2019/01,430,07/01/2019,1,SP 28 tra Montecchio Emilia e bivio circonvallazione,10175,00,9655,520,8507,1668,10175,0
2019/01,430,08/01/2019,2,SP 28 tra Montecchio Emilia e bivio circonvallazione,10177,00,9578,599,8466,1711,10177,0
2019/01,430,09/01/2019,3,SP 28 tra Montecchio Emilia e bivio circonvallazione,10485,00,9912,573,8615,1870,10485,0
2019/01,430,10/01/2019,4,SP 28 tra Montecchio Emilia e bivio circonvallazione,10793,00,10205,588,8897,1896,10793,0
2019/01,430,11/01/2019,5,SP 28 tra Montecchio Emilia e bivio circonvallazione,11401,10,10765,635,9108,2293,11401,0
2019/01,430,12/01/2019,6,SP 28 tra Montecchio Emilia e bivio circonvallazione,8338,00,8205,133,6190,2148,0,8338
2019/01,430,13/01/2019,7,SP 28 tra Montecchio Emilia e bivio circonvallazione,5776,00,5735,41,4180,1596,0,5776
2019/01,430,14/01/2019,1,SP 28 tra Montecchio Emilia e bivio circonvallazione,10690,00,10081,609,8894,1796,10690,0
2019/01,431,01/01/2019,2,SP 12 fra Sant'Ilario d'Enza (variante a sud) e Montecchio Emilia,2728,00,2712,16,1637,1091,0,2728
2019/01,431,02/01/2019,3,SP 12 fra Sant'Ilario d'Enza (variante a sud) e Montecchio Emilia,4635,00,4521,114,3790,845,4635,0
2019/01,431,03/01/2019,4,SP 12 fra Sant'Ilario d'Enza (variante a sud) e Montecchio Emilia,5011,00,4885,126,4036,975,5011,0
2019/01,431,04/01/2019,5,SP 12 fra Sant'Ilario d'Enza (variante a sud) e Montecchio Emilia,5294,00,5169,125,4141,1153,5294,0
2019/01,431,05/01/2019,6,SP 12 fra Sant'Ilario d'Enza (variante a sud) e Montecchio Emilia,4999,00,4944,55,3826,1173,0,4999
2019/01,431,06/01/2019,7,SP 12 fra Sant'Ilario d'Enza (variante a sud) e Montecchio Emilia,3741,00,3724,17,2763,978,0,3741
2019/01,431,07/01/2019,1,SP 12 fra Sant'Ilario d'Enza (variante a sud) e Montecchio Emilia,6132,20,5913,217,5050,1082,6132,0
2019/01,431,08/01/2019,2,SP 12 fra Sant'Ilario d'Enza (variante a sud) e Montecchio Emilia,6123,00,5901,222,4995,1128,6123,0
2019/01,431,09/01/2019,3,SP 12 fra Sant'Ilario d'Enza (variante a sud) e Montecchio Emilia,6431,00,6196,235,5191,1240,6431,0
2019/01,431,10/01/2019,4,SP 12 fra Sant'Ilario d'Enza (variante a sud) e Montecchio Emilia,6588,00,6364,224,5358,1230,6588,0
2019/01,431,11/01/2019,5,SP 12 fra Sant'Ilario d'Enza (variante a sud) e Montecchio Emilia,6768,00,6547,221,5425,1343,6768,0
2019/01,431,12/01/2019,6,SP 12 fra Sant'Ilario d'Enza (variante a sud) e Montecchio Emilia,5962,00,5892,70,4630,1332,0,5962
2019/01,431,13/01/2019,7,SP 12 fra Sant'Ilario d'Enza (variante a sud) e Montecchio Emilia,4398,00,4375,23,3408,990,0,4398
2019/01,431,14/01/2019,1,SP 12 fra Sant'Ilario d'Enza (variante a sud) e Montecchio Emilia,6489,00,6224,265,5396,1093,6489,0
2019/01,432,01/01/2019,2,SP 67 fra Calerno e Montecchio Emilia,4306,00,4243,63,2681,1625,0,4306
2019/01,432,02/01/2019,3,SP 67 fra Calerno e Montecchio Emilia,6754,00,6245,509,5348,1406,6754,0
2019/01,432,03/01/2019,4,SP 67 fra Calerno e Montecchio Emilia,7431,00,6825,606,5891,1540,7431,0
2019/01,432,04/01/2019,5,SP 67 fra Calerno e Montecchio Emilia,7645,00,6995,650,5955,1690,7645,0
2019/01,432,05/01/2019,6,SP 67 fra Calerno e Montecchio Emilia,6565,00,6352,213,4889,1676,0,6565
2019/01,432,06/01/2019,7,SP 67 fra Calerno e Montecchio Emilia,5511,00,5433,78,4015,1496,0,5511
2019/01,432,07/01/2019,1,SP 67 fra Calerno e Montecchio Emilia,9471,00,8477,994,7837,1634,9471,0
2019/01,432,08/01/2019,2,SP 67 fra Calerno e Montecchio Emilia,9531,00,8356,1175,7827,1704,9531,0
2019/01,432,09/01/2019,3,SP 67 fra Calerno e Montecchio Emilia,10084,00,8950,1134,8241,1843,10084,0
2019/01,432,10/01/2019,4,SP 67 fra Calerno e Montecchio Emilia,10358,00,9134,1224,8421,1937,10358,0
2019/01,432,11/01/2019,5,SP 67 fra Calerno e Montecchio Emilia,10643,10,9390,1252,8576,2067,10643,0
2019/01,432,12/01/2019,6,SP 67 fra Calerno e Montecchio Emilia,7551,00,7321,230,5626,1925,0,7551
2019/01,432,13/01/2019,7,SP 67 fra Calerno e Montecchio Emilia,6326,00,6226,100,4643,1683,0,6326
2019/01,432,14/01/2019,1,SP 67 fra Calerno e Montecchio Emilia,10323,00,9071,1252,8497,1826,10323,0
2019/01,434,14/01/2019,1,Via San Nicola (ex SP 39) tra bivio per Taneto a Caprara,2721,00,2676,45,2223,498,2721,0
2019/01,436,01/01/2019,2,SP 26 da Santa Sofia a San Piero in Bagno,796,00,790,6,550,246,0,796
2019/01,436,02/01/2019,3,SP 26 da Santa Sofia a San Piero in Bagno,948,10,916,31,741,207,948,0
2019/01,436,03/01/2019,4,SP 26 da Santa Sofia a San Piero in Bagno,844,00,793,51,682,162,844,0
2019/01,436,04/01/2019,5,SP 26 da Santa Sofia a San Piero in Bagno,909,00,877,32,679,230,909,0
2019/01,436,05/01/2019,6,SP 26 da Santa Sofia a San Piero in Bagno,849,00,842,7,616,233,0,849
2019/01,436,06/01/2019,7,SP 26 da Santa Sofia a San Piero in Bagno,771,00,768,3,575,196,0,771
2019/01,436,07/01/2019,1,SP 26 da Santa Sofia a San Piero in Bagno,785,00,751,34,627,158,785,0
2019/01,436,08/01/2019,2,SP 26 da Santa Sofia a San Piero in Bagno,783,10,725,57,639,144,783,0
2019/01,436,09/01/2019,3,SP 26 da Santa Sofia a San Piero in Bagno,904,00,859,45,724,180,904,0
2019/01,436,10/01/2019,4,SP 26 da Santa Sofia a San Piero in Bagno,770,00,710,60,595,175,770,0
2019/01,436,11/01/2019,5,SP 26 da Santa Sofia a San Piero in Bagno,826,00,780,46,634,192,826,0
2019/01,436,12/01/2019,6,SP 26 da Santa Sofia a San Piero in Bagno,844,00,828,16,616,228,0,844
2019/01,436,13/01/2019,7,SP 26 da Santa Sofia a San Piero in Bagno,827,00,820,7,629,198,0,827
2019/01,436,14/01/2019,1,SP 26 da Santa Sofia a San Piero in Bagno,873,00,814,59,698,175,873,0
2019/01,437,01/01/2019,2,SP 13 tra SS 9 (Santarcangelo di Romagna) e SP 92 (località Camerano),3534,00,3518,16,2070,1464,0,3534
2019/01,437,02/01/2019,3,SP 13 tra SS 9 (Santarcangelo di Romagna) e SP 92 (località Camerano),5437,10,5020,416,4352,1085,5437,0
2019/01,437,03/01/2019,4,SP 13 tra SS 9 (Santarcangelo di Romagna) e SP 92 (località Camerano),5598,00,5112,486,4483,1115,5598,0
2019/01,437,04/01/2019,5,SP 13 tra SS 9 (Santarcangelo di Romagna) e SP 92 (località Camerano),5769,00,5292,477,4597,1172,5769,0
2019/01,437,05/01/2019,6,SP 13 tra SS 9 (Santarcangelo di Romagna) e SP 92 (località Camerano),5159,00,5002,157,3851,1308,0,5159
2019/01,437,06/01/2019,7,SP 13 tra SS 9 (Santarcangelo di Romagna) e SP 92 (località Camerano),4136,00,4110,26,3042,1094,0,4136
2019/01,437,07/01/2019,1,SP 13 tra SS 9 (Santarcangelo di Romagna) e SP 92 (località Camerano),6621,10,5734,886,5481,1140,6621,0
2019/01,437,08/01/2019,2,SP 13 tra SS 9 (Santarcangelo di Romagna) e SP 92 (località Camerano),6845,10,5917,927,5628,1217,6845,0
2019/01,437,09/01/2019,3,SP 13 tra SS 9 (Santarcangelo di Romagna) e SP 92 (località Camerano),6917,20,6035,880,5667,1250,6917,0
2019/01,437,10/01/2019,4,SP 13 tra SS 9 (Santarcangelo di Romagna) e SP 92 (località Camerano),6894,20,5943,949,5627,1267,6894,0
2019/01,437,11/01/2019,5,SP 13 tra SS 9 (Santarcangelo di Romagna) e SP 92 (località Camerano),7061,00,6149,912,5616,1445,7061,0
2019/01,437,12/01/2019,6,SP 13 tra SS 9 (Santarcangelo di Romagna) e SP 92 (località Camerano),5661,00,5492,169,4243,1418,0,5661
2019/01,437,13/01/2019,7,SP 13 tra SS 9 (Santarcangelo di Romagna) e SP 92 (località Camerano),4443,00,4414,29,3299,1144,0,4443
2019/01,437,14/01/2019,1,SP 13 tra SS 9 (Santarcangelo di Romagna) e SP 92 (località Camerano),6946,10,6018,927,5626,1320,6946,0
2019/01,438,01/01/2019,2,SP 14 tra Colombare (bivio SP 14Ter) e bivio SP 258R,5144,00,5129,15,3384,1760,0,5144
2019/01,438,02/01/2019,3,SP 14 tra Colombare (bivio SP 14Ter) e bivio SP 258R,5815,20,5619,194,4730,1085,5815,0
2019/01,438,03/01/2019,4,SP 14 tra Colombare (bivio SP 14Ter) e bivio SP 258R,6377,00,6049,328,5141,1236,6377,0
2019/01,438,04/01/2019,5,SP 14 tra Colombare (bivio SP 14Ter) e bivio SP 258R,6436,10,6158,277,5122,1314,6436,0
2019/01,438,05/01/2019,6,SP 14 tra Colombare (bivio SP 14Ter) e bivio SP 258R,5940,00,5860,80,4388,1552,0,5940
2019/01,438,06/01/2019,7,SP 14 tra Colombare (bivio SP 14Ter) e bivio SP 258R,5434,00,5418,16,4148,1286,0,5434
2019/01,438,07/01/2019,1,SP 14 tra Colombare (bivio SP 14Ter) e bivio SP 258R,7581,20,6983,596,6283,1298,7581,0
2019/01,438,08/01/2019,2,SP 14 tra Colombare (bivio SP 14Ter) e bivio SP 258R,7715,00,7139,576,6413,1302,7715,0
2019/01,438,09/01/2019,3,SP 14 tra Colombare (bivio SP 14Ter) e bivio SP 258R,7742,00,7176,566,6314,1428,7742,0
2019/01,438,10/01/2019,4,SP 14 tra Colombare (bivio SP 14Ter) e bivio SP 258R,7791,00,7194,597,6445,1346,7791,0
2019/01,438,11/01/2019,5,SP 14 tra Colombare (bivio SP 14Ter) e bivio SP 258R,8265,10,7706,558,6580,1685,8265,0
2019/01,438,12/01/2019,6,SP 14 tra Colombare (bivio SP 14Ter) e bivio SP 258R,6489,20,6345,142,4889,1600,0,6489
2019/01,438,13/01/2019,7,SP 14 tra Colombare (bivio SP 14Ter) e bivio SP 258R,6093,00,6075,18,4730,1363,0,6093
2019/01,438,14/01/2019,1,SP 14 tra Colombare (bivio SP 14Ter) e bivio SP 258R,7687,00,7094,593,6322,1365,7687,0
2019/01,439,01/01/2019,2,SP 49 da Santarcangelo di Romagna alla località Posta (bivio SP 258R),7592,00,7561,31,4373,3219,0,7592
2019/01,439,02/01/2019,3,SP 49 da Santarcangelo di Romagna alla località Posta (bivio SP 258R),9633,00,9331,302,7751,1882,9633,0
2019/01,439,03/01/2019,4,SP 49 da Santarcangelo di Romagna alla località Posta (bivio SP 258R),10641,00,10238,403,8568,2073,10641,0
2019/01,439,04/01/2019,5,SP 49 da Santarcangelo di Romagna alla località Posta (bivio SP 258R),10745,00,10373,372,8349,2396,10745,0
2019/01,439,05/01/2019,6,SP 49 da Santarcangelo di Romagna alla località Posta (bivio SP 258R),10107,10,9963,143,7405,2702,0,10107
2019/01,439,06/01/2019,7,SP 49 da Santarcangelo di Romagna alla località Posta (bivio SP 258R),8441,00,8417,24,6233,2208,0,8441
2019/01,439,07/01/2019,1,SP 49 da Santarcangelo di Romagna alla località Posta (bivio SP 258R),11357,10,10656,700,9285,2072,11357,0
2019/01,439,08/01/2019,2,SP 49 da Santarcangelo di Romagna alla località Posta (bivio SP 258R),11779,10,11011,767,9550,2229,11779,0
2019/01,439,09/01/2019,3,SP 49 da Santarcangelo di Romagna alla località Posta (bivio SP 258R),11899,10,11141,757,9619,2280,11899,0
2019/01,439,10/01/2019,4,SP 49 da Santarcangelo di Romagna alla località Posta (bivio SP 258R),12005,10,11200,804,9665,2340,12005,0
2019/01,439,11/01/2019,5,SP 49 da Santarcangelo di Romagna alla località Posta (bivio SP 258R),12732,20,11947,783,10038,2694,12732,0
2019/01,439,12/01/2019,6,SP 49 da Santarcangelo di Romagna alla località Posta (bivio SP 258R),10967,00,10776,191,8139,2828,0,10967
2019/01,439,13/01/2019,7,SP 49 da Santarcangelo di Romagna alla località Posta (bivio SP 258R),8939,00,8909,30,6692,2247,0,8939
2019/01,439,14/01/2019,1,SP 49 da Santarcangelo di Romagna alla località Posta (bivio SP 258R),11746,10,11008,737,9490,2256,11746,0
2019/01,440,01/01/2019,2,SP 35 tra bivio SP 50 (località Cella) e Sant'Andrea in Casale,8798,00,8779,19,5171,3627,0,8798
2019/01,440,02/01/2019,3,SP 35 tra bivio SP 50 (località Cella) e Sant'Andrea in Casale,9942,00,9780,162,7701,2241,9942,0
2019/01,440,03/01/2019,4,SP 35 tra bivio SP 50 (località Cella) e Sant'Andrea in Casale,10568,00,10377,191,8174,2394,10568,0
2019/01,440,04/01/2019,5,SP 35 tra bivio SP 50 (località Cella) e Sant'Andrea in Casale,10658,00,10502,156,8005,2653,10658,0
2019/01,440,05/01/2019,6,SP 35 tra bivio SP 50 (località Cella) e Sant'Andrea in Casale,10267,00,10176,91,7254,3013,0,10267
2019/01,440,06/01/2019,7,SP 35 tra bivio SP 50 (località Cella) e Sant'Andrea in Casale,8482,20,8457,23,5894,2588,0,8482
2019/01,440,07/01/2019,1,SP 35 tra bivio SP 50 (località Cella) e Sant'Andrea in Casale,11361,00,11069,292,9174,2187,11361,0
2019/01,440,08/01/2019,2,SP 35 tra bivio SP 50 (località Cella) e Sant'Andrea in Casale,11356,00,11088,268,9170,2186,11356,0
2019/01,440,09/01/2019,3,SP 35 tra bivio SP 50 (località Cella) e Sant'Andrea in Casale,11669,00,11367,302,9347,2322,11669,0
2019/01,440,10/01/2019,4,SP 35 tra bivio SP 50 (località Cella) e Sant'Andrea in Casale,11814,00,11475,339,9413,2401,11814,0
2019/01,440,11/01/2019,5,SP 35 tra bivio SP 50 (località Cella) e Sant'Andrea in Casale,12451,10,12110,340,9746,2705,12451,0
2019/01,440,12/01/2019,6,SP 35 tra bivio SP 50 (località Cella) e Sant'Andrea in Casale,11435,00,11298,137,8391,3044,0,11435
2019/01,440,13/01/2019,7,SP 35 tra bivio SP 50 (località Cella) e Sant'Andrea in Casale,8958,00,8943,15,6333,2625,0,8958
2019/01,440,14/01/2019,1,SP 35 tra bivio SP 50 (località Cella) e Sant'Andrea in Casale,11942,00,11599,343,9580,2362,11942,0
2019/01,441,01/01/2019,2,SP 58 tra San Giovanni in Marignano e il confine regionale (Marche),5405,00,5389,16,3141,2264,0,5405
2019/01,441,02/01/2019,3,SP 58 tra San Giovanni in Marignano e il confine regionale (Marche),6457,00,6262,195,5001,1456,6457,0
2019/01,441,03/01/2019,4,SP 58 tra San Giovanni in Marignano e il confine regionale (Marche),6896,00,6708,188,5442,1454,6896,0
2019/01,441,04/01/2019,5,SP 58 tra San Giovanni in Marignano e il confine regionale (Marche),6313,00,6147,166,4805,1508,6313,0
2019/01,441,05/01/2019,6,SP 58 tra San Giovanni in Marignano e il confine regionale (Marche),7128,00,7038,90,5119,2009,0,7128
2019/01,441,06/01/2019,7,SP 58 tra San Giovanni in Marignano e il confine regionale (Marche),6161,00,6152,9,4313,1848,0,6161
2019/01,441,07/01/2019,1,SP 58 tra San Giovanni in Marignano e il confine regionale (Marche),8428,00,8078,350,6854,1574,8428,0
2019/01,441,08/01/2019,2,SP 58 tra San Giovanni in Marignano e il confine regionale (Marche),8303,00,7897,406,6754,1549,8303,0
2019/01,441,09/01/2019,3,SP 58 tra San Giovanni in Marignano e il confine regionale (Marche),8487,00,8069,418,6814,1673,8487,0
2019/01,441,10/01/2019,4,SP 58 tra San Giovanni in Marignano e il confine regionale (Marche),8580,00,8212,368,6861,1719,8580,0
2019/01,441,11/01/2019,5,SP 58 tra San Giovanni in Marignano e il confine regionale (Marche),9009,00,8609,400,7106,1903,9009,0
2019/01,441,12/01/2019,6,SP 58 tra San Giovanni in Marignano e il confine regionale (Marche),7705,00,7597,108,5692,2013,0,7705
2019/01,441,13/01/2019,7,SP 58 tra San Giovanni in Marignano e il confine regionale (Marche),6612,00,6601,11,4677,1935,0,6612
2019/01,441,14/01/2019,1,SP 58 tra San Giovanni in Marignano e il confine regionale (Marche),8580,00,8208,372,6882,1698,8580,0
2019/01,442,01/01/2019,2,SP 118 tra Casemurate (bivio SP 254R) e il confine provinciale,2275,00,2255,20,1409,866,0,2275
2019/01,442,02/01/2019,3,SP 118 tra Casemurate (bivio SP 254R) e il confine provinciale,2824,10,2646,177,2291,533,2824,0
2019/01,442,03/01/2019,4,SP 118 tra Casemurate (bivio SP 254R) e il confine provinciale,2960,00,2766,194,2371,589,2960,0
2019/01,442,04/01/2019,5,SP 118 tra Casemurate (bivio SP 254R) e il confine provinciale,3070,00,2860,210,2320,750,3070,0
2019/01,442,05/01/2019,6,SP 118 tra Casemurate (bivio SP 254R) e il confine provinciale,3032,00,2926,106,2229,803,0,3032
2019/01,442,06/01/2019,7,SP 118 tra Casemurate (bivio SP 254R) e il confine provinciale,2521,00,2482,39,1771,750,0,2521
2019/01,442,07/01/2019,1,SP 118 tra Casemurate (bivio SP 254R) e il confine provinciale,3331,10,3065,265,2677,654,3331,0
2019/01,442,08/01/2019,2,SP 118 tra Casemurate (bivio SP 254R) e il confine provinciale,3235,00,2940,295,2617,618,3235,0
2019/01,442,09/01/2019,3,SP 118 tra Casemurate (bivio SP 254R) e il confine provinciale,3430,00,3149,281,2766,664,3430,0
2019/01,442,10/01/2019,4,SP 118 tra Casemurate (bivio SP 254R) e il confine provinciale,3383,00,3128,255,2710,673,3383,0
2019/01,442,11/01/2019,5,SP 118 tra Casemurate (bivio SP 254R) e il confine provinciale,3616,00,3337,279,2801,815,3616,0
2019/01,442,12/01/2019,6,SP 118 tra Casemurate (bivio SP 254R) e il confine provinciale,3277,00,3179,98,2520,757,0,3277
2019/01,442,13/01/2019,7,SP 118 tra Casemurate (bivio SP 254R) e il confine provinciale,2531,00,2498,33,1747,784,0,2531
2019/01,442,14/01/2019,1,SP 118 tra Casemurate (bivio SP 254R) e il confine provinciale,3435,00,3145,290,2763,672,3435,0
2019/01,443,01/01/2019,2,SP 16 tra Faenza e il confine provinciale,4079,00,4054,25,2648,1431,0,4079
2019/01,443,02/01/2019,3,SP 16 tra Faenza e il confine provinciale,4769,00,4565,204,3791,978,4769,0
2019/01,443,03/01/2019,4,SP 16 tra Faenza e il confine provinciale,5001,20,4811,188,3949,1052,5001,0
2019/01,443,04/01/2019,5,SP 16 tra Faenza e il confine provinciale,5321,00,5088,233,4071,1250,5321,0
2019/01,443,05/01/2019,6,SP 16 tra Faenza e il confine provinciale,5042,20,4955,85,3729,1313,0,5042
2019/01,443,06/01/2019,7,SP 16 tra Faenza e il confine provinciale,4340,00,4320,20,3275,1065,0,4340
2019/01,443,07/01/2019,1,SP 16 tra Faenza e il confine provinciale,5104,00,4855,249,4128,976,5104,0
2019/01,443,08/01/2019,2,SP 16 tra Faenza e il confine provinciale,5282,00,5044,238,4342,940,5282,0
2019/01,443,09/01/2019,3,SP 16 tra Faenza e il confine provinciale,5270,00,5004,266,4246,1024,5270,0
2019/01,443,10/01/2019,4,SP 16 tra Faenza e il confine provinciale,5394,00,5137,257,4325,1069,5394,0
2019/01,443,11/01/2019,5,SP 16 tra Faenza e il confine provinciale,5624,00,5345,279,4420,1204,5624,0
2019/01,443,12/01/2019,6,SP 16 tra Faenza e il confine provinciale,5281,00,5184,97,4106,1175,0,5281
2019/01,443,13/01/2019,7,SP 16 tra Faenza e il confine provinciale,4569,00,4546,23,3561,1008,0,4569
2019/01,443,14/01/2019,1,SP 16 tra Faenza e il confine provinciale,5322,00,5067,255,4281,1041,5322,0
2019/01,444,01/01/2019,2,SP 5 fra Russi e San Pancrazio,3244,00,3236,8,2071,1173,0,3244
2019/01,444,02/01/2019,3,SP 5 fra Russi e San Pancrazio,4437,00,4319,118,3657,780,4437,0
2019/01,444,03/01/2019,4,SP 5 fra Russi e San Pancrazio,4677,10,4557,119,3763,914,4677,0
2019/01,444,04/01/2019,5,SP 5 fra Russi e San Pancrazio,4850,00,4715,135,3961,889,4850,0
2019/01,444,05/01/2019,6,SP 5 fra Russi e San Pancrazio,4385,00,4318,67,3371,1014,0,4385
2019/01,444,06/01/2019,7,SP 5 fra Russi e San Pancrazio,3783,00,3771,12,2968,815,0,3783
2019/01,444,07/01/2019,1,SP 5 fra Russi e San Pancrazio,5406,00,5211,195,4466,940,5406,0
2019/01,444,08/01/2019,2,SP 5 fra Russi e San Pancrazio,5621,00,5365,256,4665,956,5621,0
2019/01,444,09/01/2019,3,SP 5 fra Russi e San Pancrazio,5534,00,5202,332,4533,1001,5534,0
2019/01,444,10/01/2019,4,SP 5 fra Russi e San Pancrazio,5584,00,5329,255,4566,1018,5584,0
2019/01,444,11/01/2019,5,SP 5 fra Russi e San Pancrazio,5798,10,5558,239,4721,1077,5798,0
2019/01,444,12/01/2019,6,SP 5 fra Russi e San Pancrazio,4846,20,4781,63,3839,1007,0,4846
2019/01,444,13/01/2019,7,SP 5 fra Russi e San Pancrazio,3542,00,3532,10,2658,884,0,3542
2019/01,444,14/01/2019,1,SP 5 fra Russi e San Pancrazio,5653,00,5363,290,4623,1030,5653,0
2019/01,445,01/01/2019,2,SP 610R fra SP 253R e Conselice,3062,00,3032,30,1722,1340,0,3062
2019/01,445,02/01/2019,3,SP 610R fra SP 253R e Conselice,4366,10,3931,434,3478,888,4366,0
2019/01,445,03/01/2019,4,SP 610R fra SP 253R e Conselice,4578,00,4071,507,3572,1006,4578,0
2019/01,445,04/01/2019,5,SP 610R fra SP 253R e Conselice,4602,00,4137,465,3608,994,4602,0
2019/01,445,05/01/2019,6,SP 610R fra SP 253R e Conselice,3953,00,3827,126,2961,992,0,3953
2019/01,445,06/01/2019,7,SP 610R fra SP 253R e Conselice,3660,00,3625,35,2723,937,0,3660
2019/01,445,07/01/2019,1,SP 610R fra SP 253R e Conselice,5257,00,4531,726,4224,1033,5257,0
2019/01,445,08/01/2019,2,SP 610R fra SP 253R e Conselice,5310,00,4588,722,4248,1062,5310,0
2019/01,445,09/01/2019,3,SP 610R fra SP 253R e Conselice,5442,00,4679,763,4325,1117,5442,0
2019/01,445,10/01/2019,4,SP 610R fra SP 253R e Conselice,5534,10,4823,710,4377,1157,5534,0
2019/01,445,11/01/2019,5,SP 610R fra SP 253R e Conselice,5626,00,4843,783,4400,1226,5626,0
2019/01,445,12/01/2019,6,SP 610R fra SP 253R e Conselice,4389,00,4243,146,3225,1164,0,4389
2019/01,445,13/01/2019,7,SP 610R fra SP 253R e Conselice,3898,00,3864,34,2877,1021,0,3898
2019/01,445,14/01/2019,1,SP 610R fra SP 253R e Conselice,5429,00,4615,814,4345,1084,5429,0
2019/01,446,01/01/2019,2,SP 13 in località Santa Maria di Fabriago,4644,00,4628,16,2685,1959,0,4644
2019/01,446,02/01/2019,3,SP 13 in località Santa Maria di Fabriago,7282,00,6946,336,5946,1336,7282,0
2019/01,446,03/01/2019,4,SP 13 in località Santa Maria di Fabriago,7253,00,6879,374,5814,1439,7253,0
2019/01,446,04/01/2019,5,SP 13 in località Santa Maria di Fabriago,7506,00,7095,411,5877,1629,7506,0
2019/01,446,05/01/2019,6,SP 13 in località Santa Maria di Fabriago,6366,00,6132,234,4658,1708,0,6366
2019/01,446,06/01/2019,7,SP 13 in località Santa Maria di Fabriago,5138,00,4888,250,3731,1407,0,5138
2019/01,446,07/01/2019,1,SP 13 in località Santa Maria di Fabriago,8050,00,7401,649,6542,1508,8050,0
2019/01,446,08/01/2019,2,SP 13 in località Santa Maria di Fabriago,8654,00,7756,898,7228,1426,8654,0
2019/01,446,09/01/2019,3,SP 13 in località Santa Maria di Fabriago,8290,00,7780,510,6751,1539,8290,0
2019/01,446,10/01/2019,4,SP 13 in località Santa Maria di Fabriago,8774,10,8150,623,7026,1748,8774,0
2019/01,446,11/01/2019,5,SP 13 in località Santa Maria di Fabriago,9317,00,8707,610,7389,1928,9317,0
2019/01,446,12/01/2019,6,SP 13 in località Santa Maria di Fabriago,7418,00,7260,158,5512,1906,0,7418
2019/01,446,13/01/2019,7,SP 13 in località Santa Maria di Fabriago,5305,00,5279,26,3794,1511,0,5305
2019/01,446,14/01/2019,1,SP 13 in località Santa Maria di Fabriago,8868,00,8143,725,7190,1678,8868,0
2019/01,448,01/01/2019,2,SP 5 fra Reggiolo e intersezione SP 45 per Fabbrico,4016,00,3989,27,2387,1629,0,4016
2019/01,448,02/01/2019,3,SP 5 fra Reggiolo e intersezione SP 45 per Fabbrico,5160,00,4837,323,4068,1092,5160,0
2019/01,448,03/01/2019,4,SP 5 fra Reggiolo e intersezione SP 45 per Fabbrico,5806,00,5437,369,4562,1244,5806,0
2019/01,448,04/01/2019,5,SP 5 fra Reggiolo e intersezione SP 45 per Fabbrico,5976,00,5587,389,4505,1471,5976,0
2019/01,448,05/01/2019,6,SP 5 fra Reggiolo e intersezione SP 45 per Fabbrico,5774,00,5624,150,4073,1701,0,5774
2019/01,448,06/01/2019,7,SP 5 fra Reggiolo e intersezione SP 45 per Fabbrico,5505,00,5475,30,4049,1456,0,5505
2019/01,448,07/01/2019,1,SP 5 fra Reggiolo e intersezione SP 45 per Fabbrico,6708,00,6055,653,5420,1288,6708,0
2019/01,448,08/01/2019,2,SP 5 fra Reggiolo e intersezione SP 45 per Fabbrico,6929,00,6224,705,5655,1274,6929,0
2019/01,448,09/01/2019,3,SP 5 fra Reggiolo e intersezione SP 45 per Fabbrico,7131,00,6441,690,5669,1462,7131,0
2019/01,448,10/01/2019,4,SP 5 fra Reggiolo e intersezione SP 45 per Fabbrico,7226,00,6457,769,5727,1499,7226,0
2019/01,448,11/01/2019,5,SP 5 fra Reggiolo e intersezione SP 45 per Fabbrico,7496,00,6802,694,5768,1728,7496,0
2019/01,448,12/01/2019,6,SP 5 fra Reggiolo e intersezione SP 45 per Fabbrico,6241,00,6108,133,4388,1853,0,6241
2019/01,448,13/01/2019,7,SP 5 fra Reggiolo e intersezione SP 45 per Fabbrico,5105,00,5078,27,3574,1531,0,5105
2019/01,448,14/01/2019,1,SP 5 fra Reggiolo e intersezione SP 45 per Fabbrico,7126,00,6453,673,5774,1352,7126,0
2019/01,449,01/01/2019,2,SP 111 fra via Emilia e la variante Asse Val d'Enza,4780,00,4692,88,2929,1851,0,4780
2019/01,449,02/01/2019,3,SP 111 fra via Emilia e la variante Asse Val d'Enza,7783,10,6898,884,6215,1568,7783,0
2019/01,449,03/01/2019,4,SP 111 fra via Emilia e la variante Asse Val d'Enza,8779,10,7669,1109,7026,1753,8779,0
2019/01,449,04/01/2019,5,SP 111 fra via Emilia e la variante Asse Val d'Enza,9126,00,7983,1143,7137,1989,9126,0
2019/01,449,05/01/2019,6,SP 111 fra via Emilia e la variante Asse Val d'Enza,7485,00,7148,337,5519,1966,0,7485
2019/01,449,06/01/2019,7,SP 111 fra via Emilia e la variante Asse Val d'Enza,6386,00,6266,120,4707,1679,0,6386
2019/01,449,07/01/2019,1,SP 111 fra via Emilia e la variante Asse Val d'Enza,10613,00,8933,1680,8613,2000,10613,0
2019/01,449,08/01/2019,2,SP 111 fra via Emilia e la variante Asse Val d'Enza,10872,10,8978,1893,8815,2057,10872,0
2019/01,449,09/01/2019,3,SP 111 fra via Emilia e la variante Asse Val d'Enza,11585,10,9651,1933,9436,2149,11585,0
2019/01,449,10/01/2019,4,SP 111 fra via Emilia e la variante Asse Val d'Enza,11838,10,9741,2096,9592,2246,11838,0
2019/01,449,11/01/2019,5,SP 111 fra via Emilia e la variante Asse Val d'Enza,12241,00,10212,2029,9712,2529,12241,0
2019/01,449,12/01/2019,6,SP 111 fra via Emilia e la variante Asse Val d'Enza,7922,00,7534,388,5764,2158,0,7922
2019/01,449,13/01/2019,7,SP 111 fra via Emilia e la variante Asse Val d'Enza,7032,00,6890,142,5115,1917,0,7032
2019/01,449,14/01/2019,1,SP 111 fra via Emilia e la variante Asse Val d'Enza,12253,00,10076,2177,10080,2173,12253,0
2019/01,450,01/01/2019,2,SP 35 sul Ponte Po,3315,00,3307,8,1860,1455,0,3315
2019/01,450,02/01/2019,3,SP 35 sul Ponte Po,5378,10,4999,378,4321,1057,5378,0
2019/01,450,03/01/2019,4,SP 35 sul Ponte Po,6168,00,5710,458,4959,1209,6168,0
2019/01,450,04/01/2019,5,SP 35 sul Ponte Po,6779,10,6302,476,5266,1513,6779,0
2019/01,450,05/01/2019,6,SP 35 sul Ponte Po,6013,10,5901,111,4331,1682,0,6013
2019/01,450,06/01/2019,7,SP 35 sul Ponte Po,5153,00,5116,37,3648,1505,0,5153
2019/01,450,07/01/2019,1,SP 35 sul Ponte Po,7566,30,6798,765,6196,1370,7566,0
2019/01,450,08/01/2019,2,SP 35 sul Ponte Po,7441,20,6592,847,6083,1358,7441,0
2019/01,450,09/01/2019,3,SP 35 sul Ponte Po,8053,30,7191,859,6470,1583,8053,0
2019/01,450,10/01/2019,4,SP 35 sul Ponte Po,8239,40,7339,896,6658,1581,8239,0
2019/01,450,11/01/2019,5,SP 35 sul Ponte Po,8959,20,8064,893,6939,2020,8959,0
2019/01,450,12/01/2019,6,SP 35 sul Ponte Po,7182,00,7022,160,5201,1981,0,7182
2019/01,450,13/01/2019,7,SP 35 sul Ponte Po,5137,00,5105,32,3581,1556,0,5137
2019/01,450,14/01/2019,1,SP 35 sul Ponte Po,8362,20,7408,952,6899,1463,8362,0
2019/01,452,12/01/2019,6,SP 3 sulla variante tra Bagnolo in Piano e il casello A 1 di Reggio Emilia,8933,00,8777,156,6313,2620,0,8933
2019/01,452,13/01/2019,7,SP 3 sulla variante tra Bagnolo in Piano e il casello A 1 di Reggio Emilia,7751,00,7714,37,5297,2454,0,7751
2019/01,452,14/01/2019,1,SP 3 sulla variante tra Bagnolo in Piano e il casello A 1 di Reggio Emilia,12011,00,10748,1263,9700,2311,12011,0
2019/01,453,01/01/2019,2,Asse viario Modena-Sassuolo tra Modena e Baggiovara,20425,00,20331,94,11319,9106,0,20425
2019/01,453,02/01/2019,3,Asse viario Modena-Sassuolo tra Modena e Baggiovara,36605,00,34709,1896,28734,7871,36605,0
2019/01,453,03/01/2019,4,Asse viario Modena-Sassuolo tra Modena e Baggiovara,39714,00,37255,2459,31245,8469,39714,0
2019/01,453,04/01/2019,5,Asse viario Modena-Sassuolo tra Modena e Baggiovara,41070,20,38534,2534,31529,9541,41070,0
2019/01,453,05/01/2019,6,Asse viario Modena-Sassuolo tra Modena e Baggiovara,37078,10,36456,621,26289,10789,0,37078
2019/01,453,06/01/2019,7,Asse viario Modena-Sassuolo tra Modena e Baggiovara,31425,00,31270,155,21858,9567,0,31425
2019/01,453,07/01/2019,1,Asse viario Modena-Sassuolo tra Modena e Baggiovara,49396,30,45242,4151,39973,9423,49396,0
2019/01,453,08/01/2019,2,Asse viario Modena-Sassuolo tra Modena e Baggiovara,50214,50,45240,4969,40618,9596,50214,0
2019/01,453,09/01/2019,3,Asse viario Modena-Sassuolo tra Modena e Baggiovara,51633,00,46376,5257,41256,10377,51633,0
2019/01,453,10/01/2019,4,Asse viario Modena-Sassuolo tra Modena e Baggiovara,52611,100,47204,5397,41571,11040,52611,0
2019/01,453,11/01/2019,5,Asse viario Modena-Sassuolo tra Modena e Baggiovara,55072,10,49851,5220,42842,12230,55072,0
2019/01,453,12/01/2019,6,Asse viario Modena-Sassuolo tra Modena e Baggiovara,42468,00,41726,742,30394,12074,0,42468
2019/01,453,13/01/2019,7,Asse viario Modena-Sassuolo tra Modena e Baggiovara,34430,10,34247,182,24090,10340,0,34430
2019/01,453,14/01/2019,1,Asse viario Modena-Sassuolo tra Modena e Baggiovara,52090,10,47051,5038,41817,10273,52090,0
2019/01,502,01/01/2019,2,SP 26 tra località Pioppa e viadotto A 1 (c/o Zola Predosa),4360,00,4332,28,2758,1602,0,4360
2019/01,502,02/01/2019,3,SP 26 tra località Pioppa e viadotto A 1 (c/o Zola Predosa),9272,00,8883,389,7811,1461,9272,0
2019/01,502,03/01/2019,4,SP 26 tra località Pioppa e viadotto A 1 (c/o Zola Predosa),10579,00,10071,508,8863,1716,10579,0
2019/01,502,04/01/2019,5,SP 26 tra località Pioppa e viadotto A 1 (c/o Zola Predosa),11086,00,10592,494,9065,2021,11086,0
2019/01,502,05/01/2019,6,SP 26 tra località Pioppa e viadotto A 1 (c/o Zola Predosa),8391,00,8278,113,6410,1981,0,8391
2019/01,502,06/01/2019,7,SP 26 tra località Pioppa e viadotto A 1 (c/o Zola Predosa),6699,00,6653,46,5086,1613,0,6699
2019/01,502,07/01/2019,1,SP 26 tra località Pioppa e viadotto A 1 (c/o Zola Predosa),12961,00,12084,877,11038,1923,12961,0
2019/01,502,08/01/2019,2,SP 26 tra località Pioppa e viadotto A 1 (c/o Zola Predosa),12871,10,11992,878,10902,1969,12871,0
2019/01,502,09/01/2019,3,SP 26 tra località Pioppa e viadotto A 1 (c/o Zola Predosa),13408,10,12432,975,11236,2172,13408,0
2019/01,502,10/01/2019,4,SP 26 tra località Pioppa e viadotto A 1 (c/o Zola Predosa),13797,20,12841,954,11538,2259,13797,0
2019/01,502,11/01/2019,5,SP 26 tra località Pioppa e viadotto A 1 (c/o Zola Predosa),14017,00,13080,937,11454,2563,14017,0
2019/01,502,12/01/2019,6,SP 26 tra località Pioppa e viadotto A 1 (c/o Zola Predosa),9436,00,9291,145,7206,2230,0,9436
2019/01,502,13/01/2019,7,SP 26 tra località Pioppa e viadotto A 1 (c/o Zola Predosa),7356,00,7317,39,5662,1694,0,7356
2019/01,502,14/01/2019,1,SP 26 tra località Pioppa e viadotto A 1 (c/o Zola Predosa),13595,10,12602,992,11484,2111,13595,0
2019/01,504,01/01/2019,2,SP 7 dalla località Ca de' Mandorli al bivio per Castel de Britti,6493,00,6467,26,4062,2431,0,6493
2019/01,504,02/01/2019,3,SP 7 dalla località Ca de' Mandorli al bivio per Castel de Britti,8779,00,8570,209,7003,1776,8779,0
2019/01,504,03/01/2019,4,SP 7 dalla località Ca de' Mandorli al bivio per Castel de Britti,9410,10,9189,220,7536,1874,9410,0
2019/01,504,04/01/2019,5,SP 7 dalla località Ca de' Mandorli al bivio per Castel de Britti,9590,00,9360,230,7488,2102,9590,0
2019/01,504,05/01/2019,6,SP 7 dalla località Ca de' Mandorli al bivio per Castel de Britti,9029,00,8925,104,6835,2194,0,9029
2019/01,504,06/01/2019,7,SP 7 dalla località Ca de' Mandorli al bivio per Castel de Britti,7759,00,7731,28,5922,1837,0,7759
2019/01,504,07/01/2019,1,SP 7 dalla località Ca de' Mandorli al bivio per Castel de Britti,10738,00,10456,282,8511,2227,10738,0
2019/01,504,08/01/2019,2,SP 7 dalla località Ca de' Mandorli al bivio per Castel de Britti,10796,10,10449,346,8530,2266,10796,0
2019/01,504,09/01/2019,3,SP 7 dalla località Ca de' Mandorli al bivio per Castel de Britti,10996,00,10644,352,8668,2328,10996,0
2019/01,504,10/01/2019,4,SP 7 dalla località Ca de' Mandorli al bivio per Castel de Britti,10965,10,10608,356,8520,2445,10965,0
2019/01,504,11/01/2019,5,SP 7 dalla località Ca de' Mandorli al bivio per Castel de Britti,11489,00,11096,393,8961,2528,11489,0
2019/01,504,12/01/2019,6,SP 7 dalla località Ca de' Mandorli al bivio per Castel de Britti,10056,00,9920,136,7620,2436,0,10056
2019/01,504,13/01/2019,7,SP 7 dalla località Ca de' Mandorli al bivio per Castel de Britti,7860,00,7830,30,5935,1925,0,7860
2019/01,504,14/01/2019,1,SP 7 dalla località Ca de' Mandorli al bivio per Castel de Britti,10903,00,10517,386,8551,2352,10903,0
2019/01,505,01/01/2019,2,SP 610 tra casello A 1 (Imola) e bivio SP 51 per Castel Guelfo di Bologna,6412,00,6323,89,3499,2913,0,6412
2019/01,505,02/01/2019,3,SP 610 tra casello A 1 (Imola) e bivio SP 51 per Castel Guelfo di Bologna,10671,00,9541,1130,8511,2160,10671,0
2019/01,505,03/01/2019,4,SP 610 tra casello A 1 (Imola) e bivio SP 51 per Castel Guelfo di Bologna,10709,00,9401,1308,8419,2290,10709,0
2019/01,505,04/01/2019,5,SP 610 tra casello A 1 (Imola) e bivio SP 51 per Castel Guelfo di Bologna,10998,00,9671,1327,8469,2529,10998,0
2019/01,505,05/01/2019,6,SP 610 tra casello A 1 (Imola) e bivio SP 51 per Castel Guelfo di Bologna,8792,00,8498,294,6341,2451,0,8792
2019/01,505,06/01/2019,7,SP 610 tra casello A 1 (Imola) e bivio SP 51 per Castel Guelfo di Bologna,7752,00,7617,135,5661,2091,0,7752
2019/01,505,07/01/2019,1,SP 610 tra casello A 1 (Imola) e bivio SP 51 per Castel Guelfo di Bologna,12315,00,10418,1897,9853,2462,12315,0
2019/01,505,08/01/2019,2,SP 610 tra casello A 1 (Imola) e bivio SP 51 per Castel Guelfo di Bologna,13225,00,11141,2084,10509,2716,13225,0
2019/01,505,09/01/2019,3,SP 610 tra casello A 1 (Imola) e bivio SP 51 per Castel Guelfo di Bologna,13445,00,11336,2109,10397,3048,13445,0
2019/01,505,10/01/2019,4,SP 610 tra casello A 1 (Imola) e bivio SP 51 per Castel Guelfo di Bologna,13311,40,11147,2160,10463,2848,13311,0
2019/01,505,11/01/2019,5,SP 610 tra casello A 1 (Imola) e bivio SP 51 per Castel Guelfo di Bologna,13436,20,11343,2091,10434,3002,13436,0
2019/01,505,12/01/2019,6,SP 610 tra casello A 1 (Imola) e bivio SP 51 per Castel Guelfo di Bologna,10253,00,9874,379,7334,2919,0,10253
2019/01,505,13/01/2019,7,SP 610 tra casello A 1 (Imola) e bivio SP 51 per Castel Guelfo di Bologna,8349,00,8217,132,5825,2524,0,8349
2019/01,505,14/01/2019,1,SP 610 tra casello A 1 (Imola) e bivio SP 51 per Castel Guelfo di Bologna,13091,10,10871,2219,10423,2668,13091,0
2019/01,600,01/01/2019,2,SP 19 tra SP31 e Medicina,3087,30,3068,16,2006,1081,0,3087
2019/01,600,02/01/2019,3,SP 19 tra SP31 e Medicina,6006,00,5604,402,5032,974,6006,0
2019/01,600,03/01/2019,4,SP 19 tra SP31 e Medicina,4419,00,4097,322,3488,931,4419,0
2019/01,600,04/01/2019,5,SP 19 tra SP31 e Medicina,4148,00,3902,246,3093,1055,4148,0
2019/01,600,05/01/2019,6,SP 19 tra SP31 e Medicina,4827,10,4756,70,3565,1262,0,4827
2019/01,600,06/01/2019,7,SP 19 tra SP31 e Medicina,4957,00,4944,13,3864,1093,0,4957
2019/01,600,07/01/2019,1,SP 19 tra SP31 e Medicina,4755,00,4361,394,3734,1021,4755,0
2019/01,600,08/01/2019,2,SP 19 tra SP31 e Medicina,1578,10,1406,171,1305,273,1578,0
2019/01,600,10/01/2019,4,SP 19 tra SP31 e Medicina,4436,10,4054,381,3436,1000,4436,0
2019/01,600,11/01/2019,5,SP 19 tra SP31 e Medicina,6077,10,5514,562,4545,1532,6077,0
2019/01,600,12/01/2019,6,SP 19 tra SP31 e Medicina,4588,00,4515,73,3307,1281,0,4588
2019/01,600,13/01/2019,7,SP 19 tra SP31 e Medicina,5979,00,5964,15,4715,1264,0,5979
2019/01,600,14/01/2019,1,SP 19 tra SP31 e Medicina,7467,10,6646,820,6187,1280,7467,0
2019/01,601,01/01/2019,2,SP 21 da Castel San Pietro al bivio SP 35 (c/o Sassoleone),2478,00,2462,16,1578,900,0,2478
2019/01,601,02/01/2019,3,SP 21 da Castel San Pietro al bivio SP 35 (c/o Sassoleone),2891,10,2845,45,2353,538,2891,0
2019/01,601,03/01/2019,4,SP 21 da Castel San Pietro al bivio SP 35 (c/o Sassoleone),3002,00,2950,52,2392,610,3002,0
2019/01,601,04/01/2019,5,SP 21 da Castel San Pietro al bivio SP 35 (c/o Sassoleone),3049,00,3004,45,2360,689,3049,0
2019/01,601,05/01/2019,6,SP 21 da Castel San Pietro al bivio SP 35 (c/o Sassoleone),3315,00,3284,31,2473,842,0,3315
2019/01,601,06/01/2019,7,SP 21 da Castel San Pietro al bivio SP 35 (c/o Sassoleone),2826,00,2811,15,2179,647,0,2826
2019/01,601,07/01/2019,1,SP 21 da Castel San Pietro al bivio SP 35 (c/o Sassoleone),2963,00,2886,77,2377,586,2963,0
2019/01,601,08/01/2019,2,SP 21 da Castel San Pietro al bivio SP 35 (c/o Sassoleone),2900,10,2810,89,2344,556,2900,0
2019/01,601,09/01/2019,3,SP 21 da Castel San Pietro al bivio SP 35 (c/o Sassoleone),3106,10,3025,80,2450,656,3106,0
2019/01,601,10/01/2019,4,SP 21 da Castel San Pietro al bivio SP 35 (c/o Sassoleone),2938,00,2873,65,2326,612,2938,0
2019/01,601,11/01/2019,5,SP 21 da Castel San Pietro al bivio SP 35 (c/o Sassoleone),3223,00,3136,87,2449,774,3223,0
2019/01,601,12/01/2019,6,SP 21 da Castel San Pietro al bivio SP 35 (c/o Sassoleone),3511,10,3475,35,2691,820,0,3511
2019/01,601,13/01/2019,7,SP 21 da Castel San Pietro al bivio SP 35 (c/o Sassoleone),2976,10,2957,18,2295,681,0,2976
2019/01,601,14/01/2019,1,SP 21 da Castel San Pietro al bivio SP 35 (c/o Sassoleone),2945,00,2881,64,2355,590,2945,0
2019/01,602,01/01/2019,2,SP 9_1 da Crevalcore alla località Caselle,880,00,877,3,560,320,0,880
2019/01,602,02/01/2019,3,SP 9_1 da Crevalcore alla località Caselle,1139,00,1099,40,925,214,1139,0
2019/01,602,03/01/2019,4,SP 9_1 da Crevalcore alla località Caselle,1243,00,1207,36,1024,219,1243,0
2019/01,602,04/01/2019,5,SP 9_1 da Crevalcore alla località Caselle,1386,00,1352,34,1081,305,1386,0
2019/01,602,05/01/2019,6,SP 9_1 da Crevalcore alla località Caselle,1201,00,1187,14,927,274,0,1201
2019/01,602,06/01/2019,7,SP 9_1 da Crevalcore alla località Caselle,1060,00,1057,3,807,253,0,1060
2019/01,602,07/01/2019,1,SP 9_1 da Crevalcore alla località Caselle,1546,00,1485,61,1286,260,1546,0
2019/01,602,08/01/2019,2,SP 9_1 da Crevalcore alla località Caselle,1428,00,1373,55,1208,220,1428,0
2019/01,602,09/01/2019,3,SP 9_1 da Crevalcore alla località Caselle,1509,00,1445,64,1244,265,1509,0
2019/01,602,10/01/2019,4,SP 9_1 da Crevalcore alla località Caselle,1513,00,1455,58,1216,297,1513,0
2019/01,602,11/01/2019,5,SP 9_1 da Crevalcore alla località Caselle,1649,10,1583,65,1303,346,1649,0
2019/01,602,12/01/2019,6,SP 9_1 da Crevalcore alla località Caselle,1437,00,1400,37,1118,319,0,1437
2019/01,602,13/01/2019,7,SP 9_1 da Crevalcore alla località Caselle,1269,00,1265,4,974,295,0,1269
2019/01,602,14/01/2019,1,SP 9_1 da Crevalcore alla località Caselle,1556,00,1482,74,1268,288,1556,0
2019/01,603,01/01/2019,2,SP 10 dalla località Decima ai confini provinciali di Bologna e Ferrara,1999,00,1997,2,1243,756,0,1999
2019/01,603,02/01/2019,3,SP 10 dalla località Decima ai confini provinciali di Bologna e Ferrara,2727,00,2654,73,2105,622,2727,0
2019/01,603,03/01/2019,4,SP 10 dalla località Decima ai confini provinciali di Bologna e Ferrara,3008,00,2914,94,2267,741,3008,0
2019/01,603,04/01/2019,5,SP 10 dalla località Decima ai confini provinciali di Bologna e Ferrara,3296,00,3206,90,2456,840,3296,0
2019/01,603,05/01/2019,6,SP 10 dalla località Decima ai confini provinciali di Bologna e Ferrara,2899,00,2864,35,2019,880,0,2899
2019/01,603,06/01/2019,7,SP 10 dalla località Decima ai confini provinciali di Bologna e Ferrara,2516,00,2502,14,1734,782,0,2516
2019/01,603,07/01/2019,1,SP 10 dalla località Decima ai confini provinciali di Bologna e Ferrara,3579,00,3436,143,2761,818,3579,0
2019/01,603,08/01/2019,2,SP 10 dalla località Decima ai confini provinciali di Bologna e Ferrara,3481,00,3334,147,2717,764,3481,0
2019/01,603,09/01/2019,3,SP 10 dalla località Decima ai confini provinciali di Bologna e Ferrara,3710,00,3569,141,2856,854,3710,0
2019/01,603,10/01/2019,4,SP 10 dalla località Decima ai confini provinciali di Bologna e Ferrara,3864,00,3684,180,2956,908,3864,0
2019/01,603,11/01/2019,5,SP 10 dalla località Decima ai confini provinciali di Bologna e Ferrara,4098,00,3966,132,3054,1044,4098,0
2019/01,603,12/01/2019,6,SP 10 dalla località Decima ai confini provinciali di Bologna e Ferrara,3155,00,3091,64,2273,882,0,3155
2019/01,603,13/01/2019,7,SP 10 dalla località Decima ai confini provinciali di Bologna e Ferrara,2538,00,2531,7,1733,805,0,2538
2019/01,603,14/01/2019,1,SP 10 dalla località Decima ai confini provinciali di Bologna e Ferrara,3889,00,3733,156,2979,910,3889,0
2019/01,604,01/01/2019,2,SP 37 da Sasso Marconi alla intersezione SP 58,2526,00,2521,5,1728,798,0,2526
2019/01,604,02/01/2019,3,SP 37 da Sasso Marconi alla intersezione SP 58,3221,00,3159,62,2675,546,3221,0
2019/01,604,03/01/2019,4,SP 37 da Sasso Marconi alla intersezione SP 58,3495,00,3430,65,2932,563,3495,0
2019/01,604,04/01/2019,5,SP 37 da Sasso Marconi alla intersezione SP 58,3682,00,3597,85,3072,610,3682,0
2019/01,604,05/01/2019,6,SP 37 da Sasso Marconi alla intersezione SP 58,3271,10,3242,28,2592,679,0,3271
2019/01,604,06/01/2019,7,SP 37 da Sasso Marconi alla intersezione SP 58,3044,00,3037,7,2446,598,0,3044
2019/01,604,07/01/2019,1,SP 37 da Sasso Marconi alla intersezione SP 58,4555,10,4379,175,3877,678,4555,0
2019/01,604,08/01/2019,2,SP 37 da Sasso Marconi alla intersezione SP 58,4506,00,4290,216,3809,697,4506,0
2019/01,604,09/01/2019,3,SP 37 da Sasso Marconi alla intersezione SP 58,4680,10,4451,228,3973,707,4680,0
2019/01,604,10/01/2019,4,SP 37 da Sasso Marconi alla intersezione SP 58,4855,00,4651,204,4124,731,4855,0
2019/01,604,11/01/2019,5,SP 37 da Sasso Marconi alla intersezione SP 58,5168,20,4939,227,4299,869,5168,0
2019/01,604,12/01/2019,6,SP 37 da Sasso Marconi alla intersezione SP 58,3733,00,3700,33,2955,778,0,3733
2019/01,604,13/01/2019,7,SP 37 da Sasso Marconi alla intersezione SP 58,3144,00,3139,5,2494,650,0,3144
2019/01,604,14/01/2019,1,SP 37 da Sasso Marconi alla intersezione SP 58,4789,10,4594,194,4053,736,4789,0
2019/01,605,01/01/2019,2,SP 324 da Silla alla intersezione SP 623,5497,00,5475,22,3969,1528,0,5497
2019/01,605,02/01/2019,3,SP 324 da Silla alla intersezione SP 623,6943,00,6765,178,5809,1134,6943,0
2019/01,605,03/01/2019,4,SP 324 da Silla alla intersezione SP 623,6518,00,6312,206,5418,1100,6518,0
2019/01,605,04/01/2019,5,SP 324 da Silla alla intersezione SP 623,6887,00,6663,224,5554,1333,6887,0
2019/01,605,05/01/2019,6,SP 324 da Silla alla intersezione SP 623,6682,00,6584,98,5112,1570,0,6682
2019/01,605,06/01/2019,7,SP 324 da Silla alla intersezione SP 623,5259,00,5225,34,3904,1355,0,5259
2019/01,605,07/01/2019,1,SP 324 da Silla alla intersezione SP 623,7019,10,6711,307,5837,1182,7019,0
2019/01,605,08/01/2019,2,SP 324 da Silla alla intersezione SP 623,7122,00,6817,305,5895,1227,7122,0
2019/01,605,09/01/2019,3,SP 324 da Silla alla intersezione SP 623,7155,00,6839,316,5893,1262,7155,0
2019/01,605,10/01/2019,4,SP 324 da Silla alla intersezione SP 623,6952,00,6643,309,5690,1262,6952,0
2019/01,605,11/01/2019,5,SP 324 da Silla alla intersezione SP 623,7747,00,7420,327,6195,1552,7747,0
2019/01,605,12/01/2019,6,SP 324 da Silla alla intersezione SP 623,6214,00,6116,98,4760,1454,0,6214
2019/01,605,13/01/2019,7,SP 324 da Silla alla intersezione SP 623,5081,00,5038,43,3986,1095,0,5081
2019/01,605,14/01/2019,1,SP 324 da Silla alla intersezione SP 623,7264,00,6951,313,5993,1271,7264,0
2019/01,606,01/01/2019,2,SP 70 Cispadana in località Sant'Agostino/San Carlo,2173,00,2171,2,1386,787,0,2173
2019/01,606,02/01/2019,3,SP 70 Cispadana in località Sant'Agostino/San Carlo,4180,00,4005,175,3454,726,4180,0
2019/01,606,03/01/2019,4,SP 70 Cispadana in località Sant'Agostino/San Carlo,3208,00,3014,194,2419,789,3208,0
2019/01,606,04/01/2019,5,SP 70 Cispadana in località Sant'Agostino/San Carlo,4334,20,4131,201,3404,930,4334,0
2019/01,606,05/01/2019,6,SP 70 Cispadana in località Sant'Agostino/San Carlo,3735,10,3670,64,2689,1046,0,3735
2019/01,606,06/01/2019,7,SP 70 Cispadana in località Sant'Agostino/San Carlo,3224,30,3210,11,2304,920,0,3224
2019/01,606,07/01/2019,1,SP 70 Cispadana in località Sant'Agostino/San Carlo,4454,30,4201,250,3570,884,4454,0
2019/01,606,09/01/2019,3,SP 70 Cispadana in località Sant'Agostino/San Carlo,5470,00,5059,411,4572,898,5470,0
2019/01,606,10/01/2019,4,SP 70 Cispadana in località Sant'Agostino/San Carlo,5369,50,4992,372,4366,1003,5369,0
2019/01,606,11/01/2019,5,SP 70 Cispadana in località Sant'Agostino/San Carlo,5640,00,5239,401,4493,1147,5640,0
2019/01,606,12/01/2019,6,SP 70 Cispadana in località Sant'Agostino/San Carlo,4175,20,4112,61,3159,1016,0,4175
2019/01,606,14/01/2019,1,SP 70 Cispadana in località Sant'Agostino/San Carlo,6324,20,5842,480,5188,1136,6324,0
2019/01,607,01/01/2019,2,SP 1 da Villafranca di Forlì al confine provinciale,2040,00,2033,7,1252,788,0,2040
2019/01,607,02/01/2019,3,SP 1 da Villafranca di Forlì al confine provinciale,3080,00,2925,155,2453,627,3080,0
2019/01,607,03/01/2019,4,SP 1 da Villafranca di Forlì al confine provinciale,3285,00,3107,178,2607,678,3285,0
2019/01,607,04/01/2019,5,SP 1 da Villafranca di Forlì al confine provinciale,3397,00,3251,146,2630,767,3397,0
2019/01,607,05/01/2019,6,SP 1 da Villafranca di Forlì al confine provinciale,3008,00,2958,50,2238,770,0,3008
2019/01,607,06/01/2019,7,SP 1 da Villafranca di Forlì al confine provinciale,2847,00,2834,13,2141,706,0,2847
2019/01,607,07/01/2019,1,SP 1 da Villafranca di Forlì al confine provinciale,3926,00,3686,240,3219,707,3926,0
2019/01,607,08/01/2019,2,SP 1 da Villafranca di Forlì al confine provinciale,3848,00,3615,233,3154,694,3848,0
2019/01,607,09/01/2019,3,SP 1 da Villafranca di Forlì al confine provinciale,3937,00,3620,317,3255,682,3937,0
2019/01,607,10/01/2019,4,SP 1 da Villafranca di Forlì al confine provinciale,4034,00,3777,257,3254,780,4034,0
2019/01,607,11/01/2019,5,SP 1 da Villafranca di Forlì al confine provinciale,4327,00,4029,298,3451,876,4327,0
2019/01,607,12/01/2019,6,SP 1 da Villafranca di Forlì al confine provinciale,3372,00,3307,65,2473,899,0,3372
2019/01,607,13/01/2019,7,SP 1 da Villafranca di Forlì al confine provinciale,2935,10,2926,8,2240,695,0,2935
2019/01,607,14/01/2019,1,SP 1 da Villafranca di Forlì al confine provinciale,4113,00,3775,338,3382,731,4113,0
2019/01,608,01/01/2019,2,SP 140 da Diegaro (SS 9) a Pievesestina (E 45),6446,00,6345,101,3731,2715,0,6446
2019/01,608,02/01/2019,3,SP 140 da Diegaro (SS 9) a Pievesestina (E 45),10163,00,9381,782,8032,2131,10163,0
2019/01,608,03/01/2019,4,SP 140 da Diegaro (SS 9) a Pievesestina (E 45),10857,00,9972,885,8520,2337,10857,0
2019/01,608,04/01/2019,5,SP 140 da Diegaro (SS 9) a Pievesestina (E 45),11445,10,10518,926,8772,2673,11445,0
2019/01,608,05/01/2019,6,SP 140 da Diegaro (SS 9) a Pievesestina (E 45),9191,00,8730,461,6525,2666,0,9191
2019/01,608,06/01/2019,7,SP 140 da Diegaro (SS 9) a Pievesestina (E 45),7329,00,7201,128,5240,2089,0,7329
2019/01,608,07/01/2019,1,SP 140 da Diegaro (SS 9) a Pievesestina (E 45),12895,00,11719,1176,10401,2494,12895,0
2019/01,608,08/01/2019,2,SP 140 da Diegaro (SS 9) a Pievesestina (E 45),12978,20,11747,1229,10375,2603,12978,0
2019/01,608,09/01/2019,3,SP 140 da Diegaro (SS 9) a Pievesestina (E 45),13057,10,11690,1366,10351,2706,13057,0
2019/01,608,10/01/2019,4,SP 140 da Diegaro (SS 9) a Pievesestina (E 45),13275,10,11893,1381,10654,2621,13275,0
2019/01,608,11/01/2019,5,SP 140 da Diegaro (SS 9) a Pievesestina (E 45),13612,10,12360,1251,10539,3073,13612,0
2019/01,608,12/01/2019,6,SP 140 da Diegaro (SS 9) a Pievesestina (E 45),10074,20,9559,513,7330,2744,0,10074
2019/01,608,13/01/2019,7,SP 140 da Diegaro (SS 9) a Pievesestina (E 45),7453,00,7359,94,5305,2148,0,7453
2019/01,608,14/01/2019,1,SP 140 da Diegaro (SS 9) a Pievesestina (E 45),13222,00,11883,1339,10651,2571,13222,0
2019/01,609,01/01/2019,2,SP 4 dal bivio SP22 (per SS 12) al bivio SP 26 (per Pavullo nel Frignano),6337,10,6299,37,4947,1390,0,6337
2019/01,609,02/01/2019,3,SP 4 dal bivio SP22 (per SS 12) al bivio SP 26 (per Pavullo nel Frignano),5637,00,5325,312,4880,757,5637,0
2019/01,609,03/01/2019,4,SP 4 dal bivio SP22 (per SS 12) al bivio SP 26 (per Pavullo nel Frignano),4682,00,4350,332,4064,618,4682,0
2019/01,609,04/01/2019,5,SP 4 dal bivio SP22 (per SS 12) al bivio SP 26 (per Pavullo nel Frignano),4942,10,4619,322,4031,911,4942,0
2019/01,609,05/01/2019,6,SP 4 dal bivio SP22 (per SS 12) al bivio SP 26 (per Pavullo nel Frignano),6112,30,6028,81,4724,1388,0,6112
2019/01,609,06/01/2019,7,SP 4 dal bivio SP22 (per SS 12) al bivio SP 26 (per Pavullo nel Frignano),5634,00,5596,38,4827,807,0,5634
2019/01,609,07/01/2019,1,SP 4 dal bivio SP22 (per SS 12) al bivio SP 26 (per Pavullo nel Frignano),3406,10,3050,355,2757,649,3406,0
2019/01,609,08/01/2019,2,SP 4 dal bivio SP22 (per SS 12) al bivio SP 26 (per Pavullo nel Frignano),3287,40,2917,366,2658,629,3287,0
2019/01,609,09/01/2019,3,SP 4 dal bivio SP22 (per SS 12) al bivio SP 26 (per Pavullo nel Frignano),3516,10,3204,311,2844,672,3516,0
2019/01,609,10/01/2019,4,SP 4 dal bivio SP22 (per SS 12) al bivio SP 26 (per Pavullo nel Frignano),3577,00,3213,364,2922,655,3577,0
2019/01,609,11/01/2019,5,SP 4 dal bivio SP22 (per SS 12) al bivio SP 26 (per Pavullo nel Frignano),3848,00,3487,361,3004,844,3848,0
2019/01,609,12/01/2019,6,SP 4 dal bivio SP22 (per SS 12) al bivio SP 26 (per Pavullo nel Frignano),4296,00,4205,91,3409,887,0,4296
2019/01,609,13/01/2019,7,SP 4 dal bivio SP22 (per SS 12) al bivio SP 26 (per Pavullo nel Frignano),5219,00,5176,43,4418,801,0,5219
2019/01,609,14/01/2019,1,SP 4 dal bivio SP22 (per SS 12) al bivio SP 26 (per Pavullo nel Frignano),3507,20,3208,297,2795,712,3507,0
2019/01,610,01/01/2019,2,SP 11 da Soragna a Roncole Verdi,1469,00,1443,26,961,508,0,1469
2019/01,610,02/01/2019,3,SP 11 da Soragna a Roncole Verdi,2677,00,2531,146,2117,560,2677,0
2019/01,610,03/01/2019,4,SP 11 da Soragna a Roncole Verdi,2951,00,2758,193,2345,606,2951,0
2019/01,610,04/01/2019,5,SP 11 da Soragna a Roncole Verdi,3164,10,2958,205,2514,650,3164,0
2019/01,610,05/01/2019,6,SP 11 da Soragna a Roncole Verdi,2653,00,2580,73,1998,655,0,2653
2019/01,610,06/01/2019,7,SP 11 da Soragna a Roncole Verdi,2490,00,2454,36,1909,581,0,2490
2019/01,610,07/01/2019,1,SP 11 da Soragna a Roncole Verdi,3408,00,3145,263,2840,568,3408,0
2019/01,610,08/01/2019,2,SP 11 da Soragna a Roncole Verdi,3467,00,3196,271,2822,645,3467,0
2019/01,610,09/01/2019,3,SP 11 da Soragna a Roncole Verdi,3728,00,3480,248,3034,694,3728,0
2019/01,610,10/01/2019,4,SP 11 da Soragna a Roncole Verdi,3672,00,3370,302,2979,693,3672,0
2019/01,610,11/01/2019,5,SP 11 da Soragna a Roncole Verdi,4002,10,3721,280,2934,1068,4002,0
2019/01,610,12/01/2019,6,SP 11 da Soragna a Roncole Verdi,2894,00,2803,91,2132,762,0,2894
2019/01,610,13/01/2019,7,SP 11 da Soragna a Roncole Verdi,2357,00,2337,20,1772,585,0,2357
2019/01,610,14/01/2019,1,SP 11 da Soragna a Roncole Verdi,3607,00,3308,299,2942,665,3607,0
2019/01,611,01/01/2019,2,SP 357R da Fornovo di Taro al bivio SP 93 per Fidenza,,,,,,,,
2019/01,611,02/01/2019,3,SP 357R da Fornovo di Taro al bivio SP 93 per Fidenza,,,,,,,,
2019/01,611,03/01/2019,4,SP 357R da Fornovo di Taro al bivio SP 93 per Fidenza,,,,,,,,
2019/01,611,04/01/2019,5,SP 357R da Fornovo di Taro al bivio SP 93 per Fidenza,,,,,,,,
2019/01,611,05/01/2019,6,SP 357R da Fornovo di Taro al bivio SP 93 per Fidenza,,,,,,,,
2019/01,611,06/01/2019,7,SP 357R da Fornovo di Taro al bivio SP 93 per Fidenza,,,,,,,,
2019/01,611,07/01/2019,1,SP 357R da Fornovo di Taro al bivio SP 93 per Fidenza,,,,,,,,
2019/01,611,08/01/2019,2,SP 357R da Fornovo di Taro al bivio SP 93 per Fidenza,,,,,,,,
2019/01,611,09/01/2019,3,SP 357R da Fornovo di Taro al bivio SP 93 per Fidenza,,,,,,,,
2019/01,611,10/01/2019,4,SP 357R da Fornovo di Taro al bivio SP 93 per Fidenza,,,,,,,,
2019/01,611,11/01/2019,5,SP 357R da Fornovo di Taro al bivio SP 93 per Fidenza,,,,,,,,
2019/01,611,12/01/2019,6,SP 357R da Fornovo di Taro al bivio SP 93 per Fidenza,,,,,,,,
2019/01,611,13/01/2019,7,SP 357R da Fornovo di Taro al bivio SP 93 per Fidenza,,,,,,,,
2019/01,611,14/01/2019,1,SP 357R da Fornovo di Taro al bivio SP 93 per Fidenza,,,,,,,,
2019/01,612,01/01/2019,2,SP 665R dalla località Pilastro a Langhirano,8831,00,8797,34,5736,3095,0,8831
2019/01,612,02/01/2019,3,SP 665R dalla località Pilastro a Langhirano,13927,00,13208,719,11410,2517,13927,0
2019/01,612,03/01/2019,4,SP 665R dalla località Pilastro a Langhirano,14850,00,14032,818,12119,2731,14850,0
2019/01,612,04/01/2019,5,SP 665R dalla località Pilastro a Langhirano,16102,00,15170,932,12963,3139,16102,0
2019/01,612,05/01/2019,6,SP 665R dalla località Pilastro a Langhirano,13108,00,12902,206,9875,3233,0,13108
2019/01,612,06/01/2019,7,SP 665R dalla località Pilastro a Langhirano,11199,00,11156,43,8594,2605,0,11199
2019/01,612,07/01/2019,1,SP 665R dalla località Pilastro a Langhirano,16260,10,15289,970,13431,2829,16260,0
2019/01,612,08/01/2019,2,SP 665R dalla località Pilastro a Langhirano,16567,20,15599,966,13706,2861,16567,0
2019/01,612,09/01/2019,3,SP 665R dalla località Pilastro a Langhirano,16877,00,15867,1010,13775,3102,16877,0
2019/01,612,10/01/2019,4,SP 665R dalla località Pilastro a Langhirano,17210,00,16161,1049,14036,3174,17210,0
2019/01,612,11/01/2019,5,SP 665R dalla località Pilastro a Langhirano,17836,10,16760,1075,14333,3503,17836,0
2019/01,612,12/01/2019,6,SP 665R dalla località Pilastro a Langhirano,14045,30,13793,249,10747,3298,0,14045
2019/01,612,13/01/2019,7,SP 665R dalla località Pilastro a Langhirano,11408,00,11356,52,8774,2634,0,11408
2019/01,612,14/01/2019,1,SP 665R dalla località Pilastro a Langhirano,17221,00,16248,973,14293,2928,17221,0
2019/01,613,01/01/2019,2,SP 16 dalla località Basilicanova al bivio SP 32 centro abitato Mamiano,3350,00,3308,42,1983,1367,0,3350
2019/01,613,02/01/2019,3,SP 16 dalla località Basilicanova al bivio SP 32 centro abitato Mamiano,5007,00,4837,170,4037,970,5007,0
2019/01,613,03/01/2019,4,SP 16 dalla località Basilicanova al bivio SP 32 centro abitato Mamiano,5410,10,5206,203,4278,1132,5410,0
2019/01,613,04/01/2019,5,SP 16 dalla località Basilicanova al bivio SP 32 centro abitato Mamiano,5727,00,5528,199,4440,1287,5727,0
2019/01,613,05/01/2019,6,SP 16 dalla località Basilicanova al bivio SP 32 centro abitato Mamiano,5262,00,5132,130,3773,1489,0,5262
2019/01,613,06/01/2019,7,SP 16 dalla località Basilicanova al bivio SP 32 centro abitato Mamiano,4188,00,4147,41,3082,1106,0,4188
2019/01,613,07/01/2019,1,SP 16 dalla località Basilicanova al bivio SP 32 centro abitato Mamiano,6287,00,6037,250,5050,1237,6287,0
2019/01,613,08/01/2019,2,SP 16 dalla località Basilicanova al bivio SP 32 centro abitato Mamiano,6401,00,6116,285,5140,1261,6401,0
2019/01,613,09/01/2019,3,SP 16 dalla località Basilicanova al bivio SP 32 centro abitato Mamiano,6558,00,6318,240,5205,1353,6558,0
2019/01,613,10/01/2019,4,SP 16 dalla località Basilicanova al bivio SP 32 centro abitato Mamiano,6612,00,6320,292,5271,1341,6612,0
2019/01,613,11/01/2019,5,SP 16 dalla località Basilicanova al bivio SP 32 centro abitato Mamiano,6793,10,6520,272,5177,1616,6793,0
2019/01,613,12/01/2019,6,SP 16 dalla località Basilicanova al bivio SP 32 centro abitato Mamiano,5635,00,5475,160,4170,1465,0,5635
2019/01,613,13/01/2019,7,SP 16 dalla località Basilicanova al bivio SP 32 centro abitato Mamiano,4280,00,4238,42,3188,1092,0,4280
2019/01,613,14/01/2019,1,SP 16 dalla località Basilicanova al bivio SP 32 centro abitato Mamiano,6516,00,6268,248,5213,1303,6516,0
2019/01,614,01/01/2019,2,SP 587R dal bivio SP 10R alla A 21Dir,2765,00,2732,33,1695,1070,0,2765
2019/01,614,02/01/2019,3,SP 587R dal bivio SP 10R alla A 21Dir,4591,00,4306,285,3624,967,4591,0
2019/01,614,03/01/2019,4,SP 587R dal bivio SP 10R alla A 21Dir,5284,00,4956,328,4182,1102,5284,0
2019/01,614,04/01/2019,5,SP 587R dal bivio SP 10R alla A 21Dir,5437,00,5039,398,4256,1181,5437,0
2019/01,614,05/01/2019,6,SP 587R dal bivio SP 10R alla A 21Dir,4633,10,4478,154,3396,1237,0,4633
2019/01,614,06/01/2019,7,SP 587R dal bivio SP 10R alla A 21Dir,3862,00,3824,38,2852,1010,0,3862
2019/01,614,07/01/2019,1,SP 587R dal bivio SP 10R alla A 21Dir,6321,00,5802,519,5172,1149,6321,0
2019/01,614,08/01/2019,2,SP 587R dal bivio SP 10R alla A 21Dir,5894,00,5450,444,4845,1049,5894,0
2019/01,614,09/01/2019,3,SP 587R dal bivio SP 10R alla A 21Dir,6450,00,5989,461,5186,1264,6450,0
2019/01,614,10/01/2019,4,SP 587R dal bivio SP 10R alla A 21Dir,6630,10,6105,524,5301,1329,6630,0
2019/01,614,11/01/2019,5,SP 587R dal bivio SP 10R alla A 21Dir,7078,00,6554,524,5415,1663,7078,0
2019/01,614,12/01/2019,6,SP 587R dal bivio SP 10R alla A 21Dir,5272,00,5061,211,3960,1312,0,5272
2019/01,614,13/01/2019,7,SP 587R dal bivio SP 10R alla A 21Dir,3740,00,3690,50,2756,984,0,3740
2019/01,614,14/01/2019,1,SP 587R dal bivio SP 10R alla A 21Dir,6553,00,6071,482,5337,1216,6553,0
2019/01,615,01/01/2019,2,Piazzale Milano (ex SS 9) c/o ponte fiume Po,12909,00,12880,29,7750,5159,0,12909
2019/01,615,02/01/2019,3,Piazzale Milano (ex SS 9) c/o ponte fiume Po,21110,50,20778,327,16315,4795,21110,0
2019/01,615,03/01/2019,4,Piazzale Milano (ex SS 9) c/o ponte fiume Po,22515,40,22173,338,17461,5054,22515,0
2019/01,615,04/01/2019,5,Piazzale Milano (ex SS 9) c/o ponte fiume Po,23594,20,23216,376,17684,5910,23594,0
2019/01,615,05/01/2019,6,Piazzale Milano (ex SS 9) c/o ponte fiume Po,25987,110,25735,241,18955,7032,0,25987
2019/01,615,06/01/2019,7,Piazzale Milano (ex SS 9) c/o ponte fiume Po,22407,10,22294,112,16347,6060,0,22407
2019/01,615,07/01/2019,1,Piazzale Milano (ex SS 9) c/o ponte fiume Po,25068,140,24553,501,19312,5756,25068,0
2019/01,615,08/01/2019,2,Piazzale Milano (ex SS 9) c/o ponte fiume Po,24120,150,23625,480,18792,5328,24120,0
2019/01,615,09/01/2019,3,Piazzale Milano (ex SS 9) c/o ponte fiume Po,25450,200,24891,539,19697,5753,25450,0
2019/01,615,10/01/2019,4,Piazzale Milano (ex SS 9) c/o ponte fiume Po,25793,100,25247,536,19634,6159,25793,0
2019/01,615,11/01/2019,5,Piazzale Milano (ex SS 9) c/o ponte fiume Po,27570,150,26998,557,20411,7159,27570,0
2019/01,615,12/01/2019,6,Piazzale Milano (ex SS 9) c/o ponte fiume Po,27920,50,27584,331,20442,7478,0,27920
2019/01,615,13/01/2019,7,Piazzale Milano (ex SS 9) c/o ponte fiume Po,21967,50,21854,108,15936,6031,0,21967
2019/01,615,14/01/2019,1,Piazzale Milano (ex SS 9) c/o ponte fiume Po,25668,140,25138,516,19674,5994,25668,0
2019/01,617,01/01/2019,2,SP 7 dalla intersezione tangenziale sud/ovest di Piacenza a San Nicolò,3679,00,3674,5,2333,1346,0,3679
2019/01,617,02/01/2019,3,SP 7 dalla intersezione tangenziale sud/ovest di Piacenza a San Nicolò,5765,00,5588,177,4772,993,5765,0
2019/01,617,03/01/2019,4,SP 7 dalla intersezione tangenziale sud/ovest di Piacenza a San Nicolò,6056,00,5906,150,4921,1135,6056,0
2019/01,617,04/01/2019,5,SP 7 dalla intersezione tangenziale sud/ovest di Piacenza a San Nicolò,6252,00,6092,160,4979,1273,6252,0
2019/01,617,05/01/2019,6,SP 7 dalla intersezione tangenziale sud/ovest di Piacenza a San Nicolò,6197,10,6117,79,4620,1577,0,6197
2019/01,617,06/01/2019,7,SP 7 dalla intersezione tangenziale sud/ovest di Piacenza a San Nicolò,4945,00,4936,9,3797,1148,0,4945
2019/01,617,07/01/2019,1,SP 7 dalla intersezione tangenziale sud/ovest di Piacenza a San Nicolò,7099,00,6820,279,5921,1178,7099,0
2019/01,617,08/01/2019,2,SP 7 dalla intersezione tangenziale sud/ovest di Piacenza a San Nicolò,7172,00,6912,260,5980,1192,7172,0
2019/01,617,09/01/2019,3,SP 7 dalla intersezione tangenziale sud/ovest di Piacenza a San Nicolò,7550,10,7186,363,6223,1327,7550,0
2019/01,617,10/01/2019,4,SP 7 dalla intersezione tangenziale sud/ovest di Piacenza a San Nicolò,7538,10,7142,395,6162,1376,7538,0
2019/01,617,11/01/2019,5,SP 7 dalla intersezione tangenziale sud/ovest di Piacenza a San Nicolò,7899,00,7509,390,6346,1553,7899,0
2019/01,617,12/01/2019,6,SP 7 dalla intersezione tangenziale sud/ovest di Piacenza a San Nicolò,7088,00,6984,104,5424,1664,0,7088
2019/01,617,13/01/2019,7,SP 7 dalla intersezione tangenziale sud/ovest di Piacenza a San Nicolò,4879,00,4865,14,3686,1193,0,4879
2019/01,617,14/01/2019,1,SP 7 dalla intersezione tangenziale sud/ovest di Piacenza a San Nicolò,7628,00,7266,362,6251,1377,7628,0
2019/01,618,01/01/2019,2,SP 253R fra Bagnacavallo (A14 Dir) e Godo (bivio SP 302R),3774,00,3755,19,2438,1336,0,3774
2019/01,618,02/01/2019,3,SP 253R fra Bagnacavallo (A14 Dir) e Godo (bivio SP 302R),5720,10,5465,254,4680,1040,5720,0
2019/01,618,03/01/2019,4,SP 253R fra Bagnacavallo (A14 Dir) e Godo (bivio SP 302R),5924,00,5616,308,4726,1198,5924,0
2019/01,618,04/01/2019,5,SP 253R fra Bagnacavallo (A14 Dir) e Godo (bivio SP 302R),5768,00,5449,319,4502,1266,5768,0
2019/01,618,05/01/2019,6,SP 253R fra Bagnacavallo (A14 Dir) e Godo (bivio SP 302R),5200,00,5091,109,3794,1406,0,5200
2019/01,618,06/01/2019,7,SP 253R fra Bagnacavallo (A14 Dir) e Godo (bivio SP 302R),4236,00,4212,24,3168,1068,0,4236
2019/01,618,07/01/2019,1,SP 253R fra Bagnacavallo (A14 Dir) e Godo (bivio SP 302R),7032,00,6565,467,5845,1187,7032,0
2019/01,618,08/01/2019,2,SP 253R fra Bagnacavallo (A14 Dir) e Godo (bivio SP 302R),7184,00,6736,448,5896,1288,7184,0
2019/01,618,09/01/2019,3,SP 253R fra Bagnacavallo (A14 Dir) e Godo (bivio SP 302R),7114,00,6636,478,5758,1356,7114,0
2019/01,618,10/01/2019,4,SP 253R fra Bagnacavallo (A14 Dir) e Godo (bivio SP 302R),7574,00,7007,567,6130,1444,7574,0
2019/01,618,11/01/2019,5,SP 253R fra Bagnacavallo (A14 Dir) e Godo (bivio SP 302R),7605,10,7107,497,6065,1540,7605,0
2019/01,618,12/01/2019,6,SP 253R fra Bagnacavallo (A14 Dir) e Godo (bivio SP 302R),6167,00,6059,108,4602,1565,0,6167
2019/01,618,13/01/2019,7,SP 253R fra Bagnacavallo (A14 Dir) e Godo (bivio SP 302R),4537,00,4515,22,3418,1119,0,4537
2019/01,618,14/01/2019,1,SP 253R fra Bagnacavallo (A14 Dir) e Godo (bivio SP 302R),7156,00,6632,524,5831,1325,7156,0
2019/01,619,01/01/2019,2,SP 8 da Bagnacavallo al bivio SS 16,1739,00,1735,4,1191,548,0,1739
2019/01,619,02/01/2019,3,SP 8 da Bagnacavallo al bivio SS 16,2323,00,2228,95,1836,487,2323,0
2019/01,619,03/01/2019,4,SP 8 da Bagnacavallo al bivio SS 16,2513,00,2401,112,2009,504,2513,0
2019/01,619,04/01/2019,5,SP 8 da Bagnacavallo al bivio SS 16,2667,10,2539,127,2024,643,2667,0
2019/01,619,05/01/2019,6,SP 8 da Bagnacavallo al bivio SS 16,2441,00,2389,52,1777,664,0,2441
2019/01,619,06/01/2019,7,SP 8 da Bagnacavallo al bivio SS 16,2064,00,2059,5,1505,559,0,2064
2019/01,619,07/01/2019,1,SP 8 da Bagnacavallo al bivio SS 16,2948,00,2789,159,2344,604,2948,0
2019/01,619,08/01/2019,2,SP 8 da Bagnacavallo al bivio SS 16,2865,00,2717,148,2328,537,2865,0
2019/01,619,09/01/2019,3,SP 8 da Bagnacavallo al bivio SS 16,3059,20,2891,166,2420,639,3059,0
2019/01,619,10/01/2019,4,SP 8 da Bagnacavallo al bivio SS 16,3003,00,2825,178,2350,653,3003,0
2019/01,619,11/01/2019,5,SP 8 da Bagnacavallo al bivio SS 16,3209,30,3009,197,2511,698,3209,0
2019/01,619,12/01/2019,6,SP 8 da Bagnacavallo al bivio SS 16,2544,00,2497,47,1868,676,0,2544
2019/01,619,13/01/2019,7,SP 8 da Bagnacavallo al bivio SS 16,2221,00,2214,7,1630,591,0,2221
2019/01,619,14/01/2019,1,SP 8 da Bagnacavallo al bivio SS 16,3139,00,2950,189,2514,625,3139,0
2019/01,620,01/01/2019,2,SP 113 sulla variante di San Martino in Rio/Correggio c/o le località Prato/Gazzata,2928,00,2880,48,1682,1246,0,2928
2019/01,620,02/01/2019,3,SP 113 sulla variante di San Martino in Rio/Correggio c/o le località Prato/Gazzata,5440,00,4953,487,4369,1071,5440,0
2019/01,620,03/01/2019,4,SP 113 sulla variante di San Martino in Rio/Correggio c/o le località Prato/Gazzata,5759,00,5232,527,4666,1093,5759,0
2019/01,620,04/01/2019,5,SP 113 sulla variante di San Martino in Rio/Correggio c/o le località Prato/Gazzata,6076,00,5533,543,4723,1353,6076,0
2019/01,620,05/01/2019,6,SP 113 sulla variante di San Martino in Rio/Correggio c/o le località Prato/Gazzata,5273,00,5116,157,3850,1423,0,5273
2019/01,620,06/01/2019,7,SP 113 sulla variante di San Martino in Rio/Correggio c/o le località Prato/Gazzata,4622,00,4573,49,3382,1240,0,4622
2019/01,620,07/01/2019,1,SP 113 sulla variante di San Martino in Rio/Correggio c/o le località Prato/Gazzata,7276,00,6368,908,5889,1387,7276,0
2019/01,620,08/01/2019,2,SP 113 sulla variante di San Martino in Rio/Correggio c/o le località Prato/Gazzata,7541,00,6575,966,6147,1394,7541,0
2019/01,620,09/01/2019,3,SP 113 sulla variante di San Martino in Rio/Correggio c/o le località Prato/Gazzata,7921,00,6945,976,6455,1466,7921,0
2019/01,620,10/01/2019,4,SP 113 sulla variante di San Martino in Rio/Correggio c/o le località Prato/Gazzata,8336,00,7237,1099,6781,1555,8336,0
2019/01,620,11/01/2019,5,SP 113 sulla variante di San Martino in Rio/Correggio c/o le località Prato/Gazzata,8362,10,7325,1036,6653,1709,8362,0
2019/01,620,12/01/2019,6,SP 113 sulla variante di San Martino in Rio/Correggio c/o le località Prato/Gazzata,5821,10,5632,188,4127,1694,0,5821
2019/01,620,13/01/2019,7,SP 113 sulla variante di San Martino in Rio/Correggio c/o le località Prato/Gazzata,4654,00,4605,49,3261,1393,0,4654
2019/01,620,14/01/2019,1,SP 113 sulla variante di San Martino in Rio/Correggio c/o le località Prato/Gazzata,8059,00,7073,986,6535,1524,8059,0
2019/01,621,01/01/2019,2,SP 513R a nord di Vetto,1692,00,1684,8,1298,394,0,1692
2019/01,621,02/01/2019,3,SP 513R a nord di Vetto,1747,00,1651,96,1434,313,1747,0
2019/01,621,03/01/2019,4,SP 513R a nord di Vetto,1883,00,1801,82,1557,326,1883,0
2019/01,621,04/01/2019,5,SP 513R a nord di Vetto,1816,00,1747,69,1432,384,1816,0
2019/01,621,05/01/2019,6,SP 513R a nord di Vetto,1826,00,1786,40,1442,384,0,1826
2019/01,621,06/01/2019,7,SP 513R a nord di Vetto,2058,00,2046,12,1691,367,0,2058
2019/01,621,07/01/2019,1,SP 513R a nord di Vetto,1885,00,1767,118,1504,381,1885,0
2019/01,621,08/01/2019,2,SP 513R a nord di Vetto,1789,00,1662,127,1394,395,1789,0
2019/01,621,09/01/2019,3,SP 513R a nord di Vetto,1984,00,1850,134,1585,399,1984,0
2019/01,621,10/01/2019,4,SP 513R a nord di Vetto,1975,00,1859,116,1542,433,1975,0
2019/01,621,11/01/2019,5,SP 513R a nord di Vetto,2051,00,1926,125,1590,461,2051,0
2019/01,621,12/01/2019,6,SP 513R a nord di Vetto,2008,00,1951,57,1593,415,0,2008
2019/01,621,13/01/2019,7,SP 513R a nord di Vetto,1885,00,1873,12,1521,364,0,1885
2019/01,621,14/01/2019,1,SP 513R a nord di Vetto,1934,00,1826,108,1521,413,1934,0
2019/01,622,01/01/2019,2,SP 468R tra Correggio e il confine provinciale,7291,00,7249,42,4021,3270,0,7291
2019/01,622,02/01/2019,3,SP 468R tra Correggio e il confine provinciale,13388,30,12686,699,10716,2672,13388,0
2019/01,622,03/01/2019,4,SP 468R tra Correggio e il confine provinciale,14289,00,13518,771,11305,2984,14289,0
2019/01,622,04/01/2019,5,SP 468R tra Correggio e il confine provinciale,14962,10,14161,800,11494,3468,14962,0
2019/01,622,05/01/2019,6,SP 468R tra Correggio e il confine provinciale,13942,10,13712,229,9917,4025,0,13942
2019/01,622,06/01/2019,7,SP 468R tra Correggio e il confine provinciale,11543,20,11478,63,8409,3134,0,11543
2019/01,622,07/01/2019,1,SP 468R tra Correggio e il confine provinciale,17593,10,16369,1223,14154,3439,17593,0
2019/01,622,08/01/2019,2,SP 468R tra Correggio e il confine provinciale,18257,10,16813,1443,14794,3463,18257,0
2019/01,622,09/01/2019,3,SP 468R tra Correggio e il confine provinciale,19263,00,17679,1584,15383,3880,19263,0
2019/01,622,10/01/2019,4,SP 468R tra Correggio e il confine provinciale,18998,10,17356,1641,15200,3798,18998,0
2019/01,622,11/01/2019,5,SP 468R tra Correggio e il confine provinciale,20065,20,18523,1540,15565,4500,20065,0
2019/01,622,12/01/2019,6,SP 468R tra Correggio e il confine provinciale,15703,00,15371,332,11326,4377,0,15703
2019/01,622,13/01/2019,7,SP 468R tra Correggio e il confine provinciale,11208,00,11142,66,7703,3505,0,11208
2019/01,622,14/01/2019,1,SP 468R tra Correggio e il confine provinciale,18984,00,17415,1569,15307,3677,18984,0
2019/01,623,01/01/2019,2,SP 30 tra Campagnola Emilia e il confine provinciale,6269,00,6233,36,3551,2718,0,6269
2019/01,623,02/01/2019,3,SP 30 tra Campagnola Emilia e il confine provinciale,10363,00,9948,415,8235,2128,10363,0
2019/01,623,03/01/2019,4,SP 30 tra Campagnola Emilia e il confine provinciale,11274,10,10811,462,8937,2337,11274,0
2019/01,623,04/01/2019,5,SP 30 tra Campagnola Emilia e il confine provinciale,12170,00,11619,551,9317,2853,12170,0
2019/01,623,05/01/2019,6,SP 30 tra Campagnola Emilia e il confine provinciale,11325,00,11144,181,8157,3168,0,11325
2019/01,623,06/01/2019,7,SP 30 tra Campagnola Emilia e il confine provinciale,9795,00,9733,62,7179,2616,0,9795
2019/01,623,07/01/2019,1,SP 30 tra Campagnola Emilia e il confine provinciale,13883,00,12918,965,11249,2634,13883,0
2019/01,623,08/01/2019,2,SP 30 tra Campagnola Emilia e il confine provinciale,13714,00,12743,971,11164,2550,13714,0
2019/01,623,09/01/2019,3,SP 30 tra Campagnola Emilia e il confine provinciale,14755,00,13676,1079,11817,2938,14755,0
2019/01,623,10/01/2019,4,SP 30 tra Campagnola Emilia e il confine provinciale,14912,00,13885,1027,11907,3005,14912,0
2019/01,623,11/01/2019,5,SP 30 tra Campagnola Emilia e il confine provinciale,15591,00,14485,1106,12075,3516,15591,0
2019/01,623,12/01/2019,6,SP 30 tra Campagnola Emilia e il confine provinciale,13145,00,12902,243,9484,3661,0,13145
2019/01,623,13/01/2019,7,SP 30 tra Campagnola Emilia e il confine provinciale,9513,00,9446,67,6739,2774,0,9513
2019/01,623,14/01/2019,1,SP 30 tra Campagnola Emilia e il confine provinciale,14802,10,13769,1032,11942,2860,14802,0
2019/01,624,01/01/2019,2,SP 23 tra Rivalta e la variante di Montecavolo,5615,00,5599,16,3256,2359,0,5615
2019/01,624,02/01/2019,3,SP 23 tra Rivalta e la variante di Montecavolo,8632,00,8455,177,6966,1666,8632,0
2019/01,624,03/01/2019,4,SP 23 tra Rivalta e la variante di Montecavolo,9141,00,8937,204,7220,1921,9141,0
2019/01,624,04/01/2019,5,SP 23 tra Rivalta e la variante di Montecavolo,9895,00,9680,215,7694,2201,9895,0
2019/01,624,05/01/2019,6,SP 23 tra Rivalta e la variante di Montecavolo,10371,00,10289,82,7745,2626,0,10371
2019/01,624,06/01/2019,7,SP 23 tra Rivalta e la variante di Montecavolo,8301,00,8282,19,6232,2069,0,8301
2019/01,624,07/01/2019,1,SP 23 tra Rivalta e la variante di Montecavolo,10765,10,10403,361,8649,2116,10765,0
2019/01,624,08/01/2019,2,SP 23 tra Rivalta e la variante di Montecavolo,10852,00,10537,315,8578,2274,10852,0
2019/01,624,09/01/2019,3,SP 23 tra Rivalta e la variante di Montecavolo,11492,00,11170,322,9009,2483,11492,0
2019/01,624,10/01/2019,4,SP 23 tra Rivalta e la variante di Montecavolo,11190,00,10890,300,8717,2473,11190,0
2019/01,624,11/01/2019,5,SP 23 tra Rivalta e la variante di Montecavolo,11813,00,11501,312,9152,2661,11813,0
2019/01,624,12/01/2019,6,SP 23 tra Rivalta e la variante di Montecavolo,11476,00,11385,91,8455,3021,0,11476
2019/01,624,13/01/2019,7,SP 23 tra Rivalta e la variante di Montecavolo,8681,00,8662,19,6314,2367,0,8681
2019/01,624,14/01/2019,1,SP 23 tra Rivalta e la variante di Montecavolo,10904,10,10579,324,8627,2277,10904,0
2019/01,625,01/01/2019,2,SP 14 da Poggio Berni (bivio SP 73) a Sant'Arcangelo di Romagna,,,,,,,,
2019/01,625,02/01/2019,3,SP 14 da Poggio Berni (bivio SP 73) a Sant'Arcangelo di Romagna,,,,,,,,
2019/01,625,03/01/2019,4,SP 14 da Poggio Berni (bivio SP 73) a Sant'Arcangelo di Romagna,,,,,,,,
2019/01,625,04/01/2019,5,SP 14 da Poggio Berni (bivio SP 73) a Sant'Arcangelo di Romagna,,,,,,,,
2019/01,625,05/01/2019,6,SP 14 da Poggio Berni (bivio SP 73) a Sant'Arcangelo di Romagna,,,,,,,,
2019/01,625,06/01/2019,7,SP 14 da Poggio Berni (bivio SP 73) a Sant'Arcangelo di Romagna,,,,,,,,
2019/01,625,07/01/2019,1,SP 14 da Poggio Berni (bivio SP 73) a Sant'Arcangelo di Romagna,,,,,,,,
2019/01,625,08/01/2019,2,SP 14 da Poggio Berni (bivio SP 73) a Sant'Arcangelo di Romagna,,,,,,,,
2019/01,625,09/01/2019,3,SP 14 da Poggio Berni (bivio SP 73) a Sant'Arcangelo di Romagna,,,,,,,,
2019/01,625,10/01/2019,4,SP 14 da Poggio Berni (bivio SP 73) a Sant'Arcangelo di Romagna,,,,,,,,
2019/01,625,11/01/2019,5,SP 14 da Poggio Berni (bivio SP 73) a Sant'Arcangelo di Romagna,,,,,,,,
2019/01,625,12/01/2019,6,SP 14 da Poggio Berni (bivio SP 73) a Sant'Arcangelo di Romagna,,,,,,,,
2019/01,625,13/01/2019,7,SP 14 da Poggio Berni (bivio SP 73) a Sant'Arcangelo di Romagna,,,,,,,,
2019/01,625,14/01/2019,1,SP 14 da Poggio Berni (bivio SP 73) a Sant'Arcangelo di Romagna,,,,,,,,
2019/01,626,01/01/2019,2,SP 18 da San Clemente al bivio SP 132 (località Osteria Nuova),4943,00,4932,11,3126,1817,0,4943
2019/01,626,02/01/2019,3,SP 18 da San Clemente al bivio SP 132 (località Osteria Nuova),6219,10,6014,204,5065,1154,6219,0
2019/01,626,03/01/2019,4,SP 18 da San Clemente al bivio SP 132 (località Osteria Nuova),6983,10,6760,222,5739,1244,6983,0
2019/01,626,04/01/2019,5,SP 18 da San Clemente al bivio SP 132 (località Osteria Nuova),6501,10,6321,179,5143,1358,6501,0
2019/01,626,05/01/2019,6,SP 18 da San Clemente al bivio SP 132 (località Osteria Nuova),6602,00,6487,115,5001,1601,0,6602
2019/01,626,06/01/2019,7,SP 18 da San Clemente al bivio SP 132 (località Osteria Nuova),5233,10,5219,13,3886,1347,0,5233
2019/01,626,07/01/2019,1,SP 18 da San Clemente al bivio SP 132 (località Osteria Nuova),7614,10,7294,319,6245,1369,7614,0
2019/01,626,08/01/2019,2,SP 18 da San Clemente al bivio SP 132 (località Osteria Nuova),7382,00,7052,330,6027,1355,7382,0
2019/01,626,09/01/2019,3,SP 18 da San Clemente al bivio SP 132 (località Osteria Nuova),7344,10,7010,333,5995,1349,7344,0
2019/01,626,10/01/2019,4,SP 18 da San Clemente al bivio SP 132 (località Osteria Nuova),7750,00,7405,345,6411,1339,7750,0
2019/01,626,11/01/2019,5,SP 18 da San Clemente al bivio SP 132 (località Osteria Nuova),8030,10,7664,365,6421,1609,8030,0
2019/01,626,12/01/2019,6,SP 18 da San Clemente al bivio SP 132 (località Osteria Nuova),7392,20,7264,126,5631,1761,0,7392
2019/01,626,13/01/2019,7,SP 18 da San Clemente al bivio SP 132 (località Osteria Nuova),5691,00,5678,13,4275,1416,0,5691
2019/01,626,14/01/2019,1,SP 18 da San Clemente al bivio SP 132 (località Osteria Nuova),7585,00,7196,389,6171,1414,7585,0
2019/01,627,01/01/2019,2,SS 64 variante di Riola di Vergato,5621,00,5607,14,4009,1612,0,5621
2019/01,627,02/01/2019,3,SS 64 variante di Riola di Vergato,7260,00,7010,250,5976,1284,7260,0
2019/01,627,03/01/2019,4,SS 64 variante di Riola di Vergato,7209,00,6921,288,5872,1337,7209,0
2019/01,627,04/01/2019,5,SS 64 variante di Riola di Vergato,7498,10,7177,320,5954,1544,7498,0
2019/01,627,05/01/2019,6,SS 64 variante di Riola di Vergato,7495,00,7367,128,5820,1675,0,7495
2019/01,627,06/01/2019,7,SS 64 variante di Riola di Vergato,6358,00,6330,28,4977,1381,0,6358
2019/01,627,07/01/2019,1,SS 64 variante di Riola di Vergato,7583,10,7196,386,6174,1409,7583,0
2019/01,627,08/01/2019,2,SS 64 variante di Riola di Vergato,7377,00,6931,446,5986,1391,7377,0
2019/01,627,09/01/2019,3,SS 64 variante di Riola di Vergato,7695,00,7237,458,6196,1499,7695,0
2019/01,627,10/01/2019,4,SS 64 variante di Riola di Vergato,7714,10,7285,428,6161,1553,7714,0
2019/01,627,11/01/2019,5,SS 64 variante di Riola di Vergato,8182,00,7714,468,6408,1774,8182,0
2019/01,627,12/01/2019,6,SS 64 variante di Riola di Vergato,7600,10,7466,133,5911,1689,0,7600
2019/01,627,13/01/2019,7,SS 64 variante di Riola di Vergato,6273,00,6249,24,4872,1401,0,6273
2019/01,627,14/01/2019,1,SS 64 variante di Riola di Vergato,7974,00,7471,503,6505,1469,7974,0
2019/01,629,01/01/2019,2,SS 727 (tg Forli') tra intersezione SS 9 e l'intersezione SS 67,7348,00,7317,31,4599,2749,0,7348
2019/01,629,02/01/2019,3,SS 727 (tg Forli') tra intersezione SS 9 e l'intersezione SS 67,11836,00,11275,561,9564,2272,11836,0
2019/01,629,03/01/2019,4,SS 727 (tg Forli') tra intersezione SS 9 e l'intersezione SS 67,12813,10,12163,649,10289,2524,12813,0
2019/01,629,04/01/2019,5,SS 727 (tg Forli') tra intersezione SS 9 e l'intersezione SS 67,13467,00,12817,650,10410,3057,13467,0
2019/01,629,05/01/2019,6,SS 727 (tg Forli') tra intersezione SS 9 e l'intersezione SS 67,10751,00,10493,258,7730,3021,0,10751
2019/01,629,06/01/2019,7,SS 727 (tg Forli') tra intersezione SS 9 e l'intersezione SS 67,9250,10,9205,44,6611,2639,0,9250
2019/01,629,07/01/2019,1,SS 727 (tg Forli') tra intersezione SS 9 e l'intersezione SS 67,15774,00,14822,952,12811,2963,15774,0
2019/01,629,08/01/2019,2,SS 727 (tg Forli') tra intersezione SS 9 e l'intersezione SS 67,15576,00,14513,1063,12704,2872,15576,0
2019/01,629,09/01/2019,3,SS 727 (tg Forli') tra intersezione SS 9 e l'intersezione SS 67,15782,00,14688,1094,12767,3015,15782,0
2019/01,629,10/01/2019,4,SS 727 (tg Forli') tra intersezione SS 9 e l'intersezione SS 67,15805,00,14732,1073,12779,3026,15805,0
2019/01,629,11/01/2019,5,SS 727 (tg Forli') tra intersezione SS 9 e l'intersezione SS 67,16972,10,15812,1159,13188,3784,16972,0
2019/01,629,12/01/2019,6,SS 727 (tg Forli') tra intersezione SS 9 e l'intersezione SS 67,11663,00,11387,276,8422,3241,0,11663
2019/01,629,13/01/2019,7,SS 727 (tg Forli') tra intersezione SS 9 e l'intersezione SS 67,9998,00,9949,49,7327,2671,0,9998
2019/01,629,14/01/2019,1,SS 727 (tg Forli') tra intersezione SS 9 e l'intersezione SS 67,16002,00,14925,1077,12884,3118,16002,0
2019/01,630,01/01/2019,2,SS 726 (tg Cesena) tra intersezione ex SS 71BIS e l'intersezione SP 304R,,,,,,,,
2019/01,630,02/01/2019,3,SS 726 (tg Cesena) tra intersezione ex SS 71BIS e l'intersezione SP 304R,,,,,,,,
2019/01,630,03/01/2019,4,SS 726 (tg Cesena) tra intersezione ex SS 71BIS e l'intersezione SP 304R,,,,,,,,
2019/01,630,04/01/2019,5,SS 726 (tg Cesena) tra intersezione ex SS 71BIS e l'intersezione SP 304R,,,,,,,,
2019/01,630,05/01/2019,6,SS 726 (tg Cesena) tra intersezione ex SS 71BIS e l'intersezione SP 304R,,,,,,,,
2019/01,630,06/01/2019,7,SS 726 (tg Cesena) tra intersezione ex SS 71BIS e l'intersezione SP 304R,,,,,,,,
2019/01,630,07/01/2019,1,SS 726 (tg Cesena) tra intersezione ex SS 71BIS e l'intersezione SP 304R,,,,,,,,
2019/01,630,08/01/2019,2,SS 726 (tg Cesena) tra intersezione ex SS 71BIS e l'intersezione SP 304R,,,,,,,,
2019/01,630,09/01/2019,3,SS 726 (tg Cesena) tra intersezione ex SS 71BIS e l'intersezione SP 304R,,,,,,,,
2019/01,630,10/01/2019,4,SS 726 (tg Cesena) tra intersezione ex SS 71BIS e l'intersezione SP 304R,,,,,,,,
2019/01,630,11/01/2019,5,SS 726 (tg Cesena) tra intersezione ex SS 71BIS e l'intersezione SP 304R,,,,,,,,
2019/01,630,12/01/2019,6,SS 726 (tg Cesena) tra intersezione ex SS 71BIS e l'intersezione SP 304R,,,,,,,,
2019/01,630,13/01/2019,7,SS 726 (tg Cesena) tra intersezione ex SS 71BIS e l'intersezione SP 304R,,,,,,,,
2019/01,630,14/01/2019,1,SS 726 (tg Cesena) tra intersezione ex SS 71BIS e l'intersezione SP 304R,,,,,,,,
2019/01,631,01/01/2019,2,SS 3Bis/E 45 tra Sarsina e San Piero in Bagno,,,,,,,,
2019/01,631,02/01/2019,3,SS 3Bis/E 45 tra Sarsina e San Piero in Bagno,,,,,,,,
2019/01,631,03/01/2019,4,SS 3Bis/E 45 tra Sarsina e San Piero in Bagno,,,,,,,,
2019/01,631,04/01/2019,5,SS 3Bis/E 45 tra Sarsina e San Piero in Bagno,,,,,,,,
2019/01,631,05/01/2019,6,SS 3Bis/E 45 tra Sarsina e San Piero in Bagno,,,,,,,,
2019/01,631,06/01/2019,7,SS 3Bis/E 45 tra Sarsina e San Piero in Bagno,,,,,,,,
2019/01,631,07/01/2019,1,SS 3Bis/E 45 tra Sarsina e San Piero in Bagno,,,,,,,,
2019/01,631,08/01/2019,2,SS 3Bis/E 45 tra Sarsina e San Piero in Bagno,,,,,,,,
2019/01,631,09/01/2019,3,SS 3Bis/E 45 tra Sarsina e San Piero in Bagno,,,,,,,,
2019/01,631,10/01/2019,4,SS 3Bis/E 45 tra Sarsina e San Piero in Bagno,,,,,,,,
2019/01,631,11/01/2019,5,SS 3Bis/E 45 tra Sarsina e San Piero in Bagno,,,,,,,,
2019/01,631,12/01/2019,6,SS 3Bis/E 45 tra Sarsina e San Piero in Bagno,,,,,,,,
2019/01,631,13/01/2019,7,SS 3Bis/E 45 tra Sarsina e San Piero in Bagno,,,,,,,,
2019/01,631,14/01/2019,1,SS 3Bis/E 45 tra Sarsina e San Piero in Bagno,,,,,,,,
2019/01,632,01/01/2019,2,SS 724Dir/tangenziale complanare sud alla A 1 in direzione Reggio Emilia - tra intersezione Modena/Sassuolo e intersezione SS 12,3296,00,3272,24,2027,1269,0,3296
2019/01,632,02/01/2019,3,SS 724Dir/tangenziale complanare sud alla A 1 in direzione Reggio Emilia - tra intersezione Modena/Sassuolo e intersezione SS 12,5738,10,5440,297,4680,1058,5738,0
2019/01,633,01/01/2019,2,SS 724Dir/tangenziale complanare sud alla A 1 in direzione Bologna - tra intersezione Modena/Sassuolo e intersezione SS12,3048,00,3030,18,1722,1326,0,3048
2019/01,633,02/01/2019,3,SS 724Dir/tangenziale complanare sud alla A 1 in direzione Bologna - tra intersezione Modena/Sassuolo e intersezione SS12,5521,10,5223,297,4265,1256,5521,0
2019/01,633,03/01/2019,4,SS 724Dir/tangenziale complanare sud alla A 1 in direzione Bologna - tra intersezione Modena/Sassuolo e intersezione SS12,6139,10,5807,331,4741,1398,6139,0
2019/01,633,04/01/2019,5,SS 724Dir/tangenziale complanare sud alla A 1 in direzione Bologna - tra intersezione Modena/Sassuolo e intersezione SS12,6285,00,5927,358,4751,1534,6285,0
2019/01,633,05/01/2019,6,SS 724Dir/tangenziale complanare sud alla A 1 in direzione Bologna - tra intersezione Modena/Sassuolo e intersezione SS12,5387,00,5273,114,3762,1625,0,5387
2019/01,633,06/01/2019,7,SS 724Dir/tangenziale complanare sud alla A 1 in direzione Bologna - tra intersezione Modena/Sassuolo e intersezione SS12,4830,00,4802,28,3302,1528,0,4830
2019/01,633,07/01/2019,1,SS 724Dir/tangenziale complanare sud alla A 1 in direzione Bologna - tra intersezione Modena/Sassuolo e intersezione SS12,7359,00,6877,482,5765,1594,7359,0
2019/01,633,08/01/2019,2,SS 724Dir/tangenziale complanare sud alla A 1 in direzione Bologna - tra intersezione Modena/Sassuolo e intersezione SS12,7405,00,6941,464,5818,1587,7405,0
2019/01,633,09/01/2019,3,SS 724Dir/tangenziale complanare sud alla A 1 in direzione Bologna - tra intersezione Modena/Sassuolo e intersezione SS12,7540,10,7058,481,5836,1704,7540,0
2019/01,633,10/01/2019,4,SS 724Dir/tangenziale complanare sud alla A 1 in direzione Bologna - tra intersezione Modena/Sassuolo e intersezione SS12,7929,10,7437,491,6058,1871,7929,0
2019/01,633,11/01/2019,5,SS 724Dir/tangenziale complanare sud alla A 1 in direzione Bologna - tra intersezione Modena/Sassuolo e intersezione SS12,7878,10,7359,518,5943,1935,7878,0
2019/01,633,12/01/2019,6,SS 724Dir/tangenziale complanare sud alla A 1 in direzione Bologna - tra intersezione Modena/Sassuolo e intersezione SS12,6398,00,6291,107,4520,1878,0,6398
2019/01,633,13/01/2019,7,SS 724Dir/tangenziale complanare sud alla A 1 in direzione Bologna - tra intersezione Modena/Sassuolo e intersezione SS12,5030,00,5006,24,3493,1537,0,5030
2019/01,633,14/01/2019,1,SS 724Dir/tangenziale complanare sud alla A 1 in direzione Bologna - tra intersezione Modena/Sassuolo e intersezione SS12,7724,00,7220,504,5980,1744,7724,0
2019/01,634,07/01/2019,1,SS 12 tra Pavullo e intersezione SP 31,,,,,,,,
2019/01,634,10/01/2019,4,SS 12 tra Pavullo e intersezione SP 31,,,,,,,,
2019/01,634,14/01/2019,1,SS 12 tra Pavullo e intersezione SP 31,,,,,,,,
2019/01,635,01/01/2019,2,SS 725 (tg sud Piacenza) tra intersezione SS 45 e l'intersezione SP 6,17787,00,17684,103,11127,6660,0,17787
2019/01,635,02/01/2019,3,SS 725 (tg sud Piacenza) tra intersezione SS 45 e l'intersezione SP 6,35046,00,33524,1522,28606,6440,35046,0
2019/01,635,03/01/2019,4,SS 725 (tg sud Piacenza) tra intersezione SS 45 e l'intersezione SP 6,36973,10,35226,1746,30077,6896,36973,0
2019/01,635,04/01/2019,5,SS 725 (tg sud Piacenza) tra intersezione SS 45 e l'intersezione SP 6,38212,10,36388,1823,30598,7614,38212,0
2019/01,635,05/01/2019,6,SS 725 (tg sud Piacenza) tra intersezione SS 45 e l'intersezione SP 6,35790,00,35103,687,27669,8121,0,35790
2019/01,635,06/01/2019,7,SS 725 (tg sud Piacenza) tra intersezione SS 45 e l'intersezione SP 6,29393,00,29202,191,22449,6944,0,29393
2019/01,635,07/01/2019,1,SS 725 (tg sud Piacenza) tra intersezione SS 45 e l'intersezione SP 6,42329,10,39596,2732,34581,7748,42329,0
2019/01,635,08/01/2019,2,SS 725 (tg sud Piacenza) tra intersezione SS 45 e l'intersezione SP 6,41523,20,38747,2774,34129,7394,41523,0
2019/01,635,09/01/2019,3,SS 725 (tg sud Piacenza) tra intersezione SS 45 e l'intersezione SP 6,43260,20,40415,2843,35172,8088,43260,0
2019/01,635,10/01/2019,4,SS 725 (tg sud Piacenza) tra intersezione SS 45 e l'intersezione SP 6,44365,20,41500,2863,35934,8431,44365,0
2019/01,635,11/01/2019,5,SS 725 (tg sud Piacenza) tra intersezione SS 45 e l'intersezione SP 6,46241,10,43320,2920,36678,9563,46241,0
2019/01,635,12/01/2019,6,SS 725 (tg sud Piacenza) tra intersezione SS 45 e l'intersezione SP 6,38624,00,37782,842,29550,9074,0,38624
2019/01,635,13/01/2019,7,SS 725 (tg sud Piacenza) tra intersezione SS 45 e l'intersezione SP 6,30369,00,30176,193,23055,7314,0,30369
2019/01,635,14/01/2019,1,SS 725 (tg sud Piacenza) tra intersezione SS 45 e l'intersezione SP 6,43944,10,40794,3149,35887,8057,43944,0
2019/01,638,01/01/2019,2,SS 9 tra la tangenziale nord di Reggio Emilia e Sant'Ilario d'Enza,9874,00,9743,131,5274,4600,0,9874
2019/01,638,02/01/2019,3,SS 9 tra la tangenziale nord di Reggio Emilia e Sant'Ilario d'Enza,14148,00,13357,791,10756,3392,14148,0
2019/01,638,03/01/2019,4,SS 9 tra la tangenziale nord di Reggio Emilia e Sant'Ilario d'Enza,15798,00,14837,961,11872,3926,15798,0
2019/01,638,04/01/2019,5,SS 9 tra la tangenziale nord di Reggio Emilia e Sant'Ilario d'Enza,16768,00,15712,1056,12180,4588,16768,0
2019/01,638,05/01/2019,6,SS 9 tra la tangenziale nord di Reggio Emilia e Sant'Ilario d'Enza,16392,00,15998,394,11177,5215,0,16392
2019/01,638,06/01/2019,7,SS 9 tra la tangenziale nord di Reggio Emilia e Sant'Ilario d'Enza,14031,00,13894,137,9515,4516,0,14031
2019/01,638,07/01/2019,1,SS 9 tra la tangenziale nord di Reggio Emilia e Sant'Ilario d'Enza,17442,00,15960,1482,13382,4060,17442,0
2019/01,638,08/01/2019,2,SS 9 tra la tangenziale nord di Reggio Emilia e Sant'Ilario d'Enza,17858,00,16427,1431,13571,4287,17858,0
2019/01,638,09/01/2019,3,SS 9 tra la tangenziale nord di Reggio Emilia e Sant'Ilario d'Enza,18636,00,17124,1512,14026,4610,18636,0
2019/01,638,10/01/2019,4,SS 9 tra la tangenziale nord di Reggio Emilia e Sant'Ilario d'Enza,19089,00,17437,1652,14154,4935,19089,0
2019/01,638,11/01/2019,5,SS 9 tra la tangenziale nord di Reggio Emilia e Sant'Ilario d'Enza,19845,00,18244,1601,14191,5654,19845,0
2019/01,638,12/01/2019,6,SS 9 tra la tangenziale nord di Reggio Emilia e Sant'Ilario d'Enza,18948,00,18497,451,12726,6222,0,18948
2019/01,638,13/01/2019,7,SS 9 tra la tangenziale nord di Reggio Emilia e Sant'Ilario d'Enza,15986,00,15818,168,10766,5220,0,15986
2019/01,638,14/01/2019,1,SS 9 tra la tangenziale nord di Reggio Emilia e Sant'Ilario d'Enza,19140,20,17455,1683,14577,4563,19140,0
2019/01,639,01/01/2019,2,SS 63 località Casina (variante abitato),5133,00,5097,36,3667,1466,0,5133
2019/01,639,02/01/2019,3,SS 63 località Casina (variante abitato),5719,00,5516,203,4630,1089,5719,0
2019/01,639,03/01/2019,4,SS 63 località Casina (variante abitato),5817,10,5571,245,4575,1242,5817,0
2019/01,639,04/01/2019,5,SS 63 località Casina (variante abitato),6327,00,6107,220,4893,1434,6327,0
2019/01,639,05/01/2019,6,SS 63 località Casina (variante abitato),5824,00,5697,127,4400,1424,0,5824
2019/01,639,06/01/2019,7,SS 63 località Casina (variante abitato),5581,10,5550,30,4252,1329,0,5581
2019/01,639,07/01/2019,1,SS 63 località Casina (variante abitato),6074,10,5785,288,4800,1274,6074,0
2019/01,639,08/01/2019,2,SS 63 località Casina (variante abitato),6053,00,5776,277,4751,1302,6053,0
2019/01,639,09/01/2019,3,SS 63 località Casina (variante abitato),6352,10,6084,267,4966,1386,6352,0
2019/01,639,10/01/2019,4,SS 63 località Casina (variante abitato),6332,20,6045,285,4976,1356,6332,0
2019/01,639,11/01/2019,5,SS 63 località Casina (variante abitato),6990,20,6673,315,5413,1577,6990,0
2019/01,639,12/01/2019,6,SS 63 località Casina (variante abitato),6412,00,6271,141,4893,1519,0,6412
2019/01,639,13/01/2019,7,SS 63 località Casina (variante abitato),5722,00,5678,44,4398,1324,0,5722
2019/01,639,14/01/2019,1,SS 63 località Casina (variante abitato),6585,10,6227,357,5244,1341,6585,0
2019/01,651,01/01/2019,2,SS 9 da Imola a Castelbolognese (al confine provinciale),10661,00,10596,65,5955,4706,0,10661
2019/01,651,02/01/2019,3,SS 9 da Imola a Castelbolognese (al confine provinciale),14071,00,13723,348,10919,3152,14071,0
2019/01,651,03/01/2019,4,SS 9 da Imola a Castelbolognese (al confine provinciale),13031,00,12592,439,9716,3315,13031,0
2019/01,651,04/01/2019,5,SS 9 da Imola a Castelbolognese (al confine provinciale),14937,00,14502,435,11027,3910,14937,0
2019/01,651,05/01/2019,6,SS 9 da Imola a Castelbolognese (al confine provinciale),14995,00,14812,183,10084,4911,0,14995
2019/01,651,06/01/2019,7,SS 9 da Imola a Castelbolognese (al confine provinciale),12577,00,12514,63,8512,4065,0,12577
2019/01,651,07/01/2019,1,SS 9 da Imola a Castelbolognese (al confine provinciale),15751,00,15068,683,12380,3371,15751,0
2019/01,651,08/01/2019,2,SS 9 da Imola a Castelbolognese (al confine provinciale),16262,00,15566,696,12726,3536,16262,0
2019/01,651,09/01/2019,3,SS 9 da Imola a Castelbolognese (al confine provinciale),16067,00,15384,683,12395,3672,16067,0
2019/01,651,10/01/2019,4,SS 9 da Imola a Castelbolognese (al confine provinciale),16353,00,15630,723,12681,3672,16353,0
2019/01,651,11/01/2019,5,SS 9 da Imola a Castelbolognese (al confine provinciale),17270,00,16579,691,12693,4577,17270,0
2019/01,651,12/01/2019,6,SS 9 da Imola a Castelbolognese (al confine provinciale),16124,00,15936,188,10765,5359,0,16124
2019/01,651,13/01/2019,7,SS 9 da Imola a Castelbolognese (al confine provinciale),13558,00,13517,41,9604,3954,0,13558
2019/01,651,14/01/2019,1,SS 9 da Imola a Castelbolognese (al confine provinciale),15656,00,14946,710,12103,3553,15656,0
2019/01,652,01/01/2019,2,SS 16 dal bivio SP 610R ad Argenta,7003,00,6895,108,4658,2345,0,7003
2019/01,652,02/01/2019,3,SS 16 dal bivio SP 610R ad Argenta,10899,00,10054,845,8940,1959,10899,0
2019/01,652,03/01/2019,4,SS 16 dal bivio SP 610R ad Argenta,10326,00,9437,889,8387,1939,10326,0
2019/01,652,04/01/2019,5,SS 16 dal bivio SP 610R ad Argenta,10895,00,9983,912,8654,2241,10895,0
2019/01,652,05/01/2019,6,SS 16 dal bivio SP 610R ad Argenta,9704,00,9439,265,7368,2336,0,9704
2019/01,652,06/01/2019,7,SS 16 dal bivio SP 610R ad Argenta,8429,00,8344,85,6290,2139,0,8429
2019/01,652,07/01/2019,1,SS 16 dal bivio SP 610R ad Argenta,11300,00,10223,1077,9209,2091,11300,0
2019/01,652,08/01/2019,2,SS 16 dal bivio SP 610R ad Argenta,10984,00,9704,1280,9023,1961,10984,0
2019/01,652,09/01/2019,3,SS 16 dal bivio SP 610R ad Argenta,11215,00,9935,1280,9159,2056,11215,0
2019/01,652,10/01/2019,4,SS 16 dal bivio SP 610R ad Argenta,11445,00,10125,1320,9233,2212,11445,0
2019/01,652,11/01/2019,5,SS 16 dal bivio SP 610R ad Argenta,12463,00,11153,1310,9845,2618,12463,0
2019/01,652,12/01/2019,6,SS 16 dal bivio SP 610R ad Argenta,10039,00,9735,304,7719,2320,0,10039
2019/01,652,13/01/2019,7,SS 16 dal bivio SP 610R ad Argenta,8308,00,8231,77,6168,2140,0,8308
2019/01,652,14/01/2019,1,SS 16 dal bivio SP 610R ad Argenta,11972,00,10607,1365,9670,2302,11972,0
2019/01,653,12/01/2019,6,SP 254R dal ponte sul fiume Savio alla SS 16,8083,00,8026,57,5916,2167,0,8083
2019/01,654,01/01/2019,2,SP 7IBisR dal bivio SSPP 32/33ter alla SS 16,12058,00,11969,89,8359,3699,0,12058
2019/01,654,02/01/2019,3,SP 7IBisR dal bivio SSPP 32/33ter alla SS 16,9533,00,9273,260,7787,1746,9533,0
2019/01,654,03/01/2019,4,SP 7IBisR dal bivio SSPP 32/33ter alla SS 16,10541,00,10269,272,8480,2061,10541,0
2019/01,654,04/01/2019,5,SP 7IBisR dal bivio SSPP 32/33ter alla SS 16,10539,00,10280,259,8076,2463,10539,0
2019/01,654,05/01/2019,6,SP 7IBisR dal bivio SSPP 32/33ter alla SS 16,10415,00,10305,110,7383,3032,0,10415
2019/01,654,06/01/2019,7,SP 7IBisR dal bivio SSPP 32/33ter alla SS 16,10721,00,10664,57,8198,2523,0,10721
2019/01,654,07/01/2019,1,SP 7IBisR dal bivio SSPP 32/33ter alla SS 16,10294,00,9898,396,8431,1863,10294,0
2019/01,654,08/01/2019,2,SP 7IBisR dal bivio SSPP 32/33ter alla SS 16,10378,00,9974,404,8553,1825,10378,0
2019/01,654,09/01/2019,3,SP 7IBisR dal bivio SSPP 32/33ter alla SS 16,10628,00,10187,441,8580,2048,10628,0
2019/01,654,10/01/2019,4,SP 7IBisR dal bivio SSPP 32/33ter alla SS 16,10850,00,10443,407,8703,2147,10850,0
2019/01,654,11/01/2019,5,SP 7IBisR dal bivio SSPP 32/33ter alla SS 16,11152,00,10758,394,8777,2375,11152,0
2019/01,654,12/01/2019,6,SP 7IBisR dal bivio SSPP 32/33ter alla SS 16,10621,00,10478,143,7538,3083,0,10621
2019/01,654,13/01/2019,7,SP 7IBisR dal bivio SSPP 32/33ter alla SS 16,10659,00,10638,21,7735,2924,0,10659
2019/01,654,14/01/2019,1,SP 7IBisR dal bivio SSPP 32/33ter alla SS 16,10714,00,10288,426,8799,1915,10714,0
2019/01,655,01/01/2019,2,SP 253R dal bivio SP 302R allo svincolo A 14dir a Fornace Zarattini,9662,00,9615,47,6208,3454,0,9662
2019/01,655,02/01/2019,3,SP 253R dal bivio SP 302R allo svincolo A 14dir a Fornace Zarattini,13515,00,13076,439,10892,2623,13515,0
2019/01,655,03/01/2019,4,SP 253R dal bivio SP 302R allo svincolo A 14dir a Fornace Zarattini,14711,00,14147,564,11784,2927,14711,0
2019/01,655,04/01/2019,5,SP 253R dal bivio SP 302R allo svincolo A 14dir a Fornace Zarattini,14716,00,14200,516,11602,3114,14716,0
2019/01,655,05/01/2019,6,SP 253R dal bivio SP 302R allo svincolo A 14dir a Fornace Zarattini,13115,00,12939,176,9528,3587,0,13115
2019/01,655,06/01/2019,7,SP 253R dal bivio SP 302R allo svincolo A 14dir a Fornace Zarattini,10721,00,10672,49,7956,2765,0,10721
2019/01,655,07/01/2019,1,SP 253R dal bivio SP 302R allo svincolo A 14dir a Fornace Zarattini,16551,00,15800,751,13578,2973,16551,0
2019/01,655,08/01/2019,2,SP 253R dal bivio SP 302R allo svincolo A 14dir a Fornace Zarattini,16669,00,15880,789,13701,2968,16669,0
2019/01,655,09/01/2019,3,SP 253R dal bivio SP 302R allo svincolo A 14dir a Fornace Zarattini,17080,00,16283,797,13804,3276,17080,0
2019/01,655,10/01/2019,4,SP 253R dal bivio SP 302R allo svincolo A 14dir a Fornace Zarattini,17210,00,16428,782,13806,3404,17210,0
2019/01,655,11/01/2019,5,SP 253R dal bivio SP 302R allo svincolo A 14dir a Fornace Zarattini,17896,00,17044,852,14193,3703,17896,0
2019/01,655,12/01/2019,6,SP 253R dal bivio SP 302R allo svincolo A 14dir a Fornace Zarattini,14874,00,14670,204,10823,4051,0,14874
2019/01,655,13/01/2019,7,SP 253R dal bivio SP 302R allo svincolo A 14dir a Fornace Zarattini,11357,00,11300,57,8379,2978,0,11357
2019/01,655,14/01/2019,1,SP 253R dal bivio SP 302R allo svincolo A 14dir a Fornace Zarattini,17153,00,16325,828,14043,3110,17153,0
2019/01,660,01/01/2019,2,SP 25 tra intersezione con SS 64 e confine provinciale,,,,,,,,
2019/01,660,02/01/2019,3,SP 25 tra intersezione con SS 64 e confine provinciale,,,,,,,,
2019/01,660,03/01/2019,4,SP 25 tra intersezione con SS 64 e confine provinciale,,,,,,,,
2019/01,660,04/01/2019,5,SP 25 tra intersezione con SS 64 e confine provinciale,,,,,,,,
2019/01,660,05/01/2019,6,SP 25 tra intersezione con SS 64 e confine provinciale,,,,,,,,
2019/01,660,06/01/2019,7,SP 25 tra intersezione con SS 64 e confine provinciale,,,,,,,,
2019/01,660,07/01/2019,1,SP 25 tra intersezione con SS 64 e confine provinciale,,,,,,,,
2019/01,660,08/01/2019,2,SP 25 tra intersezione con SS 64 e confine provinciale,,,,,,,,
2019/01,660,09/01/2019,3,SP 25 tra intersezione con SS 64 e confine provinciale,,,,,,,,
2019/01,660,10/01/2019,4,SP 25 tra intersezione con SS 64 e confine provinciale,,,,,,,,
2019/01,660,11/01/2019,5,SP 25 tra intersezione con SS 64 e confine provinciale,,,,,,,,
2019/01,660,12/01/2019,6,SP 25 tra intersezione con SS 64 e confine provinciale,,,,,,,,
2019/01,660,13/01/2019,7,SP 25 tra intersezione con SS 64 e confine provinciale,,,,,,,,
2019/01,660,14/01/2019,1,SP 25 tra intersezione con SS 64 e confine provinciale,,,,,,,,
2019/01,661,01/01/2019,2,SP 15 tra Tresigallo e Massa Fiscaglia,1944,00,1939,5,1320,624,0,1944
2019/01,661,02/01/2019,3,SP 15 tra Tresigallo e Massa Fiscaglia,2717,10,2620,96,2183,534,2717,0
2019/01,661,03/01/2019,4,SP 15 tra Tresigallo e Massa Fiscaglia,2843,00,2743,100,2285,558,2843,0
2019/01,661,04/01/2019,5,SP 15 tra Tresigallo e Massa Fiscaglia,2877,10,2747,129,2275,602,2877,0
2019/01,661,05/01/2019,6,SP 15 tra Tresigallo e Massa Fiscaglia,2661,00,2593,68,1953,708,0,2661
2019/01,661,06/01/2019,7,SP 15 tra Tresigallo e Massa Fiscaglia,2491,00,2476,15,1871,620,0,2491
2019/01,661,07/01/2019,1,SP 15 tra Tresigallo e Massa Fiscaglia,3062,00,2930,132,2476,586,3062,0
2019/01,661,08/01/2019,2,SP 15 tra Tresigallo e Massa Fiscaglia,3069,10,2935,133,2495,574,3069,0
2019/01,661,09/01/2019,3,SP 15 tra Tresigallo e Massa Fiscaglia,3082,20,2931,149,2505,577,3082,0
2019/01,661,10/01/2019,4,SP 15 tra Tresigallo e Massa Fiscaglia,3214,00,3084,130,2604,610,3214,0
2019/01,661,11/01/2019,5,SP 15 tra Tresigallo e Massa Fiscaglia,3286,00,3171,115,2615,671,3286,0
2019/01,661,12/01/2019,6,SP 15 tra Tresigallo e Massa Fiscaglia,2754,00,2689,65,2017,737,0,2754
2019/01,661,13/01/2019,7,SP 15 tra Tresigallo e Massa Fiscaglia,2566,00,2560,6,1941,625,0,2566
2019/01,661,14/01/2019,1,SP 15 tra Tresigallo e Massa Fiscaglia,3118,10,2987,130,2521,597,3118,0
2019/01,662,01/01/2019,2,SP 2 tra intersezione SP 14 e Copparo,5793,00,5775,18,3558,2235,0,5793
2019/01,662,02/01/2019,3,SP 2 tra intersezione SP 14 e Copparo,10839,00,10597,242,8794,2045,10839,0
2019/01,662,03/01/2019,4,SP 2 tra intersezione SP 14 e Copparo,11360,00,11049,311,9169,2191,11360,0
2019/01,662,04/01/2019,5,SP 2 tra intersezione SP 14 e Copparo,11965,00,11590,375,9606,2359,11965,0
2019/01,662,05/01/2019,6,SP 2 tra intersezione SP 14 e Copparo,9865,00,9728,137,7455,2410,0,9865
2019/01,662,06/01/2019,7,SP 2 tra intersezione SP 14 e Copparo,8135,00,8113,22,5945,2190,0,8135
2019/01,662,07/01/2019,1,SP 2 tra intersezione SP 14 e Copparo,12796,00,12276,520,10546,2250,12796,0
2019/01,662,08/01/2019,2,SP 2 tra intersezione SP 14 e Copparo,12384,00,11862,522,10168,2216,12384,0
2019/01,662,09/01/2019,3,SP 2 tra intersezione SP 14 e Copparo,12641,10,12103,537,10334,2307,12641,0
2019/01,662,10/01/2019,4,SP 2 tra intersezione SP 14 e Copparo,13013,00,12429,584,10463,2550,13013,0
2019/01,662,11/01/2019,5,SP 2 tra intersezione SP 14 e Copparo,13537,00,13030,507,10798,2739,13537,0
2019/01,662,12/01/2019,6,SP 2 tra intersezione SP 14 e Copparo,10750,00,10635,115,8172,2578,0,10750
2019/01,662,13/01/2019,7,SP 2 tra intersezione SP 14 e Copparo,8037,00,8006,31,5810,2227,0,8037
2019/01,662,14/01/2019,1,SP 2 tra intersezione SP 14 e Copparo,12919,00,12380,539,10562,2357,12919,0
2019/01,663,01/01/2019,2,SP 60 tra intersezione SP 68 e SP62,1902,00,1892,10,1337,565,0,1902
2019/01,663,02/01/2019,3,SP 60 tra intersezione SP 68 e SP62,2393,00,2080,313,1904,489,2393,0
2019/01,663,03/01/2019,4,SP 60 tra intersezione SP 68 e SP62,2501,00,2176,325,2020,481,2501,0
2019/01,663,04/01/2019,5,SP 60 tra intersezione SP 68 e SP62,2654,00,2335,319,2085,569,2654,0
2019/01,663,05/01/2019,6,SP 60 tra intersezione SP 68 e SP62,2246,00,2140,106,1696,550,0,2246
2019/01,663,06/01/2019,7,SP 60 tra intersezione SP 68 e SP62,2318,00,2290,28,1783,535,0,2318
2019/01,663,07/01/2019,1,SP 60 tra intersezione SP 68 e SP62,2652,00,2275,377,2100,552,2652,0
2019/01,663,08/01/2019,2,SP 60 tra intersezione SP 68 e SP62,2640,00,2330,310,2154,486,2640,0
2019/01,663,09/01/2019,3,SP 60 tra intersezione SP 68 e SP62,2596,00,2260,336,2125,471,2596,0
2019/01,663,10/01/2019,4,SP 60 tra intersezione SP 68 e SP62,2821,00,2430,391,2283,538,2821,0
2019/01,663,11/01/2019,5,SP 60 tra intersezione SP 68 e SP62,3040,10,2623,416,2389,651,3040,0
2019/01,663,12/01/2019,6,SP 60 tra intersezione SP 68 e SP62,2360,00,2231,129,1788,572,0,2360
2019/01,663,13/01/2019,7,SP 60 tra intersezione SP 68 e SP62,2600,00,2579,21,2049,551,0,2600
2019/01,663,14/01/2019,1,SP 60 tra intersezione SP 68 e SP62,2855,10,2376,478,2295,560,2855,0
2019/01,665,07/01/2019,1,SP 1 tra intersezione SP7 a Piacenza,9802,20,9271,529,7778,2024,9802,0
2019/01,665,08/01/2019,2,SP 1 tra intersezione SP7 a Piacenza,5644,00,5285,359,5041,603,5644,0
2019/01,665,11/01/2019,5,SP 1 tra intersezione SP7 a Piacenza,8270,00,7903,367,6402,1868,8270,0
2019/01,665,12/01/2019,6,SP 1 tra intersezione SP7 a Piacenza,9747,20,9611,134,7179,2568,0,9747
2019/01,665,13/01/2019,7,SP 1 tra intersezione SP7 a Piacenza,7062,00,7018,44,5028,2034,0,7062
2019/01,665,14/01/2019,1,SP 1 tra intersezione SP7 a Piacenza,11348,00,10805,543,9156,2192,11348,0
2019/01,666,01/01/2019,2,SP 3 tra via Monda e via Caminate,4504,00,4493,11,2900,1604,0,4504
2019/01,666,02/01/2019,3,SP 3 tra via Monda e via Caminate,5927,00,5707,220,4703,1224,5927,0
2019/01,666,03/01/2019,4,SP 3 tra via Monda e via Caminate,6406,00,6133,273,5035,1371,6406,0
2019/01,666,04/01/2019,5,SP 3 tra via Monda e via Caminate,6683,00,6406,277,5260,1423,6683,0
2019/01,666,05/01/2019,6,SP 3 tra via Monda e via Caminate,5649,10,5552,96,4152,1497,0,5649
2019/01,666,06/01/2019,7,SP 3 tra via Monda e via Caminate,4988,10,4972,15,3738,1250,0,4988
2019/01,666,07/01/2019,1,SP 3 tra via Monda e via Caminate,7535,10,7135,399,6149,1386,7535,0
2019/01,666,08/01/2019,2,SP 3 tra via Monda e via Caminate,7271,00,6883,388,5925,1346,7271,0
2019/01,666,09/01/2019,3,SP 3 tra via Monda e via Caminate,7618,00,7207,411,6163,1455,7618,0
2019/01,666,10/01/2019,4,SP 3 tra via Monda e via Caminate,7610,10,7146,463,6145,1465,7610,0
2019/01,666,11/01/2019,5,SP 3 tra via Monda e via Caminate,7737,10,7326,410,6225,1512,7737,0
2019/01,666,12/01/2019,6,SP 3 tra via Monda e via Caminate,6367,00,6293,74,4660,1707,0,6367
2019/01,666,13/01/2019,7,SP 3 tra via Monda e via Caminate,5042,00,5019,23,3722,1320,0,5042
2019/01,666,14/01/2019,1,SP 3 tra via Monda e via Caminate,7520,10,7065,454,6109,1411,7520,0
2019/01,670,01/01/2019,2,SP 114 dalla rotatoria SP 114/viale Parisoli alla rotatoria SP467,6081,00,6056,25,3532,2549,0,6081
2019/01,670,02/01/2019,3,SP 114 dalla rotatoria SP 114/viale Parisoli alla rotatoria SP467,11965,00,11629,336,9838,2127,11965,0
2019/01,670,03/01/2019,4,SP 114 dalla rotatoria SP 114/viale Parisoli alla rotatoria SP467,12916,00,12459,457,10407,2509,12916,0
2019/01,670,04/01/2019,5,SP 114 dalla rotatoria SP 114/viale Parisoli alla rotatoria SP467,13631,00,13213,418,10822,2809,13631,0
2019/01,670,05/01/2019,6,SP 114 dalla rotatoria SP 114/viale Parisoli alla rotatoria SP467,11452,00,11298,154,8262,3190,0,11452
2019/01,670,06/01/2019,7,SP 114 dalla rotatoria SP 114/viale Parisoli alla rotatoria SP467,8372,00,8326,46,5974,2398,0,8372
2019/01,670,07/01/2019,1,SP 114 dalla rotatoria SP 114/viale Parisoli alla rotatoria SP467,15819,00,15227,592,12953,2866,15819,0
2019/01,670,08/01/2019,2,SP 114 dalla rotatoria SP 114/viale Parisoli alla rotatoria SP467,15886,00,15190,696,13135,2751,15886,0
2019/01,670,09/01/2019,3,SP 114 dalla rotatoria SP 114/viale Parisoli alla rotatoria SP467,16665,20,15926,737,13649,3016,16665,0
2019/01,670,10/01/2019,4,SP 114 dalla rotatoria SP 114/viale Parisoli alla rotatoria SP467,16825,10,16028,796,13546,3279,16825,0
2019/01,670,11/01/2019,5,SP 114 dalla rotatoria SP 114/viale Parisoli alla rotatoria SP467,17765,10,16966,798,14257,3508,17765,0
2019/01,670,12/01/2019,6,SP 114 dalla rotatoria SP 114/viale Parisoli alla rotatoria SP467,13248,00,13085,163,9857,3391,0,13248
2019/01,670,13/01/2019,7,SP 114 dalla rotatoria SP 114/viale Parisoli alla rotatoria SP467,9430,00,9388,42,6682,2748,0,9430
2019/01,670,14/01/2019,1,SP 114 dalla rotatoria SP 114/viale Parisoli alla rotatoria SP467,16582,00,15812,770,13623,2959,16582,0
2019/01,6,15/01/2019,2,SS 12 tra Fiumalbo e Abetone,1288,00,1257,31,1080,208,1288,0
2019/01,6,16/01/2019,3,SS 12 tra Fiumalbo e Abetone,1293,00,1259,34,1119,174,1293,0
2019/01,6,17/01/2019,4,SS 12 tra Fiumalbo e Abetone,1378,00,1346,32,1167,211,1378,0
2019/01,6,18/01/2019,5,SS 12 tra Fiumalbo e Abetone,1820,20,1773,45,1390,430,1820,0
2019/01,6,19/01/2019,6,SS 12 tra Fiumalbo e Abetone,2524,10,2510,13,1910,614,0,2524
2019/01,6,20/01/2019,7,SS 12 tra Fiumalbo e Abetone,2367,00,2363,4,1960,407,0,2367
2019/01,6,21/01/2019,1,SS 12 tra Fiumalbo e Abetone,1286,00,1249,37,1092,194,1286,0
2019/01,6,22/01/2019,2,SS 12 tra Fiumalbo e Abetone,1106,00,1076,30,943,163,1106,0
2019/01,6,23/01/2019,3,SS 12 tra Fiumalbo e Abetone,1076,00,1030,46,902,174,1076,0
2019/01,6,24/01/2019,4,SS 12 tra Fiumalbo e Abetone,1172,00,1124,48,971,201,1172,0
2019/01,6,25/01/2019,5,SS 12 tra Fiumalbo e Abetone,2255,10,2215,39,1682,573,2255,0
2019/01,6,26/01/2019,6,SS 12 tra Fiumalbo e Abetone,3475,00,3452,23,2768,707,0,3475
2019/01,6,27/01/2019,7,SS 12 tra Fiumalbo e Abetone,2963,00,2949,14,2563,400,0,2963
2019/01,6,28/01/2019,1,SS 12 tra Fiumalbo e Abetone,1344,10,1296,47,1151,193,1344,0
2019/01,7,15/01/2019,2,SS 64 tra Porretta Terme e Sambuca Pistoiese,6689,20,6444,243,5613,1076,6689,0
2019/01,7,16/01/2019,3,SS 64 tra Porretta Terme e Sambuca Pistoiese,6664,10,6390,273,5499,1165,6664,0
2019/01,7,17/01/2019,4,SS 64 tra Porretta Terme e Sambuca Pistoiese,6385,00,6148,237,5241,1144,6385,0
2019/01,7,18/01/2019,5,SS 64 tra Porretta Terme e Sambuca Pistoiese,7230,10,6932,297,5892,1338,7230,0
2019/01,7,19/01/2019,6,SS 64 tra Porretta Terme e Sambuca Pistoiese,7113,00,7008,105,5783,1330,0,7113
2019/01,7,20/01/2019,7,SS 64 tra Porretta Terme e Sambuca Pistoiese,5354,00,5327,27,4290,1064,0,5354
2019/01,7,21/01/2019,1,SS 64 tra Porretta Terme e Sambuca Pistoiese,6212,00,5951,261,5269,943,6212,0
2019/01,7,22/01/2019,2,SS 64 tra Porretta Terme e Sambuca Pistoiese,5892,00,5671,221,4973,919,5892,0
2019/01,7,23/01/2019,3,SS 64 tra Porretta Terme e Sambuca Pistoiese,5340,10,5115,224,4446,894,5340,0
2019/01,7,24/01/2019,4,SS 64 tra Porretta Terme e Sambuca Pistoiese,4762,20,4569,191,3906,856,4762,0
2019/01,7,25/01/2019,5,SS 64 tra Porretta Terme e Sambuca Pistoiese,6911,00,6658,253,5614,1297,6911,0
2019/01,7,26/01/2019,6,SS 64 tra Porretta Terme e Sambuca Pistoiese,7493,00,7393,100,6194,1299,0,7493
2019/01,7,27/01/2019,7,SS 64 tra Porretta Terme e Sambuca Pistoiese,5255,00,5218,37,4262,993,0,5255
2019/01,7,28/01/2019,1,SS 64 tra Porretta Terme e Sambuca Pistoiese,6513,00,6252,261,5479,1034,6513,0
2019/01,9,15/01/2019,2,SS 67 tra Rocca San Casciano e Portico San Benedetto,1040,00,942,98,875,165,1040,0
2019/01,9,16/01/2019,3,SS 67 tra Rocca San Casciano e Portico San Benedetto,1117,10,1034,82,922,195,1117,0
2019/01,9,17/01/2019,4,SS 67 tra Rocca San Casciano e Portico San Benedetto,1036,00,940,96,855,181,1036,0
2019/01,9,18/01/2019,5,SS 67 tra Rocca San Casciano e Portico San Benedetto,1175,00,1072,103,950,225,1175,0
2019/01,9,19/01/2019,6,SS 67 tra Rocca San Casciano e Portico San Benedetto,1007,00,979,28,829,178,0,1007
2019/01,9,20/01/2019,7,SS 67 tra Rocca San Casciano e Portico San Benedetto,947,00,942,5,750,197,0,947
2019/01,9,21/01/2019,1,SS 67 tra Rocca San Casciano e Portico San Benedetto,1077,00,985,92,888,189,1077,0
2019/01,9,22/01/2019,2,SS 67 tra Rocca San Casciano e Portico San Benedetto,895,00,817,78,755,140,895,0
2019/01,9,23/01/2019,3,SS 67 tra Rocca San Casciano e Portico San Benedetto,928,00,852,76,766,162,928,0
2019/01,9,24/01/2019,4,SS 67 tra Rocca San Casciano e Portico San Benedetto,878,00,792,86,723,155,878,0
2019/01,9,25/01/2019,5,SS 67 tra Rocca San Casciano e Portico San Benedetto,1104,00,1033,71,916,188,1104,0
2019/01,9,26/01/2019,6,SS 67 tra Rocca San Casciano e Portico San Benedetto,1086,10,1049,36,890,196,0,1086
2019/01,9,27/01/2019,7,SS 67 tra Rocca San Casciano e Portico San Benedetto,969,00,961,8,803,166,0,969
2019/01,9,28/01/2019,1,SS 67 tra Rocca San Casciano e Portico San Benedetto,995,00,931,64,838,157,995,0
2019/01,12,15/01/2019,2,SS 16 al Confine regionale (Marche),15937,00,15239,698,12759,3178,15937,0
2019/01,12,16/01/2019,3,SS 16 al Confine regionale (Marche),15925,10,15210,714,12688,3237,15925,0
2019/01,12,17/01/2019,4,SS 16 al Confine regionale (Marche),16097,10,15390,706,12770,3327,16097,0
2019/01,12,18/01/2019,5,SS 16 al Confine regionale (Marche),16453,00,15850,603,12557,3896,16453,0
2019/01,12,19/01/2019,6,SS 16 al Confine regionale (Marche),15767,00,15542,225,11083,4684,0,15767
2019/01,12,20/01/2019,7,SS 16 al Confine regionale (Marche),13427,10,13364,62,9355,4072,0,13427
2019/01,12,21/01/2019,1,SS 16 al Confine regionale (Marche),15397,00,14824,573,12256,3141,15397,0
2019/01,12,22/01/2019,2,SS 16 al Confine regionale (Marche),14331,20,13782,547,11419,2912,14331,0
2019/01,12,23/01/2019,3,SS 16 al Confine regionale (Marche),15117,10,14462,654,12082,3035,15117,0
2019/01,12,24/01/2019,4,SS 16 al Confine regionale (Marche),15960,10,15259,700,12601,3359,15960,0
2019/01,12,25/01/2019,5,SS 16 al Confine regionale (Marche),16528,00,15813,715,12648,3880,16528,0
2019/01,12,26/01/2019,6,SS 16 al Confine regionale (Marche),15472,10,15252,219,11158,4314,0,15472
2019/01,12,27/01/2019,7,SS 16 al Confine regionale (Marche),13101,10,13050,50,9317,3784,0,13101
2019/01,12,28/01/2019,1,SS 16 al Confine regionale (Marche),15491,20,14871,618,12385,3106,15491,0
2019/01,16,15/01/2019,2,SP 69 in località Pilastri al Confine regionale,1454,20,1311,141,1200,254,1454,0
2019/01,16,16/01/2019,3,SP 69 in località Pilastri al Confine regionale,1424,20,1277,145,1178,246,1424,0
2019/01,16,17/01/2019,4,SP 69 in località Pilastri al Confine regionale,1447,00,1294,153,1193,254,1447,0
2019/01,16,18/01/2019,5,SP 69 in località Pilastri al Confine regionale,1437,10,1300,136,1161,276,1437,0
2019/01,16,19/01/2019,6,SP 69 in località Pilastri al Confine regionale,1272,00,1236,36,935,337,0,1272
2019/01,16,20/01/2019,7,SP 69 in località Pilastri al Confine regionale,1096,00,1080,16,764,332,0,1096
2019/01,16,21/01/2019,1,SP 69 in località Pilastri al Confine regionale,1445,20,1299,144,1195,250,1445,0
2019/01,16,22/01/2019,2,SP 69 in località Pilastri al Confine regionale,1393,00,1251,142,1155,238,1393,0
2019/01,16,23/01/2019,3,SP 69 in località Pilastri al Confine regionale,1393,10,1246,146,1126,267,1393,0
2019/01,16,24/01/2019,4,SP 69 in località Pilastri al Confine regionale,1464,00,1276,188,1224,240,1464,0
2019/01,16,25/01/2019,5,SP 69 in località Pilastri al Confine regionale,1524,00,1368,156,1208,316,1524,0
2019/01,16,26/01/2019,6,SP 69 in località Pilastri al Confine regionale,1313,00,1278,35,976,337,0,1313
2019/01,16,27/01/2019,7,SP 69 in località Pilastri al Confine regionale,1162,00,1138,24,821,341,0,1162
2019/01,16,28/01/2019,1,SP 69 in località Pilastri al Confine regionale,1366,00,1234,132,1126,240,1366,0
2019/01,17,15/01/2019,2,SS 12 al Confine regionale (Lombardia),10506,00,9350,1156,8351,2155,10506,0
2019/01,17,16/01/2019,3,SS 12 al Confine regionale (Lombardia),10634,00,9515,1119,8421,2213,10634,0
2019/01,17,17/01/2019,4,SS 12 al Confine regionale (Lombardia),10480,00,9392,1088,8230,2250,10480,0
2019/01,17,18/01/2019,5,SS 12 al Confine regionale (Lombardia),10979,00,9885,1094,8468,2511,10979,0
2019/01,17,19/01/2019,6,SS 12 al Confine regionale (Lombardia),9082,00,8895,187,6720,2362,0,9082
2019/01,17,20/01/2019,7,SS 12 al Confine regionale (Lombardia),6803,00,6764,39,4895,1908,0,6803
2019/01,17,21/01/2019,1,SS 12 al Confine regionale (Lombardia),10209,00,9084,1125,8220,1989,10209,0
2019/01,17,22/01/2019,2,SS 12 al Confine regionale (Lombardia),10449,00,9366,1083,8395,2054,10449,0
2019/01,17,23/01/2019,3,SS 12 al Confine regionale (Lombardia),10326,00,9208,1118,8200,2126,10326,0
2019/01,17,24/01/2019,4,SS 12 al Confine regionale (Lombardia),10609,00,9483,1126,8371,2238,10609,0
2019/01,17,25/01/2019,5,SS 12 al Confine regionale (Lombardia),10880,00,9803,1077,8494,2386,10880,0
2019/01,17,26/01/2019,6,SS 12 al Confine regionale (Lombardia),8903,00,8688,215,6582,2321,0,8903
2019/01,17,27/01/2019,7,SS 12 al Confine regionale (Lombardia),6393,00,6337,56,4478,1915,0,6393
2019/01,17,28/01/2019,1,SS 12 al Confine regionale (Lombardia),10066,00,9095,971,8048,2018,10066,0
2019/01,19,15/01/2019,2,SP 343R tra Colorno e Casalmaggiore,965,00,811,154,827,138,965,0
2019/01,19,16/01/2019,3,SP 343R tra Colorno e Casalmaggiore,1011,00,877,134,857,154,1011,0
2019/01,19,17/01/2019,4,SP 343R tra Colorno e Casalmaggiore,983,10,879,103,825,158,983,0
2019/01,19,18/01/2019,5,SP 343R tra Colorno e Casalmaggiore,962,00,869,93,824,138,962,0
2019/01,19,19/01/2019,6,SP 343R tra Colorno e Casalmaggiore,704,00,689,15,564,140,0,704
2019/01,19,20/01/2019,7,SP 343R tra Colorno e Casalmaggiore,554,00,552,2,475,79,0,554
2019/01,19,21/01/2019,1,SP 343R tra Colorno e Casalmaggiore,1016,00,898,118,893,123,1016,0
2019/01,19,22/01/2019,2,SP 343R tra Colorno e Casalmaggiore,936,00,842,94,789,147,936,0
2019/01,19,23/01/2019,3,SP 343R tra Colorno e Casalmaggiore,949,00,835,114,796,153,949,0
2019/01,19,24/01/2019,4,SP 343R tra Colorno e Casalmaggiore,1019,00,906,113,868,151,1019,0
2019/01,19,25/01/2019,5,SP 343R tra Colorno e Casalmaggiore,982,00,856,126,827,155,982,0
2019/01,19,26/01/2019,6,SP 343R tra Colorno e Casalmaggiore,703,00,693,10,578,125,0,703
2019/01,19,27/01/2019,7,SP 343R tra Colorno e Casalmaggiore,478,00,475,3,408,70,0,478
2019/01,19,28/01/2019,1,SP 343R tra Colorno e Casalmaggiore,1059,00,914,145,909,150,1059,0
2019/01,25,15/01/2019,2,SS 9 tra San Prospero (Case Crostolo) e Sant'Ilario d'Enza,29623,60,27551,2066,22417,7206,29623,0
2019/01,25,16/01/2019,3,SS 9 tra San Prospero (Case Crostolo) e Sant'Ilario d'Enza,29859,30,27778,2078,22637,7222,29859,0
2019/01,25,17/01/2019,4,SS 9 tra San Prospero (Case Crostolo) e Sant'Ilario d'Enza,30424,20,28172,2250,22842,7582,30424,0
2019/01,25,18/01/2019,5,SS 9 tra San Prospero (Case Crostolo) e Sant'Ilario d'Enza,31325,70,29285,2033,22783,8542,31325,0
2019/01,25,19/01/2019,6,SS 9 tra San Prospero (Case Crostolo) e Sant'Ilario d'Enza,30683,00,30159,524,20865,9818,0,30683
2019/01,25,20/01/2019,7,SS 9 tra San Prospero (Case Crostolo) e Sant'Ilario d'Enza,25484,00,25334,150,17116,8368,0,25484
2019/01,25,21/01/2019,1,SS 9 tra San Prospero (Case Crostolo) e Sant'Ilario d'Enza,28975,30,26843,2129,22164,6811,28975,0
2019/01,25,22/01/2019,2,SS 9 tra San Prospero (Case Crostolo) e Sant'Ilario d'Enza,29594,50,27454,2135,22571,7023,29594,0
2019/01,25,23/01/2019,3,SS 9 tra San Prospero (Case Crostolo) e Sant'Ilario d'Enza,28805,30,26729,2073,22216,6589,28805,0
2019/01,25,24/01/2019,4,SS 9 tra San Prospero (Case Crostolo) e Sant'Ilario d'Enza,28789,20,26827,1960,21613,7176,28789,0
2019/01,25,25/01/2019,5,SS 9 tra San Prospero (Case Crostolo) e Sant'Ilario d'Enza,31468,40,29284,2180,22870,8598,31468,0
2019/01,25,26/01/2019,6,SS 9 tra San Prospero (Case Crostolo) e Sant'Ilario d'Enza,30010,10,29496,513,20408,9602,0,30010
2019/01,25,27/01/2019,7,SS 9 tra San Prospero (Case Crostolo) e Sant'Ilario d'Enza,24139,10,23996,142,16663,7476,0,24139
2019/01,25,28/01/2019,1,SS 9 tra San Prospero (Case Crostolo) e Sant'Ilario d'Enza,28726,40,26685,2037,22091,6635,28726,0
2019/01,29,15/01/2019,2,SS 9 tra Modena e Rubiera,24135,30,21792,2340,18328,5807,24135,0
2019/01,29,16/01/2019,3,SS 9 tra Modena e Rubiera,24573,10,22141,2431,18512,6061,24573,0
2019/01,29,17/01/2019,4,SS 9 tra Modena e Rubiera,24788,10,22283,2504,18619,6169,24788,0
2019/01,29,18/01/2019,5,SS 9 tra Modena e Rubiera,25488,10,23131,2356,18562,6926,25488,0
2019/01,29,19/01/2019,6,SS 9 tra Modena e Rubiera,24929,00,24548,381,17008,7921,0,24929
2019/01,29,20/01/2019,7,SS 9 tra Modena e Rubiera,22842,10,22737,104,15887,6955,0,22842
2019/01,29,21/01/2019,1,SS 9 tra Modena e Rubiera,23485,10,21260,2224,17973,5512,23485,0
2019/01,29,22/01/2019,2,SS 9 tra Modena e Rubiera,23931,00,21560,2371,18450,5481,23931,0
2019/01,29,23/01/2019,3,SS 9 tra Modena e Rubiera,23532,00,21185,2347,18218,5314,23532,0
2019/01,29,24/01/2019,4,SS 9 tra Modena e Rubiera,22684,00,20374,2310,17010,5674,22684,0
2019/01,29,25/01/2019,5,SS 9 tra Modena e Rubiera,25302,30,22945,2354,18567,6735,25302,0
2019/01,29,26/01/2019,6,SS 9 tra Modena e Rubiera,24368,00,23974,394,16806,7562,0,24368
2019/01,29,27/01/2019,7,SS 9 tra Modena e Rubiera,21358,00,21247,111,14988,6370,0,21358
2019/01,29,28/01/2019,1,SS 9 tra Modena e Rubiera,23517,20,21181,2334,18060,5457,23517,0
2019/01,52,15/01/2019,2,SP 253 tra Sesto Imolese e Medicina,6268,10,5525,742,4936,1332,6268,0
2019/01,52,16/01/2019,3,SP 253 tra Sesto Imolese e Medicina,6264,00,5538,726,4951,1313,6264,0
2019/01,52,17/01/2019,4,SP 253 tra Sesto Imolese e Medicina,6258,00,5617,641,4905,1353,6258,0
2019/01,52,18/01/2019,5,SP 253 tra Sesto Imolese e Medicina,6401,00,5721,680,4906,1495,6401,0
2019/01,52,19/01/2019,6,SP 253 tra Sesto Imolese e Medicina,4610,10,4484,125,3341,1269,0,4610
2019/01,52,20/01/2019,7,SP 253 tra Sesto Imolese e Medicina,3922,00,3888,34,2911,1011,0,3922
2019/01,52,21/01/2019,1,SP 253 tra Sesto Imolese e Medicina,5921,00,5287,634,4678,1243,5921,0
2019/01,52,22/01/2019,2,SP 253 tra Sesto Imolese e Medicina,5698,00,5121,577,4514,1184,5698,0
2019/01,52,23/01/2019,3,SP 253 tra Sesto Imolese e Medicina,5853,00,5219,634,4593,1260,5853,0
2019/01,52,24/01/2019,4,SP 253 tra Sesto Imolese e Medicina,5785,00,5146,639,4571,1214,5785,0
2019/01,52,25/01/2019,5,SP 253 tra Sesto Imolese e Medicina,6334,00,5669,665,4932,1402,6334,0
2019/01,52,26/01/2019,6,SP 253 tra Sesto Imolese e Medicina,4612,00,4466,146,3420,1192,0,4612
2019/01,52,27/01/2019,7,SP 253 tra Sesto Imolese e Medicina,3774,00,3727,47,2753,1021,0,3774
2019/01,52,28/01/2019,1,SP 253 tra Sesto Imolese e Medicina,5951,00,5259,692,4705,1246,5951,0
2019/01,53,15/01/2019,2,SS 309 a San Giuseppe di Comacchio,9843,00,5738,4105,7679,2164,9843,0
2019/01,53,16/01/2019,3,SS 309 a San Giuseppe di Comacchio,9693,10,5807,3885,7572,2121,9693,0
2019/01,53,17/01/2019,4,SS 309 a San Giuseppe di Comacchio,9612,00,5940,3672,7409,2203,9612,0
2019/01,53,18/01/2019,5,SS 309 a San Giuseppe di Comacchio,9517,00,6347,3170,7227,2290,9517,0
2019/01,53,19/01/2019,6,SS 309 a San Giuseppe di Comacchio,7724,00,6839,885,5544,2180,0,7724
2019/01,53,20/01/2019,7,SS 309 a San Giuseppe di Comacchio,7516,00,7188,328,5367,2149,0,7516
2019/01,53,21/01/2019,1,SS 309 a San Giuseppe di Comacchio,9448,00,6101,3347,7328,2120,9448,0
2019/01,53,22/01/2019,2,SS 309 a San Giuseppe di Comacchio,9411,10,5792,3618,7450,1961,9411,0
2019/01,53,23/01/2019,3,SS 309 a San Giuseppe di Comacchio,8914,00,5468,3446,6933,1981,8914,0
2019/01,53,24/01/2019,4,SS 309 a San Giuseppe di Comacchio,9325,10,5757,3567,7215,2110,9325,0
2019/01,53,25/01/2019,5,SS 309 a San Giuseppe di Comacchio,9487,10,6356,3130,7303,2184,9487,0
2019/01,53,26/01/2019,6,SS 309 a San Giuseppe di Comacchio,7877,00,6892,985,5715,2162,0,7877
2019/01,53,27/01/2019,7,SS 309 a San Giuseppe di Comacchio,7365,00,7074,291,5377,1988,0,7365
2019/01,53,28/01/2019,1,SS 309 a San Giuseppe di Comacchio,9034,10,5763,3270,6992,2042,9034,0
2019/01,95,15/01/2019,2,SP 10R tra Castel San Giovanni e Sarmato,,,,,,,,
2019/01,95,16/01/2019,3,SP 10R tra Castel San Giovanni e Sarmato,,,,,,,,
2019/01,95,17/01/2019,4,SP 10R tra Castel San Giovanni e Sarmato,,,,,,,,
2019/01,95,18/01/2019,5,SP 10R tra Castel San Giovanni e Sarmato,,,,,,,,
2019/01,95,19/01/2019,6,SP 10R tra Castel San Giovanni e Sarmato,,,,,,,,
2019/01,95,20/01/2019,7,SP 10R tra Castel San Giovanni e Sarmato,,,,,,,,
2019/01,95,21/01/2019,1,SP 10R tra Castel San Giovanni e Sarmato,,,,,,,,
2019/01,95,22/01/2019,2,SP 10R tra Castel San Giovanni e Sarmato,,,,,,,,
2019/01,95,23/01/2019,3,SP 10R tra Castel San Giovanni e Sarmato,,,,,,,,
2019/01,95,24/01/2019,4,SP 10R tra Castel San Giovanni e Sarmato,,,,,,,,
2019/01,95,25/01/2019,5,SP 10R tra Castel San Giovanni e Sarmato,,,,,,,,
2019/01,95,26/01/2019,6,SP 10R tra Castel San Giovanni e Sarmato,,,,,,,,
2019/01,95,27/01/2019,7,SP 10R tra Castel San Giovanni e Sarmato,,,,,,,,
2019/01,95,28/01/2019,1,SP 10R tra Castel San Giovanni e Sarmato,,,,,,,,
2019/01,98,15/01/2019,2,SP 302R tra Brisighella e Marradi,2864,00,2768,96,2258,606,2864,0
2019/01,98,16/01/2019,3,SP 302R tra Brisighella e Marradi,2976,00,2826,150,2338,638,2976,0
2019/01,98,17/01/2019,4,SP 302R tra Brisighella e Marradi,2908,00,2793,115,2256,652,2908,0
2019/01,98,18/01/2019,5,SP 302R tra Brisighella e Marradi,3094,00,2996,98,2350,744,3094,0
2019/01,98,19/01/2019,6,SP 302R tra Brisighella e Marradi,2614,00,2591,23,1995,619,0,2614
2019/01,98,20/01/2019,7,SP 302R tra Brisighella e Marradi,2539,00,2526,13,2037,502,0,2539
2019/01,98,21/01/2019,1,SP 302R tra Brisighella e Marradi,2822,00,2731,91,2223,599,2822,0
2019/01,98,22/01/2019,2,SP 302R tra Brisighella e Marradi,2472,00,2384,88,1958,514,2472,0
2019/01,98,23/01/2019,3,SP 302R tra Brisighella e Marradi,2514,00,2439,75,1984,530,2514,0
2019/01,98,24/01/2019,4,SP 302R tra Brisighella e Marradi,2449,00,2377,72,1940,509,2449,0
2019/01,98,25/01/2019,5,SP 302R tra Brisighella e Marradi,3016,00,2940,76,2301,715,3016,0
2019/01,98,26/01/2019,6,SP 302R tra Brisighella e Marradi,2863,00,2831,32,2169,694,0,2863
2019/01,98,27/01/2019,7,SP 302R tra Brisighella e Marradi,2732,00,2722,10,2259,473,0,2732
2019/01,98,28/01/2019,1,SP 302R tra Brisighella e Marradi,2693,00,2604,89,2148,545,2693,0
2019/01,100,15/01/2019,2,SP 258R tra Villa Verucchio ed ex Confine regionale (località Dogana),14566,00,13338,1228,11920,2646,14566,0
2019/01,100,16/01/2019,3,SP 258R tra Villa Verucchio ed ex Confine regionale (località Dogana),14675,00,13606,1069,11778,2897,14675,0
2019/01,100,17/01/2019,4,SP 258R tra Villa Verucchio ed ex Confine regionale (località Dogana),14896,00,13593,1303,11924,2972,14896,0
2019/01,100,18/01/2019,5,SP 258R tra Villa Verucchio ed ex Confine regionale (località Dogana),15365,00,14244,1121,12206,3159,15365,0
2019/01,100,19/01/2019,6,SP 258R tra Villa Verucchio ed ex Confine regionale (località Dogana),13109,00,12840,269,9866,3243,0,13109
2019/01,100,20/01/2019,7,SP 258R tra Villa Verucchio ed ex Confine regionale (località Dogana),11244,00,11179,65,8518,2726,0,11244
2019/01,100,21/01/2019,1,SP 258R tra Villa Verucchio ed ex Confine regionale (località Dogana),13720,00,12633,1087,11287,2433,13720,0
2019/01,100,22/01/2019,2,SP 258R tra Villa Verucchio ed ex Confine regionale (località Dogana),11278,00,10427,851,9410,1868,11278,0
2019/01,100,23/01/2019,3,SP 258R tra Villa Verucchio ed ex Confine regionale (località Dogana),12378,00,11508,870,10061,2317,12378,0
2019/01,100,24/01/2019,4,SP 258R tra Villa Verucchio ed ex Confine regionale (località Dogana),12462,00,11526,936,10056,2406,12462,0
2019/01,100,25/01/2019,5,SP 258R tra Villa Verucchio ed ex Confine regionale (località Dogana),14757,00,13743,1014,11754,3003,14757,0
2019/01,100,26/01/2019,6,SP 258R tra Villa Verucchio ed ex Confine regionale (località Dogana),13758,00,13498,260,10479,3279,0,13758
2019/01,100,27/01/2019,7,SP 258R tra Villa Verucchio ed ex Confine regionale (località Dogana),12815,00,12739,76,10099,2716,0,12815
2019/01,100,28/01/2019,1,SP 258R tra Villa Verucchio ed ex Confine regionale (località Dogana),14317,00,13201,1116,11643,2674,14317,0
2019/01,104,15/01/2019,2,SP 10 nuovo ponte sul Po tra innesto variante Zibello e confine regionale (Lombardia),4317,00,3108,1209,3442,875,4317,0
2019/01,104,16/01/2019,3,SP 10 nuovo ponte sul Po tra innesto variante Zibello e confine regionale (Lombardia),4570,00,3208,1362,3697,873,4570,0
2019/01,104,17/01/2019,4,SP 10 nuovo ponte sul Po tra innesto variante Zibello e confine regionale (Lombardia),4717,10,3336,1380,3803,914,4717,0
2019/01,104,18/01/2019,5,SP 10 nuovo ponte sul Po tra innesto variante Zibello e confine regionale (Lombardia),4602,00,3371,1231,3659,943,4602,0
2019/01,104,19/01/2019,6,SP 10 nuovo ponte sul Po tra innesto variante Zibello e confine regionale (Lombardia),3317,10,3043,273,2451,866,0,3317
2019/01,104,20/01/2019,7,SP 10 nuovo ponte sul Po tra innesto variante Zibello e confine regionale (Lombardia),3470,00,3397,73,2613,857,0,3470
2019/01,104,21/01/2019,1,SP 10 nuovo ponte sul Po tra innesto variante Zibello e confine regionale (Lombardia),4284,00,3057,1227,3428,856,4284,0
2019/01,104,22/01/2019,2,SP 10 nuovo ponte sul Po tra innesto variante Zibello e confine regionale (Lombardia),4190,10,2985,1204,3378,812,4190,0
2019/01,104,23/01/2019,3,SP 10 nuovo ponte sul Po tra innesto variante Zibello e confine regionale (Lombardia),4378,00,3095,1283,3522,856,4378,0
2019/01,104,24/01/2019,4,SP 10 nuovo ponte sul Po tra innesto variante Zibello e confine regionale (Lombardia),4008,10,2818,1189,3209,799,4008,0
2019/01,104,25/01/2019,5,SP 10 nuovo ponte sul Po tra innesto variante Zibello e confine regionale (Lombardia),4475,10,3242,1232,3572,903,4475,0
2019/01,104,26/01/2019,6,SP 10 nuovo ponte sul Po tra innesto variante Zibello e confine regionale (Lombardia),3245,00,2996,249,2430,815,0,3245
2019/01,104,27/01/2019,7,SP 10 nuovo ponte sul Po tra innesto variante Zibello e confine regionale (Lombardia),3109,00,3047,62,2341,768,0,3109
2019/01,104,28/01/2019,1,SP 10 nuovo ponte sul Po tra innesto variante Zibello e confine regionale (Lombardia),4212,00,3019,1193,3394,818,4212,0
2019/01,107,15/01/2019,2,SP 85 tra Rubiera e bivio SP 13MO (c/o Campogalliano),8876,00,7829,1047,7169,1707,8876,0
2019/01,107,16/01/2019,3,SP 85 tra Rubiera e bivio SP 13MO (c/o Campogalliano),9328,00,8327,1001,7429,1899,9328,0
2019/01,107,17/01/2019,4,SP 85 tra Rubiera e bivio SP 13MO (c/o Campogalliano),9209,00,8170,1039,7126,2083,9209,0
2019/01,107,18/01/2019,5,SP 85 tra Rubiera e bivio SP 13MO (c/o Campogalliano),9604,00,8604,1000,7487,2117,9604,0
2019/01,107,19/01/2019,6,SP 85 tra Rubiera e bivio SP 13MO (c/o Campogalliano),8222,00,8090,132,6105,2117,0,8222
2019/01,107,20/01/2019,7,SP 85 tra Rubiera e bivio SP 13MO (c/o Campogalliano),7172,00,7132,40,5320,1852,0,7172
2019/01,107,21/01/2019,1,SP 85 tra Rubiera e bivio SP 13MO (c/o Campogalliano),8721,00,7786,935,7014,1707,8721,0
2019/01,107,22/01/2019,2,SP 85 tra Rubiera e bivio SP 13MO (c/o Campogalliano),8738,10,7810,927,7012,1726,8738,0
2019/01,107,23/01/2019,3,SP 85 tra Rubiera e bivio SP 13MO (c/o Campogalliano),8762,00,7822,940,6989,1773,8762,0
2019/01,107,24/01/2019,4,SP 85 tra Rubiera e bivio SP 13MO (c/o Campogalliano),8506,00,7643,863,6623,1883,8506,0
2019/01,107,25/01/2019,5,SP 85 tra Rubiera e bivio SP 13MO (c/o Campogalliano),9263,00,8448,815,7159,2104,9263,0
2019/01,107,26/01/2019,6,SP 85 tra Rubiera e bivio SP 13MO (c/o Campogalliano),7890,00,7752,138,5731,2159,0,7890
2019/01,107,27/01/2019,7,SP 85 tra Rubiera e bivio SP 13MO (c/o Campogalliano),6301,00,6258,43,4632,1669,0,6301
2019/01,107,28/01/2019,1,SP 85 tra Rubiera e bivio SP 13MO (c/o Campogalliano),8391,00,7523,868,6753,1638,8391,0
2019/01,108,15/01/2019,2,SP 412R tra Castel San Giovanni (Casello A 21) e ponte fiume Po,11734,120,11320,402,8859,2875,11734,0
2019/01,108,16/01/2019,3,SP 412R tra Castel San Giovanni (Casello A 21) e ponte fiume Po,11892,130,11453,426,8974,2918,11892,0
2019/01,108,17/01/2019,4,SP 412R tra Castel San Giovanni (Casello A 21) e ponte fiume Po,12030,220,11582,426,8958,3072,12030,0
2019/01,108,18/01/2019,5,SP 412R tra Castel San Giovanni (Casello A 21) e ponte fiume Po,12604,240,12211,369,9282,3322,12604,0
2019/01,108,19/01/2019,6,SP 412R tra Castel San Giovanni (Casello A 21) e ponte fiume Po,10682,30,10578,101,8047,2635,0,10682
2019/01,108,20/01/2019,7,SP 412R tra Castel San Giovanni (Casello A 21) e ponte fiume Po,9632,00,9598,34,7290,2342,0,9632
2019/01,108,21/01/2019,1,SP 412R tra Castel San Giovanni (Casello A 21) e ponte fiume Po,11389,70,11004,378,8646,2743,11389,0
2019/01,108,22/01/2019,2,SP 412R tra Castel San Giovanni (Casello A 21) e ponte fiume Po,11203,80,10845,350,8443,2760,11203,0
2019/01,108,23/01/2019,3,SP 412R tra Castel San Giovanni (Casello A 21) e ponte fiume Po,11095,120,10684,399,8389,2706,11095,0
2019/01,108,24/01/2019,4,SP 412R tra Castel San Giovanni (Casello A 21) e ponte fiume Po,11201,180,10756,427,8368,2833,11201,0
2019/01,108,25/01/2019,5,SP 412R tra Castel San Giovanni (Casello A 21) e ponte fiume Po,12049,100,11686,353,8893,3156,12049,0
2019/01,108,26/01/2019,6,SP 412R tra Castel San Giovanni (Casello A 21) e ponte fiume Po,10448,10,10348,99,7835,2613,0,10448
2019/01,108,27/01/2019,7,SP 412R tra Castel San Giovanni (Casello A 21) e ponte fiume Po,8917,00,8885,32,6732,2185,0,8917
2019/01,108,28/01/2019,1,SP 412R tra Castel San Giovanni (Casello A 21) e ponte fiume Po,11173,30,10863,307,8397,2776,11173,0
2019/01,112,15/01/2019,2,SP 111 tra Boretto e Viadana sul ponte Po,19930,50,17139,2786,15623,4307,19930,0
2019/01,112,16/01/2019,3,SP 111 tra Boretto e Viadana sul ponte Po,19431,30,16850,2578,15013,4418,19431,0
2019/01,112,17/01/2019,4,SP 111 tra Boretto e Viadana sul ponte Po,19943,40,17272,2667,15482,4461,19943,0
2019/01,112,18/01/2019,5,SP 111 tra Boretto e Viadana sul ponte Po,21042,40,18458,2580,16133,4909,21042,0
2019/01,112,19/01/2019,6,SP 111 tra Boretto e Viadana sul ponte Po,18472,00,17950,522,13534,4938,0,18472
2019/01,112,20/01/2019,7,SP 111 tra Boretto e Viadana sul ponte Po,14370,00,14210,160,10526,3844,0,14370
2019/01,112,21/01/2019,1,SP 111 tra Boretto e Viadana sul ponte Po,19464,70,16726,2731,15348,4116,19464,0
2019/01,112,22/01/2019,2,SP 111 tra Boretto e Viadana sul ponte Po,19663,20,16874,2787,15391,4272,19663,0
2019/01,112,23/01/2019,3,SP 111 tra Boretto e Viadana sul ponte Po,19571,00,16878,2693,15352,4219,19571,0
2019/01,112,24/01/2019,4,SP 111 tra Boretto e Viadana sul ponte Po,19534,40,16847,2683,15141,4393,19534,0
2019/01,112,25/01/2019,5,SP 111 tra Boretto e Viadana sul ponte Po,20877,30,18256,2618,15916,4961,20877,0
2019/01,112,26/01/2019,6,SP 111 tra Boretto e Viadana sul ponte Po,17831,10,17327,503,13169,4662,0,17831
2019/01,112,27/01/2019,7,SP 111 tra Boretto e Viadana sul ponte Po,14060,00,13896,164,10226,3834,0,14060
2019/01,112,28/01/2019,1,SP 111 tra Boretto e Viadana sul ponte Po,19026,00,16386,2640,14899,4127,19026,0
2019/01,115,15/01/2019,2,SP 68 ad Ariano Polesine al Confine regionale (Veneto),2568,00,2260,308,2055,513,2568,0
2019/01,115,16/01/2019,3,SP 68 ad Ariano Polesine al Confine regionale (Veneto),2555,00,2269,286,2028,527,2555,0
2019/01,115,17/01/2019,4,SP 68 ad Ariano Polesine al Confine regionale (Veneto),2663,00,2372,291,2093,570,2663,0
2019/01,115,18/01/2019,5,SP 68 ad Ariano Polesine al Confine regionale (Veneto),2694,10,2454,239,2064,630,2694,0
2019/01,115,19/01/2019,6,SP 68 ad Ariano Polesine al Confine regionale (Veneto),2341,10,2266,74,1749,592,0,2341
2019/01,115,20/01/2019,7,SP 68 ad Ariano Polesine al Confine regionale (Veneto),1969,00,1954,15,1378,591,0,1969
2019/01,115,21/01/2019,1,SP 68 ad Ariano Polesine al Confine regionale (Veneto),2569,00,2326,243,2045,524,2569,0
2019/01,115,22/01/2019,2,SP 68 ad Ariano Polesine al Confine regionale (Veneto),2624,00,2332,292,2108,516,2624,0
2019/01,115,23/01/2019,3,SP 68 ad Ariano Polesine al Confine regionale (Veneto),2463,00,2228,235,1942,521,2463,0
2019/01,115,24/01/2019,4,SP 68 ad Ariano Polesine al Confine regionale (Veneto),2647,00,2382,265,2077,570,2647,0
2019/01,115,25/01/2019,5,SP 68 ad Ariano Polesine al Confine regionale (Veneto),2763,00,2502,261,2094,669,2763,0
2019/01,115,26/01/2019,6,SP 68 ad Ariano Polesine al Confine regionale (Veneto),2376,00,2314,62,1765,611,0,2376
2019/01,115,27/01/2019,7,SP 68 ad Ariano Polesine al Confine regionale (Veneto),1950,10,1935,14,1374,576,0,1950
2019/01,115,28/01/2019,1,SP 68 ad Ariano Polesine al Confine regionale (Veneto),2571,00,2305,266,2041,530,2571,0
2019/01,116,15/01/2019,2,SP 138 tra SPiero in Bagno (E 45) e Bagno di Romagna,5127,00,4899,228,4227,900,5127,0
2019/01,116,16/01/2019,3,SP 138 tra SPiero in Bagno (E 45) e Bagno di Romagna,5207,00,4907,300,4311,896,5207,0
2019/01,116,17/01/2019,4,SP 138 tra SPiero in Bagno (E 45) e Bagno di Romagna,5024,20,4713,309,4063,961,5024,0
2019/01,116,18/01/2019,5,SP 138 tra SPiero in Bagno (E 45) e Bagno di Romagna,5448,00,5162,286,4444,1004,5448,0
2019/01,116,19/01/2019,6,SP 138 tra SPiero in Bagno (E 45) e Bagno di Romagna,5125,00,5013,112,4002,1123,0,5125
2019/01,116,20/01/2019,7,SP 138 tra SPiero in Bagno (E 45) e Bagno di Romagna,4290,00,4256,34,3385,905,0,4290
2019/01,116,21/01/2019,1,SP 138 tra SPiero in Bagno (E 45) e Bagno di Romagna,4725,00,4537,188,3919,806,4725,0
2019/01,116,22/01/2019,2,SP 138 tra SPiero in Bagno (E 45) e Bagno di Romagna,4121,00,3934,187,3386,735,4121,0
2019/01,116,23/01/2019,3,SP 138 tra SPiero in Bagno (E 45) e Bagno di Romagna,4570,00,4413,157,3822,748,4570,0
2019/01,116,24/01/2019,4,SP 138 tra SPiero in Bagno (E 45) e Bagno di Romagna,4312,00,4152,160,3506,806,4312,0
2019/01,116,25/01/2019,5,SP 138 tra SPiero in Bagno (E 45) e Bagno di Romagna,5159,00,4995,164,4188,971,5159,0
2019/01,116,26/01/2019,6,SP 138 tra SPiero in Bagno (E 45) e Bagno di Romagna,5200,10,5084,115,3990,1210,0,5200
2019/01,116,27/01/2019,7,SP 138 tra SPiero in Bagno (E 45) e Bagno di Romagna,4712,00,4689,23,3668,1044,0,4712
2019/01,116,28/01/2019,1,SP 138 tra SPiero in Bagno (E 45) e Bagno di Romagna,4762,00,4593,169,4012,750,4762,0
2019/01,117,15/01/2019,2,SS 63 tra Collagna e Sassalbo (Passo del Cerreto),424,00,393,31,385,39,424,0
2019/01,117,16/01/2019,3,SS 63 tra Collagna e Sassalbo (Passo del Cerreto),388,10,360,27,335,53,388,0
2019/01,117,17/01/2019,4,SS 63 tra Collagna e Sassalbo (Passo del Cerreto),362,10,334,27,315,47,362,0
2019/01,117,18/01/2019,5,SS 63 tra Collagna e Sassalbo (Passo del Cerreto),508,00,478,30,426,82,508,0
2019/01,117,19/01/2019,6,SS 63 tra Collagna e Sassalbo (Passo del Cerreto),639,00,617,22,539,100,0,639
2019/01,117,20/01/2019,7,SS 63 tra Collagna e Sassalbo (Passo del Cerreto),792,00,783,9,706,86,0,792
2019/01,117,21/01/2019,1,SS 63 tra Collagna e Sassalbo (Passo del Cerreto),344,00,315,29,299,45,344,0
2019/01,117,22/01/2019,2,SS 63 tra Collagna e Sassalbo (Passo del Cerreto),373,00,347,26,335,38,373,0
2019/01,117,23/01/2019,3,SS 63 tra Collagna e Sassalbo (Passo del Cerreto),263,00,240,23,214,49,263,0
2019/01,117,24/01/2019,4,SS 63 tra Collagna e Sassalbo (Passo del Cerreto),253,00,228,25,216,37,253,0
2019/01,117,25/01/2019,5,SS 63 tra Collagna e Sassalbo (Passo del Cerreto),512,00,494,18,445,67,512,0
2019/01,117,26/01/2019,6,SS 63 tra Collagna e Sassalbo (Passo del Cerreto),840,00,825,15,750,90,0,840
2019/01,117,27/01/2019,7,SS 63 tra Collagna e Sassalbo (Passo del Cerreto),774,00,769,5,710,64,0,774
2019/01,117,28/01/2019,1,SS 63 tra Collagna e Sassalbo (Passo del Cerreto),338,00,302,36,288,50,338,0
2019/01,118,23/01/2019,3,SS 45 tra Ottone e Gorreto,289,00,274,15,248,41,289,0
2019/01,118,25/01/2019,5,SS 45 tra Ottone e Gorreto,349,00,334,15,281,68,349,0
2019/01,118,27/01/2019,7,SS 45 tra Ottone e Gorreto,403,00,402,1,336,67,0,403
2019/01,118,28/01/2019,1,SS 45 tra Ottone e Gorreto,293,00,277,16,243,50,293,0
2019/01,122,15/01/2019,2,SP 10R tra Piacenza (ponte fiume Trebbia) e San Nicolo',27235,70,26102,1126,21049,6186,27235,0
2019/01,122,16/01/2019,3,SP 10R tra Piacenza (ponte fiume Trebbia) e San Nicolo',26726,60,25572,1148,20594,6132,26726,0
2019/01,122,17/01/2019,4,SP 10R tra Piacenza (ponte fiume Trebbia) e San Nicolo',27452,20,26240,1210,21162,6290,27452,0
2019/01,122,18/01/2019,5,SP 10R tra Piacenza (ponte fiume Trebbia) e San Nicolo',27890,60,26773,1111,20906,6984,27890,0
2019/01,122,19/01/2019,6,SP 10R tra Piacenza (ponte fiume Trebbia) e San Nicolo',25921,00,25632,289,18169,7752,0,25921
2019/01,122,20/01/2019,7,SP 10R tra Piacenza (ponte fiume Trebbia) e San Nicolo',18640,00,18581,59,13142,5498,0,18640
2019/01,122,21/01/2019,1,SP 10R tra Piacenza (ponte fiume Trebbia) e San Nicolo',26972,60,25784,1182,20825,6147,26972,0
2019/01,122,22/01/2019,2,SP 10R tra Piacenza (ponte fiume Trebbia) e San Nicolo',25729,50,24548,1176,20083,5646,25729,0
2019/01,122,23/01/2019,3,SP 10R tra Piacenza (ponte fiume Trebbia) e San Nicolo',26196,90,25028,1159,20283,5913,26196,0
2019/01,122,24/01/2019,4,SP 10R tra Piacenza (ponte fiume Trebbia) e San Nicolo',25437,110,24379,1047,19314,6123,25437,0
2019/01,122,25/01/2019,5,SP 10R tra Piacenza (ponte fiume Trebbia) e San Nicolo',28404,60,27355,1043,20992,7412,28404,0
2019/01,122,26/01/2019,6,SP 10R tra Piacenza (ponte fiume Trebbia) e San Nicolo',25315,10,25003,311,18012,7303,0,25315
2019/01,122,27/01/2019,7,SP 10R tra Piacenza (ponte fiume Trebbia) e San Nicolo',17539,00,17482,57,11945,5594,0,17539
2019/01,122,28/01/2019,1,SP 10R tra Piacenza (ponte fiume Trebbia) e San Nicolo',26289,50,25201,1083,20516,5773,26289,0
2019/01,123,24/01/2019,4,SP 28 tra Piacenza (Tangenziale Sud) e Gossolengo,15850,00,15439,411,12529,3321,15850,0
2019/01,123,25/01/2019,5,SP 28 tra Piacenza (Tangenziale Sud) e Gossolengo,17274,10,16831,442,13502,3772,17274,0
2019/01,123,26/01/2019,6,SP 28 tra Piacenza (Tangenziale Sud) e Gossolengo,16295,00,16079,216,12708,3587,0,16295
2019/01,123,27/01/2019,7,SP 28 tra Piacenza (Tangenziale Sud) e Gossolengo,10822,00,10785,37,8175,2647,0,10822
2019/01,123,28/01/2019,1,SP 28 tra Piacenza (Tangenziale Sud) e Gossolengo,16268,00,15815,453,13175,3093,16268,0
2019/01,124,15/01/2019,2,SS 45 tra Piacenza e Settima,16529,20,15679,848,13121,3408,16529,0
2019/01,124,16/01/2019,3,SS 45 tra Piacenza e Settima,16499,00,15605,894,13037,3462,16499,0
2019/01,124,17/01/2019,4,SS 45 tra Piacenza e Settima,16443,00,15512,931,12918,3525,16443,0
2019/01,124,18/01/2019,5,SS 45 tra Piacenza e Settima,17680,00,16755,925,13520,4160,17680,0
2019/01,124,19/01/2019,6,SS 45 tra Piacenza e Settima,15520,10,15302,217,11199,4321,0,15520
2019/01,124,20/01/2019,7,SS 45 tra Piacenza e Settima,12384,10,12332,51,8918,3466,0,12384
2019/01,124,21/01/2019,1,SS 45 tra Piacenza e Settima,15890,00,15031,859,12639,3251,15890,0
2019/01,124,22/01/2019,2,SS 45 tra Piacenza e Settima,16304,10,15376,927,13084,3220,16304,0
2019/01,124,23/01/2019,3,SS 45 tra Piacenza e Settima,15609,00,14870,739,12474,3135,15609,0
2019/01,124,24/01/2019,4,SS 45 tra Piacenza e Settima,15683,00,15016,667,12327,3356,15683,0
2019/01,124,25/01/2019,5,SS 45 tra Piacenza e Settima,17302,10,16584,717,13341,3961,17302,0
2019/01,124,26/01/2019,6,SS 45 tra Piacenza e Settima,15304,00,15082,222,11082,4222,0,15304
2019/01,124,27/01/2019,7,SS 45 tra Piacenza e Settima,11290,00,11246,44,8234,3056,0,11290
2019/01,124,28/01/2019,1,SS 45 tra Piacenza e Settima,16017,00,15352,665,12656,3361,16017,0
2019/01,126,15/01/2019,2,SP 6 tra Piacenza (Tangenziale Sud) e bivio SP 42/ponte fiume Nure in località San Giorgio Piacentino,15728,00,15082,646,12498,3230,15728,0
2019/01,126,16/01/2019,3,SP 6 tra Piacenza (Tangenziale Sud) e bivio SP 42/ponte fiume Nure in località San Giorgio Piacentino,15858,00,15174,684,12652,3206,15858,0
2019/01,126,17/01/2019,4,SP 6 tra Piacenza (Tangenziale Sud) e bivio SP 42/ponte fiume Nure in località San Giorgio Piacentino,15523,00,14898,625,12280,3243,15523,0
2019/01,126,18/01/2019,5,SP 6 tra Piacenza (Tangenziale Sud) e bivio SP 42/ponte fiume Nure in località San Giorgio Piacentino,16399,00,15795,604,12525,3874,16399,0
2019/01,126,19/01/2019,6,SP 6 tra Piacenza (Tangenziale Sud) e bivio SP 42/ponte fiume Nure in località San Giorgio Piacentino,15230,00,14990,240,11069,4161,0,15230
2019/01,126,20/01/2019,7,SP 6 tra Piacenza (Tangenziale Sud) e bivio SP 42/ponte fiume Nure in località San Giorgio Piacentino,11470,00,11419,51,8346,3124,0,11470
2019/01,126,21/01/2019,1,SP 6 tra Piacenza (Tangenziale Sud) e bivio SP 42/ponte fiume Nure in località San Giorgio Piacentino,15206,00,14604,602,12107,3099,15206,0
2019/01,126,22/01/2019,2,SP 6 tra Piacenza (Tangenziale Sud) e bivio SP 42/ponte fiume Nure in località San Giorgio Piacentino,15369,00,14721,648,12216,3153,15369,0
2019/01,126,23/01/2019,3,SP 6 tra Piacenza (Tangenziale Sud) e bivio SP 42/ponte fiume Nure in località San Giorgio Piacentino,15185,10,14470,714,12168,3017,15185,0
2019/01,126,24/01/2019,4,SP 6 tra Piacenza (Tangenziale Sud) e bivio SP 42/ponte fiume Nure in località San Giorgio Piacentino,14908,10,14349,558,11628,3280,14908,0
2019/01,126,25/01/2019,5,SP 6 tra Piacenza (Tangenziale Sud) e bivio SP 42/ponte fiume Nure in località San Giorgio Piacentino,16210,10,15659,550,12481,3729,16210,0
2019/01,126,26/01/2019,6,SP 6 tra Piacenza (Tangenziale Sud) e bivio SP 42/ponte fiume Nure in località San Giorgio Piacentino,14495,00,14271,224,10750,3745,0,14495
2019/01,126,27/01/2019,7,SP 6 tra Piacenza (Tangenziale Sud) e bivio SP 42/ponte fiume Nure in località San Giorgio Piacentino,10601,00,10554,47,7761,2840,0,10601
2019/01,126,28/01/2019,1,SP 6 tra Piacenza (Tangenziale Sud) e bivio SP 42/ponte fiume Nure in località San Giorgio Piacentino,15199,10,14587,611,12170,3029,15199,0
2019/01,127,24/01/2019,4,SS 9 tra Piacenza e Pontenure,23073,10,21422,1650,18025,5048,23073,0
2019/01,127,25/01/2019,5,SS 9 tra Piacenza e Pontenure,25637,10,23824,1812,19592,6045,25637,0
2019/01,127,26/01/2019,6,SS 9 tra Piacenza e Pontenure,20962,10,20450,511,15264,5698,0,20962
2019/01,127,27/01/2019,7,SS 9 tra Piacenza e Pontenure,14705,00,14602,103,10412,4293,0,14705
2019/01,127,28/01/2019,1,SS 9 tra Piacenza e Pontenure,24060,00,22319,1741,19256,4804,24060,0
2019/01,128,15/01/2019,2,SP 10R tra Piacenza (Casello A 1/A 21) e il bivio SP 10R e SP 587R,17523,00,15528,1995,13620,3903,17523,0
2019/01,128,16/01/2019,3,SP 10R tra Piacenza (Casello A 1/A 21) e il bivio SP 10R e SP 587R,18116,00,15926,2190,14098,4018,18116,0
2019/01,128,17/01/2019,4,SP 10R tra Piacenza (Casello A 1/A 21) e il bivio SP 10R e SP 587R,17692,00,15478,2214,13749,3943,17692,0
2019/01,128,18/01/2019,5,SP 10R tra Piacenza (Casello A 1/A 21) e il bivio SP 10R e SP 587R,18062,00,16210,1852,13561,4501,18062,0
2019/01,128,19/01/2019,6,SP 10R tra Piacenza (Casello A 1/A 21) e il bivio SP 10R e SP 587R,13572,00,13125,447,9412,4160,0,13572
2019/01,128,20/01/2019,7,SP 10R tra Piacenza (Casello A 1/A 21) e il bivio SP 10R e SP 587R,10385,00,10314,71,7108,3277,0,10385
2019/01,128,21/01/2019,1,SP 10R tra Piacenza (Casello A 1/A 21) e il bivio SP 10R e SP 587R,17055,00,15166,1889,13503,3552,17055,0
2019/01,128,22/01/2019,2,SP 10R tra Piacenza (Casello A 1/A 21) e il bivio SP 10R e SP 587R,16479,00,14539,1940,12943,3536,16479,0
2019/01,128,23/01/2019,3,SP 10R tra Piacenza (Casello A 1/A 21) e il bivio SP 10R e SP 587R,17081,00,15140,1941,13413,3668,17081,0
2019/01,128,24/01/2019,4,SP 10R tra Piacenza (Casello A 1/A 21) e il bivio SP 10R e SP 587R,16611,00,14664,1947,12810,3801,16611,0
2019/01,128,25/01/2019,5,SP 10R tra Piacenza (Casello A 1/A 21) e il bivio SP 10R e SP 587R,17905,00,16219,1686,13720,4185,17905,0
2019/01,128,26/01/2019,6,SP 10R tra Piacenza (Casello A 1/A 21) e il bivio SP 10R e SP 587R,13534,00,13107,427,9511,4023,0,13534
2019/01,128,27/01/2019,7,SP 10R tra Piacenza (Casello A 1/A 21) e il bivio SP 10R e SP 587R,10100,00,10032,68,7084,3016,0,10100
2019/01,128,28/01/2019,1,SP 10R tra Piacenza (Casello A 1/A 21) e il bivio SP 10R e SP 587R,16662,00,14958,1704,13175,3487,16662,0
2019/01,129,15/01/2019,2,SS 9Var tra Parma e ponte fiume Taro (Tangenziale nord di Parma),,,,,,,,
2019/01,129,16/01/2019,3,SS 9Var tra Parma e ponte fiume Taro (Tangenziale nord di Parma),,,,,,,,
2019/01,129,17/01/2019,4,SS 9Var tra Parma e ponte fiume Taro (Tangenziale nord di Parma),,,,,,,,
2019/01,129,18/01/2019,5,SS 9Var tra Parma e ponte fiume Taro (Tangenziale nord di Parma),,,,,,,,
2019/01,129,19/01/2019,6,SS 9Var tra Parma e ponte fiume Taro (Tangenziale nord di Parma),,,,,,,,
2019/01,129,20/01/2019,7,SS 9Var tra Parma e ponte fiume Taro (Tangenziale nord di Parma),,,,,,,,
2019/01,129,21/01/2019,1,SS 9Var tra Parma e ponte fiume Taro (Tangenziale nord di Parma),,,,,,,,
2019/01,129,22/01/2019,2,SS 9Var tra Parma e ponte fiume Taro (Tangenziale nord di Parma),,,,,,,,
2019/01,129,23/01/2019,3,SS 9Var tra Parma e ponte fiume Taro (Tangenziale nord di Parma),,,,,,,,
2019/01,129,24/01/2019,4,SS 9Var tra Parma e ponte fiume Taro (Tangenziale nord di Parma),,,,,,,,
2019/01,129,25/01/2019,5,SS 9Var tra Parma e ponte fiume Taro (Tangenziale nord di Parma),,,,,,,,
2019/01,129,26/01/2019,6,SS 9Var tra Parma e ponte fiume Taro (Tangenziale nord di Parma),,,,,,,,
2019/01,129,27/01/2019,7,SS 9Var tra Parma e ponte fiume Taro (Tangenziale nord di Parma),,,,,,,,
2019/01,129,28/01/2019,1,SS 9Var tra Parma e ponte fiume Taro (Tangenziale nord di Parma),,,,,,,,
2019/01,130,15/01/2019,2,SS 62 tra Parma e Collecchio,21113,00,19921,1192,16562,4551,21113,0
2019/01,130,16/01/2019,3,SS 62 tra Parma e Collecchio,21284,40,20038,1242,16613,4671,21284,0
2019/01,130,17/01/2019,4,SS 62 tra Parma e Collecchio,21270,00,20086,1184,16412,4858,21270,0
2019/01,130,18/01/2019,5,SS 62 tra Parma e Collecchio,22390,00,21177,1213,17095,5295,22390,0
2019/01,130,19/01/2019,6,SS 62 tra Parma e Collecchio,18328,00,17966,362,12992,5336,0,18328
2019/01,130,20/01/2019,7,SS 62 tra Parma e Collecchio,14484,00,14379,105,10014,4470,0,14484
2019/01,130,21/01/2019,1,SS 62 tra Parma e Collecchio,20572,10,19252,1319,16122,4450,20572,0
2019/01,130,22/01/2019,2,SS 62 tra Parma e Collecchio,21258,00,20017,1241,16616,4642,21258,0
2019/01,130,23/01/2019,3,SS 62 tra Parma e Collecchio,20721,30,19531,1187,16300,4421,20721,0
2019/01,130,24/01/2019,4,SS 62 tra Parma e Collecchio,20783,40,19737,1042,15919,4864,20783,0
2019/01,130,25/01/2019,5,SS 62 tra Parma e Collecchio,22226,30,20987,1236,16909,5317,22226,0
2019/01,130,26/01/2019,6,SS 62 tra Parma e Collecchio,19143,00,18829,314,13706,5437,0,19143
2019/01,130,27/01/2019,7,SS 62 tra Parma e Collecchio,13778,00,13684,94,9645,4133,0,13778
2019/01,130,28/01/2019,1,SS 62 tra Parma e Collecchio,20543,00,19432,1111,16179,4364,20543,0
2019/01,131,15/01/2019,2,SP 665R tra Parma e Corcagnano,20791,40,19643,1144,16487,4304,20791,0
2019/01,131,16/01/2019,3,SP 665R tra Parma e Corcagnano,20787,70,19662,1118,16468,4319,20787,0
2019/01,131,17/01/2019,4,SP 665R tra Parma e Corcagnano,20718,20,19527,1189,16386,4332,20718,0
2019/01,131,18/01/2019,5,SP 665R tra Parma e Corcagnano,21533,20,20379,1152,16644,4889,21533,0
2019/01,131,19/01/2019,6,SP 665R tra Parma e Corcagnano,18247,20,17944,301,13336,4911,0,18247
2019/01,131,20/01/2019,7,SP 665R tra Parma e Corcagnano,13935,00,13867,68,10046,3889,0,13935
2019/01,131,21/01/2019,1,SP 665R tra Parma e Corcagnano,20205,20,19066,1137,16191,4014,20205,0
2019/01,131,22/01/2019,2,SP 665R tra Parma e Corcagnano,20385,20,19230,1153,16264,4121,20385,0
2019/01,131,23/01/2019,3,SP 665R tra Parma e Corcagnano,19522,30,18441,1078,15655,3867,19522,0
2019/01,131,24/01/2019,4,SP 665R tra Parma e Corcagnano,19189,40,18121,1064,15039,4150,19189,0
2019/01,131,25/01/2019,5,SP 665R tra Parma e Corcagnano,21067,20,19924,1141,16332,4735,21067,0
2019/01,131,26/01/2019,6,SP 665R tra Parma e Corcagnano,18571,10,18286,284,13796,4775,0,18571
2019/01,131,27/01/2019,7,SP 665R tra Parma e Corcagnano,13839,10,13772,66,10150,3689,0,13839
2019/01,131,28/01/2019,1,SP 665R tra Parma e Corcagnano,19499,20,18427,1070,15787,3712,19499,0
2019/01,132,15/01/2019,2,SP 513R tra Parma e Pilastrello,20677,10,19820,856,16439,4238,20677,0
2019/01,132,16/01/2019,3,SP 513R tra Parma e Pilastrello,20736,10,19854,881,16464,4272,20736,0
2019/01,132,17/01/2019,4,SP 513R tra Parma e Pilastrello,20954,00,20062,892,16584,4370,20954,0
2019/01,132,18/01/2019,5,SP 513R tra Parma e Pilastrello,21336,10,20383,952,16575,4761,21336,0
2019/01,132,19/01/2019,6,SP 513R tra Parma e Pilastrello,18152,00,17881,271,13371,4781,0,18152
2019/01,132,20/01/2019,7,SP 513R tra Parma e Pilastrello,14425,00,14366,59,10713,3712,0,14425
2019/01,132,21/01/2019,1,SP 513R tra Parma e Pilastrello,20030,20,19126,902,16023,4007,20030,0
2019/01,132,22/01/2019,2,SP 513R tra Parma e Pilastrello,20467,00,19626,841,16365,4102,20467,0
2019/01,132,23/01/2019,3,SP 513R tra Parma e Pilastrello,20321,20,19432,887,16201,4120,20321,0
2019/01,132,24/01/2019,4,SP 513R tra Parma e Pilastrello,19156,00,18395,761,15007,4149,19156,0
2019/01,132,25/01/2019,5,SP 513R tra Parma e Pilastrello,21416,00,20506,910,16475,4941,21416,0
2019/01,132,26/01/2019,6,SP 513R tra Parma e Pilastrello,18053,00,17833,220,13376,4677,0,18053
2019/01,132,27/01/2019,7,SP 513R tra Parma e Pilastrello,13887,00,13810,77,10463,3424,0,13887
2019/01,132,28/01/2019,1,SP 513R tra Parma e Pilastrello,19761,00,18858,903,15866,3895,19761,0
2019/01,133,15/01/2019,2,SP 62R tra Parma (viadotto A 1) e Sorbolo,18912,30,16769,2140,14598,4314,18912,0
2019/01,133,16/01/2019,3,SP 62R tra Parma (viadotto A 1) e Sorbolo,18850,20,16629,2219,14487,4363,18850,0
2019/01,133,17/01/2019,4,SP 62R tra Parma (viadotto A 1) e Sorbolo,19200,10,16976,2223,14758,4442,19200,0
2019/01,133,18/01/2019,5,SP 62R tra Parma (viadotto A 1) e Sorbolo,19604,40,17526,2074,14711,4893,19604,0
2019/01,133,19/01/2019,6,SP 62R tra Parma (viadotto A 1) e Sorbolo,18137,00,17620,517,13092,5045,0,18137
2019/01,133,20/01/2019,7,SP 62R tra Parma (viadotto A 1) e Sorbolo,15338,00,15209,129,10711,4627,0,15338
2019/01,133,21/01/2019,1,SP 62R tra Parma (viadotto A 1) e Sorbolo,18647,10,16387,2259,14451,4196,18647,0
2019/01,133,22/01/2019,2,SP 62R tra Parma (viadotto A 1) e Sorbolo,18537,00,16345,2192,14379,4158,18537,0
2019/01,133,23/01/2019,3,SP 62R tra Parma (viadotto A 1) e Sorbolo,18509,20,16376,2131,14368,4141,18509,0
2019/01,133,24/01/2019,4,SP 62R tra Parma (viadotto A 1) e Sorbolo,18587,10,16436,2150,14324,4263,18587,0
2019/01,133,25/01/2019,5,SP 62R tra Parma (viadotto A 1) e Sorbolo,19596,20,17484,2110,14758,4838,19596,0
2019/01,133,26/01/2019,6,SP 62R tra Parma (viadotto A 1) e Sorbolo,17762,10,17261,500,12702,5060,0,17762
2019/01,133,27/01/2019,7,SP 62R tra Parma (viadotto A 1) e Sorbolo,14763,00,14639,124,10443,4320,0,14763
2019/01,133,28/01/2019,1,SP 62R tra Parma (viadotto A 1) e Sorbolo,18517,10,16375,2141,14453,4064,18517,0
2019/01,134,15/01/2019,2,SP 343R tra Parma e San Polo,18572,10,16219,2352,14542,4030,18572,0
2019/01,134,16/01/2019,3,SP 343R tra Parma e San Polo,18300,10,15927,2372,14278,4022,18300,0
2019/01,134,17/01/2019,4,SP 343R tra Parma e San Polo,18452,00,16132,2320,14290,4162,18452,0
2019/01,134,18/01/2019,5,SP 343R tra Parma e San Polo,18616,00,16428,2188,14242,4374,18616,0
2019/01,134,19/01/2019,6,SP 343R tra Parma e San Polo,13758,00,13267,491,10009,3749,0,13758
2019/01,134,20/01/2019,7,SP 343R tra Parma e San Polo,10248,00,10133,115,7211,3037,0,10248
2019/01,134,21/01/2019,1,SP 343R tra Parma e San Polo,18254,00,16014,2240,14249,4005,18254,0
2019/01,134,22/01/2019,2,SP 343R tra Parma e San Polo,15244,00,13337,1907,11377,3867,15244,0
2019/01,134,23/01/2019,3,SP 343R tra Parma e San Polo,18171,00,15887,2284,14198,3973,18171,0
2019/01,134,24/01/2019,4,SP 343R tra Parma e San Polo,18135,00,15860,2275,14006,4129,18135,0
2019/01,134,25/01/2019,5,SP 343R tra Parma e San Polo,17586,00,15439,2147,13661,3925,17586,0
2019/01,134,26/01/2019,6,SP 343R tra Parma e San Polo,13545,00,13049,496,9872,3673,0,13545
2019/01,134,27/01/2019,7,SP 343R tra Parma e San Polo,10088,00,9975,113,7301,2787,0,10088
2019/01,134,28/01/2019,1,SP 343R tra Parma e San Polo,18194,00,15812,2382,14248,3946,18194,0
2019/01,135,15/01/2019,2,SP 10 tra Parma (Tangenziale) e Viarolo,,,,,,,,
2019/01,135,16/01/2019,3,SP 10 tra Parma (Tangenziale) e Viarolo,,,,,,,,
2019/01,135,17/01/2019,4,SP 10 tra Parma (Tangenziale) e Viarolo,,,,,,,,
2019/01,135,18/01/2019,5,SP 10 tra Parma (Tangenziale) e Viarolo,,,,,,,,
2019/01,135,19/01/2019,6,SP 10 tra Parma (Tangenziale) e Viarolo,,,,,,,,
2019/01,135,20/01/2019,7,SP 10 tra Parma (Tangenziale) e Viarolo,,,,,,,,
2019/01,135,21/01/2019,1,SP 10 tra Parma (Tangenziale) e Viarolo,,,,,,,,
2019/01,135,22/01/2019,2,SP 10 tra Parma (Tangenziale) e Viarolo,,,,,,,,
2019/01,135,23/01/2019,3,SP 10 tra Parma (Tangenziale) e Viarolo,,,,,,,,
2019/01,135,24/01/2019,4,SP 10 tra Parma (Tangenziale) e Viarolo,,,,,,,,
2019/01,135,25/01/2019,5,SP 10 tra Parma (Tangenziale) e Viarolo,,,,,,,,
2019/01,135,26/01/2019,6,SP 10 tra Parma (Tangenziale) e Viarolo,,,,,,,,
2019/01,135,27/01/2019,7,SP 10 tra Parma (Tangenziale) e Viarolo,,,,,,,,
2019/01,135,28/01/2019,1,SP 10 tra Parma (Tangenziale) e Viarolo,,,,,,,,
2019/01,138,15/01/2019,2,SS 63 tra Reggio Emilia e Puianello,11937,00,11574,363,9163,2774,11937,0
2019/01,138,16/01/2019,3,SS 63 tra Reggio Emilia e Puianello,11888,00,11487,401,9012,2876,11888,0
2019/01,138,17/01/2019,4,SS 63 tra Reggio Emilia e Puianello,11881,00,11475,406,9033,2848,11881,0
2019/01,138,18/01/2019,5,SS 63 tra Reggio Emilia e Puianello,12428,10,12019,408,9133,3295,12428,0
2019/01,138,19/01/2019,6,SS 63 tra Reggio Emilia e Puianello,12191,20,12054,135,8769,3422,0,12191
2019/01,138,20/01/2019,7,SS 63 tra Reggio Emilia e Puianello,9696,00,9658,38,6975,2721,0,9696
2019/01,138,21/01/2019,1,SS 63 tra Reggio Emilia e Puianello,11256,10,10848,407,8752,2504,11256,0
2019/01,138,22/01/2019,2,SS 63 tra Reggio Emilia e Puianello,11753,00,11365,388,9050,2703,11753,0
2019/01,138,23/01/2019,3,SS 63 tra Reggio Emilia e Puianello,11123,10,10723,399,8730,2393,11123,0
2019/01,138,24/01/2019,4,SS 63 tra Reggio Emilia e Puianello,10598,00,10272,326,7932,2666,10598,0
2019/01,138,25/01/2019,5,SS 63 tra Reggio Emilia e Puianello,12549,10,12153,395,9305,3244,12549,0
2019/01,138,26/01/2019,6,SS 63 tra Reggio Emilia e Puianello,12429,00,12283,146,9155,3274,0,12429
2019/01,138,27/01/2019,7,SS 63 tra Reggio Emilia e Puianello,9798,00,9761,37,7204,2594,0,9798
2019/01,138,28/01/2019,1,SS 63 tra Reggio Emilia e Puianello,11179,10,10761,417,8668,2511,11179,0
2019/01,139,20/01/2019,7,SP 467R tra Fogliano e località Pratissolo (c/o Scandiano),10668,00,10608,60,7429,3239,0,10668
2019/01,139,21/01/2019,1,SP 467R tra Fogliano e località Pratissolo (c/o Scandiano),17258,00,16613,645,14077,3181,17258,0
2019/01,139,22/01/2019,2,SP 467R tra Fogliano e località Pratissolo (c/o Scandiano),17598,20,16937,659,14254,3344,17598,0
2019/01,139,23/01/2019,3,SP 467R tra Fogliano e località Pratissolo (c/o Scandiano),17341,20,16667,672,14058,3283,17341,0
2019/01,139,24/01/2019,4,SP 467R tra Fogliano e località Pratissolo (c/o Scandiano),16140,10,15491,648,12830,3310,16140,0
2019/01,139,25/01/2019,5,SP 467R tra Fogliano e località Pratissolo (c/o Scandiano),18131,10,17488,642,14137,3994,18131,0
2019/01,139,26/01/2019,6,SP 467R tra Fogliano e località Pratissolo (c/o Scandiano),14938,00,14793,145,10959,3979,0,14938
2019/01,139,27/01/2019,7,SP 467R tra Fogliano e località Pratissolo (c/o Scandiano),10595,00,10546,49,7461,3134,0,10595
2019/01,139,28/01/2019,1,SP 467R tra Fogliano e località Pratissolo (c/o Scandiano),17085,00,16447,638,13957,3128,17085,0
2019/01,140,15/01/2019,2,SS 9 tra Masone e Rubiera,25167,10,22455,2711,18998,6169,25167,0
2019/01,140,16/01/2019,3,SS 9 tra Masone e Rubiera,25754,00,22944,2810,19279,6475,25754,0
2019/01,140,17/01/2019,4,SS 9 tra Masone e Rubiera,25776,10,22905,2870,19326,6450,25776,0
2019/01,140,18/01/2019,5,SS 9 tra Masone e Rubiera,26833,00,24063,2770,19462,7371,26833,0
2019/01,140,19/01/2019,6,SS 9 tra Masone e Rubiera,24690,00,24097,593,16597,8093,0,24690
2019/01,140,20/01/2019,7,SS 9 tra Masone e Rubiera,21158,00,21011,147,14272,6886,0,21158
2019/01,140,21/01/2019,1,SS 9 tra Masone e Rubiera,24719,10,22017,2701,18840,5879,24719,0
2019/01,140,22/01/2019,2,SS 9 tra Masone e Rubiera,25432,10,22671,2760,19326,6106,25432,0
2019/01,140,23/01/2019,3,SS 9 tra Masone e Rubiera,24726,00,22046,2680,18953,5773,24726,0
2019/01,140,24/01/2019,4,SS 9 tra Masone e Rubiera,24157,20,21563,2592,18069,6088,24157,0
2019/01,140,25/01/2019,5,SS 9 tra Masone e Rubiera,26521,00,23802,2719,19258,7263,26521,0
2019/01,140,26/01/2019,6,SS 9 tra Masone e Rubiera,25474,20,24905,567,17202,8272,0,25474
2019/01,140,27/01/2019,7,SS 9 tra Masone e Rubiera,20249,10,20108,140,13647,6602,0,20249
2019/01,140,28/01/2019,1,SS 9 tra Masone e Rubiera,24475,00,21870,2605,18683,5792,24475,0
2019/01,143,15/01/2019,2,SP 63R tra Sesso e Cadelbosco di Sopra (bivio SP 358R),25144,00,23823,1321,19947,5197,25144,0
2019/01,143,16/01/2019,3,SP 63R tra Sesso e Cadelbosco di Sopra (bivio SP 358R),25813,00,24415,1398,20357,5456,25813,0
2019/01,143,17/01/2019,4,SP 63R tra Sesso e Cadelbosco di Sopra (bivio SP 358R),25624,00,24242,1382,20162,5462,25624,0
2019/01,143,18/01/2019,5,SP 63R tra Sesso e Cadelbosco di Sopra (bivio SP 358R),26233,00,24768,1465,20217,6016,26233,0
2019/01,143,19/01/2019,6,SP 63R tra Sesso e Cadelbosco di Sopra (bivio SP 358R),22204,10,21859,344,15826,6378,0,22204
2019/01,143,20/01/2019,7,SP 63R tra Sesso e Cadelbosco di Sopra (bivio SP 358R),16834,00,16743,91,11649,5185,0,16834
2019/01,143,21/01/2019,1,SP 63R tra Sesso e Cadelbosco di Sopra (bivio SP 358R),24595,00,23160,1435,19708,4887,24595,0
2019/01,143,22/01/2019,2,SP 63R tra Sesso e Cadelbosco di Sopra (bivio SP 358R),25085,00,23716,1369,20050,5035,25085,0
2019/01,143,23/01/2019,3,SP 63R tra Sesso e Cadelbosco di Sopra (bivio SP 358R),23757,70,22372,1378,18678,5079,23757,0
2019/01,143,24/01/2019,4,SP 63R tra Sesso e Cadelbosco di Sopra (bivio SP 358R),24419,00,23121,1298,19187,5232,24419,0
2019/01,143,25/01/2019,5,SP 63R tra Sesso e Cadelbosco di Sopra (bivio SP 358R),25970,00,24593,1377,20000,5970,25970,0
2019/01,143,26/01/2019,6,SP 63R tra Sesso e Cadelbosco di Sopra (bivio SP 358R),22262,00,21942,320,15853,6409,0,22262
2019/01,143,27/01/2019,7,SP 63R tra Sesso e Cadelbosco di Sopra (bivio SP 358R),16775,00,16702,73,11771,5004,0,16775
2019/01,143,28/01/2019,1,SP 63R tra Sesso e Cadelbosco di Sopra (bivio SP 358R),24277,00,22953,1324,19435,4842,24277,0
2019/01,146,15/01/2019,2,SS 12 tra Montale e Modena,20846,00,19625,1221,16243,4603,20846,0
2019/01,146,16/01/2019,3,SS 12 tra Montale e Modena,19990,00,18815,1175,15134,4856,19990,0
2019/01,146,17/01/2019,4,SS 12 tra Montale e Modena,21719,10,20361,1357,16756,4963,21719,0
2019/01,146,18/01/2019,5,SS 12 tra Montale e Modena,21935,10,20680,1254,16709,5226,21935,0
2019/01,146,19/01/2019,6,SS 12 tra Montale e Modena,18268,00,17935,333,12938,5330,0,18268
2019/01,146,20/01/2019,7,SS 12 tra Montale e Modena,14906,20,14825,79,10624,4282,0,14906
2019/01,146,21/01/2019,1,SS 12 tra Montale e Modena,20322,20,19087,1233,15981,4341,20322,0
2019/01,146,22/01/2019,2,SS 12 tra Montale e Modena,20599,20,19353,1244,16184,4415,20599,0
2019/01,146,23/01/2019,3,SS 12 tra Montale e Modena,20307,30,19058,1246,15810,4497,20307,0
2019/01,146,24/01/2019,4,SS 12 tra Montale e Modena,19636,10,18320,1315,14963,4673,19636,0
2019/01,146,25/01/2019,5,SS 12 tra Montale e Modena,21912,30,20660,1249,16618,5294,21912,0
2019/01,146,26/01/2019,6,SS 12 tra Montale e Modena,18816,20,18518,296,13421,5395,0,18816
2019/01,146,27/01/2019,7,SS 12 tra Montale e Modena,14538,00,14454,84,10517,4021,0,14538
2019/01,146,28/01/2019,1,SS 12 tra Montale e Modena,20032,20,18787,1243,15737,4295,20032,0
2019/01,147,15/01/2019,2,SP 623 tra Modena Sud/casello A 1 e Spilamberto,19288,10,16130,3157,15085,4203,19288,0
2019/01,147,16/01/2019,3,SP 623 tra Modena Sud/casello A 1 e Spilamberto,19369,10,16104,3264,14892,4477,19369,0
2019/01,147,17/01/2019,4,SP 623 tra Modena Sud/casello A 1 e Spilamberto,19733,10,16554,3178,15199,4534,19733,0
2019/01,147,18/01/2019,5,SP 623 tra Modena Sud/casello A 1 e Spilamberto,20084,00,16784,3300,15111,4973,20084,0
2019/01,147,19/01/2019,6,SP 623 tra Modena Sud/casello A 1 e Spilamberto,15617,00,15104,513,10884,4733,0,15617
2019/01,147,20/01/2019,7,SP 623 tra Modena Sud/casello A 1 e Spilamberto,14312,00,14167,145,10028,4284,0,14312
2019/01,147,21/01/2019,1,SP 623 tra Modena Sud/casello A 1 e Spilamberto,18533,00,15299,3234,14601,3932,18533,0
2019/01,147,22/01/2019,2,SP 623 tra Modena Sud/casello A 1 e Spilamberto,18433,10,15246,3186,14454,3979,18433,0
2019/01,147,23/01/2019,3,SP 623 tra Modena Sud/casello A 1 e Spilamberto,18031,00,14954,3077,13921,4110,18031,0
2019/01,147,24/01/2019,4,SP 623 tra Modena Sud/casello A 1 e Spilamberto,16033,10,13303,2729,11730,4303,16033,0
2019/01,147,25/01/2019,5,SP 623 tra Modena Sud/casello A 1 e Spilamberto,18924,20,15923,2999,13994,4930,18924,0
2019/01,147,26/01/2019,6,SP 623 tra Modena Sud/casello A 1 e Spilamberto,15769,00,15269,500,11124,4645,0,15769
2019/01,147,27/01/2019,7,SP 623 tra Modena Sud/casello A 1 e Spilamberto,13032,00,12869,163,9308,3724,0,13032
2019/01,147,28/01/2019,1,SP 623 tra Modena Sud/casello A 1 e Spilamberto,18417,00,15306,3111,14531,3886,18417,0
2019/01,149,15/01/2019,2,SP 255 tra Modena e Navicello,35778,520,32499,3227,27760,8018,35778,0
2019/01,149,16/01/2019,3,SP 255 tra Modena e Navicello,35837,410,32506,3290,27154,8683,35837,0
2019/01,149,17/01/2019,4,SP 255 tra Modena e Navicello,36648,540,33354,3240,28176,8472,36648,0
2019/01,149,18/01/2019,5,SP 255 tra Modena e Navicello,37210,470,34034,3129,28006,9204,37210,0
2019/01,149,19/01/2019,6,SP 255 tra Modena e Navicello,29287,30,28753,531,20704,8583,0,29287
2019/01,149,20/01/2019,7,SP 255 tra Modena e Navicello,22512,30,22403,106,15534,6978,0,22512
2019/01,149,21/01/2019,1,SP 255 tra Modena e Navicello,35175,410,31987,3147,27571,7604,35175,0
2019/01,149,22/01/2019,2,SP 255 tra Modena e Navicello,35515,470,32272,3196,27656,7859,35515,0
2019/01,149,23/01/2019,3,SP 255 tra Modena e Navicello,35224,400,32157,3027,27261,7963,35224,0
2019/01,149,24/01/2019,4,SP 255 tra Modena e Navicello,34864,310,31693,3140,26645,8219,34864,0
2019/01,149,25/01/2019,5,SP 255 tra Modena e Navicello,36731,340,33597,3100,27588,9143,36731,0
2019/01,149,26/01/2019,6,SP 255 tra Modena e Navicello,29216,10,28684,531,20707,8509,0,29216
2019/01,149,27/01/2019,7,SP 255 tra Modena e Navicello,22479,10,22369,109,15411,7068,0,22479
2019/01,149,28/01/2019,1,SP 255 tra Modena e Navicello,34090,510,31024,3015,26862,7228,34090,0
2019/01,150,15/01/2019,2,SS 12 tra Modena e Bastiglia,23892,20,21936,1954,18866,5026,23892,0
2019/01,150,16/01/2019,3,SS 12 tra Modena e Bastiglia,24334,00,22369,1965,19141,5193,24334,0
2019/01,150,17/01/2019,4,SS 12 tra Modena e Bastiglia,24639,00,22676,1963,19404,5235,24639,0
2019/01,150,18/01/2019,5,SS 12 tra Modena e Bastiglia,24871,00,23084,1787,18969,5902,24871,0
2019/01,150,19/01/2019,6,SS 12 tra Modena e Bastiglia,19411,00,19103,308,13365,6046,0,19411
2019/01,150,20/01/2019,7,SS 12 tra Modena e Bastiglia,15795,00,15743,52,10608,5187,0,15795
2019/01,150,21/01/2019,1,SS 12 tra Modena e Bastiglia,23337,00,21374,1963,18581,4756,23337,0
2019/01,150,22/01/2019,2,SS 12 tra Modena e Bastiglia,23784,20,21778,2004,18862,4922,23784,0
2019/01,150,23/01/2019,3,SS 12 tra Modena e Bastiglia,23541,20,21607,1932,18566,4975,23541,0
2019/01,150,24/01/2019,4,SS 12 tra Modena e Bastiglia,23204,30,21278,1923,18012,5192,23204,0
2019/01,150,25/01/2019,5,SS 12 tra Modena e Bastiglia,25087,00,23167,1920,19012,6075,25087,0
2019/01,150,26/01/2019,6,SS 12 tra Modena e Bastiglia,20075,00,19734,341,13786,6289,0,20075
2019/01,150,27/01/2019,7,SS 12 tra Modena e Bastiglia,15752,00,15696,56,10843,4909,0,15752
2019/01,150,28/01/2019,1,SS 12 tra Modena e Bastiglia,22832,10,21025,1806,18235,4597,22832,0
2019/01,152,15/01/2019,2,SP 569 tra Innesto tangenziale Bologna e uscita Zola Predosa (Gesso/Rivabella),62928,140,60278,2636,49533,13395,62928,0
2019/01,152,16/01/2019,3,SP 569 tra Innesto tangenziale Bologna e uscita Zola Predosa (Gesso/Rivabella),64345,10,61682,2662,50619,13726,64345,0
2019/01,152,17/01/2019,4,SP 569 tra Innesto tangenziale Bologna e uscita Zola Predosa (Gesso/Rivabella),65218,30,62537,2678,50980,14238,65218,0
2019/01,152,18/01/2019,5,SP 569 tra Innesto tangenziale Bologna e uscita Zola Predosa (Gesso/Rivabella),66178,20,63532,2644,50751,15427,66178,0
2019/01,152,19/01/2019,6,SP 569 tra Innesto tangenziale Bologna e uscita Zola Predosa (Gesso/Rivabella),59039,00,58542,497,43854,15185,0,59039
2019/01,152,20/01/2019,7,SP 569 tra Innesto tangenziale Bologna e uscita Zola Predosa (Gesso/Rivabella),48182,10,48017,164,36253,11929,0,48182
2019/01,152,21/01/2019,1,SP 569 tra Innesto tangenziale Bologna e uscita Zola Predosa (Gesso/Rivabella),62183,00,59794,2389,49603,12580,62183,0
2019/01,152,22/01/2019,2,SP 569 tra Innesto tangenziale Bologna e uscita Zola Predosa (Gesso/Rivabella),62003,40,59306,2693,49432,12571,62003,0
2019/01,152,23/01/2019,3,SP 569 tra Innesto tangenziale Bologna e uscita Zola Predosa (Gesso/Rivabella),64647,40,61927,2716,49465,15182,64647,0
2019/01,152,24/01/2019,4,SP 569 tra Innesto tangenziale Bologna e uscita Zola Predosa (Gesso/Rivabella),60792,20,58212,2578,46432,14360,60792,0
2019/01,152,25/01/2019,5,SP 569 tra Innesto tangenziale Bologna e uscita Zola Predosa (Gesso/Rivabella),61938,00,59501,2437,47000,14938,61938,0
2019/01,152,26/01/2019,6,SP 569 tra Innesto tangenziale Bologna e uscita Zola Predosa (Gesso/Rivabella),58859,20,58254,603,43811,15048,0,58859
2019/01,153,15/01/2019,2,Via Porrettana (ex SS 64) tra Bologna e Pontecchio Marconi,12137,00,11840,297,9517,2620,12137,0
2019/01,153,16/01/2019,3,Via Porrettana (ex SS 64) tra Bologna e Pontecchio Marconi,11843,10,11545,297,9233,2610,11843,0
2019/01,153,17/01/2019,4,Via Porrettana (ex SS 64) tra Bologna e Pontecchio Marconi,11941,00,11685,256,9222,2719,11941,0
2019/01,153,18/01/2019,5,Via Porrettana (ex SS 64) tra Bologna e Pontecchio Marconi,12437,00,12165,272,9479,2958,12437,0
2019/01,153,19/01/2019,6,Via Porrettana (ex SS 64) tra Bologna e Pontecchio Marconi,11260,00,11144,116,8383,2877,0,11260
2019/01,153,20/01/2019,7,Via Porrettana (ex SS 64) tra Bologna e Pontecchio Marconi,7006,00,6988,18,4808,2198,0,7006
2019/01,153,22/01/2019,2,Via Porrettana (ex SS 64) tra Bologna e Pontecchio Marconi,8899,00,8720,179,7131,1768,8899,0
2019/01,153,26/01/2019,6,Via Porrettana (ex SS 64) tra Bologna e Pontecchio Marconi,11361,00,11229,132,8419,2942,0,11361
2019/01,153,27/01/2019,7,Via Porrettana (ex SS 64) tra Bologna e Pontecchio Marconi,8171,10,8144,26,5989,2182,0,8171
2019/01,154,18/01/2019,5,Tra Rastignano e Pian di Macina (SP85 Fondo Valle Savena),12218,20,11942,274,9537,2681,12218,0
2019/01,154,19/01/2019,6,Tra Rastignano e Pian di Macina (SP85 Fondo Valle Savena),9453,10,9395,57,7117,2336,0,9453
2019/01,154,20/01/2019,7,Tra Rastignano e Pian di Macina (SP85 Fondo Valle Savena),7914,10,7897,16,5986,1928,0,7914
2019/01,154,21/01/2019,1,Tra Rastignano e Pian di Macina (SP85 Fondo Valle Savena),10964,70,10703,254,8757,2207,10964,0
2019/01,154,22/01/2019,2,Tra Rastignano e Pian di Macina (SP85 Fondo Valle Savena),10614,10,10342,271,8678,1936,10614,0
2019/01,154,23/01/2019,3,Tra Rastignano e Pian di Macina (SP85 Fondo Valle Savena),10414,00,10128,286,8324,2090,10414,0
2019/01,154,24/01/2019,4,Tra Rastignano e Pian di Macina (SP85 Fondo Valle Savena),9448,10,9181,266,7377,2071,9448,0
2019/01,154,25/01/2019,5,Tra Rastignano e Pian di Macina (SP85 Fondo Valle Savena),11593,40,11363,226,8977,2616,11593,0
2019/01,154,26/01/2019,6,Tra Rastignano e Pian di Macina (SP85 Fondo Valle Savena),9446,10,9387,58,7212,2234,0,9446
2019/01,154,27/01/2019,7,Tra Rastignano e Pian di Macina (SP85 Fondo Valle Savena),7439,10,7425,13,5564,1875,0,7439
2019/01,154,28/01/2019,1,Tra Rastignano e Pian di Macina (SP85 Fondo Valle Savena),10956,10,10737,218,8692,2264,10956,0
2019/01,155,15/01/2019,2,Via Emilia tra San Lazzaro e Idice,14826,00,14329,497,11729,3097,14826,0
2019/01,155,16/01/2019,3,Via Emilia tra San Lazzaro e Idice,15315,10,14841,473,12033,3282,15315,0
2019/01,155,17/01/2019,4,Via Emilia tra San Lazzaro e Idice,14994,10,14457,536,11756,3238,14994,0
2019/01,155,18/01/2019,5,Via Emilia tra San Lazzaro e Idice,15392,00,14902,490,11932,3460,15392,0
2019/01,155,19/01/2019,6,Via Emilia tra San Lazzaro e Idice,14085,00,13809,276,10293,3792,0,14085
2019/01,155,20/01/2019,7,Via Emilia tra San Lazzaro e Idice,10397,10,10328,68,7321,3076,0,10397
2019/01,155,21/01/2019,1,Via Emilia tra San Lazzaro e Idice,14181,10,13714,466,11328,2853,14181,0
2019/01,155,22/01/2019,2,Via Emilia tra San Lazzaro e Idice,14163,00,13672,491,11265,2898,14163,0
2019/01,155,23/01/2019,3,Via Emilia tra San Lazzaro e Idice,14426,00,13919,507,11215,3211,14426,0
2019/01,155,24/01/2019,4,Via Emilia tra San Lazzaro e Idice,14069,00,13583,486,10838,3231,14069,0
2019/01,155,25/01/2019,5,Via Emilia tra San Lazzaro e Idice,15634,10,15146,487,12091,3543,15634,0
2019/01,155,26/01/2019,6,Via Emilia tra San Lazzaro e Idice,14329,20,14061,266,10564,3765,0,14329
2019/01,155,27/01/2019,7,Via Emilia tra San Lazzaro e Idice,10959,10,10892,66,7840,3119,0,10959
2019/01,155,28/01/2019,1,Via Emilia tra San Lazzaro e Idice,13851,00,13382,469,11049,2802,13851,0
2019/01,156,15/01/2019,2,SP 253 tra la località Villanova e inizio variante Castenaso,21682,20,20958,722,17207,4475,21682,0
2019/01,156,16/01/2019,3,SP 253 tra la località Villanova e inizio variante Castenaso,21565,10,20862,702,17119,4446,21565,0
2019/01,156,17/01/2019,4,SP 253 tra la località Villanova e inizio variante Castenaso,21865,00,21156,709,17180,4685,21865,0
2019/01,156,18/01/2019,5,SP 253 tra la località Villanova e inizio variante Castenaso,22337,10,21644,692,17465,4872,22337,0
2019/01,156,19/01/2019,6,SP 253 tra la località Villanova e inizio variante Castenaso,19233,00,19077,156,14477,4756,0,19233
2019/01,156,20/01/2019,7,SP 253 tra la località Villanova e inizio variante Castenaso,14143,00,14109,34,10557,3586,0,14143
2019/01,156,21/01/2019,1,SP 253 tra la località Villanova e inizio variante Castenaso,20870,10,20207,662,16769,4101,20870,0
2019/01,156,22/01/2019,2,SP 253 tra la località Villanova e inizio variante Castenaso,20950,10,20240,709,16787,4163,20950,0
2019/01,156,23/01/2019,3,SP 253 tra la località Villanova e inizio variante Castenaso,20781,00,20129,652,16507,4274,20781,0
2019/01,156,24/01/2019,4,SP 253 tra la località Villanova e inizio variante Castenaso,20410,10,19791,618,16017,4393,20410,0
2019/01,156,25/01/2019,5,SP 253 tra la località Villanova e inizio variante Castenaso,21878,10,21211,666,17092,4786,21878,0
2019/01,156,26/01/2019,6,SP 253 tra la località Villanova e inizio variante Castenaso,19040,00,18881,159,14430,4610,0,19040
2019/01,156,27/01/2019,7,SP 253 tra la località Villanova e inizio variante Castenaso,13840,00,13804,36,10258,3582,0,13840
2019/01,156,28/01/2019,1,SP 253 tra la località Villanova e inizio variante Castenaso,20616,20,19959,655,16589,4027,20616,0
2019/01,157,15/01/2019,2,Via San Donato (ex SP 5) tra Granarolo dell'Emilia e Quarto Inferiore,11801,00,11542,259,9389,2412,11801,0
2019/01,157,16/01/2019,3,Via San Donato (ex SP 5) tra Granarolo dell'Emilia e Quarto Inferiore,11916,00,11627,289,9410,2506,11916,0
2019/01,157,17/01/2019,4,Via San Donato (ex SP 5) tra Granarolo dell'Emilia e Quarto Inferiore,11670,00,11415,255,9190,2480,11670,0
2019/01,157,18/01/2019,5,Via San Donato (ex SP 5) tra Granarolo dell'Emilia e Quarto Inferiore,12121,10,11844,276,9391,2730,12121,0
2019/01,157,19/01/2019,6,Via San Donato (ex SP 5) tra Granarolo dell'Emilia e Quarto Inferiore,11155,20,11026,127,8348,2807,0,11155
2019/01,157,20/01/2019,7,Via San Donato (ex SP 5) tra Granarolo dell'Emilia e Quarto Inferiore,7988,00,7954,34,5773,2215,0,7988
2019/01,157,21/01/2019,1,Via San Donato (ex SP 5) tra Granarolo dell'Emilia e Quarto Inferiore,11656,00,11368,288,9393,2263,11656,0
2019/01,157,22/01/2019,2,Via San Donato (ex SP 5) tra Granarolo dell'Emilia e Quarto Inferiore,11413,10,11134,278,9065,2348,11413,0
2019/01,157,23/01/2019,3,Via San Donato (ex SP 5) tra Granarolo dell'Emilia e Quarto Inferiore,11369,10,11124,244,8951,2418,11369,0
2019/01,157,24/01/2019,4,Via San Donato (ex SP 5) tra Granarolo dell'Emilia e Quarto Inferiore,11235,20,10958,275,8772,2463,11235,0
2019/01,157,25/01/2019,5,Via San Donato (ex SP 5) tra Granarolo dell'Emilia e Quarto Inferiore,12113,10,11818,294,9316,2797,12113,0
2019/01,157,26/01/2019,6,Via San Donato (ex SP 5) tra Granarolo dell'Emilia e Quarto Inferiore,10840,00,10710,130,8135,2705,0,10840
2019/01,157,27/01/2019,7,Via San Donato (ex SP 5) tra Granarolo dell'Emilia e Quarto Inferiore,8273,10,8228,44,5972,2301,0,8273
2019/01,157,28/01/2019,1,Via San Donato (ex SP 5) tra Granarolo dell'Emilia e Quarto Inferiore,11243,00,10934,309,9028,2215,11243,0
2019/01,158,15/01/2019,2,SS 64 tra Bologna e Lovoleto,11791,10,11057,733,9274,2517,11791,0
2019/01,158,16/01/2019,3,SS 64 tra Bologna e Lovoleto,11736,00,11016,720,9199,2537,11736,0
2019/01,158,17/01/2019,4,SS 64 tra Bologna e Lovoleto,11602,20,10886,714,8962,2640,11602,0
2019/01,158,18/01/2019,5,SS 64 tra Bologna e Lovoleto,11838,20,11098,738,8974,2864,11838,0
2019/01,158,19/01/2019,6,SS 64 tra Bologna e Lovoleto,8958,20,8777,179,6359,2599,0,8958
2019/01,158,20/01/2019,7,SS 64 tra Bologna e Lovoleto,6822,00,6763,59,4803,2019,0,6822
2019/01,158,21/01/2019,1,SS 64 tra Bologna e Lovoleto,11797,20,11035,760,9356,2441,11797,0
2019/01,158,22/01/2019,2,SS 64 tra Bologna e Lovoleto,11369,20,10646,721,8924,2445,11369,0
2019/01,158,23/01/2019,3,SS 64 tra Bologna e Lovoleto,11522,20,10802,718,8997,2525,11522,0
2019/01,158,24/01/2019,4,SS 64 tra Bologna e Lovoleto,11414,10,10685,728,8915,2499,11414,0
2019/01,158,25/01/2019,5,SS 64 tra Bologna e Lovoleto,12143,10,11452,690,9321,2822,12143,0
2019/01,158,26/01/2019,6,SS 64 tra Bologna e Lovoleto,8952,00,8747,205,6417,2535,0,8952
2019/01,158,27/01/2019,7,SS 64 tra Bologna e Lovoleto,6810,00,6748,62,4881,1929,0,6810
2019/01,158,28/01/2019,1,SS 64 tra Bologna e Lovoleto,11384,00,10715,669,9056,2328,11384,0
2019/01,160,15/01/2019,2,SP 18 tra Bargellino e Calderara di Reno (c/o Variante SP18),18567,20,16834,1731,14753,3814,18567,0
2019/01,160,16/01/2019,3,SP 18 tra Bargellino e Calderara di Reno (c/o Variante SP18),18787,30,17109,1675,14959,3828,18787,0
2019/01,160,17/01/2019,4,SP 18 tra Bargellino e Calderara di Reno (c/o Variante SP18),18520,20,16823,1695,14581,3939,18520,0
2019/01,160,18/01/2019,5,SP 18 tra Bargellino e Calderara di Reno (c/o Variante SP18),19020,10,17336,1683,14934,4086,19020,0
2019/01,160,19/01/2019,6,SP 18 tra Bargellino e Calderara di Reno (c/o Variante SP18),12943,00,12541,402,9462,3481,0,12943
2019/01,160,20/01/2019,7,SP 18 tra Bargellino e Calderara di Reno (c/o Variante SP18),8884,10,8832,51,6492,2392,0,8884
2019/01,160,21/01/2019,1,SP 18 tra Bargellino e Calderara di Reno (c/o Variante SP18),17596,00,16094,1502,14282,3314,17596,0
2019/01,160,22/01/2019,2,SP 18 tra Bargellino e Calderara di Reno (c/o Variante SP18),18113,00,16532,1581,14495,3618,18113,0
2019/01,160,23/01/2019,3,SP 18 tra Bargellino e Calderara di Reno (c/o Variante SP18),17895,00,16314,1581,14225,3670,17895,0
2019/01,160,24/01/2019,4,SP 18 tra Bargellino e Calderara di Reno (c/o Variante SP18),17470,10,15895,1574,13787,3683,17470,0
2019/01,160,25/01/2019,5,SP 18 tra Bargellino e Calderara di Reno (c/o Variante SP18),18621,10,17003,1617,14644,3977,18621,0
2019/01,160,26/01/2019,6,SP 18 tra Bargellino e Calderara di Reno (c/o Variante SP18),13363,00,12940,423,9880,3483,0,13363
2019/01,160,27/01/2019,7,SP 18 tra Bargellino e Calderara di Reno (c/o Variante SP18),9049,00,8993,56,6727,2322,0,9049
2019/01,160,28/01/2019,1,SP 18 tra Bargellino e Calderara di Reno (c/o Variante SP18),17585,00,16119,1466,14313,3272,17585,0
2019/01,161,15/01/2019,2,SP 568 da Tavernelle all'intersezione della SP3,18948,00,17713,1235,14555,4393,18948,0
2019/01,161,16/01/2019,3,SP 568 da Tavernelle all'intersezione della SP3,19094,00,18007,1087,14743,4351,19094,0
2019/01,161,17/01/2019,4,SP 568 da Tavernelle all'intersezione della SP3,19100,00,18034,1066,14542,4558,19100,0
2019/01,161,18/01/2019,5,SP 568 da Tavernelle all'intersezione della SP3,19663,00,18615,1048,14655,5008,19663,0
2019/01,161,19/01/2019,6,SP 568 da Tavernelle all'intersezione della SP3,16944,10,16721,222,11699,5245,0,16944
2019/01,161,20/01/2019,7,SP 568 da Tavernelle all'intersezione della SP3,13679,10,13642,36,9400,4279,0,13679
2019/01,161,21/01/2019,1,SP 568 da Tavernelle all'intersezione della SP3,18206,00,17270,936,14171,4035,18206,0
2019/01,161,22/01/2019,2,SP 568 da Tavernelle all'intersezione della SP3,18526,00,17524,1002,14404,4122,18526,0
2019/01,161,23/01/2019,3,SP 568 da Tavernelle all'intersezione della SP3,18473,00,17473,1000,14269,4204,18473,0
2019/01,161,24/01/2019,4,SP 568 da Tavernelle all'intersezione della SP3,18324,00,17305,1019,13782,4542,18324,0
2019/01,161,25/01/2019,5,SP 568 da Tavernelle all'intersezione della SP3,19570,00,18541,1029,14539,5031,19570,0
2019/01,161,26/01/2019,6,SP 568 da Tavernelle all'intersezione della SP3,16637,00,16420,217,11606,5031,0,16637
2019/01,161,27/01/2019,7,SP 568 da Tavernelle all'intersezione della SP3,13735,00,13688,47,9729,4006,0,13735
2019/01,161,28/01/2019,1,SP 568 da Tavernelle all'intersezione della SP3,18188,00,17182,1006,14073,4115,18188,0
2019/01,162,15/01/2019,2,SS 9 località Cavazzona,17079,10,15242,1836,12154,4925,17079,0
2019/01,162,16/01/2019,3,SS 9 località Cavazzona,17062,00,15277,1785,12041,5021,17062,0
2019/01,162,17/01/2019,4,SS 9 località Cavazzona,17623,20,15912,1709,12239,5384,17623,0
2019/01,162,18/01/2019,5,SS 9 località Cavazzona,17989,00,16299,1690,12448,5541,17989,0
2019/01,162,19/01/2019,6,SS 9 località Cavazzona,15527,10,15124,402,10091,5436,0,15527
2019/01,162,20/01/2019,7,SS 9 località Cavazzona,13206,00,13108,98,8375,4831,0,13206
2019/01,162,21/01/2019,1,SS 9 località Cavazzona,16482,00,14865,1617,11835,4647,16482,0
2019/01,162,22/01/2019,2,SS 9 località Cavazzona,16448,00,14787,1661,11890,4558,16448,0
2019/01,162,23/01/2019,3,SS 9 località Cavazzona,16019,00,14407,1612,11732,4287,16019,0
2019/01,162,24/01/2019,4,SS 9 località Cavazzona,16631,00,14886,1745,12075,4556,16631,0
2019/01,162,25/01/2019,5,SS 9 località Cavazzona,17772,00,16158,1614,12289,5483,17772,0
2019/01,162,26/01/2019,6,SS 9 località Cavazzona,15351,00,14930,421,10103,5248,0,15351
2019/01,162,27/01/2019,7,SS 9 località Cavazzona,12709,10,12595,113,8323,4386,0,12709
2019/01,162,28/01/2019,1,SS 9 località Cavazzona,15974,00,14387,1587,11609,4365,15974,0
2019/01,170,16/01/2019,3,SS 67 tra Rovere e Forlì,9242,00,8787,455,7362,1880,9242,0
2019/01,170,17/01/2019,4,SS 67 tra Rovere e Forlì,9258,00,8856,402,7320,1938,9258,0
2019/01,170,18/01/2019,5,SS 67 tra Rovere e Forlì,9423,00,9013,410,7337,2086,9423,0
2019/01,170,19/01/2019,6,SS 67 tra Rovere e Forlì,8190,00,8035,155,6036,2154,0,8190
2019/01,170,20/01/2019,7,SS 67 tra Rovere e Forlì,6336,00,6300,36,4660,1676,0,6336
2019/01,170,21/01/2019,1,SS 67 tra Rovere e Forlì,8976,00,8566,410,7167,1809,8976,0
2019/01,170,22/01/2019,2,SS 67 tra Rovere e Forlì,8203,10,7807,395,6521,1682,8203,0
2019/01,170,23/01/2019,3,SS 67 tra Rovere e Forlì,8775,00,8430,345,6890,1885,8775,0
2019/01,170,24/01/2019,4,SS 67 tra Rovere e Forlì,8677,00,8303,374,6807,1870,8677,0
2019/01,170,25/01/2019,5,SS 67 tra Rovere e Forlì,9397,10,8996,400,7277,2120,9397,0
2019/01,170,26/01/2019,6,SS 67 tra Rovere e Forlì,8474,00,8306,168,6343,2131,0,8474
2019/01,170,27/01/2019,7,SS 67 tra Rovere e Forlì,6543,00,6502,41,4861,1682,0,6543
2019/01,170,28/01/2019,1,SS 67 tra Rovere e Forlì,8835,00,8405,430,7119,1716,8835,0
2019/01,171,15/01/2019,2,SP 56 tra Forlì e bivio SS67 (Castrocaro Terme),6736,00,6511,225,5386,1350,6736,0
2019/01,171,16/01/2019,3,SP 56 tra Forlì e bivio SS67 (Castrocaro Terme),6821,00,6620,201,5443,1378,6821,0
2019/01,171,17/01/2019,4,SP 56 tra Forlì e bivio SS67 (Castrocaro Terme),6618,10,6435,182,5238,1380,6618,0
2019/01,171,18/01/2019,5,SP 56 tra Forlì e bivio SS67 (Castrocaro Terme),6998,00,6784,214,5446,1552,6998,0
2019/01,171,19/01/2019,6,SP 56 tra Forlì e bivio SS67 (Castrocaro Terme),6421,00,6364,57,4648,1773,0,6421
2019/01,171,20/01/2019,7,SP 56 tra Forlì e bivio SS67 (Castrocaro Terme),4844,00,4834,10,3619,1225,0,4844
2019/01,171,21/01/2019,1,SP 56 tra Forlì e bivio SS67 (Castrocaro Terme),6558,10,6385,172,5195,1363,6558,0
2019/01,171,22/01/2019,2,SP 56 tra Forlì e bivio SS67 (Castrocaro Terme),6095,10,5922,172,4920,1175,6095,0
2019/01,171,23/01/2019,3,SP 56 tra Forlì e bivio SS67 (Castrocaro Terme),6417,00,6252,165,5129,1288,6417,0
2019/01,171,24/01/2019,4,SP 56 tra Forlì e bivio SS67 (Castrocaro Terme),6637,00,6443,194,5197,1440,6637,0
2019/01,171,25/01/2019,5,SP 56 tra Forlì e bivio SS67 (Castrocaro Terme),7034,00,6844,190,5409,1625,7034,0
2019/01,171,26/01/2019,6,SP 56 tra Forlì e bivio SS67 (Castrocaro Terme),6772,00,6706,66,4953,1819,0,6772
2019/01,171,27/01/2019,7,SP 56 tra Forlì e bivio SS67 (Castrocaro Terme),5023,00,5014,9,3806,1217,0,5023
2019/01,171,28/01/2019,1,SP 56 tra Forlì e bivio SS67 (Castrocaro Terme),6554,10,6382,171,5223,1331,6554,0
2019/01,173,15/01/2019,2,SP 4 tra Ronco (SS9) e bivio SP 72 (Para),7908,00,7457,451,6405,1503,7908,0
2019/01,173,16/01/2019,3,SP 4 tra Ronco (SS9) e bivio SP 72 (Para),8268,10,7836,431,6615,1653,8268,0
2019/01,173,17/01/2019,4,SP 4 tra Ronco (SS9) e bivio SP 72 (Para),8038,20,7604,432,6398,1640,8038,0
2019/01,173,18/01/2019,5,SP 4 tra Ronco (SS9) e bivio SP 72 (Para),8268,00,7832,436,6466,1802,8268,0
2019/01,173,19/01/2019,6,SP 4 tra Ronco (SS9) e bivio SP 72 (Para),6118,10,5961,156,4529,1589,0,6118
2019/01,173,20/01/2019,7,SP 4 tra Ronco (SS9) e bivio SP 72 (Para),4539,00,4510,29,3352,1187,0,4539
2019/01,173,21/01/2019,1,SP 4 tra Ronco (SS9) e bivio SP 72 (Para),7859,00,7432,427,6428,1431,7859,0
2019/01,173,22/01/2019,2,SP 4 tra Ronco (SS9) e bivio SP 72 (Para),7180,00,6796,384,5951,1229,7180,0
2019/01,173,23/01/2019,3,SP 4 tra Ronco (SS9) e bivio SP 72 (Para),7458,10,7092,365,6003,1455,7458,0
2019/01,173,24/01/2019,4,SP 4 tra Ronco (SS9) e bivio SP 72 (Para),7523,00,7147,376,5991,1532,7523,0
2019/01,173,25/01/2019,5,SP 4 tra Ronco (SS9) e bivio SP 72 (Para),8130,10,7694,435,6359,1771,8130,0
2019/01,173,26/01/2019,6,SP 4 tra Ronco (SS9) e bivio SP 72 (Para),6455,10,6289,165,4849,1606,0,6455
2019/01,173,27/01/2019,7,SP 4 tra Ronco (SS9) e bivio SP 72 (Para),4884,00,4855,29,3700,1184,0,4884
2019/01,173,28/01/2019,1,SP 4 tra Ronco (SS9) e bivio SP 72 (Para),7881,20,7440,439,6461,1420,7881,0
2019/01,174,15/01/2019,2,SS 9 tra Ronco e Forlimpopoli,,,,,,,,
2019/01,174,16/01/2019,3,SS 9 tra Ronco e Forlimpopoli,,,,,,,,
2019/01,174,17/01/2019,4,SS 9 tra Ronco e Forlimpopoli,,,,,,,,
2019/01,174,18/01/2019,5,SS 9 tra Ronco e Forlimpopoli,,,,,,,,
2019/01,174,19/01/2019,6,SS 9 tra Ronco e Forlimpopoli,,,,,,,,
2019/01,174,20/01/2019,7,SS 9 tra Ronco e Forlimpopoli,,,,,,,,
2019/01,174,21/01/2019,1,SS 9 tra Ronco e Forlimpopoli,,,,,,,,
2019/01,174,22/01/2019,2,SS 9 tra Ronco e Forlimpopoli,,,,,,,,
2019/01,174,23/01/2019,3,SS 9 tra Ronco e Forlimpopoli,,,,,,,,
2019/01,174,24/01/2019,4,SS 9 tra Ronco e Forlimpopoli,,,,,,,,
2019/01,174,25/01/2019,5,SS 9 tra Ronco e Forlimpopoli,,,,,,,,
2019/01,174,26/01/2019,6,SS 9 tra Ronco e Forlimpopoli,,,,,,,,
2019/01,174,27/01/2019,7,SS 9 tra Ronco e Forlimpopoli,,,,,,,,
2019/01,174,28/01/2019,1,SS 9 tra Ronco e Forlimpopoli,,,,,,,,
2019/01,176,15/01/2019,2,SP 2 in località La Caserma al Confine Provinciale,7787,00,7239,548,6316,1471,7787,0
2019/01,176,16/01/2019,3,SP 2 in località La Caserma al Confine Provinciale,7760,10,7112,647,6332,1428,7760,0
2019/01,176,17/01/2019,4,SP 2 in località La Caserma al Confine Provinciale,8062,00,7461,601,6381,1681,8062,0
2019/01,176,18/01/2019,5,SP 2 in località La Caserma al Confine Provinciale,7833,00,7248,585,6100,1733,7833,0
2019/01,176,19/01/2019,6,SP 2 in località La Caserma al Confine Provinciale,6894,00,6753,141,4698,2196,0,6894
2019/01,176,20/01/2019,7,SP 2 in località La Caserma al Confine Provinciale,7166,10,7138,27,5229,1937,0,7166
2019/01,176,21/01/2019,1,SP 2 in località La Caserma al Confine Provinciale,7301,00,6721,580,5938,1363,7301,0
2019/01,176,22/01/2019,2,SP 2 in località La Caserma al Confine Provinciale,6359,00,5872,487,5198,1161,6359,0
2019/01,176,23/01/2019,3,SP 2 in località La Caserma al Confine Provinciale,6956,00,6501,455,5574,1382,6956,0
2019/01,176,24/01/2019,4,SP 2 in località La Caserma al Confine Provinciale,7212,00,6746,466,5725,1487,7212,0
2019/01,176,25/01/2019,5,SP 2 in località La Caserma al Confine Provinciale,8226,00,7674,552,6425,1801,8226,0
2019/01,176,26/01/2019,6,SP 2 in località La Caserma al Confine Provinciale,8040,00,7883,157,5877,2163,0,8040
2019/01,176,27/01/2019,7,SP 2 in località La Caserma al Confine Provinciale,7907,00,7879,28,6108,1799,0,7907
2019/01,176,28/01/2019,1,SP 2 in località La Caserma al Confine Provinciale,7184,00,6564,620,5890,1294,7184,0
2019/01,177,15/01/2019,2,NSA 313 - Prosecuzione tangenziale di Bologna complanare sud alla A 14 nel tratto San Lazzaro/Idice,17355,00,16401,954,13453,3902,17355,0
2019/01,177,16/01/2019,3,NSA 313 - Prosecuzione tangenziale di Bologna complanare sud alla A 14 nel tratto San Lazzaro/Idice,16643,20,15867,774,12525,4118,16643,0
2019/01,177,17/01/2019,4,NSA 313 - Prosecuzione tangenziale di Bologna complanare sud alla A 14 nel tratto San Lazzaro/Idice,16724,10,15933,790,12694,4030,16724,0
2019/01,177,18/01/2019,5,NSA 313 - Prosecuzione tangenziale di Bologna complanare sud alla A 14 nel tratto San Lazzaro/Idice,16793,20,16037,754,12733,4060,16793,0
2019/01,177,19/01/2019,6,NSA 313 - Prosecuzione tangenziale di Bologna complanare sud alla A 14 nel tratto San Lazzaro/Idice,12931,00,12765,166,8977,3954,0,12931
2019/01,177,20/01/2019,7,NSA 313 - Prosecuzione tangenziale di Bologna complanare sud alla A 14 nel tratto San Lazzaro/Idice,11070,00,11027,43,7319,3751,0,11070
2019/01,177,21/01/2019,1,NSA 313 - Prosecuzione tangenziale di Bologna complanare sud alla A 14 nel tratto San Lazzaro/Idice,16467,00,15614,853,12848,3619,16467,0
2019/01,177,22/01/2019,2,NSA 313 - Prosecuzione tangenziale di Bologna complanare sud alla A 14 nel tratto San Lazzaro/Idice,16047,00,15257,790,12298,3749,16047,0
2019/01,177,23/01/2019,3,NSA 313 - Prosecuzione tangenziale di Bologna complanare sud alla A 14 nel tratto San Lazzaro/Idice,15979,00,15160,819,12357,3622,15979,0
2019/01,177,24/01/2019,4,NSA 313 - Prosecuzione tangenziale di Bologna complanare sud alla A 14 nel tratto San Lazzaro/Idice,15858,20,15098,758,12121,3737,15858,0
2019/01,177,25/01/2019,5,NSA 313 - Prosecuzione tangenziale di Bologna complanare sud alla A 14 nel tratto San Lazzaro/Idice,16986,00,16215,771,12810,4176,16986,0
2019/01,177,26/01/2019,6,NSA 313 - Prosecuzione tangenziale di Bologna complanare sud alla A 14 nel tratto San Lazzaro/Idice,12842,00,12669,173,8928,3914,0,12842
2019/01,177,27/01/2019,7,NSA 313 - Prosecuzione tangenziale di Bologna complanare sud alla A 14 nel tratto San Lazzaro/Idice,10847,00,10802,45,7347,3500,0,10847
2019/01,177,28/01/2019,1,NSA 313 - Prosecuzione tangenziale di Bologna complanare sud alla A 14 nel tratto San Lazzaro/Idice,16419,00,15560,859,12736,3683,16419,0
2019/01,182,15/01/2019,2,SP 258R tra Rimini e A 14,16665,00,16024,641,13165,3500,16665,0
2019/01,182,16/01/2019,3,SP 258R tra Rimini e A 14,16863,20,16218,643,13251,3612,16863,0
2019/01,182,17/01/2019,4,SP 258R tra Rimini e A 14,16981,20,16295,684,13144,3837,16981,0
2019/01,182,18/01/2019,5,SP 258R tra Rimini e A 14,17547,00,16916,631,13272,4275,17547,0
2019/01,182,19/01/2019,6,SP 258R tra Rimini e A 14,15912,20,15695,215,11055,4857,0,15912
2019/01,182,20/01/2019,7,SP 258R tra Rimini e A 14,13895,10,13844,50,9544,4351,0,13895
2019/01,182,21/01/2019,1,SP 258R tra Rimini e A 14,18346,00,17667,679,14507,3839,18346,0
2019/01,182,22/01/2019,2,SP 258R tra Rimini e A 14,16646,00,16035,611,13396,3250,16646,0
2019/01,182,23/01/2019,3,SP 258R tra Rimini e A 14,16636,20,16009,625,13088,3548,16636,0
2019/01,182,24/01/2019,4,SP 258R tra Rimini e A 14,16476,00,15887,589,12960,3516,16476,0
2019/01,182,25/01/2019,5,SP 258R tra Rimini e A 14,17305,00,16689,616,13106,4199,17305,0
2019/01,182,26/01/2019,6,SP 258R tra Rimini e A 14,16065,00,15843,222,11306,4759,0,16065
2019/01,182,27/01/2019,7,SP 258R tra Rimini e A 14,13109,30,13037,69,9217,3892,0,13109
2019/01,182,28/01/2019,1,SP 258R tra Rimini e A 14,16622,00,15972,650,13193,3429,16622,0
2019/01,186,15/01/2019,2,SS 16 tra Rimini e Igea Marina-Viserba,26934,30,25613,1318,21274,5660,26934,0
2019/01,186,16/01/2019,3,SS 16 tra Rimini e Igea Marina-Viserba,27320,20,25942,1376,21680,5640,27320,0
2019/01,186,17/01/2019,4,SS 16 tra Rimini e Igea Marina-Viserba,28386,10,26884,1501,22070,6316,28386,0
2019/01,186,18/01/2019,5,SS 16 tra Rimini e Igea Marina-Viserba,29703,20,28269,1432,22806,6897,29703,0
2019/01,186,19/01/2019,6,SS 16 tra Rimini e Igea Marina-Viserba,30177,00,29581,596,22098,8079,0,30177
2019/01,186,20/01/2019,7,SS 16 tra Rimini e Igea Marina-Viserba,28176,40,27899,273,20457,7719,0,28176
2019/01,186,21/01/2019,1,SS 16 tra Rimini e Igea Marina-Viserba,29361,20,28217,1142,22689,6672,29361,0
2019/01,186,22/01/2019,2,SS 16 tra Rimini e Igea Marina-Viserba,26759,00,25630,1129,21212,5547,26759,0
2019/01,186,23/01/2019,3,SS 16 tra Rimini e Igea Marina-Viserba,28233,10,26894,1338,22659,5574,28233,0
2019/01,186,24/01/2019,4,SS 16 tra Rimini e Igea Marina-Viserba,27813,10,26103,1709,21712,6101,27813,0
2019/01,186,25/01/2019,5,SS 16 tra Rimini e Igea Marina-Viserba,28483,30,26952,1528,21761,6722,28483,0
2019/01,186,26/01/2019,6,SS 16 tra Rimini e Igea Marina-Viserba,26458,40,25941,513,19143,7315,0,26458
2019/01,186,27/01/2019,7,SS 16 tra Rimini e Igea Marina-Viserba,22935,10,22794,140,16468,6467,0,22935
2019/01,186,28/01/2019,1,SS 16 tra Rimini e Igea Marina-Viserba,25991,10,24845,1145,20627,5364,25991,0
2019/01,188,16/01/2019,3,SS 9 tra Rimini e Santa Giustina,27787,20,26560,1225,21636,6151,27787,0
2019/01,188,17/01/2019,4,SS 9 tra Rimini e Santa Giustina,28369,20,27129,1238,22010,6359,28369,0
2019/01,188,18/01/2019,5,SS 9 tra Rimini e Santa Giustina,27661,10,26460,1200,22234,5427,27661,0
2019/01,215,15/01/2019,2,SP 3_1 tra accesso interporto Bologna e viadotto A 13,28578,90,21580,6989,21349,7229,28578,0
2019/01,215,16/01/2019,3,SP 3_1 tra accesso interporto Bologna e viadotto A 13,28660,100,21791,6859,21333,7327,28660,0
2019/01,215,17/01/2019,4,SP 3_1 tra accesso interporto Bologna e viadotto A 13,28570,30,21483,7084,21201,7369,28570,0
2019/01,215,18/01/2019,5,SP 3_1 tra accesso interporto Bologna e viadotto A 13,29467,40,22608,6855,21838,7629,29467,0
2019/01,215,19/01/2019,6,SP 3_1 tra accesso interporto Bologna e viadotto A 13,14728,10,13128,1599,10035,4693,0,14728
2019/01,215,20/01/2019,7,SP 3_1 tra accesso interporto Bologna e viadotto A 13,10783,10,10655,127,7871,2912,0,10783
2019/01,215,21/01/2019,1,SP 3_1 tra accesso interporto Bologna e viadotto A 13,26665,60,20791,5868,20762,5903,26665,0
2019/01,215,22/01/2019,2,SP 3_1 tra accesso interporto Bologna e viadotto A 13,27843,30,21003,6837,20833,7010,27843,0
2019/01,215,23/01/2019,3,SP 3_1 tra accesso interporto Bologna e viadotto A 13,27891,70,21032,6852,20849,7042,27891,0
2019/01,215,24/01/2019,4,SP 3_1 tra accesso interporto Bologna e viadotto A 13,27743,20,20913,6828,20449,7294,27743,0
2019/01,215,25/01/2019,5,SP 3_1 tra accesso interporto Bologna e viadotto A 13,28852,20,22049,6801,21408,7444,28852,0
2019/01,215,26/01/2019,6,SP 3_1 tra accesso interporto Bologna e viadotto A 13,13107,20,11688,1417,8609,4498,0,13107
2019/01,215,27/01/2019,7,SP 3_1 tra accesso interporto Bologna e viadotto A 13,9954,10,9808,145,7052,2902,0,9954
2019/01,215,28/01/2019,1,SP 3_1 tra accesso interporto Bologna e viadotto A 13,25358,40,19700,5654,19484,5874,25358,0
2019/01,218,15/01/2019,2,SP 10 tra Polesine e Roccabianca su variante Zibello,2360,00,2005,355,1881,479,2360,0
2019/01,218,16/01/2019,3,SP 10 tra Polesine e Roccabianca su variante Zibello,2347,00,1925,422,1912,435,2347,0
2019/01,218,17/01/2019,4,SP 10 tra Polesine e Roccabianca su variante Zibello,2474,00,2059,415,1998,476,2474,0
2019/01,218,18/01/2019,5,SP 10 tra Polesine e Roccabianca su variante Zibello,2393,00,2004,389,1881,512,2393,0
2019/01,218,19/01/2019,6,SP 10 tra Polesine e Roccabianca su variante Zibello,1797,00,1714,83,1289,508,0,1797
2019/01,218,20/01/2019,7,SP 10 tra Polesine e Roccabianca su variante Zibello,1509,00,1487,22,1138,371,0,1509
2019/01,218,21/01/2019,1,SP 10 tra Polesine e Roccabianca su variante Zibello,2200,00,1900,300,1780,420,2200,0
2019/01,218,22/01/2019,2,SP 10 tra Polesine e Roccabianca su variante Zibello,2312,00,1931,381,1853,459,2312,0
2019/01,218,23/01/2019,3,SP 10 tra Polesine e Roccabianca su variante Zibello,2376,00,2007,369,1882,494,2376,0
2019/01,218,24/01/2019,4,SP 10 tra Polesine e Roccabianca su variante Zibello,2249,00,1861,388,1770,479,2249,0
2019/01,218,25/01/2019,5,SP 10 tra Polesine e Roccabianca su variante Zibello,2350,00,1998,352,1835,515,2350,0
2019/01,218,26/01/2019,6,SP 10 tra Polesine e Roccabianca su variante Zibello,1683,00,1588,95,1245,438,0,1683
2019/01,218,27/01/2019,7,SP 10 tra Polesine e Roccabianca su variante Zibello,1345,00,1316,29,1013,332,0,1345
2019/01,218,28/01/2019,1,SP 10 tra Polesine e Roccabianca su variante Zibello,2309,00,1932,377,1808,501,2309,0
2019/01,219,15/01/2019,2,SS 9 tra Fiorenzuola d'Arda e Pontenure,16652,120,15332,1308,13389,3263,16652,0
2019/01,219,16/01/2019,3,SS 9 tra Fiorenzuola d'Arda e Pontenure,16944,140,15558,1372,13593,3351,16944,0
2019/01,219,17/01/2019,4,SS 9 tra Fiorenzuola d'Arda e Pontenure,17553,110,15881,1661,14135,3418,17553,0
2019/01,219,18/01/2019,5,SS 9 tra Fiorenzuola d'Arda e Pontenure,17062,80,15758,1296,13309,3753,17062,0
2019/01,219,19/01/2019,6,SS 9 tra Fiorenzuola d'Arda e Pontenure,13704,110,13338,355,10236,3468,0,13704
2019/01,219,20/01/2019,7,SS 9 tra Fiorenzuola d'Arda e Pontenure,11342,40,11242,96,8450,2892,0,11342
2019/01,219,21/01/2019,1,SS 9 tra Fiorenzuola d'Arda e Pontenure,16242,90,14883,1350,13090,3152,16242,0
2019/01,219,22/01/2019,2,SS 9 tra Fiorenzuola d'Arda e Pontenure,16313,110,14871,1431,13181,3132,16313,0
2019/01,219,23/01/2019,3,SS 9 tra Fiorenzuola d'Arda e Pontenure,15873,80,14529,1336,12779,3094,15873,0
2019/01,219,24/01/2019,4,SS 9 tra Fiorenzuola d'Arda e Pontenure,15679,190,14374,1286,12477,3202,15679,0
2019/01,219,25/01/2019,5,SS 9 tra Fiorenzuola d'Arda e Pontenure,16936,150,15615,1306,13210,3726,16936,0
2019/01,219,26/01/2019,6,SS 9 tra Fiorenzuola d'Arda e Pontenure,13736,100,13321,405,10239,3497,0,13736
2019/01,219,27/01/2019,7,SS 9 tra Fiorenzuola d'Arda e Pontenure,9899,00,9812,87,7262,2637,0,9899
2019/01,219,28/01/2019,1,SS 9 tra Fiorenzuola d'Arda e Pontenure,16203,100,14798,1395,13032,3171,16203,0
2019/01,220,15/01/2019,2,SS 9 tra Fiorenzuola d'Arda e Fidenza al confine provinciale,13646,00,12037,1609,11050,2596,13646,0
2019/01,220,16/01/2019,3,SS 9 tra Fiorenzuola d'Arda e Fidenza al confine provinciale,15080,00,13138,1942,12284,2796,15080,0
2019/01,220,17/01/2019,4,SS 9 tra Fiorenzuola d'Arda e Fidenza al confine provinciale,14869,00,12944,1925,12038,2831,14869,0
2019/01,220,18/01/2019,5,SS 9 tra Fiorenzuola d'Arda e Fidenza al confine provinciale,13910,00,12381,1529,10739,3171,13910,0
2019/01,220,19/01/2019,6,SS 9 tra Fiorenzuola d'Arda e Fidenza al confine provinciale,12767,00,12358,409,9780,2987,0,12767
2019/01,220,20/01/2019,7,SS 9 tra Fiorenzuola d'Arda e Fidenza al confine provinciale,12109,00,11986,123,9386,2723,0,12109
2019/01,220,21/01/2019,1,SS 9 tra Fiorenzuola d'Arda e Fidenza al confine provinciale,14120,00,12392,1728,11464,2656,14120,0
2019/01,220,22/01/2019,2,SS 9 tra Fiorenzuola d'Arda e Fidenza al confine provinciale,13251,10,11747,1503,10637,2614,13251,0
2019/01,220,23/01/2019,3,SS 9 tra Fiorenzuola d'Arda e Fidenza al confine provinciale,12742,00,11250,1492,10276,2466,12742,0
2019/01,220,24/01/2019,4,SS 9 tra Fiorenzuola d'Arda e Fidenza al confine provinciale,12650,00,11147,1503,10100,2550,12650,0
2019/01,220,25/01/2019,5,SS 9 tra Fiorenzuola d'Arda e Fidenza al confine provinciale,13980,00,12394,1586,10847,3133,13980,0
2019/01,220,26/01/2019,6,SS 9 tra Fiorenzuola d'Arda e Fidenza al confine provinciale,12680,00,12283,397,9733,2947,0,12680
2019/01,220,27/01/2019,7,SS 9 tra Fiorenzuola d'Arda e Fidenza al confine provinciale,10467,00,10389,78,8112,2355,0,10467
2019/01,220,28/01/2019,1,SS 9 tra Fiorenzuola d'Arda e Fidenza al confine provinciale,12882,3200,11041,1521,10385,2497,12882,0
2019/01,221,15/01/2019,2,SS 9 tra Fidenza e A 15,24514,10,21614,2899,19151,5363,24514,0
2019/01,221,16/01/2019,3,SS 9 tra Fidenza e A 15,24998,00,21965,3033,19604,5394,24998,0
2019/01,221,17/01/2019,4,SS 9 tra Fidenza e A 15,24852,00,21874,2978,19417,5435,24852,0
2019/01,221,18/01/2019,5,SS 9 tra Fidenza e A 15,25120,10,22232,2887,19191,5929,25120,0
2019/01,221,19/01/2019,6,SS 9 tra Fidenza e A 15,20181,00,19487,694,14485,5696,0,20181
2019/01,221,20/01/2019,7,SS 9 tra Fidenza e A 15,17258,00,17051,207,12333,4925,0,17258
2019/01,221,21/01/2019,1,SS 9 tra Fidenza e A 15,25025,00,21924,3101,19814,5211,25025,0
2019/01,221,22/01/2019,2,SS 9 tra Fidenza e A 15,24459,00,21575,2884,19098,5361,24459,0
2019/01,221,23/01/2019,3,SS 9 tra Fidenza e A 15,23575,00,20698,2877,18628,4947,23575,0
2019/01,221,24/01/2019,4,SS 9 tra Fidenza e A 15,23575,00,20803,2772,18282,5293,23575,0
2019/01,221,25/01/2019,5,SS 9 tra Fidenza e A 15,24699,10,21849,2849,18900,5799,24699,0
2019/01,221,26/01/2019,6,SS 9 tra Fidenza e A 15,20089,10,19424,664,14645,5444,0,20089
2019/01,221,27/01/2019,7,SS 9 tra Fidenza e A 15,15771,00,15641,130,11494,4277,0,15771
2019/01,221,28/01/2019,1,SS 9 tra Fidenza e A 15,24066,00,21282,2784,19005,5061,24066,0
2019/01,222,25/01/2019,5,SP 359R tra Fidenza e Salsomaggiore Terme,16577,90,16135,433,12474,4103,16577,0
2019/01,222,26/01/2019,6,SP 359R tra Fidenza e Salsomaggiore Terme,15226,20,15016,208,10806,4420,0,15226
2019/01,222,27/01/2019,7,SP 359R tra Fidenza e Salsomaggiore Terme,11172,00,11132,40,7931,3241,0,11172
2019/01,222,28/01/2019,1,SP 359R tra Fidenza e Salsomaggiore Terme,15356,80,14916,432,12003,3353,15356,0
2019/01,223,15/01/2019,2,SP 357R tra SS 9 e Noceto,10748,00,9519,1229,8386,2362,10748,0
2019/01,223,16/01/2019,3,SP 357R tra SS 9 e Noceto,10900,00,9567,1333,8637,2263,10900,0
2019/01,223,17/01/2019,4,SP 357R tra SS 9 e Noceto,10934,00,9612,1322,8522,2412,10934,0
2019/01,223,18/01/2019,5,SP 357R tra SS 9 e Noceto,11101,00,9866,1235,8667,2434,11101,0
2019/01,223,19/01/2019,6,SP 357R tra SS 9 e Noceto,8957,10,8671,285,6470,2487,0,8957
2019/01,223,20/01/2019,7,SP 357R tra SS 9 e Noceto,6950,00,6863,87,5090,1860,0,6950
2019/01,223,21/01/2019,1,SP 357R tra SS 9 e Noceto,10624,00,9348,1276,8508,2116,10624,0
2019/01,223,22/01/2019,2,SP 357R tra SS 9 e Noceto,10801,00,9536,1265,8559,2242,10801,0
2019/01,223,23/01/2019,3,SP 357R tra SS 9 e Noceto,10426,00,9214,1212,8273,2153,10426,0
2019/01,223,24/01/2019,4,SP 357R tra SS 9 e Noceto,10495,00,9261,1234,8145,2350,10495,0
2019/01,223,25/01/2019,5,SP 357R tra SS 9 e Noceto,11079,00,9832,1247,8580,2499,11079,0
2019/01,223,26/01/2019,6,SP 357R tra SS 9 e Noceto,9313,00,9011,302,6927,2386,0,9313
2019/01,223,27/01/2019,7,SP 357R tra SS 9 e Noceto,6393,00,6311,82,4576,1817,0,6393
2019/01,223,28/01/2019,1,SP 357R tra SS 9 e Noceto,10701,00,9413,1288,8501,2200,10701,0
2019/01,226,15/01/2019,2,SP 32 dal bivio SP 16 (per Langhirano) al bivio SP 665R,11742,30,10905,834,9526,2216,11742,0
2019/01,226,16/01/2019,3,SP 32 dal bivio SP 16 (per Langhirano) al bivio SP 665R,11253,10,10402,850,9113,2140,11253,0
2019/01,226,17/01/2019,4,SP 32 dal bivio SP 16 (per Langhirano) al bivio SP 665R,11546,10,10723,822,9300,2246,11546,0
2019/01,226,18/01/2019,5,SP 32 dal bivio SP 16 (per Langhirano) al bivio SP 665R,11834,10,11046,787,9300,2534,11834,0
2019/01,226,19/01/2019,6,SP 32 dal bivio SP 16 (per Langhirano) al bivio SP 665R,8747,00,8473,274,6554,2193,0,8747
2019/01,226,20/01/2019,7,SP 32 dal bivio SP 16 (per Langhirano) al bivio SP 665R,7301,00,7208,93,5564,1737,0,7301
2019/01,226,21/01/2019,1,SP 32 dal bivio SP 16 (per Langhirano) al bivio SP 665R,11082,20,10279,801,9034,2048,11082,0
2019/01,226,22/01/2019,2,SP 32 dal bivio SP 16 (per Langhirano) al bivio SP 665R,11474,10,10681,792,9338,2136,11474,0
2019/01,226,23/01/2019,3,SP 32 dal bivio SP 16 (per Langhirano) al bivio SP 665R,10912,00,10139,773,8999,1913,10912,0
2019/01,226,24/01/2019,4,SP 32 dal bivio SP 16 (per Langhirano) al bivio SP 665R,10215,30,9521,691,8201,2014,10215,0
2019/01,226,25/01/2019,5,SP 32 dal bivio SP 16 (per Langhirano) al bivio SP 665R,11714,00,10900,814,9228,2486,11714,0
2019/01,226,26/01/2019,6,SP 32 dal bivio SP 16 (per Langhirano) al bivio SP 665R,9019,00,8787,232,6778,2241,0,9019
2019/01,226,27/01/2019,7,SP 32 dal bivio SP 16 (per Langhirano) al bivio SP 665R,6810,00,6717,93,5130,1680,0,6810
2019/01,226,28/01/2019,1,SP 32 dal bivio SP 16 (per Langhirano) al bivio SP 665R,10707,10,9966,740,8781,1926,10707,0
2019/01,227,26/01/2019,6,SP 34 da Colorno al bivio SP 60 (al confine provinciale),5104,10,5026,77,3955,1149,0,5104
2019/01,227,27/01/2019,7,SP 34 da Colorno al bivio SP 60 (al confine provinciale),2969,00,2956,13,2142,827,0,2969
2019/01,227,28/01/2019,1,SP 34 da Colorno al bivio SP 60 (al confine provinciale),5615,00,5438,177,4545,1070,5615,0
2019/01,228,15/01/2019,2,SP 62R tra Brescello (bivio SP 41) e Sorbolo (bivio SP 20),11248,40,9349,1895,8987,2261,11248,0
2019/01,228,16/01/2019,3,SP 62R tra Brescello (bivio SP 41) e Sorbolo (bivio SP 20),11095,50,9142,1948,8752,2343,11095,0
2019/01,228,17/01/2019,4,SP 62R tra Brescello (bivio SP 41) e Sorbolo (bivio SP 20),11091,10,9211,1879,8869,2222,11091,0
2019/01,228,18/01/2019,5,SP 62R tra Brescello (bivio SP 41) e Sorbolo (bivio SP 20),11285,10,9460,1824,8763,2522,11285,0
2019/01,228,19/01/2019,6,SP 62R tra Brescello (bivio SP 41) e Sorbolo (bivio SP 20),10097,00,9683,414,7435,2662,0,10097
2019/01,228,20/01/2019,7,SP 62R tra Brescello (bivio SP 41) e Sorbolo (bivio SP 20),8853,10,8756,96,6322,2531,0,8853
2019/01,228,21/01/2019,1,SP 62R tra Brescello (bivio SP 41) e Sorbolo (bivio SP 20),10767,00,8839,1928,8686,2081,10767,0
2019/01,228,22/01/2019,2,SP 62R tra Brescello (bivio SP 41) e Sorbolo (bivio SP 20),11094,10,9133,1960,8855,2239,11094,0
2019/01,228,23/01/2019,3,SP 62R tra Brescello (bivio SP 41) e Sorbolo (bivio SP 20),10699,10,8891,1807,8635,2064,10699,0
2019/01,228,24/01/2019,4,SP 62R tra Brescello (bivio SP 41) e Sorbolo (bivio SP 20),10771,10,8857,1913,8606,2165,10771,0
2019/01,228,25/01/2019,5,SP 62R tra Brescello (bivio SP 41) e Sorbolo (bivio SP 20),11164,20,9381,1781,8762,2402,11164,0
2019/01,228,26/01/2019,6,SP 62R tra Brescello (bivio SP 41) e Sorbolo (bivio SP 20),9442,00,9070,372,6920,2522,0,9442
2019/01,228,27/01/2019,7,SP 62R tra Brescello (bivio SP 41) e Sorbolo (bivio SP 20),8246,00,8148,98,6008,2238,0,8246
2019/01,228,28/01/2019,1,SP 62R tra Brescello (bivio SP 41) e Sorbolo (bivio SP 20),10574,20,8723,1849,8460,2114,10574,0
2019/01,229,15/01/2019,2,SP 111 tra bivio SP 1 (a nord di Poviglio) e Boretto (innesto variante),,,,,,,,
2019/01,229,16/01/2019,3,SP 111 tra bivio SP 1 (a nord di Poviglio) e Boretto (innesto variante),,,,,,,,
2019/01,229,17/01/2019,4,SP 111 tra bivio SP 1 (a nord di Poviglio) e Boretto (innesto variante),,,,,,,,
2019/01,229,18/01/2019,5,SP 111 tra bivio SP 1 (a nord di Poviglio) e Boretto (innesto variante),,,,,,,,
2019/01,229,19/01/2019,6,SP 111 tra bivio SP 1 (a nord di Poviglio) e Boretto (innesto variante),,,,,,,,
2019/01,229,20/01/2019,7,SP 111 tra bivio SP 1 (a nord di Poviglio) e Boretto (innesto variante),,,,,,,,
2019/01,229,21/01/2019,1,SP 111 tra bivio SP 1 (a nord di Poviglio) e Boretto (innesto variante),,,,,,,,
2019/01,229,22/01/2019,2,SP 111 tra bivio SP 1 (a nord di Poviglio) e Boretto (innesto variante),,,,,,,,
2019/01,229,23/01/2019,3,SP 111 tra bivio SP 1 (a nord di Poviglio) e Boretto (innesto variante),,,,,,,,
2019/01,229,24/01/2019,4,SP 111 tra bivio SP 1 (a nord di Poviglio) e Boretto (innesto variante),,,,,,,,
2019/01,229,25/01/2019,5,SP 111 tra bivio SP 1 (a nord di Poviglio) e Boretto (innesto variante),,,,,,,,
2019/01,229,26/01/2019,6,SP 111 tra bivio SP 1 (a nord di Poviglio) e Boretto (innesto variante),,,,,,,,
2019/01,229,27/01/2019,7,SP 111 tra bivio SP 1 (a nord di Poviglio) e Boretto (innesto variante),,,,,,,,
2019/01,229,28/01/2019,1,SP 111 tra bivio SP 1 (a nord di Poviglio) e Boretto (innesto variante),,,,,,,,
2019/01,230,15/01/2019,2,SP 62RVar Cispadana da Boretto (bivio Variante SP 358R) a Gualtieri (bivio SP 63R),11052,00,8573,2479,8916,2136,11052,0
2019/01,230,16/01/2019,3,SP 62RVar Cispadana da Boretto (bivio Variante SP 358R) a Gualtieri (bivio SP 63R),11293,00,8727,2566,9055,2238,11293,0
2019/01,230,17/01/2019,4,SP 62RVar Cispadana da Boretto (bivio Variante SP 358R) a Gualtieri (bivio SP 63R),11414,00,8722,2692,9065,2349,11414,0
2019/01,230,18/01/2019,5,SP 62RVar Cispadana da Boretto (bivio Variante SP 358R) a Gualtieri (bivio SP 63R),11585,00,9109,2476,9025,2560,11585,0
2019/01,230,19/01/2019,6,SP 62RVar Cispadana da Boretto (bivio Variante SP 358R) a Gualtieri (bivio SP 63R),8797,00,8311,486,6441,2356,0,8797
2019/01,230,20/01/2019,7,SP 62RVar Cispadana da Boretto (bivio Variante SP 358R) a Gualtieri (bivio SP 63R),8376,00,8245,131,5909,2467,0,8376
2019/01,230,21/01/2019,1,SP 62RVar Cispadana da Boretto (bivio Variante SP 358R) a Gualtieri (bivio SP 63R),10901,00,8324,2577,8758,2143,10901,0
2019/01,230,22/01/2019,2,SP 62RVar Cispadana da Boretto (bivio Variante SP 358R) a Gualtieri (bivio SP 63R),10893,00,8419,2474,8787,2106,10893,0
2019/01,230,23/01/2019,3,SP 62RVar Cispadana da Boretto (bivio Variante SP 358R) a Gualtieri (bivio SP 63R),10840,10,8311,2528,8747,2093,10840,0
2019/01,230,24/01/2019,4,SP 62RVar Cispadana da Boretto (bivio Variante SP 358R) a Gualtieri (bivio SP 63R),11009,00,8501,2508,8896,2113,11009,0
2019/01,230,25/01/2019,5,SP 62RVar Cispadana da Boretto (bivio Variante SP 358R) a Gualtieri (bivio SP 63R),11433,00,8996,2437,8976,2457,11433,0
2019/01,230,26/01/2019,6,SP 62RVar Cispadana da Boretto (bivio Variante SP 358R) a Gualtieri (bivio SP 63R),8352,00,7938,414,6076,2276,0,8352
2019/01,230,27/01/2019,7,SP 62RVar Cispadana da Boretto (bivio Variante SP 358R) a Gualtieri (bivio SP 63R),7619,00,7502,117,5451,2168,0,7619
2019/01,230,28/01/2019,1,SP 62RVar Cispadana da Boretto (bivio Variante SP 358R) a Gualtieri (bivio SP 63R),10763,00,8268,2495,8613,2150,10763,0
2019/01,231,15/01/2019,2,SP 63R tra la località Santa Vittoria (c/o bivio SP 81) e la Cispadana,7067,00,6614,453,5841,1226,7067,0
2019/01,231,16/01/2019,3,SP 63R tra la località Santa Vittoria (c/o bivio SP 81) e la Cispadana,6990,10,6522,467,5669,1321,6990,0
2019/01,231,17/01/2019,4,SP 63R tra la località Santa Vittoria (c/o bivio SP 81) e la Cispadana,7171,00,6727,444,5834,1337,7171,0
2019/01,231,18/01/2019,5,SP 63R tra la località Santa Vittoria (c/o bivio SP 81) e la Cispadana,7250,00,6721,529,5849,1401,7250,0
2019/01,231,19/01/2019,6,SP 63R tra la località Santa Vittoria (c/o bivio SP 81) e la Cispadana,6236,00,6089,147,4778,1458,0,6236
2019/01,231,20/01/2019,7,SP 63R tra la località Santa Vittoria (c/o bivio SP 81) e la Cispadana,4640,00,4622,18,3431,1209,0,4640
2019/01,231,21/01/2019,1,SP 63R tra la località Santa Vittoria (c/o bivio SP 81) e la Cispadana,6632,00,6194,438,5529,1103,6632,0
2019/01,231,22/01/2019,2,SP 63R tra la località Santa Vittoria (c/o bivio SP 81) e la Cispadana,6919,00,6470,449,5694,1225,6919,0
2019/01,231,23/01/2019,3,SP 63R tra la località Santa Vittoria (c/o bivio SP 81) e la Cispadana,7040,00,6554,486,5708,1332,7040,0
2019/01,231,24/01/2019,4,SP 63R tra la località Santa Vittoria (c/o bivio SP 81) e la Cispadana,6831,30,6336,492,5564,1267,6831,0
2019/01,231,25/01/2019,5,SP 63R tra la località Santa Vittoria (c/o bivio SP 81) e la Cispadana,7095,10,6637,457,5707,1388,7095,0
2019/01,231,26/01/2019,6,SP 63R tra la località Santa Vittoria (c/o bivio SP 81) e la Cispadana,6407,10,6265,141,4834,1573,0,6407
2019/01,231,27/01/2019,7,SP 63R tra la località Santa Vittoria (c/o bivio SP 81) e la Cispadana,4540,00,4529,11,3308,1232,0,4540
2019/01,231,28/01/2019,1,SP 63R tra la località Santa Vittoria (c/o bivio SP 81) e la Cispadana,6707,20,6260,445,5487,1220,6707,0
2019/01,236,15/01/2019,2,SP 468 tra Casumaro e Reno Centese,5448,00,4845,603,4392,1056,5448,0
2019/01,236,16/01/2019,3,SP 468 tra Casumaro e Reno Centese,5480,00,4937,543,4458,1022,5480,0
2019/01,236,17/01/2019,4,SP 468 tra Casumaro e Reno Centese,5460,00,4835,625,4445,1015,5460,0
2019/01,236,18/01/2019,5,SP 468 tra Casumaro e Reno Centese,5689,00,5142,547,4449,1240,5689,0
2019/01,236,19/01/2019,6,SP 468 tra Casumaro e Reno Centese,4873,00,4763,110,3725,1148,0,4873
2019/01,236,20/01/2019,7,SP 468 tra Casumaro e Reno Centese,3675,00,3664,11,2621,1054,0,3675
2019/01,236,21/01/2019,1,SP 468 tra Casumaro e Reno Centese,5385,00,4794,591,4331,1054,5385,0
2019/01,236,22/01/2019,2,SP 468 tra Casumaro e Reno Centese,5134,00,4594,540,4181,953,5134,0
2019/01,236,23/01/2019,3,SP 468 tra Casumaro e Reno Centese,5255,00,4710,545,4267,988,5255,0
2019/01,236,24/01/2019,4,SP 468 tra Casumaro e Reno Centese,5429,10,4862,566,4343,1086,5429,0
2019/01,236,25/01/2019,5,SP 468 tra Casumaro e Reno Centese,5663,00,5114,549,4530,1133,5663,0
2019/01,236,26/01/2019,6,SP 468 tra Casumaro e Reno Centese,4993,10,4876,116,3830,1163,0,4993
2019/01,236,27/01/2019,7,SP 468 tra Casumaro e Reno Centese,3625,00,3607,18,2693,932,0,3625
2019/01,236,28/01/2019,1,SP 468 tra Casumaro e Reno Centese,5188,00,4667,521,4214,974,5188,0
2019/01,237,15/01/2019,2,SP 23 tra Quattro Castella e la Variante di Montecavolo (c/o bivio SP 21),14706,00,13906,800,11885,2821,14706,0
2019/01,237,16/01/2019,3,SP 23 tra Quattro Castella e la Variante di Montecavolo (c/o bivio SP 21),15170,00,14358,812,12097,3073,15170,0
2019/01,237,17/01/2019,4,SP 23 tra Quattro Castella e la Variante di Montecavolo (c/o bivio SP 21),15029,00,14242,787,11869,3160,15029,0
2019/01,237,18/01/2019,5,SP 23 tra Quattro Castella e la Variante di Montecavolo (c/o bivio SP 21),15004,00,14226,778,11707,3297,15004,0
2019/01,237,19/01/2019,6,SP 23 tra Quattro Castella e la Variante di Montecavolo (c/o bivio SP 21),13185,00,12999,186,9775,3410,0,13185
2019/01,237,20/01/2019,7,SP 23 tra Quattro Castella e la Variante di Montecavolo (c/o bivio SP 21),10268,00,10233,35,7687,2581,0,10268
2019/01,237,21/01/2019,1,SP 23 tra Quattro Castella e la Variante di Montecavolo (c/o bivio SP 21),14138,00,13424,714,11431,2707,14138,0
2019/01,237,22/01/2019,2,SP 23 tra Quattro Castella e la Variante di Montecavolo (c/o bivio SP 21),14559,00,13781,778,11744,2815,14559,0
2019/01,237,23/01/2019,3,SP 23 tra Quattro Castella e la Variante di Montecavolo (c/o bivio SP 21),14039,10,13325,713,11362,2677,14039,0
2019/01,237,24/01/2019,4,SP 23 tra Quattro Castella e la Variante di Montecavolo (c/o bivio SP 21),13018,00,12433,585,10220,2798,13018,0
2019/01,237,25/01/2019,5,SP 23 tra Quattro Castella e la Variante di Montecavolo (c/o bivio SP 21),14685,00,13998,687,11436,3249,14685,0
2019/01,237,26/01/2019,6,SP 23 tra Quattro Castella e la Variante di Montecavolo (c/o bivio SP 21),12840,00,12628,212,9512,3328,0,12840
2019/01,237,27/01/2019,7,SP 23 tra Quattro Castella e la Variante di Montecavolo (c/o bivio SP 21),9842,00,9802,40,7393,2449,0,9842
2019/01,237,28/01/2019,1,SP 23 tra Quattro Castella e la Variante di Montecavolo (c/o bivio SP 21),14013,00,13347,666,11335,2678,14013,0
2019/01,238,15/01/2019,2,SP 37 fra Albinea e Scandiano (bivio SP 7),11190,00,10581,609,8906,2284,11190,0
2019/01,238,16/01/2019,3,SP 37 fra Albinea e Scandiano (bivio SP 7),11269,00,10687,582,8912,2357,11269,0
2019/01,238,17/01/2019,4,SP 37 fra Albinea e Scandiano (bivio SP 7),11213,00,10561,652,8820,2393,11213,0
2019/01,238,18/01/2019,5,SP 37 fra Albinea e Scandiano (bivio SP 7),10826,00,10266,560,8193,2633,10826,0
2019/01,238,19/01/2019,6,SP 37 fra Albinea e Scandiano (bivio SP 7),9252,00,9131,121,6601,2651,0,9252
2019/01,238,20/01/2019,7,SP 37 fra Albinea e Scandiano (bivio SP 7),7385,00,7349,36,5381,2004,0,7385
2019/01,238,21/01/2019,1,SP 37 fra Albinea e Scandiano (bivio SP 7),10976,00,10388,588,8865,2111,10976,0
2019/01,238,22/01/2019,2,SP 37 fra Albinea e Scandiano (bivio SP 7),10974,00,10368,606,8759,2215,10974,0
2019/01,238,23/01/2019,3,SP 37 fra Albinea e Scandiano (bivio SP 7),10857,00,10238,619,8827,2030,10857,0
2019/01,238,24/01/2019,4,SP 37 fra Albinea e Scandiano (bivio SP 7),9663,00,9157,506,7671,1992,9663,0
2019/01,238,25/01/2019,5,SP 37 fra Albinea e Scandiano (bivio SP 7),11088,00,10496,592,8516,2572,11088,0
2019/01,238,26/01/2019,6,SP 37 fra Albinea e Scandiano (bivio SP 7),9036,00,8881,155,6447,2589,0,9036
2019/01,238,27/01/2019,7,SP 37 fra Albinea e Scandiano (bivio SP 7),6842,00,6809,33,4960,1882,0,6842
2019/01,238,28/01/2019,1,SP 37 fra Albinea e Scandiano (bivio SP 7),10492,00,9959,533,8504,1988,10492,0
2019/01,239,15/01/2019,2,SP 486R fra Sassuolo e Castellarano,26945,10,23518,3426,21668,5277,26945,0
2019/01,239,16/01/2019,3,SP 486R fra Sassuolo e Castellarano,27650,20,23743,3905,22242,5408,27650,0
2019/01,239,17/01/2019,4,SP 486R fra Sassuolo e Castellarano,27449,10,23595,3853,21979,5470,27449,0
2019/01,239,18/01/2019,5,SP 486R fra Sassuolo e Castellarano,27450,10,24123,3326,21785,5665,27450,0
2019/01,239,19/01/2019,6,SP 486R fra Sassuolo e Castellarano,19934,00,19584,350,14679,5255,0,19934
2019/01,239,20/01/2019,7,SP 486R fra Sassuolo e Castellarano,15663,10,15576,86,11331,4332,0,15663
2019/01,239,21/01/2019,1,SP 486R fra Sassuolo e Castellarano,26041,20,22958,3081,21080,4961,26041,0
2019/01,239,22/01/2019,2,SP 486R fra Sassuolo e Castellarano,26327,00,22926,3401,21241,5086,26327,0
2019/01,239,23/01/2019,3,SP 486R fra Sassuolo e Castellarano,24953,10,21528,3424,20420,4533,24953,0
2019/01,239,24/01/2019,4,SP 486R fra Sassuolo e Castellarano,23506,00,20218,3288,18664,4842,23506,0
2019/01,239,25/01/2019,5,SP 486R fra Sassuolo e Castellarano,26892,40,23742,3146,21072,5820,26892,0
2019/01,239,26/01/2019,6,SP 486R fra Sassuolo e Castellarano,20115,10,19694,420,14841,5274,0,20115
2019/01,239,27/01/2019,7,SP 486R fra Sassuolo e Castellarano,14879,10,14747,131,10847,4032,0,14879
2019/01,239,28/01/2019,1,SP 486R fra Sassuolo e Castellarano,25347,10,22384,2962,20468,4879,25347,0
2019/01,242,15/01/2019,2,SS 12 tra Maranello e Pavullo nel Frignano,14792,00,13478,1314,11708,3084,14792,0
2019/01,242,16/01/2019,3,SS 12 tra Maranello e Pavullo nel Frignano,15167,00,13818,1349,11885,3282,15167,0
2019/01,242,17/01/2019,4,SS 12 tra Maranello e Pavullo nel Frignano,15105,10,13707,1397,11681,3424,15105,0
2019/01,242,18/01/2019,5,SS 12 tra Maranello e Pavullo nel Frignano,15620,10,14263,1356,11878,3742,15620,0
2019/01,242,19/01/2019,6,SS 12 tra Maranello e Pavullo nel Frignano,13143,00,12901,242,9560,3583,0,13143
2019/01,242,20/01/2019,7,SS 12 tra Maranello e Pavullo nel Frignano,12542,10,12479,62,9594,2948,0,12542
2019/01,242,21/01/2019,1,SS 12 tra Maranello e Pavullo nel Frignano,14168,00,12943,1225,11361,2807,14168,0
2019/01,242,22/01/2019,2,SS 12 tra Maranello e Pavullo nel Frignano,13180,00,12082,1098,10532,2648,13180,0
2019/01,242,23/01/2019,3,SS 12 tra Maranello e Pavullo nel Frignano,12455,20,11363,1090,10005,2450,12455,0
2019/01,242,24/01/2019,4,SS 12 tra Maranello e Pavullo nel Frignano,10962,10,10098,863,8419,2543,10962,0
2019/01,242,25/01/2019,5,SS 12 tra Maranello e Pavullo nel Frignano,14969,00,13785,1184,11464,3505,14969,0
2019/01,242,26/01/2019,6,SS 12 tra Maranello e Pavullo nel Frignano,14559,10,14305,253,10783,3776,0,14559
2019/01,242,27/01/2019,7,SS 12 tra Maranello e Pavullo nel Frignano,12310,10,12252,57,9520,2790,0,12310
2019/01,242,28/01/2019,1,SS 12 tra Maranello e Pavullo nel Frignano,13760,00,12649,1111,10970,2790,13760,0
2019/01,243,15/01/2019,2,SP 27 tra Ponte Samoggia e Muffa,11158,00,10328,830,8937,2221,11158,0
2019/01,243,16/01/2019,3,SP 27 tra Ponte Samoggia e Muffa,11260,10,10383,876,8984,2276,11260,0
2019/01,243,17/01/2019,4,SP 27 tra Ponte Samoggia e Muffa,11015,00,10207,808,8730,2285,11015,0
2019/01,243,18/01/2019,5,SP 27 tra Ponte Samoggia e Muffa,11272,00,10507,765,8916,2356,11272,0
2019/01,243,19/01/2019,6,SP 27 tra Ponte Samoggia e Muffa,8417,10,8263,153,6264,2153,0,8417
2019/01,243,20/01/2019,7,SP 27 tra Ponte Samoggia e Muffa,5916,10,5872,43,4401,1515,0,5916
2019/01,243,21/01/2019,1,SP 27 tra Ponte Samoggia e Muffa,10519,00,9749,770,8526,1993,10519,0
2019/01,243,22/01/2019,2,SP 27 tra Ponte Samoggia e Muffa,10703,00,9933,770,8671,2032,10703,0
2019/01,243,23/01/2019,3,SP 27 tra Ponte Samoggia e Muffa,10424,00,9676,748,8363,2061,10424,0
2019/01,243,24/01/2019,4,SP 27 tra Ponte Samoggia e Muffa,10151,10,9418,732,8013,2138,10151,0
2019/01,243,25/01/2019,5,SP 27 tra Ponte Samoggia e Muffa,10912,00,10171,741,8654,2258,10912,0
2019/01,243,26/01/2019,6,SP 27 tra Ponte Samoggia e Muffa,8368,00,8193,175,6233,2135,0,8368
2019/01,243,27/01/2019,7,SP 27 tra Ponte Samoggia e Muffa,5973,00,5927,46,4479,1494,0,5973
2019/01,243,28/01/2019,1,SP 27 tra Ponte Samoggia e Muffa,10286,00,9575,711,8376,1910,10286,0
2019/01,244,15/01/2019,2,SP 569 tra Pragatto e innesto variante Ponte Ronca,27361,00,25719,1642,21357,6004,27361,0
2019/01,244,16/01/2019,3,SP 569 tra Pragatto e innesto variante Ponte Ronca,27655,00,26131,1524,21630,6025,27655,0
2019/01,244,17/01/2019,4,SP 569 tra Pragatto e innesto variante Ponte Ronca,27407,10,25837,1569,21122,6285,27407,0
2019/01,244,18/01/2019,5,SP 569 tra Pragatto e innesto variante Ponte Ronca,29068,00,27474,1594,22144,6924,29068,0
2019/01,244,19/01/2019,6,SP 569 tra Pragatto e innesto variante Ponte Ronca,26141,00,25844,297,19490,6651,0,26141
2019/01,244,20/01/2019,7,SP 569 tra Pragatto e innesto variante Ponte Ronca,21719,10,21632,86,16286,5433,0,21719
2019/01,244,21/01/2019,1,SP 569 tra Pragatto e innesto variante Ponte Ronca,26932,10,25332,1599,21366,5566,26932,0
2019/01,244,22/01/2019,2,SP 569 tra Pragatto e innesto variante Ponte Ronca,26836,10,25215,1620,21148,5688,26836,0
2019/01,244,23/01/2019,3,SP 569 tra Pragatto e innesto variante Ponte Ronca,26469,10,24862,1606,20760,5709,26469,0
2019/01,244,24/01/2019,4,SP 569 tra Pragatto e innesto variante Ponte Ronca,25340,00,23881,1459,19550,5790,25340,0
2019/01,244,25/01/2019,5,SP 569 tra Pragatto e innesto variante Ponte Ronca,28765,10,27116,1648,22035,6730,28765,0
2019/01,244,26/01/2019,6,SP 569 tra Pragatto e innesto variante Ponte Ronca,27384,00,26985,399,20468,6916,0,27384
2019/01,244,27/01/2019,7,SP 569 tra Pragatto e innesto variante Ponte Ronca,21412,00,21335,77,16261,5151,0,21412
2019/01,244,28/01/2019,1,SP 569 tra Pragatto e innesto variante Ponte Ronca,25963,00,24330,1633,20716,5247,25963,0
2019/01,245,15/01/2019,2,SP 569 da intersezione Pedemontana a Savignano sul Panaro,6844,10,6463,380,5267,1577,6844,0
2019/01,245,16/01/2019,3,SP 569 da intersezione Pedemontana a Savignano sul Panaro,7098,00,6710,388,5512,1586,7098,0
2019/01,245,17/01/2019,4,SP 569 da intersezione Pedemontana a Savignano sul Panaro,6676,00,6311,365,5085,1591,6676,0
2019/01,245,18/01/2019,5,SP 569 da intersezione Pedemontana a Savignano sul Panaro,7671,00,7278,393,5818,1853,7671,0
2019/01,245,19/01/2019,6,SP 569 da intersezione Pedemontana a Savignano sul Panaro,7603,00,7460,143,5613,1990,0,7603
2019/01,245,20/01/2019,7,SP 569 da intersezione Pedemontana a Savignano sul Panaro,6406,00,6362,44,4868,1538,0,6406
2019/01,245,21/01/2019,1,SP 569 da intersezione Pedemontana a Savignano sul Panaro,6642,00,6257,385,5226,1416,6642,0
2019/01,245,22/01/2019,2,SP 569 da intersezione Pedemontana a Savignano sul Panaro,6864,00,6464,400,5430,1434,6864,0
2019/01,245,23/01/2019,3,SP 569 da intersezione Pedemontana a Savignano sul Panaro,6581,00,6203,378,5138,1443,6581,0
2019/01,245,24/01/2019,4,SP 569 da intersezione Pedemontana a Savignano sul Panaro,6092,10,5768,323,4638,1454,6092,0
2019/01,245,25/01/2019,5,SP 569 da intersezione Pedemontana a Savignano sul Panaro,7548,00,7156,392,5728,1820,7548,0
2019/01,245,26/01/2019,6,SP 569 da intersezione Pedemontana a Savignano sul Panaro,8390,00,8255,135,6328,2062,0,8390
2019/01,245,27/01/2019,7,SP 569 da intersezione Pedemontana a Savignano sul Panaro,6380,00,6339,41,4895,1485,0,6380
2019/01,245,28/01/2019,1,SP 569 da intersezione Pedemontana a Savignano sul Panaro,6584,00,6198,386,5205,1379,6584,0
2019/01,246,15/01/2019,2,SP 255 da Decima a San Giovanni in Persiceto,14599,00,13513,1086,11540,3059,14599,0
2019/01,246,16/01/2019,3,SP 255 da Decima a San Giovanni in Persiceto,14939,00,13855,1084,11623,3316,14939,0
2019/01,246,17/01/2019,4,SP 255 da Decima a San Giovanni in Persiceto,14737,00,13614,1123,11490,3247,14737,0
2019/01,246,18/01/2019,5,SP 255 da Decima a San Giovanni in Persiceto,15169,10,14098,1070,11610,3559,15169,0
2019/01,246,19/01/2019,6,SP 255 da Decima a San Giovanni in Persiceto,11968,00,11782,186,8421,3547,0,11968
2019/01,246,20/01/2019,7,SP 255 da Decima a San Giovanni in Persiceto,8531,00,8481,50,5843,2688,0,8531
2019/01,246,21/01/2019,1,SP 255 da Decima a San Giovanni in Persiceto,14303,00,13251,1052,11407,2896,14303,0
2019/01,246,22/01/2019,2,SP 255 da Decima a San Giovanni in Persiceto,14240,00,13136,1104,11334,2906,14240,0
2019/01,246,23/01/2019,3,SP 255 da Decima a San Giovanni in Persiceto,14359,10,13320,1038,11354,3005,14359,0
2019/01,246,24/01/2019,4,SP 255 da Decima a San Giovanni in Persiceto,14307,00,13299,1008,11109,3198,14307,0
2019/01,246,25/01/2019,5,SP 255 da Decima a San Giovanni in Persiceto,14917,00,13866,1051,11323,3594,14917,0
2019/01,246,26/01/2019,6,SP 255 da Decima a San Giovanni in Persiceto,11414,00,11210,204,8092,3322,0,11414
2019/01,246,27/01/2019,7,SP 255 da Decima a San Giovanni in Persiceto,8595,00,8556,39,6037,2558,0,8595
2019/01,246,28/01/2019,1,SP 255 da Decima a San Giovanni in Persiceto,13982,10,12951,1030,11031,2951,13982,0
2019/01,247,15/01/2019,2,SP 255 fra Nonantola e Sant'Agata Bolognese,10225,00,8713,1512,8057,2168,10225,0
2019/01,247,16/01/2019,3,SP 255 fra Nonantola e Sant'Agata Bolognese,10380,00,8791,1589,8015,2365,10380,0
2019/01,247,17/01/2019,4,SP 255 fra Nonantola e Sant'Agata Bolognese,10460,00,8942,1518,8105,2355,10460,0
2019/01,247,18/01/2019,5,SP 255 fra Nonantola e Sant'Agata Bolognese,10669,00,9211,1458,8134,2535,10669,0
2019/01,247,19/01/2019,6,SP 255 fra Nonantola e Sant'Agata Bolognese,7327,00,7092,235,5098,2229,0,7327
2019/01,247,20/01/2019,7,SP 255 fra Nonantola e Sant'Agata Bolognese,6087,00,6041,46,4244,1843,0,6087
2019/01,247,21/01/2019,1,SP 255 fra Nonantola e Sant'Agata Bolognese,9933,00,8460,1473,7882,2051,9933,0
2019/01,247,22/01/2019,2,SP 255 fra Nonantola e Sant'Agata Bolognese,10108,00,8584,1524,7924,2184,10108,0
2019/01,247,23/01/2019,3,SP 255 fra Nonantola e Sant'Agata Bolognese,9884,00,8440,1444,7774,2110,9884,0
2019/01,247,24/01/2019,4,SP 255 fra Nonantola e Sant'Agata Bolognese,9891,00,8427,1464,7616,2275,9891,0
2019/01,247,25/01/2019,5,SP 255 fra Nonantola e Sant'Agata Bolognese,10398,00,8903,1495,8042,2356,10398,0
2019/01,247,26/01/2019,6,SP 255 fra Nonantola e Sant'Agata Bolognese,6806,00,6594,212,4771,2035,0,6806
2019/01,247,27/01/2019,7,SP 255 fra Nonantola e Sant'Agata Bolognese,5833,00,5795,38,4055,1778,0,5833
2019/01,247,28/01/2019,1,SP 255 fra Nonantola e Sant'Agata Bolognese,9814,00,8365,1449,7738,2076,9814,0
2019/01,251,15/01/2019,2,SP 610 tra Imola e Casalfiumanese in località Ca' Miseria,12610,10,11951,658,9813,2797,12610,0
2019/01,251,16/01/2019,3,SP 610 tra Imola e Casalfiumanese in località Ca' Miseria,12763,10,12064,698,9870,2893,12763,0
2019/01,251,17/01/2019,4,SP 610 tra Imola e Casalfiumanese in località Ca' Miseria,13213,10,12504,708,10356,2857,13213,0
2019/01,251,18/01/2019,5,SP 610 tra Imola e Casalfiumanese in località Ca' Miseria,13115,20,12464,649,10132,2983,13115,0
2019/01,251,19/01/2019,6,SP 610 tra Imola e Casalfiumanese in località Ca' Miseria,11590,10,11438,151,8731,2859,0,11590
2019/01,251,20/01/2019,7,SP 610 tra Imola e Casalfiumanese in località Ca' Miseria,8946,00,8914,32,6787,2159,0,8946
2019/01,251,21/01/2019,1,SP 610 tra Imola e Casalfiumanese in località Ca' Miseria,12285,10,11572,712,9804,2481,12285,0
2019/01,251,22/01/2019,2,SP 610 tra Imola e Casalfiumanese in località Ca' Miseria,12043,10,11363,679,9602,2441,12043,0
2019/01,251,23/01/2019,3,SP 610 tra Imola e Casalfiumanese in località Ca' Miseria,11976,00,11372,604,9249,2727,11976,0
2019/01,251,24/01/2019,4,SP 610 tra Imola e Casalfiumanese in località Ca' Miseria,11700,00,11113,587,9000,2700,11700,0
2019/01,251,25/01/2019,5,SP 610 tra Imola e Casalfiumanese in località Ca' Miseria,13002,30,12381,618,10055,2947,13002,0
2019/01,251,26/01/2019,6,SP 610 tra Imola e Casalfiumanese in località Ca' Miseria,12004,00,11850,154,9006,2998,0,12004
2019/01,251,27/01/2019,7,SP 610 tra Imola e Casalfiumanese in località Ca' Miseria,9252,00,9205,47,7128,2124,0,9252
2019/01,251,28/01/2019,1,SP 610 tra Imola e Casalfiumanese in località Ca' Miseria,12164,00,11524,640,9639,2525,12164,0
2019/01,252,15/01/2019,2,SP 3_2 tra Budrio e bivio SP 29 per Medicina,9367,20,8433,932,7679,1688,9367,0
2019/01,252,16/01/2019,3,SP 3_2 tra Budrio e bivio SP 29 per Medicina,9242,00,8420,822,7576,1666,9242,0
2019/01,252,17/01/2019,4,SP 3_2 tra Budrio e bivio SP 29 per Medicina,9254,00,8469,785,7519,1735,9254,0
2019/01,252,18/01/2019,5,SP 3_2 tra Budrio e bivio SP 29 per Medicina,9499,10,8765,733,7469,2030,9499,0
2019/01,252,19/01/2019,6,SP 3_2 tra Budrio e bivio SP 29 per Medicina,6744,00,6621,123,5060,1684,0,6744
2019/01,252,20/01/2019,7,SP 3_2 tra Budrio e bivio SP 29 per Medicina,5957,00,5924,33,4558,1399,0,5957
2019/01,252,21/01/2019,1,SP 3_2 tra Budrio e bivio SP 29 per Medicina,9127,00,8369,758,7460,1667,9127,0
2019/01,252,22/01/2019,2,SP 3_2 tra Budrio e bivio SP 29 per Medicina,8523,00,7811,712,6970,1553,8523,0
2019/01,252,23/01/2019,3,SP 3_2 tra Budrio e bivio SP 29 per Medicina,8589,00,7865,724,6875,1714,8589,0
2019/01,252,24/01/2019,4,SP 3_2 tra Budrio e bivio SP 29 per Medicina,8647,00,7958,689,6957,1690,8647,0
2019/01,252,25/01/2019,5,SP 3_2 tra Budrio e bivio SP 29 per Medicina,9274,00,8530,744,7404,1870,9274,0
2019/01,252,26/01/2019,6,SP 3_2 tra Budrio e bivio SP 29 per Medicina,6699,00,6579,120,5029,1670,0,6699
2019/01,252,27/01/2019,7,SP 3_2 tra Budrio e bivio SP 29 per Medicina,5657,00,5622,35,4281,1376,0,5657
2019/01,252,28/01/2019,1,SP 3_2 tra Budrio e bivio SP 29 per Medicina,8799,00,8039,760,7164,1635,8799,0
2019/01,255,15/01/2019,2,SS 9 tra Castel San Pietro e Imola,19529,00,18749,780,15567,3962,19529,0
2019/01,255,16/01/2019,3,SS 9 tra Castel San Pietro e Imola,19446,20,18726,718,15382,4064,19446,0
2019/01,255,17/01/2019,4,SS 9 tra Castel San Pietro e Imola,19543,50,18720,818,15561,3982,19543,0
2019/01,255,18/01/2019,5,SS 9 tra Castel San Pietro e Imola,19998,30,19339,656,15789,4209,19998,0
2019/01,255,19/01/2019,6,SS 9 tra Castel San Pietro e Imola,17357,10,17121,235,12577,4780,0,17357
2019/01,255,20/01/2019,7,SS 9 tra Castel San Pietro e Imola,13616,10,13554,61,9922,3694,0,13616
2019/01,255,21/01/2019,1,SS 9 tra Castel San Pietro e Imola,19242,50,18505,732,15226,4016,19242,0
2019/01,255,22/01/2019,2,SS 9 tra Castel San Pietro e Imola,18446,00,17709,737,14810,3636,18446,0
2019/01,255,23/01/2019,3,SS 9 tra Castel San Pietro e Imola,18661,10,17926,734,14765,3896,18661,0
2019/01,255,24/01/2019,4,SS 9 tra Castel San Pietro e Imola,18408,10,17699,708,14544,3864,18408,0
2019/01,255,25/01/2019,5,SS 9 tra Castel San Pietro e Imola,20504,10,19800,703,15982,4522,20504,0
2019/01,255,26/01/2019,6,SS 9 tra Castel San Pietro e Imola,17709,30,17476,230,13507,4202,0,17709
2019/01,255,27/01/2019,7,SS 9 tra Castel San Pietro e Imola,13140,00,13061,79,9334,3806,0,13140
2019/01,255,28/01/2019,1,SS 9 tra Castel San Pietro e Imola,18834,10,18194,639,14838,3996,18834,0
2019/01,256,16/01/2019,3,SP 302R tra Faenza (bivio SP 66) e Brisighella,7923,10,7641,281,6265,1658,7923,0
2019/01,256,17/01/2019,4,SP 302R tra Faenza (bivio SP 66) e Brisighella,8010,00,7730,280,6260,1750,8010,0
2019/01,256,18/01/2019,5,SP 302R tra Faenza (bivio SP 66) e Brisighella,8199,00,7950,249,6329,1870,8199,0
2019/01,256,19/01/2019,6,SP 302R tra Faenza (bivio SP 66) e Brisighella,7567,00,7481,86,5661,1906,0,7567
2019/01,256,20/01/2019,7,SP 302R tra Faenza (bivio SP 66) e Brisighella,6410,00,6394,16,4930,1480,0,6410
2019/01,256,21/01/2019,1,SP 302R tra Faenza (bivio SP 66) e Brisighella,7762,00,7554,208,6155,1607,7762,0
2019/01,256,22/01/2019,2,SP 302R tra Faenza (bivio SP 66) e Brisighella,7078,00,6862,216,5706,1372,7078,0
2019/01,256,23/01/2019,3,SP 302R tra Faenza (bivio SP 66) e Brisighella,7368,10,7172,195,5815,1553,7368,0
2019/01,256,24/01/2019,4,SP 302R tra Faenza (bivio SP 66) e Brisighella,7042,10,6848,193,5492,1550,7042,0
2019/01,256,25/01/2019,5,SP 302R tra Faenza (bivio SP 66) e Brisighella,8111,00,7904,207,6239,1872,8111,0
2019/01,256,26/01/2019,6,SP 302R tra Faenza (bivio SP 66) e Brisighella,7849,00,7756,93,5919,1930,0,7849
2019/01,256,27/01/2019,7,SP 302R tra Faenza (bivio SP 66) e Brisighella,6833,00,6811,22,5504,1329,0,6833
2019/01,256,28/01/2019,1,SP 302R tra Faenza (bivio SP 66) e Brisighella,7598,00,7383,215,6101,1497,7598,0
2019/01,257,15/01/2019,2,SP 302R tra Faenza e il bivio SP 4 (a sud di Russi),6491,00,6285,206,5163,1328,6491,0
2019/01,257,16/01/2019,3,SP 302R tra Faenza e il bivio SP 4 (a sud di Russi),6440,00,6249,191,5040,1400,6440,0
2019/01,257,17/01/2019,4,SP 302R tra Faenza e il bivio SP 4 (a sud di Russi),6594,00,6395,199,5103,1491,6594,0
2019/01,257,18/01/2019,5,SP 302R tra Faenza e il bivio SP 4 (a sud di Russi),6538,10,6352,185,4992,1546,6538,0
2019/01,257,19/01/2019,6,SP 302R tra Faenza e il bivio SP 4 (a sud di Russi),5918,00,5832,86,4264,1654,0,5918
2019/01,257,20/01/2019,7,SP 302R tra Faenza e il bivio SP 4 (a sud di Russi),4453,00,4432,21,3238,1215,0,4453
2019/01,257,21/01/2019,1,SP 302R tra Faenza e il bivio SP 4 (a sud di Russi),6383,00,6225,158,5078,1305,6383,0
2019/01,257,22/01/2019,2,SP 302R tra Faenza e il bivio SP 4 (a sud di Russi),5997,00,5824,173,4858,1139,5997,0
2019/01,257,23/01/2019,3,SP 302R tra Faenza e il bivio SP 4 (a sud di Russi),6073,00,5910,163,4794,1279,6073,0
2019/01,257,24/01/2019,4,SP 302R tra Faenza e il bivio SP 4 (a sud di Russi),6248,00,6080,168,4872,1376,6248,0
2019/01,257,25/01/2019,5,SP 302R tra Faenza e il bivio SP 4 (a sud di Russi),6342,00,6169,173,4866,1476,6342,0
2019/01,257,26/01/2019,6,SP 302R tra Faenza e il bivio SP 4 (a sud di Russi),5708,00,5608,100,4119,1589,0,5708
2019/01,257,27/01/2019,7,SP 302R tra Faenza e il bivio SP 4 (a sud di Russi),4563,00,4543,20,3366,1197,0,4563
2019/01,257,28/01/2019,1,SP 302R tra Faenza e il bivio SP 4 (a sud di Russi),5990,10,5819,170,4782,1208,5990,0
2019/01,258,15/01/2019,2,SS 9 tra Forlimpopoli e Cesena,24331,30,22286,2042,19085,5246,24331,0
2019/01,258,16/01/2019,3,SS 9 tra Forlimpopoli e Cesena,24520,130,22489,2018,19248,5272,24520,0
2019/01,258,17/01/2019,4,SS 9 tra Forlimpopoli e Cesena,24326,10,22281,2044,18826,5500,24326,0
2019/01,258,18/01/2019,5,SS 9 tra Forlimpopoli e Cesena,25139,00,23076,2063,19211,5928,25139,0
2019/01,258,19/01/2019,6,SS 9 tra Forlimpopoli e Cesena,20584,00,19808,776,14813,5771,0,20584
2019/01,258,20/01/2019,7,SS 9 tra Forlimpopoli e Cesena,16301,00,16093,208,11554,4747,0,16301
2019/01,258,21/01/2019,1,SS 9 tra Forlimpopoli e Cesena,23613,120,21664,1937,18652,4961,23613,0
2019/01,258,22/01/2019,2,SS 9 tra Forlimpopoli e Cesena,21723,80,19833,1882,17314,4409,21723,0
2019/01,258,23/01/2019,3,SS 9 tra Forlimpopoli e Cesena,22900,50,21036,1859,17980,4920,22900,0
2019/01,258,24/01/2019,4,SS 9 tra Forlimpopoli e Cesena,23419,10,21533,1885,18277,5142,23419,0
2019/01,258,25/01/2019,5,SS 9 tra Forlimpopoli e Cesena,24734,30,22797,1934,18903,5831,24734,0
2019/01,258,26/01/2019,6,SS 9 tra Forlimpopoli e Cesena,21471,50,20705,761,15370,6101,0,21471
2019/01,258,27/01/2019,7,SS 9 tra Forlimpopoli e Cesena,16331,00,16138,193,11608,4723,0,16331
2019/01,258,28/01/2019,1,SS 9 tra Forlimpopoli e Cesena,23406,160,21498,1892,18613,4793,23406,0
2019/01,259,15/01/2019,2,SP 7 in località Calabrina al Confine Provinciale,7955,00,7509,446,6341,1614,7955,0
2019/01,259,16/01/2019,3,SP 7 in località Calabrina al Confine Provinciale,8102,00,7566,536,6465,1637,8102,0
2019/01,259,17/01/2019,4,SP 7 in località Calabrina al Confine Provinciale,8042,00,7568,474,6328,1714,8042,0
2019/01,259,18/01/2019,5,SP 7 in località Calabrina al Confine Provinciale,8119,00,7686,433,6041,2078,8119,0
2019/01,259,19/01/2019,6,SP 7 in località Calabrina al Confine Provinciale,7300,00,7139,161,4696,2604,0,7300
2019/01,259,20/01/2019,7,SP 7 in località Calabrina al Confine Provinciale,7163,00,7131,32,4822,2341,0,7163
2019/01,259,21/01/2019,1,SP 7 in località Calabrina al Confine Provinciale,7522,00,7059,463,5998,1524,7522,0
2019/01,259,22/01/2019,2,SP 7 in località Calabrina al Confine Provinciale,6403,00,5979,424,5149,1254,6403,0
2019/01,259,23/01/2019,3,SP 7 in località Calabrina al Confine Provinciale,7250,00,6781,469,5780,1470,7250,0
2019/01,259,24/01/2019,4,SP 7 in località Calabrina al Confine Provinciale,7488,00,7059,429,5765,1723,7488,0
2019/01,259,25/01/2019,5,SP 7 in località Calabrina al Confine Provinciale,8485,00,8091,394,6335,2150,8485,0
2019/01,259,26/01/2019,6,SP 7 in località Calabrina al Confine Provinciale,7630,00,7459,171,5247,2383,0,7630
2019/01,259,27/01/2019,7,SP 7 in località Calabrina al Confine Provinciale,6429,00,6393,36,4483,1946,0,6429
2019/01,259,28/01/2019,1,SP 7 in località Calabrina al Confine Provinciale,7025,00,6566,459,5583,1442,7025,0
2019/01,260,15/01/2019,2,SP 8 tra Cesena e A 14,11005,00,10673,332,8959,2046,11005,0
2019/01,260,16/01/2019,3,SP 8 tra Cesena e A 14,11593,00,11271,322,9405,2188,11593,0
2019/01,260,17/01/2019,4,SP 8 tra Cesena e A 14,11054,10,10752,301,8902,2152,11054,0
2019/01,260,18/01/2019,5,SP 8 tra Cesena e A 14,11667,10,11327,339,9142,2525,11667,0
2019/01,260,19/01/2019,6,SP 8 tra Cesena e A 14,10003,00,9906,97,7272,2731,0,10003
2019/01,260,20/01/2019,7,SP 8 tra Cesena e A 14,7875,00,7851,24,5566,2309,0,7875
2019/01,260,21/01/2019,1,SP 8 tra Cesena e A 14,10911,00,10593,318,8998,1913,10911,0
2019/01,260,22/01/2019,2,SP 8 tra Cesena e A 14,9802,00,9513,289,8087,1715,9802,0
2019/01,260,23/01/2019,3,SP 8 tra Cesena e A 14,10469,00,10162,307,8427,2042,10469,0
2019/01,260,24/01/2019,4,SP 8 tra Cesena e A 14,10953,00,10662,291,8774,2179,10953,0
2019/01,260,25/01/2019,5,SP 8 tra Cesena e A 14,11727,00,11417,310,9059,2668,11727,0
2019/01,260,26/01/2019,6,SP 8 tra Cesena e A 14,10903,00,10796,107,7988,2915,0,10903
2019/01,260,27/01/2019,7,SP 8 tra Cesena e A 14,8283,00,8263,20,5899,2384,0,8283
2019/01,260,28/01/2019,1,SP 8 tra Cesena e A 14,11028,00,10632,396,9144,1884,11028,0
2019/01,261,15/01/2019,2,SS 9 tra Cesena e Savignano sul Rubicone,28229,00,25970,2259,22407,5822,28229,0
2019/01,261,16/01/2019,3,SS 9 tra Cesena e Savignano sul Rubicone,28753,40,26447,2302,22872,5881,28753,0
2019/01,261,17/01/2019,4,SS 9 tra Cesena e Savignano sul Rubicone,28575,10,26313,2261,22499,6076,28575,0
2019/01,261,18/01/2019,5,SS 9 tra Cesena e Savignano sul Rubicone,29383,10,27114,2268,22895,6488,29383,0
2019/01,261,19/01/2019,6,SS 9 tra Cesena e Savignano sul Rubicone,22445,00,21661,784,16097,6348,0,22445
2019/01,261,20/01/2019,7,SS 9 tra Cesena e Savignano sul Rubicone,16657,00,16496,161,11561,5096,0,16657
2019/01,261,21/01/2019,1,SS 9 tra Cesena e Savignano sul Rubicone,27702,00,25527,2175,22315,5387,27702,0
2019/01,261,22/01/2019,2,SS 9 tra Cesena e Savignano sul Rubicone,25676,00,23595,2081,20924,4752,25676,0
2019/01,261,23/01/2019,3,SS 9 tra Cesena e Savignano sul Rubicone,27112,00,25083,2029,21791,5321,27112,0
2019/01,261,24/01/2019,4,SS 9 tra Cesena e Savignano sul Rubicone,27647,00,25696,1951,21873,5774,27647,0
2019/01,261,25/01/2019,5,SS 9 tra Cesena e Savignano sul Rubicone,28741,00,26608,2133,22319,6422,28741,0
2019/01,261,26/01/2019,6,SS 9 tra Cesena e Savignano sul Rubicone,22866,10,22126,739,16658,6208,0,22866
2019/01,261,27/01/2019,7,SS 9 tra Cesena e Savignano sul Rubicone,16232,10,16105,126,11289,4943,0,16232
2019/01,261,28/01/2019,1,SS 9 tra Cesena e Savignano sul Rubicone,26717,00,24811,1906,21346,5371,26717,0
2019/01,262,15/01/2019,2,SS 9 tra Savignano sul Rubicone e Santarcangelo di Romagna,,,,,,,,
2019/01,262,16/01/2019,3,SS 9 tra Savignano sul Rubicone e Santarcangelo di Romagna,,,,,,,,
2019/01,262,17/01/2019,4,SS 9 tra Savignano sul Rubicone e Santarcangelo di Romagna,,,,,,,,
2019/01,262,18/01/2019,5,SS 9 tra Savignano sul Rubicone e Santarcangelo di Romagna,,,,,,,,
2019/01,262,19/01/2019,6,SS 9 tra Savignano sul Rubicone e Santarcangelo di Romagna,,,,,,,,
2019/01,262,20/01/2019,7,SS 9 tra Savignano sul Rubicone e Santarcangelo di Romagna,,,,,,,,
2019/01,262,21/01/2019,1,SS 9 tra Savignano sul Rubicone e Santarcangelo di Romagna,,,,,,,,
2019/01,262,22/01/2019,2,SS 9 tra Savignano sul Rubicone e Santarcangelo di Romagna,,,,,,,,
2019/01,262,23/01/2019,3,SS 9 tra Savignano sul Rubicone e Santarcangelo di Romagna,,,,,,,,
2019/01,262,24/01/2019,4,SS 9 tra Savignano sul Rubicone e Santarcangelo di Romagna,,,,,,,,
2019/01,262,25/01/2019,5,SS 9 tra Savignano sul Rubicone e Santarcangelo di Romagna,,,,,,,,
2019/01,262,26/01/2019,6,SS 9 tra Savignano sul Rubicone e Santarcangelo di Romagna,,,,,,,,
2019/01,262,27/01/2019,7,SS 9 tra Savignano sul Rubicone e Santarcangelo di Romagna,,,,,,,,
2019/01,262,28/01/2019,1,SS 9 tra Savignano sul Rubicone e Santarcangelo di Romagna,,,,,,,,
2019/01,263,15/01/2019,2,Via Adriatica (ex SS 16) tra Riccione e Misano Adriatico,16240,00,15838,402,12951,3289,16240,0
2019/01,263,16/01/2019,3,Via Adriatica (ex SS 16) tra Riccione e Misano Adriatico,16251,10,15841,409,12759,3492,16251,0
2019/01,263,17/01/2019,4,Via Adriatica (ex SS 16) tra Riccione e Misano Adriatico,16715,00,16323,392,13064,3651,16715,0
2019/01,263,18/01/2019,5,Via Adriatica (ex SS 16) tra Riccione e Misano Adriatico,16914,00,16531,383,12738,4176,16914,0
2019/01,263,19/01/2019,6,Via Adriatica (ex SS 16) tra Riccione e Misano Adriatico,16596,10,16426,169,11146,5450,0,16596
2019/01,263,20/01/2019,7,Via Adriatica (ex SS 16) tra Riccione e Misano Adriatico,14336,10,14282,53,9307,5029,0,14336
2019/01,263,21/01/2019,1,Via Adriatica (ex SS 16) tra Riccione e Misano Adriatico,15833,00,15516,317,12465,3368,15833,0
2019/01,263,22/01/2019,2,Via Adriatica (ex SS 16) tra Riccione e Misano Adriatico,14972,00,14608,364,11807,3165,14972,0
2019/01,263,23/01/2019,3,Via Adriatica (ex SS 16) tra Riccione e Misano Adriatico,15752,00,15382,370,12209,3543,15752,0
2019/01,263,24/01/2019,4,Via Adriatica (ex SS 16) tra Riccione e Misano Adriatico,16089,00,15719,370,12458,3631,16089,0
2019/01,263,25/01/2019,5,Via Adriatica (ex SS 16) tra Riccione e Misano Adriatico,16881,00,16450,431,12610,4271,16881,0
2019/01,263,26/01/2019,6,Via Adriatica (ex SS 16) tra Riccione e Misano Adriatico,16707,20,16557,148,11432,5275,0,16707
2019/01,263,27/01/2019,7,Via Adriatica (ex SS 16) tra Riccione e Misano Adriatico,13901,00,13859,42,9199,4702,0,13901
2019/01,263,28/01/2019,1,Via Adriatica (ex SS 16) tra Riccione e Misano Adriatico,16033,10,15684,348,12711,3322,16033,0
2019/01,269,15/01/2019,2,SS 12 a Medolla,19696,10,17799,1896,15927,3769,19696,0
2019/01,269,16/01/2019,3,SS 12 a Medolla,19416,00,17555,1861,15659,3757,19416,0
2019/01,269,17/01/2019,4,SS 12 a Medolla,20000,00,18101,1899,16109,3891,20000,0
2019/01,269,18/01/2019,5,SS 12 a Medolla,19864,00,18130,1734,15541,4323,19864,0
2019/01,269,19/01/2019,6,SS 12 a Medolla,14856,00,14583,273,10604,4252,0,14856
2019/01,269,20/01/2019,7,SS 12 a Medolla,11988,00,11927,61,8403,3585,0,11988
2019/01,269,21/01/2019,1,SS 12 a Medolla,18914,20,17048,1864,15407,3507,18914,0
2019/01,269,22/01/2019,2,SS 12 a Medolla,19429,10,17643,1785,15854,3575,19429,0
2019/01,269,23/01/2019,3,SS 12 a Medolla,19384,10,17550,1833,15503,3881,19384,0
2019/01,269,24/01/2019,4,SS 12 a Medolla,19361,10,17451,1909,15486,3875,19361,0
2019/01,269,25/01/2019,5,SS 12 a Medolla,20240,10,18416,1823,15663,4577,20240,0
2019/01,269,26/01/2019,6,SS 12 a Medolla,15274,00,14932,342,10860,4414,0,15274
2019/01,269,27/01/2019,7,SS 12 a Medolla,11518,00,11451,67,8065,3453,0,11518
2019/01,269,28/01/2019,1,SS 12 a Medolla,18499,10,16772,1726,15073,3426,18499,0
2019/01,275,15/01/2019,2,SP 5 dall'intersezione SP 3 a intersezione per Ca' de Fabbri,11001,00,10505,496,8855,2146,11001,0
2019/01,275,16/01/2019,3,SP 5 dall'intersezione SP 3 a intersezione per Ca' de Fabbri,11231,00,10725,506,8934,2297,11231,0
2019/01,275,17/01/2019,4,SP 5 dall'intersezione SP 3 a intersezione per Ca' de Fabbri,11083,00,10582,501,8723,2360,11083,0
2019/01,275,18/01/2019,5,SP 5 dall'intersezione SP 3 a intersezione per Ca' de Fabbri,11431,00,10922,509,8938,2493,11431,0
2019/01,275,19/01/2019,6,SP 5 dall'intersezione SP 3 a intersezione per Ca' de Fabbri,8706,00,8553,153,6450,2256,0,8706
2019/01,275,20/01/2019,7,SP 5 dall'intersezione SP 3 a intersezione per Ca' de Fabbri,5812,00,5781,31,4037,1775,0,5812
2019/01,275,21/01/2019,1,SP 5 dall'intersezione SP 3 a intersezione per Ca' de Fabbri,7893,00,7521,372,5862,2031,7893,0
2019/01,275,25/01/2019,5,SP 5 dall'intersezione SP 3 a intersezione per Ca' de Fabbri,9825,00,9404,421,7541,2284,9825,0
2019/01,275,26/01/2019,6,SP 5 dall'intersezione SP 3 a intersezione per Ca' de Fabbri,8390,10,8231,158,6139,2251,0,8390
2019/01,275,27/01/2019,7,SP 5 dall'intersezione SP 3 a intersezione per Ca' de Fabbri,6518,00,6474,44,4801,1717,0,6518
2019/01,275,28/01/2019,1,SP 5 dall'intersezione SP 3 a intersezione per Ca' de Fabbri,10470,10,10000,469,8459,2011,10470,0
2019/01,276,15/01/2019,2,SP 3_2 tra intersezione SP 5 e ponte torrente Idice,12709,00,11478,1231,10395,2314,12709,0
2019/01,276,16/01/2019,3,SP 3_2 tra intersezione SP 5 e ponte torrente Idice,12373,00,11259,1114,9999,2374,12373,0
2019/01,276,17/01/2019,4,SP 3_2 tra intersezione SP 5 e ponte torrente Idice,10045,00,9063,982,7754,2291,10045,0
2019/01,276,18/01/2019,5,SP 3_2 tra intersezione SP 5 e ponte torrente Idice,12590,00,11508,1082,10070,2520,12590,0
2019/01,276,19/01/2019,6,SP 3_2 tra intersezione SP 5 e ponte torrente Idice,7551,00,7373,178,5600,1951,0,7551
2019/01,276,20/01/2019,7,SP 3_2 tra intersezione SP 5 e ponte torrente Idice,6453,00,6408,45,4754,1699,0,6453
2019/01,276,21/01/2019,1,SP 3_2 tra intersezione SP 5 e ponte torrente Idice,11557,00,10589,968,9359,2198,11557,0
2019/01,276,22/01/2019,2,SP 3_2 tra intersezione SP 5 e ponte torrente Idice,12324,00,11273,1051,10114,2210,12324,0
2019/01,276,23/01/2019,3,SP 3_2 tra intersezione SP 5 e ponte torrente Idice,11877,00,10853,1024,9712,2165,11877,0
2019/01,276,24/01/2019,4,SP 3_2 tra intersezione SP 5 e ponte torrente Idice,11833,00,10800,1033,9643,2190,11833,0
2019/01,276,25/01/2019,5,SP 3_2 tra intersezione SP 5 e ponte torrente Idice,12202,00,11186,1016,9828,2374,12202,0
2019/01,276,26/01/2019,6,SP 3_2 tra intersezione SP 5 e ponte torrente Idice,7130,00,6939,191,5144,1986,0,7130
2019/01,276,27/01/2019,7,SP 3_2 tra intersezione SP 5 e ponte torrente Idice,5913,00,5856,57,4361,1552,0,5913
2019/01,276,28/01/2019,1,SP 3_2 tra intersezione SP 5 e ponte torrente Idice,11541,00,10470,1071,9460,2081,11541,0
2019/01,277,18/01/2019,5,SP 6 tra Budrio e San Martino in Argine,8065,00,7592,473,6183,1882,8065,0
2019/01,277,19/01/2019,6,SP 6 tra Budrio e San Martino in Argine,5879,00,5763,116,4329,1550,0,5879
2019/01,277,20/01/2019,7,SP 6 tra Budrio e San Martino in Argine,4382,00,4357,25,3151,1231,0,4382
2019/01,277,21/01/2019,1,SP 6 tra Budrio e San Martino in Argine,7631,00,7205,426,6111,1520,7631,0
2019/01,277,22/01/2019,2,SP 6 tra Budrio e San Martino in Argine,7706,00,7218,488,6142,1564,7706,0
2019/01,277,23/01/2019,3,SP 6 tra Budrio e San Martino in Argine,7631,00,7216,415,5993,1638,7631,0
2019/01,277,24/01/2019,4,SP 6 tra Budrio e San Martino in Argine,7739,10,7269,469,6045,1694,7739,0
2019/01,277,25/01/2019,5,SP 6 tra Budrio e San Martino in Argine,7700,00,7245,455,5973,1727,7700,0
2019/01,277,26/01/2019,6,SP 6 tra Budrio e San Martino in Argine,6063,00,5921,142,4510,1553,0,6063
2019/01,277,27/01/2019,7,SP 6 tra Budrio e San Martino in Argine,4362,00,4333,29,3184,1178,0,4362
2019/01,277,28/01/2019,1,SP 6 tra Budrio e San Martino in Argine,7463,00,6984,479,5951,1512,7463,0
2019/01,278,15/01/2019,2,SP 6 tra Budrio e bivio SP 253,14141,00,13383,758,11275,2866,14141,0
2019/01,278,16/01/2019,3,SP 6 tra Budrio e bivio SP 253,14072,00,13345,727,11183,2889,14072,0
2019/01,278,17/01/2019,4,SP 6 tra Budrio e bivio SP 253,13984,00,13278,706,11005,2979,13984,0
2019/01,278,18/01/2019,5,SP 6 tra Budrio e bivio SP 253,14604,00,13912,692,11401,3203,14604,0
2019/01,278,19/01/2019,6,SP 6 tra Budrio e bivio SP 253,11180,00,10990,190,8271,2909,0,11180
2019/01,278,20/01/2019,7,SP 6 tra Budrio e bivio SP 253,8732,00,8689,43,6348,2384,0,8732
2019/01,278,21/01/2019,1,SP 6 tra Budrio e bivio SP 253,13595,00,12945,650,11006,2589,13595,0
2019/01,278,22/01/2019,2,SP 6 tra Budrio e bivio SP 253,13921,00,13209,712,11126,2795,13921,0
2019/01,278,23/01/2019,3,SP 6 tra Budrio e bivio SP 253,13833,00,13157,676,10972,2861,13833,0
2019/01,278,24/01/2019,4,SP 6 tra Budrio e bivio SP 253,13580,00,12880,700,10673,2907,13580,0
2019/01,278,25/01/2019,5,SP 6 tra Budrio e bivio SP 253,14130,10,13463,666,10967,3163,14130,0
2019/01,278,26/01/2019,6,SP 6 tra Budrio e bivio SP 253,11048,00,10877,171,8263,2785,0,11048
2019/01,278,27/01/2019,7,SP 6 tra Budrio e bivio SP 253,7922,00,7877,45,5776,2146,0,7922
2019/01,278,28/01/2019,1,SP 6 tra Budrio e bivio SP 253,13650,00,12955,695,11086,2564,13650,0
2019/01,279,15/01/2019,2,SP 31 dal bivio SP 28 per Castenaso a Ponte Rizzoli,14854,00,13587,1267,12603,2251,14854,0
2019/01,279,16/01/2019,3,SP 31 dal bivio SP 28 per Castenaso a Ponte Rizzoli,14314,00,13252,1062,11966,2348,14314,0
2019/01,279,17/01/2019,4,SP 31 dal bivio SP 28 per Castenaso a Ponte Rizzoli,14160,10,13115,1044,11843,2317,14160,0
2019/01,279,18/01/2019,5,SP 31 dal bivio SP 28 per Castenaso a Ponte Rizzoli,14536,00,13523,1013,11950,2586,14536,0
2019/01,279,19/01/2019,6,SP 31 dal bivio SP 28 per Castenaso a Ponte Rizzoli,9687,10,9545,141,7576,2111,0,9687
2019/01,279,20/01/2019,7,SP 31 dal bivio SP 28 per Castenaso a Ponte Rizzoli,7903,00,7858,45,6158,1745,0,7903
2019/01,279,21/01/2019,1,SP 31 dal bivio SP 28 per Castenaso a Ponte Rizzoli,13801,10,12793,1007,11612,2189,13801,0
2019/01,279,22/01/2019,2,SP 31 dal bivio SP 28 per Castenaso a Ponte Rizzoli,13462,00,12472,990,11378,2084,13462,0
2019/01,279,23/01/2019,3,SP 31 dal bivio SP 28 per Castenaso a Ponte Rizzoli,13243,00,12416,827,11028,2215,13243,0
2019/01,279,24/01/2019,4,SP 31 dal bivio SP 28 per Castenaso a Ponte Rizzoli,13176,00,12269,907,11040,2136,13176,0
2019/01,279,25/01/2019,5,SP 31 dal bivio SP 28 per Castenaso a Ponte Rizzoli,14289,10,13406,882,11842,2447,14289,0
2019/01,279,26/01/2019,6,SP 31 dal bivio SP 28 per Castenaso a Ponte Rizzoli,9728,00,9567,161,7545,2183,0,9728
2019/01,279,27/01/2019,7,SP 31 dal bivio SP 28 per Castenaso a Ponte Rizzoli,7727,00,7690,37,5932,1795,0,7727
2019/01,279,28/01/2019,1,SP 31 dal bivio SP 28 per Castenaso a Ponte Rizzoli,13615,00,12686,929,11524,2091,13615,0
2019/01,280,15/01/2019,2,SP 26 tra Gesso e Ponte Rivabella,20530,00,19885,645,15965,4565,20530,0
2019/01,280,16/01/2019,3,SP 26 tra Gesso e Ponte Rivabella,21009,00,20510,499,16398,4611,21009,0
2019/01,280,17/01/2019,4,SP 26 tra Gesso e Ponte Rivabella,21331,00,20849,482,16431,4900,21331,0
2019/01,280,18/01/2019,5,SP 26 tra Gesso e Ponte Rivabella,21957,00,21454,503,16763,5194,21957,0
2019/01,280,19/01/2019,6,SP 26 tra Gesso e Ponte Rivabella,18554,00,18373,181,13637,4917,0,18554
2019/01,280,20/01/2019,7,SP 26 tra Gesso e Ponte Rivabella,14043,00,14000,43,10312,3731,0,14043
2019/01,280,21/01/2019,1,SP 26 tra Gesso e Ponte Rivabella,20556,00,20083,473,16285,4271,20556,0
2019/01,280,22/01/2019,2,SP 26 tra Gesso e Ponte Rivabella,19989,00,19533,456,16054,3935,19989,0
2019/01,280,23/01/2019,3,SP 26 tra Gesso e Ponte Rivabella,18977,00,18544,433,14723,4254,18977,0
2019/01,280,24/01/2019,4,SP 26 tra Gesso e Ponte Rivabella,18272,00,17838,434,13960,4312,18272,0
2019/01,280,25/01/2019,5,SP 26 tra Gesso e Ponte Rivabella,21273,00,20818,455,16319,4954,21273,0
2019/01,280,26/01/2019,6,SP 26 tra Gesso e Ponte Rivabella,18257,00,18090,167,13468,4789,0,18257
2019/01,280,27/01/2019,7,SP 26 tra Gesso e Ponte Rivabella,13727,00,13699,28,10209,3518,0,13727
2019/01,280,28/01/2019,1,SP 26 tra Gesso e Ponte Rivabella,19936,00,19503,433,15758,4178,19936,0
2019/01,281,15/01/2019,2,SP 78_1 tra Bazzano e Intersezione SP 27 a Monteveglio,6685,00,6482,203,5381,1304,6685,0
2019/01,281,16/01/2019,3,SP 78_1 tra Bazzano e Intersezione SP 27 a Monteveglio,6677,00,6455,222,5277,1400,6677,0
2019/01,281,17/01/2019,4,SP 78_1 tra Bazzano e Intersezione SP 27 a Monteveglio,7420,30,7197,220,5958,1462,7420,0
2019/01,281,18/01/2019,5,SP 78_1 tra Bazzano e Intersezione SP 27 a Monteveglio,6895,00,6669,226,5346,1549,6895,0
2019/01,281,19/01/2019,6,SP 78_1 tra Bazzano e Intersezione SP 27 a Monteveglio,6626,10,6526,99,5040,1586,0,6626
2019/01,281,20/01/2019,7,SP 78_1 tra Bazzano e Intersezione SP 27 a Monteveglio,4262,00,4228,34,3172,1090,0,4262
2019/01,281,21/01/2019,1,SP 78_1 tra Bazzano e Intersezione SP 27 a Monteveglio,6480,20,6282,196,5200,1280,6480,0
2019/01,281,22/01/2019,2,SP 78_1 tra Bazzano e Intersezione SP 27 a Monteveglio,6292,10,6068,223,5126,1166,6292,0
2019/01,281,23/01/2019,3,SP 78_1 tra Bazzano e Intersezione SP 27 a Monteveglio,6385,30,6165,217,5119,1266,6385,0
2019/01,281,24/01/2019,4,SP 78_1 tra Bazzano e Intersezione SP 27 a Monteveglio,5788,10,5598,189,4519,1269,5788,0
2019/01,281,25/01/2019,5,SP 78_1 tra Bazzano e Intersezione SP 27 a Monteveglio,6587,10,6394,192,5124,1463,6587,0
2019/01,281,26/01/2019,6,SP 78_1 tra Bazzano e Intersezione SP 27 a Monteveglio,6320,10,6248,71,4718,1602,0,6320
2019/01,281,27/01/2019,7,SP 78_1 tra Bazzano e Intersezione SP 27 a Monteveglio,4169,00,4131,38,3146,1023,0,4169
2019/01,281,28/01/2019,1,SP 78_1 tra Bazzano e Intersezione SP 27 a Monteveglio,6222,10,6057,164,5016,1206,6222,0
2019/01,282,15/01/2019,2,SS 9 tra Anzola dell'Emilia e Bologna,23702,00,21327,2375,18107,5595,23702,0
2019/01,282,16/01/2019,3,SS 9 tra Anzola dell'Emilia e Bologna,23966,00,21619,2347,18190,5776,23966,0
2019/01,282,17/01/2019,4,SS 9 tra Anzola dell'Emilia e Bologna,24237,00,21953,2284,18219,6018,24237,0
2019/01,282,18/01/2019,5,SS 9 tra Anzola dell'Emilia e Bologna,24563,00,22228,2335,18364,6199,24563,0
2019/01,282,19/01/2019,6,SS 9 tra Anzola dell'Emilia e Bologna,17693,00,17162,531,12392,5301,0,17693
2019/01,282,20/01/2019,7,SS 9 tra Anzola dell'Emilia e Bologna,14336,00,14221,115,9854,4482,0,14336
2019/01,282,21/01/2019,1,SS 9 tra Anzola dell'Emilia e Bologna,23266,00,20977,2289,17966,5300,23266,0
2019/01,282,22/01/2019,2,SS 9 tra Anzola dell'Emilia e Bologna,23220,00,20939,2281,17787,5433,23220,0
2019/01,282,23/01/2019,3,SS 9 tra Anzola dell'Emilia e Bologna,23109,00,20860,2249,17676,5433,23109,0
2019/01,282,24/01/2019,4,SS 9 tra Anzola dell'Emilia e Bologna,22740,00,20481,2259,17298,5442,22740,0
2019/01,282,25/01/2019,5,SS 9 tra Anzola dell'Emilia e Bologna,24202,00,21918,2284,18234,5968,24202,0
2019/01,282,26/01/2019,6,SS 9 tra Anzola dell'Emilia e Bologna,17806,00,17231,575,12382,5424,0,17806
2019/01,282,27/01/2019,7,SS 9 tra Anzola dell'Emilia e Bologna,14015,00,13913,102,9757,4258,0,14015
2019/01,282,28/01/2019,1,SS 9 tra Anzola dell'Emilia e Bologna,23037,10,20738,2298,17767,5270,23037,0
2019/01,285,15/01/2019,2,SP 1 fra Crevalcore e Decima,6177,00,5799,378,4923,1254,6177,0
2019/01,285,16/01/2019,3,SP 1 fra Crevalcore e Decima,6067,00,5635,432,4738,1329,6067,0
2019/01,285,17/01/2019,4,SP 1 fra Crevalcore e Decima,6218,00,5790,428,4866,1352,6218,0
2019/01,285,18/01/2019,5,SP 1 fra Crevalcore e Decima,6637,00,6240,397,5091,1546,6637,0
2019/01,285,19/01/2019,6,SP 1 fra Crevalcore e Decima,5286,00,5186,100,3780,1506,0,5286
2019/01,285,20/01/2019,7,SP 1 fra Crevalcore e Decima,3633,00,3619,14,2494,1139,0,3633
2019/01,285,21/01/2019,1,SP 1 fra Crevalcore e Decima,6016,00,5589,427,4830,1186,6016,0
2019/01,285,22/01/2019,2,SP 1 fra Crevalcore e Decima,6333,10,5910,422,5063,1270,6333,0
2019/01,285,23/01/2019,3,SP 1 fra Crevalcore e Decima,5887,00,5501,386,4658,1229,5887,0
2019/01,285,24/01/2019,4,SP 1 fra Crevalcore e Decima,6153,00,5752,401,4820,1333,6153,0
2019/01,285,25/01/2019,5,SP 1 fra Crevalcore e Decima,6501,00,6078,423,4950,1551,6501,0
2019/01,285,26/01/2019,6,SP 1 fra Crevalcore e Decima,5243,00,5154,89,3796,1447,0,5243
2019/01,285,27/01/2019,7,SP 1 fra Crevalcore e Decima,3743,00,3722,21,2653,1090,0,3743
2019/01,285,28/01/2019,1,SP 1 fra Crevalcore e Decima,5690,00,5316,374,4513,1177,5690,0
2019/01,287,15/01/2019,2,SP 6 fra Cento e Pilastrello,8119,00,7615,504,6582,1537,8119,0
2019/01,287,16/01/2019,3,SP 6 fra Cento e Pilastrello,8034,00,7562,472,6394,1640,8034,0
2019/01,287,17/01/2019,4,SP 6 fra Cento e Pilastrello,8109,00,7596,513,6532,1577,8109,0
2019/01,287,18/01/2019,5,SP 6 fra Cento e Pilastrello,6530,20,6169,359,5068,1462,6530,0
2019/01,287,25/01/2019,5,SP 6 fra Cento e Pilastrello,7100,00,6687,413,5502,1598,7100,0
2019/01,287,26/01/2019,6,SP 6 fra Cento e Pilastrello,7199,00,7083,116,5078,2121,0,7199
2019/01,287,27/01/2019,7,SP 6 fra Cento e Pilastrello,5295,00,5282,13,3779,1516,0,5295
2019/01,288,15/01/2019,2,SP 42 fra Pieve di Cento e Castello d'Argile,18719,00,17885,834,14572,4147,18719,0
2019/01,288,16/01/2019,3,SP 42 fra Pieve di Cento e Castello d'Argile,18799,00,17985,814,14593,4206,18799,0
2019/01,288,17/01/2019,4,SP 42 fra Pieve di Cento e Castello d'Argile,19037,00,18107,930,14781,4256,19037,0
2019/01,288,18/01/2019,5,SP 42 fra Pieve di Cento e Castello d'Argile,19432,10,18551,880,14855,4577,19432,0
2019/01,288,19/01/2019,6,SP 42 fra Pieve di Cento e Castello d'Argile,14158,10,13939,218,10232,3926,0,14158
2019/01,288,20/01/2019,7,SP 42 fra Pieve di Cento e Castello d'Argile,10724,00,10666,58,7472,3252,0,10724
2019/01,288,21/01/2019,1,SP 42 fra Pieve di Cento e Castello d'Argile,18330,00,17471,859,14559,3771,18330,0
2019/01,288,22/01/2019,2,SP 42 fra Pieve di Cento e Castello d'Argile,18670,00,17753,917,14735,3935,18670,0
2019/01,288,23/01/2019,3,SP 42 fra Pieve di Cento e Castello d'Argile,18159,00,17311,848,14126,4033,18159,0
2019/01,288,24/01/2019,4,SP 42 fra Pieve di Cento e Castello d'Argile,18283,10,17424,858,14185,4098,18283,0
2019/01,288,25/01/2019,5,SP 42 fra Pieve di Cento e Castello d'Argile,19158,00,18352,806,14625,4533,19158,0
2019/01,288,26/01/2019,6,SP 42 fra Pieve di Cento e Castello d'Argile,14716,10,14483,232,10531,4185,0,14716
2019/01,288,27/01/2019,7,SP 42 fra Pieve di Cento e Castello d'Argile,11219,00,11160,59,7981,3238,0,11219
2019/01,288,28/01/2019,1,SP 42 fra Pieve di Cento e Castello d'Argile,18179,00,17308,871,14331,3848,18179,0
2019/01,289,15/01/2019,2,SP 66 fra Cento e Sant'Agostino,14381,00,13569,812,11610,2771,14381,0
2019/01,289,16/01/2019,3,SP 66 fra Cento e Sant'Agostino,14839,00,14041,798,11847,2992,14839,0
2019/01,289,17/01/2019,4,SP 66 fra Cento e Sant'Agostino,14732,20,13888,842,11696,3036,14732,0
2019/01,289,18/01/2019,5,SP 66 fra Cento e Sant'Agostino,14750,00,13959,791,11495,3255,14750,0
2019/01,289,19/01/2019,6,SP 66 fra Cento e Sant'Agostino,12774,00,12569,205,9248,3526,0,12774
2019/01,289,20/01/2019,7,SP 66 fra Cento e Sant'Agostino,9451,10,9395,55,6635,2816,0,9451
2019/01,289,21/01/2019,1,SP 66 fra Cento e Sant'Agostino,14279,00,13453,826,11756,2523,14279,0
2019/01,289,22/01/2019,2,SP 66 fra Cento e Sant'Agostino,14144,00,13335,809,11475,2669,14144,0
2019/01,289,23/01/2019,3,SP 66 fra Cento e Sant'Agostino,14143,10,13357,785,11410,2733,14143,0
2019/01,289,24/01/2019,4,SP 66 fra Cento e Sant'Agostino,14399,00,13650,749,11509,2890,14399,0
2019/01,289,25/01/2019,5,SP 66 fra Cento e Sant'Agostino,14862,00,14080,782,11700,3162,14862,0
2019/01,289,26/01/2019,6,SP 66 fra Cento e Sant'Agostino,12921,00,12723,198,9572,3349,0,12921
2019/01,289,27/01/2019,7,SP 66 fra Cento e Sant'Agostino,9169,00,9136,33,6677,2492,0,9169
2019/01,289,28/01/2019,1,SP 66 fra Cento e Sant'Agostino,14260,00,13434,826,11682,2578,14260,0
2019/01,290,15/01/2019,2,SP 11 fra Pieve di Cento e San Pietro in Casale,6384,00,6002,382,5143,1241,6384,0
2019/01,290,16/01/2019,3,SP 11 fra Pieve di Cento e San Pietro in Casale,6372,00,6014,358,5090,1282,6372,0
2019/01,290,17/01/2019,4,SP 11 fra Pieve di Cento e San Pietro in Casale,6181,00,5844,337,4910,1271,6181,0
2019/01,290,18/01/2019,5,SP 11 fra Pieve di Cento e San Pietro in Casale,6497,00,6182,315,4941,1556,6497,0
2019/01,290,19/01/2019,6,SP 11 fra Pieve di Cento e San Pietro in Casale,5673,00,5577,96,3848,1825,0,5673
2019/01,290,20/01/2019,7,SP 11 fra Pieve di Cento e San Pietro in Casale,4166,00,4148,18,2757,1409,0,4166
2019/01,290,21/01/2019,1,SP 11 fra Pieve di Cento e San Pietro in Casale,6180,00,5840,340,4981,1199,6180,0
2019/01,290,22/01/2019,2,SP 11 fra Pieve di Cento e San Pietro in Casale,6278,00,5905,373,5088,1190,6278,0
2019/01,290,23/01/2019,3,SP 11 fra Pieve di Cento e San Pietro in Casale,6121,20,5759,360,4856,1265,6121,0
2019/01,290,24/01/2019,4,SP 11 fra Pieve di Cento e San Pietro in Casale,6218,00,5845,373,4943,1275,6218,0
2019/01,290,25/01/2019,5,SP 11 fra Pieve di Cento e San Pietro in Casale,6472,00,6134,338,4925,1547,6472,0
2019/01,290,26/01/2019,6,SP 11 fra Pieve di Cento e San Pietro in Casale,5857,00,5733,124,4043,1814,0,5857
2019/01,290,27/01/2019,7,SP 11 fra Pieve di Cento e San Pietro in Casale,4523,00,4502,21,3036,1487,0,4523
2019/01,290,28/01/2019,1,SP 11 fra Pieve di Cento e San Pietro in Casale,5914,00,5591,323,4770,1144,5914,0
2019/01,291,15/01/2019,2,SP 4 tra San Pietro in Casale e San Vincenzo/San Venanzio,10471,00,10089,382,8119,2352,10471,0
2019/01,291,16/01/2019,3,SP 4 tra San Pietro in Casale e San Vincenzo/San Venanzio,10465,00,10069,396,8090,2375,10465,0
2019/01,291,17/01/2019,4,SP 4 tra San Pietro in Casale e San Vincenzo/San Venanzio,10459,00,10040,419,8026,2433,10459,0
2019/01,291,18/01/2019,5,SP 4 tra San Pietro in Casale e San Vincenzo/San Venanzio,10882,00,10474,408,8283,2599,10882,0
2019/01,291,19/01/2019,6,SP 4 tra San Pietro in Casale e San Vincenzo/San Venanzio,8810,00,8712,98,6427,2383,0,8810
2019/01,291,20/01/2019,7,SP 4 tra San Pietro in Casale e San Vincenzo/San Venanzio,6709,00,6691,18,4908,1801,0,6709
2019/01,291,21/01/2019,1,SP 4 tra San Pietro in Casale e San Vincenzo/San Venanzio,10109,10,9652,456,7980,2129,10109,0
2019/01,291,22/01/2019,2,SP 4 tra San Pietro in Casale e San Vincenzo/San Venanzio,10383,00,9927,456,8125,2258,10383,0
2019/01,291,23/01/2019,3,SP 4 tra San Pietro in Casale e San Vincenzo/San Venanzio,10141,00,9775,366,7894,2247,10141,0
2019/01,291,24/01/2019,4,SP 4 tra San Pietro in Casale e San Vincenzo/San Venanzio,10250,00,9857,393,7941,2309,10250,0
2019/01,291,25/01/2019,5,SP 4 tra San Pietro in Casale e San Vincenzo/San Venanzio,10636,00,10231,405,8092,2544,10636,0
2019/01,291,26/01/2019,6,SP 4 tra San Pietro in Casale e San Vincenzo/San Venanzio,8778,00,8666,112,6441,2337,0,8778
2019/01,291,27/01/2019,7,SP 4 tra San Pietro in Casale e San Vincenzo/San Venanzio,6359,00,6328,31,4632,1727,0,6359
2019/01,291,28/01/2019,1,SP 4 tra San Pietro in Casale e San Vincenzo/San Venanzio,9869,00,9494,375,7744,2125,9869,0
2019/01,292,15/01/2019,2,SP 4 tra San Giorgio di Piano e Intersezione SP 11 c/o San Pietro in Casale,17909,00,17271,638,13888,4021,17909,0
2019/01,292,16/01/2019,3,SP 4 tra San Giorgio di Piano e Intersezione SP 11 c/o San Pietro in Casale,17777,00,17149,628,13631,4146,17777,0
2019/01,292,17/01/2019,4,SP 4 tra San Giorgio di Piano e Intersezione SP 11 c/o San Pietro in Casale,17959,00,17306,653,13705,4254,17959,0
2019/01,292,18/01/2019,5,SP 4 tra San Giorgio di Piano e Intersezione SP 11 c/o San Pietro in Casale,18306,00,17718,588,13692,4614,18306,0
2019/01,292,19/01/2019,6,SP 4 tra San Giorgio di Piano e Intersezione SP 11 c/o San Pietro in Casale,14373,00,14191,182,10124,4249,0,14373
2019/01,292,20/01/2019,7,SP 4 tra San Giorgio di Piano e Intersezione SP 11 c/o San Pietro in Casale,10675,00,10639,36,7714,2961,0,10675
2019/01,292,21/01/2019,1,SP 4 tra San Giorgio di Piano e Intersezione SP 11 c/o San Pietro in Casale,17294,00,16645,649,13544,3750,17294,0
2019/01,292,22/01/2019,2,SP 4 tra San Giorgio di Piano e Intersezione SP 11 c/o San Pietro in Casale,17669,00,16985,684,13721,3948,17669,0
2019/01,292,23/01/2019,3,SP 4 tra San Giorgio di Piano e Intersezione SP 11 c/o San Pietro in Casale,17166,10,16533,632,13128,4038,17166,0
2019/01,292,24/01/2019,4,SP 4 tra San Giorgio di Piano e Intersezione SP 11 c/o San Pietro in Casale,17297,20,16674,621,13221,4076,17297,0
2019/01,292,25/01/2019,5,SP 4 tra San Giorgio di Piano e Intersezione SP 11 c/o San Pietro in Casale,18452,00,17811,641,13842,4610,18452,0
2019/01,292,26/01/2019,6,SP 4 tra San Giorgio di Piano e Intersezione SP 11 c/o San Pietro in Casale,14456,00,14265,191,10363,4093,0,14456
2019/01,292,27/01/2019,7,SP 4 tra San Giorgio di Piano e Intersezione SP 11 c/o San Pietro in Casale,10120,00,10077,43,7094,3026,0,10120
2019/01,292,28/01/2019,1,SP 4 tra San Giorgio di Piano e Intersezione SP 11 c/o San Pietro in Casale,16779,00,16154,625,13136,3643,16779,0
2019/01,295,15/01/2019,2,SP 9 fra Colorno e Torrile centro abitato di Bezze,3558,00,3190,368,2897,661,3558,0
2019/01,295,16/01/2019,3,SP 9 fra Colorno e Torrile centro abitato di Bezze,3760,00,3348,412,3056,704,3760,0
2019/01,295,17/01/2019,4,SP 9 fra Colorno e Torrile centro abitato di Bezze,3678,10,3295,382,2963,715,3678,0
2019/01,295,18/01/2019,5,SP 9 fra Colorno e Torrile centro abitato di Bezze,3735,30,3385,347,2985,750,3735,0
2019/01,295,19/01/2019,6,SP 9 fra Colorno e Torrile centro abitato di Bezze,2541,00,2417,124,1915,626,0,2541
2019/01,295,20/01/2019,7,SP 9 fra Colorno e Torrile centro abitato di Bezze,2121,00,2066,55,1576,545,0,2121
2019/01,295,21/01/2019,1,SP 9 fra Colorno e Torrile centro abitato di Bezze,3600,10,3185,414,2922,678,3600,0
2019/01,295,22/01/2019,2,SP 9 fra Colorno e Torrile centro abitato di Bezze,3743,00,3339,404,3038,705,3743,0
2019/01,295,23/01/2019,3,SP 9 fra Colorno e Torrile centro abitato di Bezze,3657,00,3265,392,2952,705,3657,0
2019/01,295,24/01/2019,4,SP 9 fra Colorno e Torrile centro abitato di Bezze,3479,00,3106,373,2812,667,3479,0
2019/01,295,25/01/2019,5,SP 9 fra Colorno e Torrile centro abitato di Bezze,3716,00,3354,362,2933,783,3716,0
2019/01,295,26/01/2019,6,SP 9 fra Colorno e Torrile centro abitato di Bezze,2770,00,2663,107,2074,696,0,2770
2019/01,295,27/01/2019,7,SP 9 fra Colorno e Torrile centro abitato di Bezze,1945,10,1893,51,1460,485,0,1945
2019/01,295,28/01/2019,1,SP 9 fra Colorno e Torrile centro abitato di Bezze,3524,10,3136,387,2871,653,3524,0
2019/01,298,15/01/2019,2,SP 588R da Castione Marchesi (A 1) a Busseto,2888,20,2688,198,2378,510,2888,0
2019/01,298,16/01/2019,3,SP 588R da Castione Marchesi (A 1) a Busseto,3038,00,2794,244,2525,513,3038,0
2019/01,298,17/01/2019,4,SP 588R da Castione Marchesi (A 1) a Busseto,3026,00,2809,217,2448,578,3026,0
2019/01,298,18/01/2019,5,SP 588R da Castione Marchesi (A 1) a Busseto,3109,00,2922,187,2477,632,3109,0
2019/01,298,19/01/2019,6,SP 588R da Castione Marchesi (A 1) a Busseto,2581,00,2520,61,1915,666,0,2581
2019/01,298,20/01/2019,7,SP 588R da Castione Marchesi (A 1) a Busseto,1804,00,1781,23,1302,502,0,1804
2019/01,298,21/01/2019,1,SP 588R da Castione Marchesi (A 1) a Busseto,2889,10,2710,178,2401,488,2889,0
2019/01,298,22/01/2019,2,SP 588R da Castione Marchesi (A 1) a Busseto,2846,00,2678,168,2373,473,2846,0
2019/01,298,23/01/2019,3,SP 588R da Castione Marchesi (A 1) a Busseto,2854,00,2666,188,2399,455,2854,0
2019/01,298,24/01/2019,4,SP 588R da Castione Marchesi (A 1) a Busseto,2832,00,2634,198,2280,552,2832,0
2019/01,298,25/01/2019,5,SP 588R da Castione Marchesi (A 1) a Busseto,2936,10,2762,173,2340,596,2936,0
2019/01,298,26/01/2019,6,SP 588R da Castione Marchesi (A 1) a Busseto,2257,00,2203,54,1683,574,0,2257
2019/01,298,27/01/2019,7,SP 588R da Castione Marchesi (A 1) a Busseto,1777,00,1749,28,1289,488,0,1777
2019/01,298,28/01/2019,1,SP 588R da Castione Marchesi (A 1) a Busseto,2767,00,2614,153,2301,466,2767,0
2019/01,300,15/01/2019,2,SP 462R fra Fiorenzuola d'Arda e Cortemaggiore,8405,20,7339,1064,6857,1548,8405,0
2019/01,300,16/01/2019,3,SP 462R fra Fiorenzuola d'Arda e Cortemaggiore,8701,10,7601,1099,7065,1636,8701,0
2019/01,300,17/01/2019,4,SP 462R fra Fiorenzuola d'Arda e Cortemaggiore,8563,10,7419,1143,7036,1527,8563,0
2019/01,300,18/01/2019,5,SP 462R fra Fiorenzuola d'Arda e Cortemaggiore,8553,10,7449,1103,6772,1781,8553,0
2019/01,300,19/01/2019,6,SP 462R fra Fiorenzuola d'Arda e Cortemaggiore,6578,10,6264,313,4896,1682,0,6578
2019/01,300,20/01/2019,7,SP 462R fra Fiorenzuola d'Arda e Cortemaggiore,5077,00,4987,90,3869,1208,0,5077
2019/01,300,21/01/2019,1,SP 462R fra Fiorenzuola d'Arda e Cortemaggiore,8165,10,7138,1026,6628,1537,8165,0
2019/01,300,22/01/2019,2,SP 462R fra Fiorenzuola d'Arda e Cortemaggiore,8008,30,6900,1105,6504,1504,8008,0
2019/01,300,23/01/2019,3,SP 462R fra Fiorenzuola d'Arda e Cortemaggiore,7907,10,6889,1017,6444,1463,7907,0
2019/01,300,24/01/2019,4,SP 462R fra Fiorenzuola d'Arda e Cortemaggiore,8015,10,7026,988,6454,1561,8015,0
2019/01,300,25/01/2019,5,SP 462R fra Fiorenzuola d'Arda e Cortemaggiore,8366,30,7351,1012,6572,1794,8366,0
2019/01,300,26/01/2019,6,SP 462R fra Fiorenzuola d'Arda e Cortemaggiore,6410,10,6091,318,4729,1681,0,6410
2019/01,300,27/01/2019,7,SP 462R fra Fiorenzuola d'Arda e Cortemaggiore,4898,00,4825,73,3756,1142,0,4898
2019/01,300,28/01/2019,1,SP 462R fra Fiorenzuola d'Arda e Cortemaggiore,7866,70,6876,983,6356,1510,7866,0
2019/01,301,15/01/2019,2,SP 4 tra Fiorenzuola d'Arda (Tg Sud) e Castell'Arquato,8097,00,7580,517,6578,1519,8097,0
2019/01,301,16/01/2019,3,SP 4 tra Fiorenzuola d'Arda (Tg Sud) e Castell'Arquato,8027,00,7534,493,6417,1610,8027,0
2019/01,301,17/01/2019,4,SP 4 tra Fiorenzuola d'Arda (Tg Sud) e Castell'Arquato,8252,00,7721,531,6537,1715,8252,0
2019/01,301,18/01/2019,5,SP 4 tra Fiorenzuola d'Arda (Tg Sud) e Castell'Arquato,8172,10,7683,488,6245,1927,8172,0
2019/01,301,19/01/2019,6,SP 4 tra Fiorenzuola d'Arda (Tg Sud) e Castell'Arquato,7105,00,6996,109,5409,1696,0,7105
2019/01,301,20/01/2019,7,SP 4 tra Fiorenzuola d'Arda (Tg Sud) e Castell'Arquato,5468,00,5449,19,4032,1436,0,5468
2019/01,301,21/01/2019,1,SP 4 tra Fiorenzuola d'Arda (Tg Sud) e Castell'Arquato,7697,10,7264,432,6160,1537,7697,0
2019/01,301,22/01/2019,2,SP 4 tra Fiorenzuola d'Arda (Tg Sud) e Castell'Arquato,7654,00,7202,452,6102,1552,7654,0
2019/01,301,23/01/2019,3,SP 4 tra Fiorenzuola d'Arda (Tg Sud) e Castell'Arquato,7480,10,7040,439,6081,1399,7480,0
2019/01,301,24/01/2019,4,SP 4 tra Fiorenzuola d'Arda (Tg Sud) e Castell'Arquato,7481,00,6985,496,5881,1600,7481,0
2019/01,301,25/01/2019,5,SP 4 tra Fiorenzuola d'Arda (Tg Sud) e Castell'Arquato,8343,00,7817,526,6478,1865,8343,0
2019/01,301,26/01/2019,6,SP 4 tra Fiorenzuola d'Arda (Tg Sud) e Castell'Arquato,7209,00,7119,90,5471,1738,0,7209
2019/01,301,27/01/2019,7,SP 4 tra Fiorenzuola d'Arda (Tg Sud) e Castell'Arquato,4912,00,4894,18,3641,1271,0,4912
2019/01,301,28/01/2019,1,SP 4 tra Fiorenzuola d'Arda (Tg Sud) e Castell'Arquato,7826,00,7199,627,6358,1468,7826,0
2019/01,302,15/01/2019,2,SP 12 da Fidenza (Casello A 1) a Soragna,7837,00,6870,967,6418,1419,7837,0
2019/01,302,16/01/2019,3,SP 12 da Fidenza (Casello A 1) a Soragna,8006,00,6905,1101,6628,1378,8006,0
2019/01,302,17/01/2019,4,SP 12 da Fidenza (Casello A 1) a Soragna,8697,00,7505,1192,7278,1419,8697,0
2019/01,302,18/01/2019,5,SP 12 da Fidenza (Casello A 1) a Soragna,8073,00,7151,922,6418,1655,8073,0
2019/01,302,19/01/2019,6,SP 12 da Fidenza (Casello A 1) a Soragna,7500,00,7259,241,5408,2092,0,7500
2019/01,302,20/01/2019,7,SP 12 da Fidenza (Casello A 1) a Soragna,6568,00,6511,57,4746,1822,0,6568
2019/01,302,21/01/2019,1,SP 12 da Fidenza (Casello A 1) a Soragna,7693,10,6797,895,6303,1390,7693,0
2019/01,302,22/01/2019,2,SP 12 da Fidenza (Casello A 1) a Soragna,7520,00,6552,968,6253,1267,7520,0
2019/01,302,23/01/2019,3,SP 12 da Fidenza (Casello A 1) a Soragna,7530,10,6512,1017,6292,1238,7530,0
2019/01,302,24/01/2019,4,SP 12 da Fidenza (Casello A 1) a Soragna,7614,00,6738,876,6146,1468,7614,0
2019/01,302,25/01/2019,5,SP 12 da Fidenza (Casello A 1) a Soragna,7814,00,6874,940,6199,1615,7814,0
2019/01,302,26/01/2019,6,SP 12 da Fidenza (Casello A 1) a Soragna,6936,00,6725,211,5244,1692,0,6936
2019/01,302,27/01/2019,7,SP 12 da Fidenza (Casello A 1) a Soragna,5731,00,5675,56,4293,1438,0,5731
2019/01,302,28/01/2019,1,SP 12 da Fidenza (Casello A 1) a Soragna,7524,20,6609,913,6236,1288,7524,0
2019/01,303,15/01/2019,2,SP 11 fra Borgonovo e Gragnano,9153,00,8624,529,7411,1742,9153,0
2019/01,303,16/01/2019,3,SP 11 fra Borgonovo e Gragnano,9333,10,8886,446,7506,1827,9333,0
2019/01,303,17/01/2019,4,SP 11 fra Borgonovo e Gragnano,9021,00,8571,450,7264,1757,9021,0
2019/01,303,18/01/2019,5,SP 11 fra Borgonovo e Gragnano,9397,00,9030,367,7364,2033,9397,0
2019/01,303,19/01/2019,6,SP 11 fra Borgonovo e Gragnano,8237,00,8113,124,6073,2164,0,8237
2019/01,303,20/01/2019,7,SP 11 fra Borgonovo e Gragnano,6382,00,6347,35,4703,1679,0,6382
2019/01,303,21/01/2019,1,SP 11 fra Borgonovo e Gragnano,8749,00,8318,431,7078,1671,8749,0
2019/01,303,22/01/2019,2,SP 11 fra Borgonovo e Gragnano,9113,00,8585,528,7417,1696,9113,0
2019/01,303,23/01/2019,3,SP 11 fra Borgonovo e Gragnano,8667,00,8156,511,7168,1499,8667,0
2019/01,303,24/01/2019,4,SP 11 fra Borgonovo e Gragnano,8271,00,7822,449,6598,1673,8271,0
2019/01,303,25/01/2019,5,SP 11 fra Borgonovo e Gragnano,9155,00,8689,466,7215,1940,9155,0
2019/01,303,26/01/2019,6,SP 11 fra Borgonovo e Gragnano,7784,00,7641,143,5879,1905,0,7784
2019/01,303,27/01/2019,7,SP 11 fra Borgonovo e Gragnano,6042,00,5997,45,4447,1595,0,6042
2019/01,303,28/01/2019,1,SP 11 fra Borgonovo e Gragnano,8766,00,8348,418,7119,1647,8766,0
2019/01,304,15/01/2019,2,SP 42 fra Podenzano e bivio SP 6/ponte fiume Nure in località San Giorgio Piacentino,6626,00,6259,367,5353,1273,6626,0
2019/01,304,16/01/2019,3,SP 42 fra Podenzano e bivio SP 6/ponte fiume Nure in località San Giorgio Piacentino,6901,00,6509,392,5536,1365,6901,0
2019/01,304,17/01/2019,4,SP 42 fra Podenzano e bivio SP 6/ponte fiume Nure in località San Giorgio Piacentino,6656,00,6261,395,5346,1310,6656,0
2019/01,304,18/01/2019,5,SP 42 fra Podenzano e bivio SP 6/ponte fiume Nure in località San Giorgio Piacentino,6856,00,6511,345,5279,1577,6856,0
2019/01,304,19/01/2019,6,SP 42 fra Podenzano e bivio SP 6/ponte fiume Nure in località San Giorgio Piacentino,5406,00,5319,87,3946,1460,0,5406
2019/01,304,20/01/2019,7,SP 42 fra Podenzano e bivio SP 6/ponte fiume Nure in località San Giorgio Piacentino,4331,00,4308,23,3245,1086,0,4331
2019/01,304,21/01/2019,1,SP 42 fra Podenzano e bivio SP 6/ponte fiume Nure in località San Giorgio Piacentino,6316,00,5992,324,5120,1196,6316,0
2019/01,304,22/01/2019,2,SP 42 fra Podenzano e bivio SP 6/ponte fiume Nure in località San Giorgio Piacentino,6571,00,6214,357,5252,1319,6571,0
2019/01,304,23/01/2019,3,SP 42 fra Podenzano e bivio SP 6/ponte fiume Nure in località San Giorgio Piacentino,6395,00,6036,359,5237,1158,6395,0
2019/01,304,24/01/2019,4,SP 42 fra Podenzano e bivio SP 6/ponte fiume Nure in località San Giorgio Piacentino,6232,00,5922,310,5001,1231,6232,0
2019/01,304,25/01/2019,5,SP 42 fra Podenzano e bivio SP 6/ponte fiume Nure in località San Giorgio Piacentino,6539,00,6274,265,5103,1436,6539,0
2019/01,304,26/01/2019,6,SP 42 fra Podenzano e bivio SP 6/ponte fiume Nure in località San Giorgio Piacentino,5179,00,5112,67,3803,1376,0,5179
2019/01,304,27/01/2019,7,SP 42 fra Podenzano e bivio SP 6/ponte fiume Nure in località San Giorgio Piacentino,4137,10,4117,19,3134,1003,0,4137
2019/01,304,28/01/2019,1,SP 42 fra Podenzano e bivio SP 6/ponte fiume Nure in località San Giorgio Piacentino,6317,00,5905,412,5081,1236,6317,0
2019/01,305,24/01/2019,4,SP 6Bis fra Carpaneto e Castell'Arquato,3545,00,3327,218,2759,786,3545,0
2019/01,305,25/01/2019,5,SP 6Bis fra Carpaneto e Castell'Arquato,4244,00,3831,413,3260,984,4244,0
2019/01,305,26/01/2019,6,SP 6Bis fra Carpaneto e Castell'Arquato,3967,00,3884,83,2930,1037,0,3967
2019/01,305,27/01/2019,7,SP 6Bis fra Carpaneto e Castell'Arquato,3192,00,3152,40,2441,751,0,3192
2019/01,305,28/01/2019,1,SP 6Bis fra Carpaneto e Castell'Arquato,3797,00,3413,384,3054,743,3797,0
2019/01,306,15/01/2019,2,SP 654R fra Ponte dell'Olio e Bettola,4211,00,4030,181,3442,769,4211,0
2019/01,306,16/01/2019,3,SP 654R fra Ponte dell'Olio e Bettola,4148,00,3995,153,3324,824,4148,0
2019/01,306,17/01/2019,4,SP 654R fra Ponte dell'Olio e Bettola,4257,10,4102,154,3466,791,4257,0
2019/01,306,18/01/2019,5,SP 654R fra Ponte dell'Olio e Bettola,4445,00,4294,151,3497,948,4445,0
2019/01,306,19/01/2019,6,SP 654R fra Ponte dell'Olio e Bettola,4130,00,4067,63,3162,968,0,4130
2019/01,306,20/01/2019,7,SP 654R fra Ponte dell'Olio e Bettola,3910,00,3887,23,3073,837,0,3910
2019/01,306,21/01/2019,1,SP 654R fra Ponte dell'Olio e Bettola,4388,00,4236,152,3532,856,4388,0
2019/01,306,22/01/2019,2,SP 654R fra Ponte dell'Olio e Bettola,4169,30,3997,169,3362,807,4169,0
2019/01,306,23/01/2019,3,SP 654R fra Ponte dell'Olio e Bettola,3764,00,3651,113,3096,668,3764,0
2019/01,306,24/01/2019,4,SP 654R fra Ponte dell'Olio e Bettola,3421,00,3303,118,2729,692,3421,0
2019/01,306,25/01/2019,5,SP 654R fra Ponte dell'Olio e Bettola,4352,10,4222,129,3413,939,4352,0
2019/01,306,26/01/2019,6,SP 654R fra Ponte dell'Olio e Bettola,4382,10,4307,74,3408,974,0,4382
2019/01,306,27/01/2019,7,SP 654R fra Ponte dell'Olio e Bettola,3666,00,3648,18,2878,788,0,3666
2019/01,306,28/01/2019,1,SP 654R fra Ponte dell'Olio e Bettola,4312,10,4159,152,3518,794,4312,0
2019/01,307,15/01/2019,2,SS 45 tra Rivergaro e Perino,3868,00,3666,202,3177,691,3868,0
2019/01,307,16/01/2019,3,SS 45 tra Rivergaro e Perino,4032,00,3851,181,3233,799,4032,0
2019/01,307,17/01/2019,4,SS 45 tra Rivergaro e Perino,3640,00,3461,179,2955,685,3640,0
2019/01,307,18/01/2019,5,SS 45 tra Rivergaro e Perino,4174,00,3992,182,3205,969,4174,0
2019/01,307,19/01/2019,6,SS 45 tra Rivergaro e Perino,4444,10,4328,115,3498,946,0,4444
2019/01,307,20/01/2019,7,SS 45 tra Rivergaro e Perino,4400,00,4379,21,3581,819,0,4400
2019/01,307,21/01/2019,1,SS 45 tra Rivergaro e Perino,3719,00,3556,163,2999,720,3719,0
2019/01,307,22/01/2019,2,SS 45 tra Rivergaro e Perino,3821,00,3650,171,3132,689,3821,0
2019/01,307,23/01/2019,3,SS 45 tra Rivergaro e Perino,3394,00,3204,190,2767,627,3394,0
2019/01,307,24/01/2019,4,SS 45 tra Rivergaro e Perino,3321,00,3171,150,2627,694,3321,0
2019/01,307,25/01/2019,5,SS 45 tra Rivergaro e Perino,4072,00,3892,180,3170,902,4072,0
2019/01,307,26/01/2019,6,SS 45 tra Rivergaro e Perino,4348,00,4244,104,3437,911,0,4348
2019/01,307,27/01/2019,7,SS 45 tra Rivergaro e Perino,4116,00,4094,22,3388,728,0,4116
2019/01,307,28/01/2019,1,SS 45 tra Rivergaro e Perino,3623,10,3458,164,2868,755,3623,0
2019/01,308,23/01/2019,3,SP 412R fra Pianello Val Tidone e Borgonovo Val Tidone,6153,00,5838,315,5158,995,6153,0
2019/01,308,24/01/2019,4,SP 412R fra Pianello Val Tidone e Borgonovo Val Tidone,5545,00,5292,253,4397,1148,5545,0
2019/01,308,25/01/2019,5,SP 412R fra Pianello Val Tidone e Borgonovo Val Tidone,6604,10,6337,266,5242,1362,6604,0
2019/01,308,26/01/2019,6,SP 412R fra Pianello Val Tidone e Borgonovo Val Tidone,6364,00,6259,105,5017,1347,0,6364
2019/01,308,27/01/2019,7,SP 412R fra Pianello Val Tidone e Borgonovo Val Tidone,4884,00,4858,26,3756,1128,0,4884
2019/01,308,28/01/2019,1,SP 412R fra Pianello Val Tidone e Borgonovo Val Tidone,6143,00,5868,275,4984,1159,6143,0
2019/01,309,15/01/2019,2,SP 10R fra Castelvetro Piacentino e Monticelli d'Ongina,11029,20,10500,527,8743,2286,11029,0
2019/01,309,16/01/2019,3,SP 10R fra Castelvetro Piacentino e Monticelli d'Ongina,10934,10,10406,527,8736,2198,10934,0
2019/01,309,17/01/2019,4,SP 10R fra Castelvetro Piacentino e Monticelli d'Ongina,10783,00,10281,502,8609,2174,10783,0
2019/01,309,18/01/2019,5,SP 10R fra Castelvetro Piacentino e Monticelli d'Ongina,11502,00,10987,515,8908,2594,11502,0
2019/01,309,19/01/2019,6,SP 10R fra Castelvetro Piacentino e Monticelli d'Ongina,10754,10,10575,178,8078,2676,0,10754
2019/01,309,20/01/2019,7,SP 10R fra Castelvetro Piacentino e Monticelli d'Ongina,9074,00,9035,39,6956,2118,0,9074
2019/01,309,21/01/2019,1,SP 10R fra Castelvetro Piacentino e Monticelli d'Ongina,10748,10,10260,487,8637,2111,10748,0
2019/01,309,22/01/2019,2,SP 10R fra Castelvetro Piacentino e Monticelli d'Ongina,10517,10,10020,496,8505,2012,10517,0
2019/01,309,23/01/2019,3,SP 10R fra Castelvetro Piacentino e Monticelli d'Ongina,10649,00,10125,524,8541,2108,10649,0
2019/01,309,24/01/2019,4,SP 10R fra Castelvetro Piacentino e Monticelli d'Ongina,10482,00,9957,525,8332,2150,10482,0
2019/01,309,25/01/2019,5,SP 10R fra Castelvetro Piacentino e Monticelli d'Ongina,11659,00,11189,470,9050,2609,11659,0
2019/01,309,26/01/2019,6,SP 10R fra Castelvetro Piacentino e Monticelli d'Ongina,10536,00,10371,165,7912,2624,0,10536
2019/01,309,27/01/2019,7,SP 10R fra Castelvetro Piacentino e Monticelli d'Ongina,8823,00,8772,51,6911,1912,0,8823
2019/01,309,28/01/2019,1,SP 10R fra Castelvetro Piacentino e Monticelli d'Ongina,10901,00,10395,506,8723,2178,10901,0
2019/01,310,15/01/2019,2,SP 358R fra Cadelbosco di Sopra e Castelnovo di Sotto,15822,00,15015,807,12651,3171,15822,0
2019/01,310,16/01/2019,3,SP 358R fra Cadelbosco di Sopra e Castelnovo di Sotto,15604,00,14723,881,12313,3291,15604,0
2019/01,310,17/01/2019,4,SP 358R fra Cadelbosco di Sopra e Castelnovo di Sotto,16048,00,15132,916,12676,3372,16048,0
2019/01,310,18/01/2019,5,SP 358R fra Cadelbosco di Sopra e Castelnovo di Sotto,16311,00,15444,867,12544,3767,16311,0
2019/01,310,19/01/2019,6,SP 358R fra Cadelbosco di Sopra e Castelnovo di Sotto,13145,00,12919,226,9254,3891,0,13145
2019/01,310,20/01/2019,7,SP 358R fra Cadelbosco di Sopra e Castelnovo di Sotto,10338,00,10288,50,7089,3249,0,10338
2019/01,310,21/01/2019,1,SP 358R fra Cadelbosco di Sopra e Castelnovo di Sotto,15438,10,14564,873,12228,3210,15438,0
2019/01,310,22/01/2019,2,SP 358R fra Cadelbosco di Sopra e Castelnovo di Sotto,15693,00,14813,880,12547,3146,15693,0
2019/01,310,23/01/2019,3,SP 358R fra Cadelbosco di Sopra e Castelnovo di Sotto,15282,00,14383,899,12133,3149,15282,0
2019/01,310,24/01/2019,4,SP 358R fra Cadelbosco di Sopra e Castelnovo di Sotto,14911,10,14128,782,11695,3216,14911,0
2019/01,310,25/01/2019,5,SP 358R fra Cadelbosco di Sopra e Castelnovo di Sotto,15933,00,15040,893,12298,3635,15933,0
2019/01,310,26/01/2019,6,SP 358R fra Cadelbosco di Sopra e Castelnovo di Sotto,13258,00,13044,214,9377,3881,0,13258
2019/01,310,27/01/2019,7,SP 358R fra Cadelbosco di Sopra e Castelnovo di Sotto,9925,00,9868,57,6969,2956,0,9925
2019/01,310,28/01/2019,1,SP 358R fra Cadelbosco di Sopra e Castelnovo di Sotto,15163,00,14338,825,12142,3021,15163,0
2019/01,311,15/01/2019,2,SP 62RVar tra la località San Giacomo (bivio SP 42) ed SP 2 (c/o Tagliata),11057,00,8497,2560,8939,2118,11057,0
2019/01,311,16/01/2019,3,SP 62RVar tra la località San Giacomo (bivio SP 42) ed SP 2 (c/o Tagliata),11411,00,8779,2632,9131,2280,11411,0
2019/01,311,17/01/2019,4,SP 62RVar tra la località San Giacomo (bivio SP 42) ed SP 2 (c/o Tagliata),11586,00,8858,2728,9365,2221,11586,0
2019/01,311,18/01/2019,5,SP 62RVar tra la località San Giacomo (bivio SP 42) ed SP 2 (c/o Tagliata),11723,00,9119,2604,9234,2489,11723,0
2019/01,311,19/01/2019,6,SP 62RVar tra la località San Giacomo (bivio SP 42) ed SP 2 (c/o Tagliata),8402,00,7896,506,6124,2278,0,8402
2019/01,311,20/01/2019,7,SP 62RVar tra la località San Giacomo (bivio SP 42) ed SP 2 (c/o Tagliata),8285,00,8159,126,5902,2383,0,8285
2019/01,311,21/01/2019,1,SP 62RVar tra la località San Giacomo (bivio SP 42) ed SP 2 (c/o Tagliata),11057,10,8428,2628,8960,2097,11057,0
2019/01,311,22/01/2019,2,SP 62RVar tra la località San Giacomo (bivio SP 42) ed SP 2 (c/o Tagliata),11157,00,8535,2622,9055,2102,11157,0
2019/01,311,23/01/2019,3,SP 62RVar tra la località San Giacomo (bivio SP 42) ed SP 2 (c/o Tagliata),10946,00,8298,2648,8836,2110,10946,0
2019/01,311,24/01/2019,4,SP 62RVar tra la località San Giacomo (bivio SP 42) ed SP 2 (c/o Tagliata),11016,10,8342,2673,8934,2082,11016,0
2019/01,311,25/01/2019,5,SP 62RVar tra la località San Giacomo (bivio SP 42) ed SP 2 (c/o Tagliata),11562,00,9029,2533,9122,2440,11562,0
2019/01,311,26/01/2019,6,SP 62RVar tra la località San Giacomo (bivio SP 42) ed SP 2 (c/o Tagliata),8533,00,8109,424,6193,2340,0,8533
2019/01,311,27/01/2019,7,SP 62RVar tra la località San Giacomo (bivio SP 42) ed SP 2 (c/o Tagliata),7300,10,7193,106,5249,2051,0,7300
2019/01,311,28/01/2019,1,SP 62RVar tra la località San Giacomo (bivio SP 42) ed SP 2 (c/o Tagliata),10803,10,8250,2552,8715,2088,10803,0
2019/01,312,15/01/2019,2,SP 42 fra Novellara e San Giacomo (SP 62R),14049,00,12773,1276,11330,2719,14049,0
2019/01,312,16/01/2019,3,SP 42 fra Novellara e San Giacomo (SP 62R),13955,00,12618,1337,11183,2772,13955,0
2019/01,312,17/01/2019,4,SP 42 fra Novellara e San Giacomo (SP 62R),14250,00,12941,1309,11398,2852,14250,0
2019/01,312,18/01/2019,5,SP 42 fra Novellara e San Giacomo (SP 62R),14501,00,13252,1249,11215,3286,14501,0
2019/01,312,19/01/2019,6,SP 42 fra Novellara e San Giacomo (SP 62R),11279,00,11114,165,8014,3265,0,11279
2019/01,312,20/01/2019,7,SP 42 fra Novellara e San Giacomo (SP 62R),9051,00,8976,75,6380,2671,0,9051
2019/01,312,21/01/2019,1,SP 42 fra Novellara e San Giacomo (SP 62R),13355,00,12112,1243,10748,2607,13355,0
2019/01,312,22/01/2019,2,SP 42 fra Novellara e San Giacomo (SP 62R),13565,00,12340,1225,10977,2588,13565,0
2019/01,312,23/01/2019,3,SP 42 fra Novellara e San Giacomo (SP 62R),13707,10,12391,1315,11005,2702,13707,0
2019/01,312,24/01/2019,4,SP 42 fra Novellara e San Giacomo (SP 62R),13856,00,12649,1207,11053,2803,13856,0
2019/01,312,25/01/2019,5,SP 42 fra Novellara e San Giacomo (SP 62R),14211,10,12952,1258,11084,3127,14211,0
2019/01,312,26/01/2019,6,SP 42 fra Novellara e San Giacomo (SP 62R),11289,10,11091,197,8093,3196,0,11289
2019/01,312,27/01/2019,7,SP 42 fra Novellara e San Giacomo (SP 62R),8745,00,8683,62,6219,2526,0,8745
2019/01,312,28/01/2019,1,SP 42 fra Novellara e San Giacomo (SP 62R),13308,00,12068,1240,10828,2480,13308,0
2019/01,314,15/01/2019,2,SP 2 fra Reggiolo (bivio SP 2) e località Villarotta (SP 84),8604,00,8189,415,6940,1664,8604,0
2019/01,314,16/01/2019,3,SP 2 fra Reggiolo (bivio SP 2) e località Villarotta (SP 84),8784,00,8382,402,7078,1706,8784,0
2019/01,314,17/01/2019,4,SP 2 fra Reggiolo (bivio SP 2) e località Villarotta (SP 84),8625,00,8219,406,6833,1792,8625,0
2019/01,314,18/01/2019,5,SP 2 fra Reggiolo (bivio SP 2) e località Villarotta (SP 84),9258,00,8908,350,7206,2052,9258,0
2019/01,314,19/01/2019,6,SP 2 fra Reggiolo (bivio SP 2) e località Villarotta (SP 84),7498,00,7338,160,5468,2030,0,7498
2019/01,314,20/01/2019,7,SP 2 fra Reggiolo (bivio SP 2) e località Villarotta (SP 84),6161,00,6108,53,4328,1833,0,6161
2019/01,314,21/01/2019,1,SP 2 fra Reggiolo (bivio SP 2) e località Villarotta (SP 84),8434,00,8044,390,6738,1696,8434,0
2019/01,314,22/01/2019,2,SP 2 fra Reggiolo (bivio SP 2) e località Villarotta (SP 84),8472,00,8106,366,6810,1662,8472,0
2019/01,314,23/01/2019,3,SP 2 fra Reggiolo (bivio SP 2) e località Villarotta (SP 84),8410,00,8046,364,6715,1695,8410,0
2019/01,314,24/01/2019,4,SP 2 fra Reggiolo (bivio SP 2) e località Villarotta (SP 84),8484,10,8104,379,6726,1758,8484,0
2019/01,314,25/01/2019,5,SP 2 fra Reggiolo (bivio SP 2) e località Villarotta (SP 84),9098,00,8710,388,7068,2030,9098,0
2019/01,314,26/01/2019,6,SP 2 fra Reggiolo (bivio SP 2) e località Villarotta (SP 84),7142,00,6993,149,5174,1968,0,7142
2019/01,314,27/01/2019,7,SP 2 fra Reggiolo (bivio SP 2) e località Villarotta (SP 84),5500,00,5465,35,3849,1651,0,5500
2019/01,314,28/01/2019,1,SP 2 fra Reggiolo (bivio SP 2) e località Villarotta (SP 84),8193,00,7798,395,6562,1631,8193,0
2019/01,318,15/01/2019,2,SP 51 fra Sassuolo (bivio SP 467R) e Rubiera,10710,10,8212,2497,8778,1932,10710,0
2019/01,318,16/01/2019,3,SP 51 fra Sassuolo (bivio SP 467R) e Rubiera,11152,10,8402,2749,9071,2081,11152,0
2019/01,318,17/01/2019,4,SP 51 fra Sassuolo (bivio SP 467R) e Rubiera,11201,00,8385,2816,9047,2154,11201,0
2019/01,318,18/01/2019,5,SP 51 fra Sassuolo (bivio SP 467R) e Rubiera,11339,00,8845,2494,8886,2453,11339,0
2019/01,318,19/01/2019,6,SP 51 fra Sassuolo (bivio SP 467R) e Rubiera,7991,00,7778,213,5494,2497,0,7991
2019/01,318,20/01/2019,7,SP 51 fra Sassuolo (bivio SP 467R) e Rubiera,7123,00,7082,41,5008,2115,0,7123
2019/01,318,21/01/2019,1,SP 51 fra Sassuolo (bivio SP 467R) e Rubiera,10555,20,8123,2430,8697,1858,10555,0
2019/01,318,22/01/2019,2,SP 51 fra Sassuolo (bivio SP 467R) e Rubiera,10803,00,8200,2603,8833,1970,10803,0
2019/01,318,23/01/2019,3,SP 51 fra Sassuolo (bivio SP 467R) e Rubiera,10713,10,8038,2674,8791,1922,10713,0
2019/01,318,24/01/2019,4,SP 51 fra Sassuolo (bivio SP 467R) e Rubiera,10269,40,7738,2527,8189,2080,10269,0
2019/01,318,25/01/2019,5,SP 51 fra Sassuolo (bivio SP 467R) e Rubiera,11302,40,8860,2438,8882,2420,11302,0
2019/01,318,26/01/2019,6,SP 51 fra Sassuolo (bivio SP 467R) e Rubiera,8656,10,8440,215,6017,2639,0,8656
2019/01,318,27/01/2019,7,SP 51 fra Sassuolo (bivio SP 467R) e Rubiera,6638,00,6580,58,4752,1886,0,6638
2019/01,318,28/01/2019,1,SP 51 fra Sassuolo (bivio SP 467R) e Rubiera,10378,10,8018,2359,8427,1951,10378,0
2019/01,319,15/01/2019,2,SP 15 tra Sassuolo e Magreta,,,,,,,,
2019/01,319,16/01/2019,3,SP 15 tra Sassuolo e Magreta,,,,,,,,
2019/01,319,17/01/2019,4,SP 15 tra Sassuolo e Magreta,,,,,,,,
2019/01,319,18/01/2019,5,SP 15 tra Sassuolo e Magreta,,,,,,,,
2019/01,319,19/01/2019,6,SP 15 tra Sassuolo e Magreta,,,,,,,,
2019/01,319,20/01/2019,7,SP 15 tra Sassuolo e Magreta,,,,,,,,
2019/01,319,21/01/2019,1,SP 15 tra Sassuolo e Magreta,,,,,,,,
2019/01,319,22/01/2019,2,SP 15 tra Sassuolo e Magreta,,,,,,,,
2019/01,319,23/01/2019,3,SP 15 tra Sassuolo e Magreta,,,,,,,,
2019/01,319,24/01/2019,4,SP 15 tra Sassuolo e Magreta,,,,,,,,
2019/01,319,25/01/2019,5,SP 15 tra Sassuolo e Magreta,,,,,,,,
2019/01,319,26/01/2019,6,SP 15 tra Sassuolo e Magreta,,,,,,,,
2019/01,319,27/01/2019,7,SP 15 tra Sassuolo e Magreta,,,,,,,,
2019/01,319,28/01/2019,1,SP 15 tra Sassuolo e Magreta,,,,,,,,
2019/01,321,15/01/2019,2,SP 467 tra SP 486 e confine provinciale,,,,,,,,
2019/01,321,16/01/2019,3,SP 467 tra SP 486 e confine provinciale,,,,,,,,
2019/01,321,17/01/2019,4,SP 467 tra SP 486 e confine provinciale,,,,,,,,
2019/01,321,18/01/2019,5,SP 467 tra SP 486 e confine provinciale,,,,,,,,
2019/01,321,19/01/2019,6,SP 467 tra SP 486 e confine provinciale,,,,,,,,
2019/01,321,20/01/2019,7,SP 467 tra SP 486 e confine provinciale,,,,,,,,
2019/01,321,21/01/2019,1,SP 467 tra SP 486 e confine provinciale,,,,,,,,
2019/01,321,22/01/2019,2,SP 467 tra SP 486 e confine provinciale,,,,,,,,
2019/01,321,23/01/2019,3,SP 467 tra SP 486 e confine provinciale,,,,,,,,
2019/01,321,24/01/2019,4,SP 467 tra SP 486 e confine provinciale,,,,,,,,
2019/01,321,25/01/2019,5,SP 467 tra SP 486 e confine provinciale,,,,,,,,
2019/01,321,26/01/2019,6,SP 467 tra SP 486 e confine provinciale,,,,,,,,
2019/01,321,27/01/2019,7,SP 467 tra SP 486 e confine provinciale,,,,,,,,
2019/01,321,28/01/2019,1,SP 467 tra SP 486 e confine provinciale,,,,,,,,
2019/01,323,15/01/2019,2,SP 467 fra SP 3 e SS 12,26035,10,22556,3478,20739,5296,26035,0
2019/01,323,16/01/2019,3,SP 467 fra SP 3 e SS 12,26463,00,22809,3654,21033,5430,26463,0
2019/01,323,17/01/2019,4,SP 467 fra SP 3 e SS 12,26235,00,22476,3759,20650,5585,26235,0
2019/01,323,18/01/2019,5,SP 467 fra SP 3 e SS 12,27120,00,23526,3594,21206,5914,27120,0
2019/01,323,19/01/2019,6,SP 467 fra SP 3 e SS 12,16882,00,16406,476,12102,4780,0,16882
2019/01,323,20/01/2019,7,SP 467 fra SP 3 e SS 12,13012,00,12930,82,9471,3541,0,13012
2019/01,323,21/01/2019,1,SP 467 fra SP 3 e SS 12,25578,20,22075,3501,20482,5096,25578,0
2019/01,323,22/01/2019,2,SP 467 fra SP 3 e SS 12,25461,10,21935,3525,20308,5153,25461,0
2019/01,323,23/01/2019,3,SP 467 fra SP 3 e SS 12,25574,00,22106,3468,20573,5001,25574,0
2019/01,323,24/01/2019,4,SP 467 fra SP 3 e SS 12,23455,00,20205,3250,18477,4978,23455,0
2019/01,323,25/01/2019,5,SP 467 fra SP 3 e SS 12,26275,00,22946,3329,20374,5901,26275,0
2019/01,323,26/01/2019,6,SP 467 fra SP 3 e SS 12,17779,00,17248,531,12764,5015,0,17779
2019/01,323,27/01/2019,7,SP 467 fra SP 3 e SS 12,12386,10,12270,115,8962,3424,0,12386
2019/01,323,28/01/2019,1,SP 467 fra SP 3 e SS 12,25470,20,22163,3305,20392,5078,25470,0
2019/01,328,18/01/2019,5,SP 486 tra Modena e Baggiovara,18361,20,17971,388,13827,4534,18361,0
2019/01,328,19/01/2019,6,SP 486 tra Modena e Baggiovara,22471,10,22220,250,15979,6492,0,22471
2019/01,328,20/01/2019,7,SP 486 tra Modena e Baggiovara,15642,00,15538,104,10553,5089,0,15642
2019/01,328,21/01/2019,1,SP 486 tra Modena e Baggiovara,24201,20,23676,523,19289,4912,24201,0
2019/01,328,22/01/2019,2,SP 486 tra Modena e Baggiovara,24234,10,23642,591,19043,5191,24234,0
2019/01,328,23/01/2019,3,SP 486 tra Modena e Baggiovara,24617,20,23999,616,19041,5576,24617,0
2019/01,328,24/01/2019,4,SP 486 tra Modena e Baggiovara,23550,10,22971,578,18093,5457,23550,0
2019/01,328,25/01/2019,5,SP 486 tra Modena e Baggiovara,25469,00,24910,559,19460,6009,25469,0
2019/01,328,26/01/2019,6,SP 486 tra Modena e Baggiovara,22198,00,21950,248,15760,6438,0,22198
2019/01,328,27/01/2019,7,SP 486 tra Modena e Baggiovara,15974,00,15878,96,11145,4829,0,15974
2019/01,328,28/01/2019,1,SP 486 tra Modena e Baggiovara,23832,10,23249,582,18888,4944,23832,0
2019/01,331,17/01/2019,4,SP 325 tra Casello A 1 (Sasso Marconi) e Vado,5769,00,5487,282,4403,1366,5769,0
2019/01,331,18/01/2019,5,SP 325 tra Casello A 1 (Sasso Marconi) e Vado,7755,00,7340,415,5989,1766,7755,0
2019/01,331,19/01/2019,6,SP 325 tra Casello A 1 (Sasso Marconi) e Vado,6002,00,5931,71,4479,1523,0,6002
2019/01,331,26/01/2019,6,SP 325 tra Casello A 1 (Sasso Marconi) e Vado,5671,00,5609,62,4160,1511,0,5671
2019/01,332,15/01/2019,2,SP 306R fra Castel Bolognese e Riolo Terme,8299,00,7701,598,6667,1632,8299,0
2019/01,332,16/01/2019,3,SP 306R fra Castel Bolognese e Riolo Terme,8148,10,7608,539,6482,1666,8148,0
2019/01,332,17/01/2019,4,SP 306R fra Castel Bolognese e Riolo Terme,8491,00,7967,524,6687,1804,8491,0
2019/01,332,18/01/2019,5,SP 306R fra Castel Bolognese e Riolo Terme,8572,00,8048,524,6679,1893,8572,0
2019/01,332,19/01/2019,6,SP 306R fra Castel Bolognese e Riolo Terme,7049,00,6909,140,5190,1859,0,7049
2019/01,332,20/01/2019,7,SP 306R fra Castel Bolognese e Riolo Terme,5964,00,5933,31,4405,1559,0,5964
2019/01,332,21/01/2019,1,SP 306R fra Castel Bolognese e Riolo Terme,8106,00,7636,470,6499,1607,8106,0
2019/01,332,22/01/2019,2,SP 306R fra Castel Bolognese e Riolo Terme,7707,10,7251,455,6229,1478,7707,0
2019/01,332,23/01/2019,3,SP 306R fra Castel Bolognese e Riolo Terme,7739,10,7268,470,6080,1659,7739,0
2019/01,332,24/01/2019,4,SP 306R fra Castel Bolognese e Riolo Terme,8011,00,7598,413,6291,1720,8011,0
2019/01,332,25/01/2019,5,SP 306R fra Castel Bolognese e Riolo Terme,8276,00,7823,453,6418,1858,8276,0
2019/01,332,26/01/2019,6,SP 306R fra Castel Bolognese e Riolo Terme,7365,20,7230,133,5449,1916,0,7365
2019/01,332,27/01/2019,7,SP 306R fra Castel Bolognese e Riolo Terme,6108,10,6073,34,4561,1547,0,6108
2019/01,332,28/01/2019,1,SP 306R fra Castel Bolognese e Riolo Terme,7957,00,7565,392,6304,1653,7957,0
2019/01,333,15/01/2019,2,SS 9 tra Castel Bolognese e Faenza,22393,00,21429,964,17291,5102,22393,0
2019/01,333,16/01/2019,3,SS 9 tra Castel Bolognese e Faenza,22439,00,21542,897,17201,5238,22439,0
2019/01,333,17/01/2019,4,SS 9 tra Castel Bolognese e Faenza,22398,10,21566,831,17160,5238,22398,0
2019/01,333,18/01/2019,5,SS 9 tra Castel Bolognese e Faenza,23566,00,22742,824,17430,6136,23566,0
2019/01,333,19/01/2019,6,SS 9 tra Castel Bolognese e Faenza,21053,00,20801,252,14052,7001,0,21053
2019/01,333,20/01/2019,7,SS 9 tra Castel Bolognese e Faenza,16609,00,16553,56,11240,5369,0,16609
2019/01,333,21/01/2019,1,SS 9 tra Castel Bolognese e Faenza,21806,00,21064,742,16932,4874,21806,0
2019/01,333,22/01/2019,2,SS 9 tra Castel Bolognese e Faenza,20820,10,20119,700,16299,4521,20820,0
2019/01,333,23/01/2019,3,SS 9 tra Castel Bolognese e Faenza,21444,00,20760,684,16515,4929,21444,0
2019/01,333,24/01/2019,4,SS 9 tra Castel Bolognese e Faenza,21412,00,20730,682,16416,4996,21412,0
2019/01,333,25/01/2019,5,SS 9 tra Castel Bolognese e Faenza,23281,00,22519,762,16961,6320,23281,0
2019/01,333,26/01/2019,6,SS 9 tra Castel Bolognese e Faenza,20791,00,20552,239,13650,7141,0,20791
2019/01,333,27/01/2019,7,SS 9 tra Castel Bolognese e Faenza,16155,00,16080,75,10981,5174,0,16155
2019/01,333,28/01/2019,1,SS 9 tra Castel Bolognese e Faenza,21492,10,20753,738,16748,4744,21492,0
2019/01,334,15/01/2019,2,SP 8 dal Casello A 1 (Faenza) a Cotignola,14326,00,13376,950,11309,3017,14326,0
2019/01,334,16/01/2019,3,SP 8 dal Casello A 1 (Faenza) a Cotignola,14456,00,13537,919,11442,3014,14456,0
2019/01,334,17/01/2019,4,SP 8 dal Casello A 1 (Faenza) a Cotignola,14948,00,14013,935,11853,3095,14948,0
2019/01,334,18/01/2019,5,SP 8 dal Casello A 1 (Faenza) a Cotignola,15475,00,14594,881,12123,3352,15475,0
2019/01,334,19/01/2019,6,SP 8 dal Casello A 1 (Faenza) a Cotignola,14030,00,13830,200,10114,3916,0,14030
2019/01,334,20/01/2019,7,SP 8 dal Casello A 1 (Faenza) a Cotignola,12190,00,12170,20,8995,3195,0,12190
2019/01,334,21/01/2019,1,SP 8 dal Casello A 1 (Faenza) a Cotignola,14315,00,13439,876,11539,2776,14315,0
2019/01,334,22/01/2019,2,SP 8 dal Casello A 1 (Faenza) a Cotignola,13906,00,12981,925,11319,2587,13906,0
2019/01,334,23/01/2019,3,SP 8 dal Casello A 1 (Faenza) a Cotignola,14229,00,13441,788,11365,2864,14229,0
2019/01,334,24/01/2019,4,SP 8 dal Casello A 1 (Faenza) a Cotignola,14422,00,13597,825,11462,2960,14422,0
2019/01,334,25/01/2019,5,SP 8 dal Casello A 1 (Faenza) a Cotignola,14843,00,14014,829,11284,3559,14843,0
2019/01,334,26/01/2019,6,SP 8 dal Casello A 1 (Faenza) a Cotignola,13681,00,13489,192,9376,4305,0,13681
2019/01,334,27/01/2019,7,SP 8 dal Casello A 1 (Faenza) a Cotignola,12172,00,12141,31,9056,3116,0,12172
2019/01,334,28/01/2019,1,SP 8 dal Casello A 1 (Faenza) a Cotignola,14044,00,13120,924,11294,2750,14044,0
2019/01,335,15/01/2019,2,SP 7 tra l'A 14 (bivio SP 29) e l'A 14dir (Barbiano),7131,00,6603,528,5804,1327,7131,0
2019/01,335,16/01/2019,3,SP 7 tra l'A 14 (bivio SP 29) e l'A 14dir (Barbiano),7312,00,6799,513,5935,1377,7312,0
2019/01,335,17/01/2019,4,SP 7 tra l'A 14 (bivio SP 29) e l'A 14dir (Barbiano),7275,00,6732,543,5855,1420,7275,0
2019/01,335,18/01/2019,5,SP 7 tra l'A 14 (bivio SP 29) e l'A 14dir (Barbiano),7328,00,6793,535,5771,1557,7328,0
2019/01,335,19/01/2019,6,SP 7 tra l'A 14 (bivio SP 29) e l'A 14dir (Barbiano),5805,00,5713,92,4057,1748,0,5805
2019/01,335,20/01/2019,7,SP 7 tra l'A 14 (bivio SP 29) e l'A 14dir (Barbiano),4918,00,4896,22,3541,1377,0,4918
2019/01,335,21/01/2019,1,SP 7 tra l'A 14 (bivio SP 29) e l'A 14dir (Barbiano),7061,00,6477,584,5710,1351,7061,0
2019/01,335,22/01/2019,2,SP 7 tra l'A 14 (bivio SP 29) e l'A 14dir (Barbiano),6814,10,6302,511,5621,1193,6814,0
2019/01,335,23/01/2019,3,SP 7 tra l'A 14 (bivio SP 29) e l'A 14dir (Barbiano),6893,00,6422,471,5613,1280,6893,0
2019/01,335,24/01/2019,4,SP 7 tra l'A 14 (bivio SP 29) e l'A 14dir (Barbiano),7170,00,6636,534,5727,1443,7170,0
2019/01,335,25/01/2019,5,SP 7 tra l'A 14 (bivio SP 29) e l'A 14dir (Barbiano),7088,00,6624,464,5562,1526,7088,0
2019/01,335,26/01/2019,6,SP 7 tra l'A 14 (bivio SP 29) e l'A 14dir (Barbiano),5689,00,5590,99,3918,1771,0,5689
2019/01,335,27/01/2019,7,SP 7 tra l'A 14 (bivio SP 29) e l'A 14dir (Barbiano),4752,00,4724,28,3274,1478,0,4752
2019/01,335,28/01/2019,1,SP 7 tra l'A 14 (bivio SP 29) e l'A 14dir (Barbiano),6853,00,6285,568,5557,1296,6853,0
2019/01,336,15/01/2019,2,SP 253R tra Lugo (ponte fiume Senio) e Bagnacavallo,11457,00,10731,726,9256,2201,11457,0
2019/01,336,16/01/2019,3,SP 253R tra Lugo (ponte fiume Senio) e Bagnacavallo,11381,00,10542,839,9253,2128,11381,0
2019/01,336,17/01/2019,4,SP 253R tra Lugo (ponte fiume Senio) e Bagnacavallo,11473,00,10735,738,9266,2207,11473,0
2019/01,336,18/01/2019,5,SP 253R tra Lugo (ponte fiume Senio) e Bagnacavallo,11857,00,11143,714,9345,2512,11857,0
2019/01,336,19/01/2019,6,SP 253R tra Lugo (ponte fiume Senio) e Bagnacavallo,9677,00,9516,161,7240,2437,0,9677
2019/01,336,20/01/2019,7,SP 253R tra Lugo (ponte fiume Senio) e Bagnacavallo,6357,00,6330,27,4588,1769,0,6357
2019/01,336,21/01/2019,1,SP 253R tra Lugo (ponte fiume Senio) e Bagnacavallo,10980,00,10307,673,8948,2032,10980,0
2019/01,336,22/01/2019,2,SP 253R tra Lugo (ponte fiume Senio) e Bagnacavallo,10699,00,10055,644,8797,1902,10699,0
2019/01,336,23/01/2019,3,SP 253R tra Lugo (ponte fiume Senio) e Bagnacavallo,10809,00,10186,623,8675,2134,10809,0
2019/01,336,24/01/2019,4,SP 253R tra Lugo (ponte fiume Senio) e Bagnacavallo,11352,00,10666,686,9094,2258,11352,0
2019/01,336,25/01/2019,5,SP 253R tra Lugo (ponte fiume Senio) e Bagnacavallo,11677,00,11038,639,9193,2484,11677,0
2019/01,336,26/01/2019,6,SP 253R tra Lugo (ponte fiume Senio) e Bagnacavallo,9550,00,9393,157,7212,2338,0,9550
2019/01,336,27/01/2019,7,SP 253R tra Lugo (ponte fiume Senio) e Bagnacavallo,6478,00,6446,32,4763,1715,0,6478
2019/01,336,28/01/2019,1,SP 253R tra Lugo (ponte fiume Senio) e Bagnacavallo,11057,00,10370,687,9031,2026,11057,0
2019/01,337,15/01/2019,2,SP 14 fra Lugo (bivio SSPP 41/46) e Fusignano,11932,00,11390,542,9652,2280,11932,0
2019/01,337,16/01/2019,3,SP 14 fra Lugo (bivio SSPP 41/46) e Fusignano,12210,00,11599,611,10031,2179,12210,0
2019/01,337,17/01/2019,4,SP 14 fra Lugo (bivio SSPP 41/46) e Fusignano,12037,30,11440,594,9703,2334,12037,0
2019/01,337,18/01/2019,5,SP 14 fra Lugo (bivio SSPP 41/46) e Fusignano,12283,10,11679,603,9795,2488,12283,0
2019/01,337,19/01/2019,6,SP 14 fra Lugo (bivio SSPP 41/46) e Fusignano,9973,00,9808,165,7602,2371,0,9973
2019/01,337,20/01/2019,7,SP 14 fra Lugo (bivio SSPP 41/46) e Fusignano,6762,00,6738,24,4892,1870,0,6762
2019/01,337,21/01/2019,1,SP 14 fra Lugo (bivio SSPP 41/46) e Fusignano,11678,10,11118,559,9615,2063,11678,0
2019/01,337,22/01/2019,2,SP 14 fra Lugo (bivio SSPP 41/46) e Fusignano,11672,10,11102,569,9566,2106,11672,0
2019/01,337,23/01/2019,3,SP 14 fra Lugo (bivio SSPP 41/46) e Fusignano,11306,30,10805,498,9209,2097,11306,0
2019/01,337,24/01/2019,4,SP 14 fra Lugo (bivio SSPP 41/46) e Fusignano,11614,00,11068,546,9481,2133,11614,0
2019/01,337,25/01/2019,5,SP 14 fra Lugo (bivio SSPP 41/46) e Fusignano,12007,20,11443,562,9572,2435,12007,0
2019/01,337,26/01/2019,6,SP 14 fra Lugo (bivio SSPP 41/46) e Fusignano,10074,00,9900,174,7684,2390,0,10074
2019/01,337,27/01/2019,7,SP 14 fra Lugo (bivio SSPP 41/46) e Fusignano,6335,00,6313,22,4530,1805,0,6335
2019/01,337,28/01/2019,1,SP 14 fra Lugo (bivio SSPP 41/46) e Fusignano,11423,00,10836,587,9385,2038,11423,0
2019/01,339,15/01/2019,2,SP 3 tra San Lorenzo in Noceto e Predappio,7551,00,7175,376,6057,1494,7551,0
2019/01,339,16/01/2019,3,SP 3 tra San Lorenzo in Noceto e Predappio,7845,00,7481,364,6195,1650,7845,0
2019/01,339,17/01/2019,4,SP 3 tra San Lorenzo in Noceto e Predappio,7741,00,7365,376,6162,1579,7741,0
2019/01,339,18/01/2019,5,SP 3 tra San Lorenzo in Noceto e Predappio,7605,10,7217,387,5975,1630,7605,0
2019/01,339,19/01/2019,6,SP 3 tra San Lorenzo in Noceto e Predappio,6693,00,6593,100,4889,1804,0,6693
2019/01,339,20/01/2019,7,SP 3 tra San Lorenzo in Noceto e Predappio,5261,00,5240,21,3975,1286,0,5261
2019/01,339,21/01/2019,1,SP 3 tra San Lorenzo in Noceto e Predappio,7169,00,6830,339,5862,1307,7169,0
2019/01,339,22/01/2019,2,SP 3 tra San Lorenzo in Noceto e Predappio,6543,00,6195,348,5425,1118,6543,0
2019/01,339,23/01/2019,3,SP 3 tra San Lorenzo in Noceto e Predappio,6935,00,6670,265,5553,1382,6935,0
2019/01,339,24/01/2019,4,SP 3 tra San Lorenzo in Noceto e Predappio,7042,00,6714,328,5597,1445,7042,0
2019/01,339,25/01/2019,5,SP 3 tra San Lorenzo in Noceto e Predappio,7783,10,7444,338,6094,1689,7783,0
2019/01,339,26/01/2019,6,SP 3 tra San Lorenzo in Noceto e Predappio,6693,00,6596,97,4940,1753,0,6693
2019/01,339,27/01/2019,7,SP 3 tra San Lorenzo in Noceto e Predappio,5519,00,5494,25,4241,1278,0,5519
2019/01,339,28/01/2019,1,SP 3 tra San Lorenzo in Noceto e Predappio,7330,10,6987,342,5923,1407,7330,0
2019/01,340,15/01/2019,2,SP 72 tra San Martino in Strada e bivio ex SS 310R (Meldola),10364,00,9930,434,8336,2028,10364,0
2019/01,340,16/01/2019,3,SP 72 tra San Martino in Strada e bivio ex SS 310R (Meldola),10233,00,9849,384,8174,2059,10233,0
2019/01,340,17/01/2019,4,SP 72 tra San Martino in Strada e bivio ex SS 310R (Meldola),10162,00,9742,420,8075,2087,10162,0
2019/01,340,18/01/2019,5,SP 72 tra San Martino in Strada e bivio ex SS 310R (Meldola),10141,10,9707,433,8045,2096,10141,0
2019/01,340,19/01/2019,6,SP 72 tra San Martino in Strada e bivio ex SS 310R (Meldola),7962,10,7834,127,5793,2169,0,7962
2019/01,340,20/01/2019,7,SP 72 tra San Martino in Strada e bivio ex SS 310R (Meldola),6620,00,6598,22,4774,1846,0,6620
2019/01,340,21/01/2019,1,SP 72 tra San Martino in Strada e bivio ex SS 310R (Meldola),9695,00,9313,382,7863,1832,9695,0
2019/01,340,22/01/2019,2,SP 72 tra San Martino in Strada e bivio ex SS 310R (Meldola),8789,00,8423,366,7240,1549,8789,0
2019/01,340,23/01/2019,3,SP 72 tra San Martino in Strada e bivio ex SS 310R (Meldola),9482,00,9128,354,7571,1911,9482,0
2019/01,340,24/01/2019,4,SP 72 tra San Martino in Strada e bivio ex SS 310R (Meldola),9385,10,9049,335,7440,1945,9385,0
2019/01,340,25/01/2019,5,SP 72 tra San Martino in Strada e bivio ex SS 310R (Meldola),10235,00,9852,383,7969,2266,10235,0
2019/01,340,26/01/2019,6,SP 72 tra San Martino in Strada e bivio ex SS 310R (Meldola),8485,00,8315,170,6254,2231,0,8485
2019/01,340,27/01/2019,7,SP 72 tra San Martino in Strada e bivio ex SS 310R (Meldola),6952,00,6933,19,5196,1756,0,6952
2019/01,340,28/01/2019,1,SP 72 tra San Martino in Strada e bivio ex SS 310R (Meldola),9817,00,9396,421,7965,1852,9817,0
2019/01,342,15/01/2019,2,SP 33 in località Gatteo,16903,00,15341,1562,13581,3322,16903,0
2019/01,342,16/01/2019,3,SP 33 in località Gatteo,16867,10,15335,1531,13503,3364,16867,0
2019/01,342,17/01/2019,4,SP 33 in località Gatteo,16785,10,15208,1576,13159,3626,16785,0
2019/01,342,18/01/2019,5,SP 33 in località Gatteo,17636,20,16092,1542,13624,4012,17636,0
2019/01,342,19/01/2019,6,SP 33 in località Gatteo,14092,20,13669,421,10218,3874,0,14092
2019/01,342,20/01/2019,7,SP 33 in località Gatteo,11566,10,11446,119,8263,3303,0,11566
2019/01,342,21/01/2019,1,SP 33 in località Gatteo,16948,10,15362,1585,13821,3127,16948,0
2019/01,342,22/01/2019,2,SP 33 in località Gatteo,15630,10,14230,1399,12792,2838,15630,0
2019/01,342,23/01/2019,3,SP 33 in località Gatteo,15948,00,14529,1419,12839,3109,15948,0
2019/01,342,24/01/2019,4,SP 33 in località Gatteo,16393,00,14860,1533,12830,3563,16393,0
2019/01,342,25/01/2019,5,SP 33 in località Gatteo,17141,00,15672,1469,13337,3804,17141,0
2019/01,342,26/01/2019,6,SP 33 in località Gatteo,14257,10,13840,416,10535,3722,0,14257
2019/01,342,27/01/2019,7,SP 33 in località Gatteo,10996,00,10908,88,7944,3052,0,10996
2019/01,342,28/01/2019,1,SP 33 in località Gatteo,16105,10,14583,1521,12946,3159,16105,0
2019/01,343,15/01/2019,2,SP 4 tra Galeata e Santa Sofia,5443,00,5094,349,4268,1175,5443,0
2019/01,343,16/01/2019,3,SP 4 tra Galeata e Santa Sofia,5490,00,5165,325,4268,1222,5490,0
2019/01,343,17/01/2019,4,SP 4 tra Galeata e Santa Sofia,5363,00,5046,317,4089,1274,5363,0
2019/01,343,18/01/2019,5,SP 4 tra Galeata e Santa Sofia,5419,00,5085,334,4181,1238,5419,0
2019/01,343,19/01/2019,6,SP 4 tra Galeata e Santa Sofia,4942,00,4789,153,3556,1386,0,4942
2019/01,343,20/01/2019,7,SP 4 tra Galeata e Santa Sofia,4168,00,4144,24,3236,932,0,4168
2019/01,343,21/01/2019,1,SP 4 tra Galeata e Santa Sofia,5136,00,4802,334,4082,1054,5136,0
2019/01,343,22/01/2019,2,SP 4 tra Galeata e Santa Sofia,4420,00,4134,286,3456,964,4420,0
2019/01,343,23/01/2019,3,SP 4 tra Galeata e Santa Sofia,4626,00,4384,242,3557,1069,4626,0
2019/01,343,24/01/2019,4,SP 4 tra Galeata e Santa Sofia,4790,00,4499,291,3706,1084,4790,0
2019/01,343,25/01/2019,5,SP 4 tra Galeata e Santa Sofia,5449,00,5140,309,4253,1196,5449,0
2019/01,343,26/01/2019,6,SP 4 tra Galeata e Santa Sofia,5743,00,5586,157,4421,1322,0,5743
2019/01,343,27/01/2019,7,SP 4 tra Galeata e Santa Sofia,5063,00,5040,23,4198,865,0,5063
2019/01,343,28/01/2019,1,SP 4 tra Galeata e Santa Sofia,5306,00,4966,340,4149,1157,5306,0
2019/01,344,15/01/2019,2,SS 3Bis/E 45 tra Borello e Mercato Saraceno,18163,160,13805,4342,14147,4016,18163,0
2019/01,344,16/01/2019,3,SS 3Bis/E 45 tra Borello e Mercato Saraceno,16940,60,13417,3517,13415,3525,16940,0
2019/01,344,17/01/2019,4,SS 3Bis/E 45 tra Borello e Mercato Saraceno,12700,00,11342,1358,9993,2707,12700,0
2019/01,344,18/01/2019,5,SS 3Bis/E 45 tra Borello e Mercato Saraceno,13168,10,12041,1126,10230,2938,13168,0
2019/01,344,19/01/2019,6,SS 3Bis/E 45 tra Borello e Mercato Saraceno,10869,00,10487,382,8015,2854,0,10869
2019/01,344,20/01/2019,7,SS 3Bis/E 45 tra Borello e Mercato Saraceno,9623,00,9511,112,7254,2369,0,9623
2019/01,344,21/01/2019,1,SS 3Bis/E 45 tra Borello e Mercato Saraceno,11327,00,10330,997,9175,2152,11327,0
2019/01,344,22/01/2019,2,SS 3Bis/E 45 tra Borello e Mercato Saraceno,9242,30,8318,921,7548,1694,9242,0
2019/01,344,23/01/2019,3,SS 3Bis/E 45 tra Borello e Mercato Saraceno,9454,00,8637,817,7509,1945,9454,0
2019/01,344,24/01/2019,4,SS 3Bis/E 45 tra Borello e Mercato Saraceno,10080,20,9302,776,7868,2212,10080,0
2019/01,344,25/01/2019,5,SS 3Bis/E 45 tra Borello e Mercato Saraceno,12174,00,11335,839,9370,2804,12174,0
2019/01,344,26/01/2019,6,SS 3Bis/E 45 tra Borello e Mercato Saraceno,11479,00,11184,295,8624,2855,0,11479
2019/01,344,27/01/2019,7,SS 3Bis/E 45 tra Borello e Mercato Saraceno,10429,00,10344,85,8095,2334,0,10429
2019/01,344,28/01/2019,1,SS 3Bis/E 45 tra Borello e Mercato Saraceno,11205,10,10371,833,9051,2154,11205,0
2019/01,348,15/01/2019,2,SP 10 dal bivio con SP 89 (San Mauro Pascoli) c/o A 14  al bivio SS 16 (San Mauro Mare),,,,,,,,
2019/01,348,16/01/2019,3,SP 10 dal bivio con SP 89 (San Mauro Pascoli) c/o A 14  al bivio SS 16 (San Mauro Mare),,,,,,,,
2019/01,348,17/01/2019,4,SP 10 dal bivio con SP 89 (San Mauro Pascoli) c/o A 14  al bivio SS 16 (San Mauro Mare),,,,,,,,
2019/01,348,18/01/2019,5,SP 10 dal bivio con SP 89 (San Mauro Pascoli) c/o A 14  al bivio SS 16 (San Mauro Mare),,,,,,,,
2019/01,348,19/01/2019,6,SP 10 dal bivio con SP 89 (San Mauro Pascoli) c/o A 14  al bivio SS 16 (San Mauro Mare),,,,,,,,
2019/01,348,20/01/2019,7,SP 10 dal bivio con SP 89 (San Mauro Pascoli) c/o A 14  al bivio SS 16 (San Mauro Mare),,,,,,,,
2019/01,348,21/01/2019,1,SP 10 dal bivio con SP 89 (San Mauro Pascoli) c/o A 14  al bivio SS 16 (San Mauro Mare),,,,,,,,
2019/01,348,22/01/2019,2,SP 10 dal bivio con SP 89 (San Mauro Pascoli) c/o A 14  al bivio SS 16 (San Mauro Mare),,,,,,,,
2019/01,348,23/01/2019,3,SP 10 dal bivio con SP 89 (San Mauro Pascoli) c/o A 14  al bivio SS 16 (San Mauro Mare),,,,,,,,
2019/01,348,24/01/2019,4,SP 10 dal bivio con SP 89 (San Mauro Pascoli) c/o A 14  al bivio SS 16 (San Mauro Mare),,,,,,,,
2019/01,348,25/01/2019,5,SP 10 dal bivio con SP 89 (San Mauro Pascoli) c/o A 14  al bivio SS 16 (San Mauro Mare),,,,,,,,
2019/01,348,26/01/2019,6,SP 10 dal bivio con SP 89 (San Mauro Pascoli) c/o A 14  al bivio SS 16 (San Mauro Mare),,,,,,,,
2019/01,348,27/01/2019,7,SP 10 dal bivio con SP 89 (San Mauro Pascoli) c/o A 14  al bivio SS 16 (San Mauro Mare),,,,,,,,
2019/01,348,28/01/2019,1,SP 10 dal bivio con SP 89 (San Mauro Pascoli) c/o A 14  al bivio SS 16 (San Mauro Mare),,,,,,,,
2019/01,349,15/01/2019,2,SS 16 tra Cervia e Cesenatico,18728,10,16668,2059,14645,4083,18728,0
2019/01,349,16/01/2019,3,SS 16 tra Cervia e Cesenatico,19044,00,16971,2073,14896,4148,19044,0
2019/01,349,17/01/2019,4,SS 16 tra Cervia e Cesenatico,19909,30,17687,2219,15314,4595,19909,0
2019/01,349,18/01/2019,5,SS 16 tra Cervia e Cesenatico,20981,10,18901,2079,15713,5268,20981,0
2019/01,349,19/01/2019,6,SS 16 tra Cervia e Cesenatico,21146,10,20572,573,14352,6794,0,21146
2019/01,349,20/01/2019,7,SS 16 tra Cervia e Cesenatico,21408,00,21234,174,14892,6516,0,21408
2019/01,349,21/01/2019,1,SS 16 tra Cervia e Cesenatico,19951,10,18018,1932,15455,4496,19951,0
2019/01,349,22/01/2019,2,SS 16 tra Cervia e Cesenatico,17489,00,15528,1961,13922,3567,17489,0
2019/01,349,23/01/2019,3,SS 16 tra Cervia e Cesenatico,18150,00,16222,1928,14268,3882,18150,0
2019/01,349,24/01/2019,4,SS 16 tra Cervia e Cesenatico,19187,00,17094,2093,14749,4438,19187,0
2019/01,349,25/01/2019,5,SS 16 tra Cervia e Cesenatico,20609,00,18675,1934,15367,5242,20609,0
2019/01,349,26/01/2019,6,SS 16 tra Cervia e Cesenatico,20728,10,20207,520,14227,6501,0,20728
2019/01,349,27/01/2019,7,SS 16 tra Cervia e Cesenatico,19798,00,19660,138,14310,5488,0,19798
2019/01,349,28/01/2019,1,SS 16 tra Cervia e Cesenatico,18483,00,16474,2009,14503,3980,18483,0
2019/01,351,15/01/2019,2,SS 72 tra Rimini e  San Marino,,,,,,,,
2019/01,351,16/01/2019,3,SS 72 tra Rimini e  San Marino,,,,,,,,
2019/01,351,17/01/2019,4,SS 72 tra Rimini e  San Marino,,,,,,,,
2019/01,351,18/01/2019,5,SS 72 tra Rimini e  San Marino,,,,,,,,
2019/01,351,19/01/2019,6,SS 72 tra Rimini e  San Marino,,,,,,,,
2019/01,351,20/01/2019,7,SS 72 tra Rimini e  San Marino,,,,,,,,
2019/01,351,21/01/2019,1,SS 72 tra Rimini e  San Marino,,,,,,,,
2019/01,351,22/01/2019,2,SS 72 tra Rimini e  San Marino,,,,,,,,
2019/01,351,23/01/2019,3,SS 72 tra Rimini e  San Marino,,,,,,,,
2019/01,351,24/01/2019,4,SS 72 tra Rimini e  San Marino,,,,,,,,
2019/01,351,25/01/2019,5,SS 72 tra Rimini e  San Marino,,,,,,,,
2019/01,351,26/01/2019,6,SS 72 tra Rimini e  San Marino,,,,,,,,
2019/01,351,27/01/2019,7,SS 72 tra Rimini e  San Marino,,,,,,,,
2019/01,351,28/01/2019,1,SS 72 tra Rimini e  San Marino,,,,,,,,
2019/01,354,15/01/2019,2,SP 31 tra Viadotto A 14 e Coriano,12210,10,11886,323,9804,2406,12210,0
2019/01,354,16/01/2019,3,SP 31 tra Viadotto A 14 e Coriano,12314,00,11985,329,9877,2437,12314,0
2019/01,354,17/01/2019,4,SP 31 tra Viadotto A 14 e Coriano,12379,30,12016,360,9790,2589,12379,0
2019/01,354,18/01/2019,5,SP 31 tra Viadotto A 14 e Coriano,12525,00,12242,283,9734,2791,12525,0
2019/01,354,19/01/2019,6,SP 31 tra Viadotto A 14 e Coriano,11592,00,11491,101,8253,3339,0,11592
2019/01,354,20/01/2019,7,SP 31 tra Viadotto A 14 e Coriano,9711,10,9683,27,6780,2931,0,9711
2019/01,354,21/01/2019,1,SP 31 tra Viadotto A 14 e Coriano,12021,20,11736,283,9691,2330,12021,0
2019/01,354,22/01/2019,2,SP 31 tra Viadotto A 14 e Coriano,10460,00,10172,288,8404,2056,10460,0
2019/01,354,23/01/2019,3,SP 31 tra Viadotto A 14 e Coriano,11721,10,11452,268,9345,2376,11721,0
2019/01,354,24/01/2019,4,SP 31 tra Viadotto A 14 e Coriano,11712,20,11416,294,9269,2443,11712,0
2019/01,354,25/01/2019,5,SP 31 tra Viadotto A 14 e Coriano,12631,20,12308,321,9802,2829,12631,0
2019/01,354,26/01/2019,6,SP 31 tra Viadotto A 14 e Coriano,11400,00,11267,133,8244,3156,0,11400
2019/01,354,27/01/2019,7,SP 31 tra Viadotto A 14 e Coriano,9537,10,9509,27,6762,2775,0,9537
2019/01,354,28/01/2019,1,SP 31 tra Viadotto A 14 e Coriano,12174,00,11847,327,9842,2332,12174,0
2019/01,355,15/01/2019,2,SP 17V tra San Giovanni in Marignano e Morciano di Romagna (variante),15172,00,14434,738,12184,2988,15172,0
2019/01,355,16/01/2019,3,SP 17V tra San Giovanni in Marignano e Morciano di Romagna (variante),15789,00,15124,665,12838,2951,15789,0
2019/01,355,17/01/2019,4,SP 17V tra San Giovanni in Marignano e Morciano di Romagna (variante),15932,00,15242,690,12813,3119,15932,0
2019/01,355,18/01/2019,5,SP 17V tra San Giovanni in Marignano e Morciano di Romagna (variante),14877,00,14296,581,11735,3142,14877,0
2019/01,355,19/01/2019,6,SP 17V tra San Giovanni in Marignano e Morciano di Romagna (variante),12574,00,12447,127,9443,3131,0,12574
2019/01,355,20/01/2019,7,SP 17V tra San Giovanni in Marignano e Morciano di Romagna (variante),9434,00,9394,40,6883,2551,0,9434
2019/01,355,21/01/2019,1,SP 17V tra San Giovanni in Marignano e Morciano di Romagna (variante),14645,00,13940,705,11995,2650,14645,0
2019/01,355,22/01/2019,2,SP 17V tra San Giovanni in Marignano e Morciano di Romagna (variante),12463,00,11770,693,10199,2264,12463,0
2019/01,355,23/01/2019,3,SP 17V tra San Giovanni in Marignano e Morciano di Romagna (variante),13923,00,13437,486,11283,2640,13923,0
2019/01,355,24/01/2019,4,SP 17V tra San Giovanni in Marignano e Morciano di Romagna (variante),14673,00,14038,635,11834,2839,14673,0
2019/01,355,25/01/2019,5,SP 17V tra San Giovanni in Marignano e Morciano di Romagna (variante),15894,00,15306,588,12626,3268,15894,0
2019/01,355,26/01/2019,6,SP 17V tra San Giovanni in Marignano e Morciano di Romagna (variante),13497,00,13360,137,10318,3179,0,13497
2019/01,355,27/01/2019,7,SP 17V tra San Giovanni in Marignano e Morciano di Romagna (variante),10098,00,10070,28,7456,2642,0,10098
2019/01,355,28/01/2019,1,SP 17V tra San Giovanni in Marignano e Morciano di Romagna (variante),15085,00,14433,652,12342,2743,15085,0
2019/01,356,15/01/2019,2,SP 2 fra Reggiolo c/o bivio variante nord e confine regionale,7375,00,6464,911,5875,1500,7375,0
2019/01,356,16/01/2019,3,SP 2 fra Reggiolo c/o bivio variante nord e confine regionale,7444,00,6503,941,5961,1483,7444,0
2019/01,356,17/01/2019,4,SP 2 fra Reggiolo c/o bivio variante nord e confine regionale,7443,00,6564,879,5900,1543,7443,0
2019/01,356,18/01/2019,5,SP 2 fra Reggiolo c/o bivio variante nord e confine regionale,7820,00,6894,926,6080,1740,7820,0
2019/01,356,19/01/2019,6,SP 2 fra Reggiolo c/o bivio variante nord e confine regionale,6229,00,6081,148,4504,1725,0,6229
2019/01,356,20/01/2019,7,SP 2 fra Reggiolo c/o bivio variante nord e confine regionale,5092,00,5034,58,3609,1483,0,5092
2019/01,356,21/01/2019,1,SP 2 fra Reggiolo c/o bivio variante nord e confine regionale,6909,00,6036,873,5486,1423,6909,0
2019/01,356,22/01/2019,2,SP 2 fra Reggiolo c/o bivio variante nord e confine regionale,7312,00,6340,972,5849,1463,7312,0
2019/01,356,23/01/2019,3,SP 2 fra Reggiolo c/o bivio variante nord e confine regionale,7278,00,6342,936,5833,1445,7278,0
2019/01,356,24/01/2019,4,SP 2 fra Reggiolo c/o bivio variante nord e confine regionale,7272,00,6396,876,5817,1455,7272,0
2019/01,356,25/01/2019,5,SP 2 fra Reggiolo c/o bivio variante nord e confine regionale,7781,00,6816,965,5998,1783,7781,0
2019/01,356,26/01/2019,6,SP 2 fra Reggiolo c/o bivio variante nord e confine regionale,6226,00,6038,188,4385,1841,0,6226
2019/01,356,27/01/2019,7,SP 2 fra Reggiolo c/o bivio variante nord e confine regionale,4492,00,4443,49,3111,1381,0,4492
2019/01,356,28/01/2019,1,SP 2 fra Reggiolo c/o bivio variante nord e confine regionale,7069,10,6201,867,5724,1345,7069,0
2019/01,357,15/01/2019,2,SP 306R fra Casola Valsenio e bivio SP 65 c/o località Isola,3427,30,3029,395,2860,567,3427,0
2019/01,357,16/01/2019,3,SP 306R fra Casola Valsenio e bivio SP 65 c/o località Isola,3285,10,2933,351,2671,614,3285,0
2019/01,357,17/01/2019,4,SP 306R fra Casola Valsenio e bivio SP 65 c/o località Isola,3434,10,3062,371,2761,673,3434,0
2019/01,357,18/01/2019,5,SP 306R fra Casola Valsenio e bivio SP 65 c/o località Isola,3383,10,3010,372,2677,706,3383,0
2019/01,357,19/01/2019,6,SP 306R fra Casola Valsenio e bivio SP 65 c/o località Isola,2847,00,2742,105,2151,696,0,2847
2019/01,357,20/01/2019,7,SP 306R fra Casola Valsenio e bivio SP 65 c/o località Isola,2641,00,2634,7,2085,556,0,2641
2019/01,357,21/01/2019,1,SP 306R fra Casola Valsenio e bivio SP 65 c/o località Isola,3070,00,2771,299,2497,573,3070,0
2019/01,357,22/01/2019,2,SP 306R fra Casola Valsenio e bivio SP 65 c/o località Isola,2958,00,2691,267,2482,476,2958,0
2019/01,357,23/01/2019,3,SP 306R fra Casola Valsenio e bivio SP 65 c/o località Isola,2994,00,2640,354,2496,498,2994,0
2019/01,357,24/01/2019,4,SP 306R fra Casola Valsenio e bivio SP 65 c/o località Isola,2642,20,2374,266,2104,538,2642,0
2019/01,357,25/01/2019,5,SP 306R fra Casola Valsenio e bivio SP 65 c/o località Isola,3242,00,2942,300,2595,647,3242,0
2019/01,357,26/01/2019,6,SP 306R fra Casola Valsenio e bivio SP 65 c/o località Isola,2795,00,2711,84,2110,685,0,2795
2019/01,357,27/01/2019,7,SP 306R fra Casola Valsenio e bivio SP 65 c/o località Isola,2685,00,2678,7,2177,508,0,2685
2019/01,357,28/01/2019,1,SP 306R fra Casola Valsenio e bivio SP 65 c/o località Isola,3115,00,2835,280,2540,575,3115,0
2019/01,376,15/01/2019,2,SP 68 tra Portomaggiore e la Superstrada Ferrara-Mare,3181,00,3014,167,2595,586,3181,0
2019/01,376,16/01/2019,3,SP 68 tra Portomaggiore e la Superstrada Ferrara-Mare,3118,10,2945,172,2543,575,3118,0
2019/01,376,17/01/2019,4,SP 68 tra Portomaggiore e la Superstrada Ferrara-Mare,3120,00,2950,170,2542,578,3120,0
2019/01,376,18/01/2019,5,SP 68 tra Portomaggiore e la Superstrada Ferrara-Mare,3285,00,3131,154,2648,637,3285,0
2019/01,376,19/01/2019,6,SP 68 tra Portomaggiore e la Superstrada Ferrara-Mare,2577,00,2483,94,1907,670,0,2577
2019/01,376,20/01/2019,7,SP 68 tra Portomaggiore e la Superstrada Ferrara-Mare,1933,00,1925,8,1456,477,0,1933
2019/01,376,21/01/2019,1,SP 68 tra Portomaggiore e la Superstrada Ferrara-Mare,3000,00,2823,177,2417,583,3000,0
2019/01,376,22/01/2019,2,SP 68 tra Portomaggiore e la Superstrada Ferrara-Mare,3105,00,2932,173,2506,599,3105,0
2019/01,376,23/01/2019,3,SP 68 tra Portomaggiore e la Superstrada Ferrara-Mare,3042,10,2858,183,2440,602,3042,0
2019/01,376,24/01/2019,4,SP 68 tra Portomaggiore e la Superstrada Ferrara-Mare,3172,00,2992,180,2606,566,3172,0
2019/01,376,25/01/2019,5,SP 68 tra Portomaggiore e la Superstrada Ferrara-Mare,3245,10,3067,177,2603,642,3245,0
2019/01,376,26/01/2019,6,SP 68 tra Portomaggiore e la Superstrada Ferrara-Mare,2720,00,2639,81,2061,659,0,2720
2019/01,376,27/01/2019,7,SP 68 tra Portomaggiore e la Superstrada Ferrara-Mare,1960,00,1954,6,1497,463,0,1960
2019/01,376,28/01/2019,1,SP 68 tra Portomaggiore e la Superstrada Ferrara-Mare,2933,00,2753,180,2408,525,2933,0
2019/01,377,15/01/2019,2,SP 18 tra Bondeno e il confine regionale (Lombardia),5142,00,4691,451,4185,957,5142,0
2019/01,377,16/01/2019,3,SP 18 tra Bondeno e il confine regionale (Lombardia),5015,10,4618,396,4045,970,5015,0
2019/01,377,17/01/2019,4,SP 18 tra Bondeno e il confine regionale (Lombardia),4965,10,4557,407,4018,947,4965,0
2019/01,377,18/01/2019,5,SP 18 tra Bondeno e il confine regionale (Lombardia),5358,10,4899,458,4207,1151,5358,0
2019/01,377,19/01/2019,6,SP 18 tra Bondeno e il confine regionale (Lombardia),4045,10,3967,77,2965,1080,0,4045
2019/01,377,20/01/2019,7,SP 18 tra Bondeno e il confine regionale (Lombardia),3304,10,3276,27,2380,924,0,3304
2019/01,377,21/01/2019,1,SP 18 tra Bondeno e il confine regionale (Lombardia),4901,00,4500,401,3972,929,4901,0
2019/01,377,22/01/2019,2,SP 18 tra Bondeno e il confine regionale (Lombardia),5025,00,4600,425,4131,894,5025,0
2019/01,377,23/01/2019,3,SP 18 tra Bondeno e il confine regionale (Lombardia),4839,10,4473,365,3876,963,4839,0
2019/01,377,24/01/2019,4,SP 18 tra Bondeno e il confine regionale (Lombardia),4847,00,4463,384,3887,960,4847,0
2019/01,377,25/01/2019,5,SP 18 tra Bondeno e il confine regionale (Lombardia),5054,10,4694,359,4002,1052,5054,0
2019/01,377,26/01/2019,6,SP 18 tra Bondeno e il confine regionale (Lombardia),4205,00,4130,75,3119,1086,0,4205
2019/01,377,27/01/2019,7,SP 18 tra Bondeno e il confine regionale (Lombardia),3172,00,3150,22,2304,868,0,3172
2019/01,377,28/01/2019,1,SP 18 tra Bondeno e il confine regionale (Lombardia),4818,10,4450,367,3917,901,4818,0
2019/01,381,19/01/2019,6,SS 724 Tangenziale nord di Modena,,,,,,,,
2019/01,381,20/01/2019,7,SS 724 Tangenziale nord di Modena,,,,,,,,
2019/01,381,21/01/2019,1,SS 724 Tangenziale nord di Modena,,,,,,,,
2019/01,381,22/01/2019,2,SS 724 Tangenziale nord di Modena,,,,,,,,
2019/01,381,23/01/2019,3,SS 724 Tangenziale nord di Modena,,,,,,,,
2019/01,381,24/01/2019,4,SS 724 Tangenziale nord di Modena,,,,,,,,
2019/01,381,25/01/2019,5,SS 724 Tangenziale nord di Modena,,,,,,,,
2019/01,381,26/01/2019,6,SS 724 Tangenziale nord di Modena,,,,,,,,
2019/01,381,27/01/2019,7,SS 724 Tangenziale nord di Modena,,,,,,,,
2019/01,381,28/01/2019,1,SS 724 Tangenziale nord di Modena,,,,,,,,
2019/01,383,15/01/2019,2,SS 722 Tangenziale nord di Reggio Emilia,32953,90,29140,3804,26566,6387,32953,0
2019/01,383,16/01/2019,3,SS 722 Tangenziale nord di Reggio Emilia,34078,110,30079,3988,27343,6735,34078,0
2019/01,383,17/01/2019,4,SS 722 Tangenziale nord di Reggio Emilia,33603,80,29513,4082,26938,6665,33603,0
2019/01,383,18/01/2019,5,SS 722 Tangenziale nord di Reggio Emilia,34407,160,30338,4053,27107,7300,34407,0
2019/01,383,19/01/2019,6,SS 722 Tangenziale nord di Reggio Emilia,25127,40,24357,766,18072,7055,0,25127
2019/01,383,20/01/2019,7,SS 722 Tangenziale nord di Reggio Emilia,20184,20,19993,189,14114,6070,0,20184
2019/01,383,21/01/2019,1,SS 722 Tangenziale nord di Reggio Emilia,31935,150,28169,3751,25845,6090,31935,0
2019/01,383,22/01/2019,2,SS 722 Tangenziale nord di Reggio Emilia,32990,70,29074,3909,26649,6341,32990,0
2019/01,383,23/01/2019,3,SS 722 Tangenziale nord di Reggio Emilia,32602,110,28741,3850,26443,6159,32602,0
2019/01,383,24/01/2019,4,SS 722 Tangenziale nord di Reggio Emilia,31178,90,27416,3753,25039,6139,31178,0
2019/01,383,25/01/2019,5,SS 722 Tangenziale nord di Reggio Emilia,33801,50,29906,3890,26496,7305,33801,0
2019/01,383,26/01/2019,6,SS 722 Tangenziale nord di Reggio Emilia,25810,30,25066,741,18605,7205,0,25810
2019/01,383,27/01/2019,7,SS 722 Tangenziale nord di Reggio Emilia,19612,10,19436,175,13726,5886,0,19612
2019/01,383,28/01/2019,1,SS 722 Tangenziale nord di Reggio Emilia,32231,20,28535,3694,26203,6028,32231,0
2019/01,385,15/01/2019,2,SP 10R fra Castel San Giovanni e Confine regionale (Lombardia),12944,10,11438,1505,10149,2795,12944,0
2019/01,385,16/01/2019,3,SP 10R fra Castel San Giovanni e Confine regionale (Lombardia),12311,00,11028,1283,9624,2687,12311,0
2019/01,385,17/01/2019,4,SP 10R fra Castel San Giovanni e Confine regionale (Lombardia),12791,00,11456,1335,9994,2797,12791,0
2019/01,385,18/01/2019,5,SP 10R fra Castel San Giovanni e Confine regionale (Lombardia),12992,00,11702,1290,9782,3210,12992,0
2019/01,385,19/01/2019,6,SP 10R fra Castel San Giovanni e Confine regionale (Lombardia),10485,10,10177,307,7777,2708,0,10485
2019/01,385,20/01/2019,7,SP 10R fra Castel San Giovanni e Confine regionale (Lombardia),8102,00,8019,83,5931,2171,0,8102
2019/01,385,21/01/2019,1,SP 10R fra Castel San Giovanni e Confine regionale (Lombardia),11824,00,10555,1269,9207,2617,11824,0
2019/01,385,22/01/2019,2,SP 10R fra Castel San Giovanni e Confine regionale (Lombardia),12090,00,10736,1354,9448,2642,12090,0
2019/01,385,23/01/2019,3,SP 10R fra Castel San Giovanni e Confine regionale (Lombardia),11556,00,10206,1350,9112,2444,11556,0
2019/01,385,24/01/2019,4,SP 10R fra Castel San Giovanni e Confine regionale (Lombardia),11717,00,10548,1169,9101,2616,11717,0
2019/01,385,25/01/2019,5,SP 10R fra Castel San Giovanni e Confine regionale (Lombardia),12889,00,11624,1265,9794,3095,12889,0
2019/01,385,26/01/2019,6,SP 10R fra Castel San Giovanni e Confine regionale (Lombardia),10383,00,10127,256,7608,2775,0,10383
2019/01,385,27/01/2019,7,SP 10R fra Castel San Giovanni e Confine regionale (Lombardia),7478,00,7388,90,5349,2129,0,7478
2019/01,385,28/01/2019,1,SP 10R fra Castel San Giovanni e Confine regionale (Lombardia),11800,00,10554,1246,9228,2572,11800,0
2019/01,388,15/01/2019,2,SP 31 fra bivio SP 12 in località Castelnuovo Fogliani e il confine provinciale,4522,00,4394,128,3727,795,4522,0
2019/01,388,16/01/2019,3,SP 31 fra bivio SP 12 in località Castelnuovo Fogliani e il confine provinciale,4313,00,4145,168,3481,832,4313,0
2019/01,388,17/01/2019,4,SP 31 fra bivio SP 12 in località Castelnuovo Fogliani e il confine provinciale,4386,00,4259,127,3575,811,4386,0
2019/01,388,18/01/2019,5,SP 31 fra bivio SP 12 in località Castelnuovo Fogliani e il confine provinciale,4653,00,4532,121,3621,1032,4653,0
2019/01,388,19/01/2019,6,SP 31 fra bivio SP 12 in località Castelnuovo Fogliani e il confine provinciale,4574,00,4523,51,3404,1170,0,4574
2019/01,388,20/01/2019,7,SP 31 fra bivio SP 12 in località Castelnuovo Fogliani e il confine provinciale,4085,00,4065,20,3254,831,0,4085
2019/01,388,21/01/2019,1,SP 31 fra bivio SP 12 in località Castelnuovo Fogliani e il confine provinciale,4253,00,4136,117,3446,807,4253,0
2019/01,388,22/01/2019,2,SP 31 fra bivio SP 12 in località Castelnuovo Fogliani e il confine provinciale,4446,00,4295,151,3704,742,4446,0
2019/01,388,23/01/2019,3,SP 31 fra bivio SP 12 in località Castelnuovo Fogliani e il confine provinciale,3933,00,3813,120,3281,652,3933,0
2019/01,388,24/01/2019,4,SP 31 fra bivio SP 12 in località Castelnuovo Fogliani e il confine provinciale,4056,10,3954,101,3203,853,4056,0
2019/01,388,25/01/2019,5,SP 31 fra bivio SP 12 in località Castelnuovo Fogliani e il confine provinciale,4639,00,4496,143,3688,951,4639,0
2019/01,388,26/01/2019,6,SP 31 fra bivio SP 12 in località Castelnuovo Fogliani e il confine provinciale,4491,00,4432,59,3386,1105,0,4491
2019/01,388,27/01/2019,7,SP 31 fra bivio SP 12 in località Castelnuovo Fogliani e il confine provinciale,3690,00,3674,16,2866,824,0,3690
2019/01,388,28/01/2019,1,SP 31 fra bivio SP 12 in località Castelnuovo Fogliani e il confine provinciale,4178,00,4040,138,3455,723,4178,0
2019/01,389,15/01/2019,2,SP 588R fra Villanova d’Arda e confine provinciale,3959,10,3586,372,3281,678,3959,0
2019/01,389,16/01/2019,3,SP 588R fra Villanova d’Arda e confine provinciale,3992,10,3598,393,3242,750,3992,0
2019/01,389,17/01/2019,4,SP 588R fra Villanova d’Arda e confine provinciale,4232,00,3744,488,3482,750,4232,0
2019/01,389,18/01/2019,5,SP 588R fra Villanova d’Arda e confine provinciale,4000,00,3630,370,3177,823,4000,0
2019/01,389,19/01/2019,6,SP 588R fra Villanova d’Arda e confine provinciale,3390,00,3314,76,2506,884,0,3390
2019/01,389,20/01/2019,7,SP 588R fra Villanova d’Arda e confine provinciale,3054,00,3026,28,2294,760,0,3054
2019/01,389,21/01/2019,1,SP 588R fra Villanova d’Arda e confine provinciale,3753,10,3402,350,3104,649,3753,0
2019/01,389,22/01/2019,2,SP 588R fra Villanova d’Arda e confine provinciale,3885,10,3509,375,3224,661,3885,0
2019/01,389,23/01/2019,3,SP 588R fra Villanova d’Arda e confine provinciale,3820,00,3456,364,3059,761,3820,0
2019/01,389,24/01/2019,4,SP 588R fra Villanova d’Arda e confine provinciale,3617,10,3268,348,2934,683,3617,0
2019/01,389,25/01/2019,5,SP 588R fra Villanova d’Arda e confine provinciale,3813,00,3502,311,2996,817,3813,0
2019/01,389,26/01/2019,6,SP 588R fra Villanova d’Arda e confine provinciale,3547,00,3449,98,2631,916,0,3547
2019/01,389,27/01/2019,7,SP 588R fra Villanova d’Arda e confine provinciale,3095,00,3053,42,2358,737,0,3095
2019/01,389,28/01/2019,1,SP 588R fra Villanova d’Arda e confine provinciale,3655,00,3304,351,2968,687,3655,0
2019/01,390,15/01/2019,2,SP 462R dal bivio SP 10R in località Monticelli a Cortemaggiore,2956,00,2796,160,2359,597,2956,0
2019/01,390,16/01/2019,3,SP 462R dal bivio SP 10R in località Monticelli a Cortemaggiore,2949,00,2797,152,2368,581,2949,0
2019/01,390,17/01/2019,4,SP 462R dal bivio SP 10R in località Monticelli a Cortemaggiore,3009,00,2808,201,2416,593,3009,0
2019/01,390,18/01/2019,5,SP 462R dal bivio SP 10R in località Monticelli a Cortemaggiore,3073,10,2934,138,2325,748,3073,0
2019/01,390,19/01/2019,6,SP 462R dal bivio SP 10R in località Monticelli a Cortemaggiore,2775,00,2726,49,2003,772,0,2775
2019/01,390,20/01/2019,7,SP 462R dal bivio SP 10R in località Monticelli a Cortemaggiore,2612,00,2590,22,2019,593,0,2612
2019/01,390,21/01/2019,1,SP 462R dal bivio SP 10R in località Monticelli a Cortemaggiore,2866,00,2741,125,2307,559,2866,0
2019/01,390,22/01/2019,2,SP 462R dal bivio SP 10R in località Monticelli a Cortemaggiore,2754,00,2623,131,2270,484,2754,0
2019/01,390,23/01/2019,3,SP 462R dal bivio SP 10R in località Monticelli a Cortemaggiore,2753,00,2606,147,2235,518,2753,0
2019/01,390,24/01/2019,4,SP 462R dal bivio SP 10R in località Monticelli a Cortemaggiore,2614,10,2467,146,2086,528,2614,0
2019/01,390,25/01/2019,5,SP 462R dal bivio SP 10R in località Monticelli a Cortemaggiore,3068,00,2897,171,2410,658,3068,0
2019/01,390,26/01/2019,6,SP 462R dal bivio SP 10R in località Monticelli a Cortemaggiore,2735,00,2668,67,1995,740,0,2735
2019/01,390,27/01/2019,7,SP 462R dal bivio SP 10R in località Monticelli a Cortemaggiore,2374,00,2346,28,1887,487,0,2374
2019/01,390,28/01/2019,1,SP 462R dal bivio SP 10R in località Monticelli a Cortemaggiore,2703,00,2563,140,2160,543,2703,0
2019/01,391,15/01/2019,2,SP 10R fra Castelvetro Piacentino e confine regionale (Lombardia),19972,00,19426,546,15737,4235,19972,0
2019/01,391,16/01/2019,3,SP 10R fra Castelvetro Piacentino e confine regionale (Lombardia),19972,00,19403,569,15630,4342,19972,0
2019/01,391,17/01/2019,4,SP 10R fra Castelvetro Piacentino e confine regionale (Lombardia),19807,00,19260,547,15513,4294,19807,0
2019/01,391,18/01/2019,5,SP 10R fra Castelvetro Piacentino e confine regionale (Lombardia),21147,00,20598,549,15852,5295,21147,0
2019/01,391,19/01/2019,6,SP 10R fra Castelvetro Piacentino e confine regionale (Lombardia),21250,00,21033,217,15170,6080,0,21250
2019/01,391,20/01/2019,7,SP 10R fra Castelvetro Piacentino e confine regionale (Lombardia),18496,00,18422,74,13678,4818,0,18496
2019/01,391,21/01/2019,1,SP 10R fra Castelvetro Piacentino e confine regionale (Lombardia),19040,10,18532,507,15117,3923,19040,0
2019/01,391,22/01/2019,2,SP 10R fra Castelvetro Piacentino e confine regionale (Lombardia),19386,30,18866,517,15367,4019,19386,0
2019/01,391,23/01/2019,3,SP 10R fra Castelvetro Piacentino e confine regionale (Lombardia),19563,00,19029,534,15434,4129,19563,0
2019/01,391,24/01/2019,4,SP 10R fra Castelvetro Piacentino e confine regionale (Lombardia),19244,10,18754,489,15072,4172,19244,0
2019/01,391,25/01/2019,5,SP 10R fra Castelvetro Piacentino e confine regionale (Lombardia),21592,00,21092,500,16168,5424,21592,0
2019/01,391,26/01/2019,6,SP 10R fra Castelvetro Piacentino e confine regionale (Lombardia),20576,00,20365,211,14607,5969,0,20576
2019/01,391,27/01/2019,7,SP 10R fra Castelvetro Piacentino e confine regionale (Lombardia),16932,00,16847,85,12459,4473,0,16932
2019/01,391,28/01/2019,1,SP 10R fra Castelvetro Piacentino e confine regionale (Lombardia),19265,00,18772,493,15161,4104,19265,0
2019/01,393,15/01/2019,2,SP 10R fra Caorso e Roncaglia,11215,20,9620,1593,8797,2418,11215,0
2019/01,393,16/01/2019,3,SP 10R fra Caorso e Roncaglia,11417,00,9718,1699,8898,2519,11417,0
2019/01,393,17/01/2019,4,SP 10R fra Caorso e Roncaglia,11127,00,9563,1564,8656,2471,11127,0
2019/01,393,18/01/2019,5,SP 10R fra Caorso e Roncaglia,11335,10,9954,1380,8628,2707,11335,0
2019/01,393,19/01/2019,6,SP 10R fra Caorso e Roncaglia,8518,10,8227,290,5984,2534,0,8518
2019/01,393,20/01/2019,7,SP 10R fra Caorso e Roncaglia,6694,00,6633,61,4729,1965,0,6694
2019/01,393,21/01/2019,1,SP 10R fra Caorso e Roncaglia,10963,00,9444,1519,8690,2273,10963,0
2019/01,393,22/01/2019,2,SP 10R fra Caorso e Roncaglia,10815,10,9259,1555,8542,2273,10815,0
2019/01,393,23/01/2019,3,SP 10R fra Caorso e Roncaglia,10885,30,9347,1535,8539,2346,10885,0
2019/01,393,24/01/2019,4,SP 10R fra Caorso e Roncaglia,10862,20,9337,1523,8467,2395,10862,0
2019/01,393,25/01/2019,5,SP 10R fra Caorso e Roncaglia,11459,00,10124,1335,8815,2644,11459,0
2019/01,393,26/01/2019,6,SP 10R fra Caorso e Roncaglia,8534,00,8193,341,6046,2488,0,8534
2019/01,393,27/01/2019,7,SP 10R fra Caorso e Roncaglia,6720,00,6667,53,4905,1815,0,6720
2019/01,393,28/01/2019,1,SP 10R fra Caorso e Roncaglia,10597,10,9211,1385,8401,2196,10597,0
2019/01,394,15/01/2019,2,SP 523R da Roccamurata (bivio SP 308R) a Borgo Val di Taro,4318,00,3957,361,3458,860,4318,0
2019/01,394,16/01/2019,3,SP 523R da Roccamurata (bivio SP 308R) a Borgo Val di Taro,4505,00,4100,405,3655,850,4505,0
2019/01,394,17/01/2019,4,SP 523R da Roccamurata (bivio SP 308R) a Borgo Val di Taro,4469,00,4081,388,3557,912,4469,0
2019/01,394,18/01/2019,5,SP 523R da Roccamurata (bivio SP 308R) a Borgo Val di Taro,4656,00,4275,381,3629,1027,4656,0
2019/01,394,19/01/2019,6,SP 523R da Roccamurata (bivio SP 308R) a Borgo Val di Taro,3567,00,3455,112,2779,788,0,3567
2019/01,394,20/01/2019,7,SP 523R da Roccamurata (bivio SP 308R) a Borgo Val di Taro,3200,00,3171,29,2443,757,0,3200
2019/01,394,21/01/2019,1,SP 523R da Roccamurata (bivio SP 308R) a Borgo Val di Taro,4746,00,4345,401,3859,887,4746,0
2019/01,394,22/01/2019,2,SP 523R da Roccamurata (bivio SP 308R) a Borgo Val di Taro,4624,00,4195,429,3714,910,4624,0
2019/01,394,23/01/2019,3,SP 523R da Roccamurata (bivio SP 308R) a Borgo Val di Taro,3954,00,3580,374,3256,698,3954,0
2019/01,394,24/01/2019,4,SP 523R da Roccamurata (bivio SP 308R) a Borgo Val di Taro,3677,10,3386,290,2865,812,3677,0
2019/01,394,25/01/2019,5,SP 523R da Roccamurata (bivio SP 308R) a Borgo Val di Taro,4682,00,4234,448,3636,1046,4682,0
2019/01,394,26/01/2019,6,SP 523R da Roccamurata (bivio SP 308R) a Borgo Val di Taro,3684,00,3574,110,2857,827,0,3684
2019/01,394,27/01/2019,7,SP 523R da Roccamurata (bivio SP 308R) a Borgo Val di Taro,2752,00,2724,28,2072,680,0,2752
2019/01,394,28/01/2019,1,SP 523R da Roccamurata (bivio SP 308R) a Borgo Val di Taro,4596,00,4206,390,3681,915,4596,0
2019/01,395,15/01/2019,2,SP 308R da Fornovo di Taro (bivio SS 62) a Solignano,4343,00,4114,229,3486,857,4343,0
2019/01,395,16/01/2019,3,SP 308R da Fornovo di Taro (bivio SS 62) a Solignano,4207,00,3982,225,3374,833,4207,0
2019/01,395,17/01/2019,4,SP 308R da Fornovo di Taro (bivio SS 62) a Solignano,4099,00,3889,210,3227,872,4099,0
2019/01,395,18/01/2019,5,SP 308R da Fornovo di Taro (bivio SS 62) a Solignano,4266,00,4055,211,3328,938,4266,0
2019/01,395,19/01/2019,6,SP 308R da Fornovo di Taro (bivio SS 62) a Solignano,3445,00,3382,63,2647,798,0,3445
2019/01,395,20/01/2019,7,SP 308R da Fornovo di Taro (bivio SS 62) a Solignano,3037,00,3014,23,2342,695,0,3037
2019/01,395,21/01/2019,1,SP 308R da Fornovo di Taro (bivio SS 62) a Solignano,4220,00,3988,232,3361,859,4220,0
2019/01,395,22/01/2019,2,SP 308R da Fornovo di Taro (bivio SS 62) a Solignano,4301,10,4097,203,3467,834,4301,0
2019/01,395,23/01/2019,3,SP 308R da Fornovo di Taro (bivio SS 62) a Solignano,3619,00,3462,157,2931,688,3619,0
2019/01,395,24/01/2019,4,SP 308R da Fornovo di Taro (bivio SS 62) a Solignano,3395,10,3255,139,2640,755,3395,0
2019/01,395,25/01/2019,5,SP 308R da Fornovo di Taro (bivio SS 62) a Solignano,4326,00,4143,183,3347,979,4326,0
2019/01,395,26/01/2019,6,SP 308R da Fornovo di Taro (bivio SS 62) a Solignano,3469,00,3411,58,2696,773,0,3469
2019/01,395,27/01/2019,7,SP 308R da Fornovo di Taro (bivio SS 62) a Solignano,2751,00,2733,18,2116,635,0,2751
2019/01,395,28/01/2019,1,SP 308R da Fornovo di Taro (bivio SS 62) a Solignano,4044,00,3855,189,3179,865,4044,0
2019/01,396,15/01/2019,2,SP 28 fra Fornovo di Taro e Varano de Melegari centro abitato Viazzano,7690,00,7385,305,6299,1391,7690,0
2019/01,396,16/01/2019,3,SP 28 fra Fornovo di Taro e Varano de Melegari centro abitato Viazzano,7350,00,7063,287,6003,1347,7350,0
2019/01,396,17/01/2019,4,SP 28 fra Fornovo di Taro e Varano de Melegari centro abitato Viazzano,7530,00,7223,307,6123,1407,7530,0
2019/01,396,18/01/2019,5,SP 28 fra Fornovo di Taro e Varano de Melegari centro abitato Viazzano,7721,10,7440,280,6176,1545,7721,0
2019/01,396,19/01/2019,6,SP 28 fra Fornovo di Taro e Varano de Melegari centro abitato Viazzano,5994,00,5891,103,4683,1311,0,5994
2019/01,396,20/01/2019,7,SP 28 fra Fornovo di Taro e Varano de Melegari centro abitato Viazzano,5218,00,5177,41,4133,1085,0,5218
2019/01,396,21/01/2019,1,SP 28 fra Fornovo di Taro e Varano de Melegari centro abitato Viazzano,7268,00,6987,281,5906,1362,7268,0
2019/01,396,22/01/2019,2,SP 28 fra Fornovo di Taro e Varano de Melegari centro abitato Viazzano,7866,00,7571,295,6389,1477,7866,0
2019/01,396,23/01/2019,3,SP 28 fra Fornovo di Taro e Varano de Melegari centro abitato Viazzano,7074,00,6800,274,5857,1217,7074,0
2019/01,396,24/01/2019,4,SP 28 fra Fornovo di Taro e Varano de Melegari centro abitato Viazzano,6712,00,6502,210,5398,1314,6712,0
2019/01,396,25/01/2019,5,SP 28 fra Fornovo di Taro e Varano de Melegari centro abitato Viazzano,7727,00,7422,305,6180,1547,7727,0
2019/01,396,26/01/2019,6,SP 28 fra Fornovo di Taro e Varano de Melegari centro abitato Viazzano,5965,00,5858,107,4687,1278,0,5965
2019/01,396,27/01/2019,7,SP 28 fra Fornovo di Taro e Varano de Melegari centro abitato Viazzano,4896,00,4862,34,3909,987,0,4896
2019/01,396,28/01/2019,1,SP 28 fra Fornovo di Taro e Varano de Melegari centro abitato Viazzano,7209,00,6942,267,5935,1274,7209,0
2019/01,397,24/01/2019,4,SP 12 fra casello A 1 e Fidenza,,,,,,,,
2019/01,397,25/01/2019,5,SP 12 fra casello A 1 e Fidenza,,,,,,,,
2019/01,397,26/01/2019,6,SP 12 fra casello A 1 e Fidenza,,,,,,,,
2019/01,397,27/01/2019,7,SP 12 fra casello A 1 e Fidenza,,,,,,,,
2019/01,397,28/01/2019,1,SP 12 fra casello A 1 e Fidenza,,,,,,,,
2019/01,398,15/01/2019,2,SP 11 tra Fontevivo e Cispadana (tangenziale),,,,,,,,
2019/01,398,16/01/2019,3,SP 11 tra Fontevivo e Cispadana (tangenziale),,,,,,,,
2019/01,398,17/01/2019,4,SP 11 tra Fontevivo e Cispadana (tangenziale),,,,,,,,
2019/01,398,18/01/2019,5,SP 11 tra Fontevivo e Cispadana (tangenziale),,,,,,,,
2019/01,398,19/01/2019,6,SP 11 tra Fontevivo e Cispadana (tangenziale),,,,,,,,
2019/01,398,20/01/2019,7,SP 11 tra Fontevivo e Cispadana (tangenziale),,,,,,,,
2019/01,398,21/01/2019,1,SP 11 tra Fontevivo e Cispadana (tangenziale),,,,,,,,
2019/01,398,22/01/2019,2,SP 11 tra Fontevivo e Cispadana (tangenziale),,,,,,,,
2019/01,398,23/01/2019,3,SP 11 tra Fontevivo e Cispadana (tangenziale),,,,,,,,
2019/01,398,24/01/2019,4,SP 11 tra Fontevivo e Cispadana (tangenziale),,,,,,,,
2019/01,398,25/01/2019,5,SP 11 tra Fontevivo e Cispadana (tangenziale),,,,,,,,
2019/01,398,26/01/2019,6,SP 11 tra Fontevivo e Cispadana (tangenziale),,,,,,,,
2019/01,398,27/01/2019,7,SP 11 tra Fontevivo e Cispadana (tangenziale),,,,,,,,
2019/01,398,28/01/2019,1,SP 11 tra Fontevivo e Cispadana (tangenziale),,,,,,,,
2019/01,401,15/01/2019,2,SP 513R fra Traversetolo e confine provinciale,7192,10,6623,568,5866,1326,7192,0
2019/01,401,16/01/2019,3,SP 513R fra Traversetolo e confine provinciale,7037,20,6435,600,5757,1280,7037,0
2019/01,401,17/01/2019,4,SP 513R fra Traversetolo e confine provinciale,7035,00,6467,568,5747,1288,7035,0
2019/01,401,18/01/2019,5,SP 513R fra Traversetolo e confine provinciale,7392,10,6827,564,6000,1392,7392,0
2019/01,401,19/01/2019,6,SP 513R fra Traversetolo e confine provinciale,6091,20,5944,145,4677,1414,0,6091
2019/01,401,20/01/2019,7,SP 513R fra Traversetolo e confine provinciale,6404,00,6368,36,5270,1134,0,6404
2019/01,401,21/01/2019,1,SP 513R fra Traversetolo e confine provinciale,6734,20,6187,545,5549,1185,6734,0
2019/01,401,22/01/2019,2,SP 513R fra Traversetolo e confine provinciale,6802,00,6216,586,5634,1168,6802,0
2019/01,401,23/01/2019,3,SP 513R fra Traversetolo e confine provinciale,6605,20,6029,574,5493,1112,6605,0
2019/01,401,24/01/2019,4,SP 513R fra Traversetolo e confine provinciale,5930,00,5455,475,4824,1106,5930,0
2019/01,401,25/01/2019,5,SP 513R fra Traversetolo e confine provinciale,7289,00,6622,667,5799,1490,7289,0
2019/01,401,26/01/2019,6,SP 513R fra Traversetolo e confine provinciale,6393,00,6200,193,4956,1437,0,6393
2019/01,401,27/01/2019,7,SP 513R fra Traversetolo e confine provinciale,5876,00,5830,46,4807,1069,0,5876
2019/01,401,28/01/2019,1,SP 513R fra Traversetolo e confine provinciale,6562,10,5976,585,5439,1123,6562,0
2019/01,402,15/01/2019,2,SP 18 da Pilastrello (bivio SP 513R) al bivio per la Pedemontana,13615,00,13321,294,10983,2632,13615,0
2019/01,402,16/01/2019,3,SP 18 da Pilastrello (bivio SP 513R) al bivio per la Pedemontana,13607,00,13296,311,10949,2658,13607,0
2019/01,402,17/01/2019,4,SP 18 da Pilastrello (bivio SP 513R) al bivio per la Pedemontana,13914,10,13589,324,11222,2692,13914,0
2019/01,402,18/01/2019,5,SP 18 da Pilastrello (bivio SP 513R) al bivio per la Pedemontana,13807,00,13493,314,10870,2937,13807,0
2019/01,402,19/01/2019,6,SP 18 da Pilastrello (bivio SP 513R) al bivio per la Pedemontana,11972,00,11857,115,9018,2954,0,11972
2019/01,402,20/01/2019,7,SP 18 da Pilastrello (bivio SP 513R) al bivio per la Pedemontana,9012,10,8984,27,6708,2304,0,9012
2019/01,402,21/01/2019,1,SP 18 da Pilastrello (bivio SP 513R) al bivio per la Pedemontana,13186,00,12875,311,10697,2489,13186,0
2019/01,402,22/01/2019,2,SP 18 da Pilastrello (bivio SP 513R) al bivio per la Pedemontana,13719,00,13451,268,11017,2702,13719,0
2019/01,402,23/01/2019,3,SP 18 da Pilastrello (bivio SP 513R) al bivio per la Pedemontana,13648,00,13347,301,10982,2666,13648,0
2019/01,402,24/01/2019,4,SP 18 da Pilastrello (bivio SP 513R) al bivio per la Pedemontana,12799,00,12549,250,10176,2623,12799,0
2019/01,402,25/01/2019,5,SP 18 da Pilastrello (bivio SP 513R) al bivio per la Pedemontana,13961,00,13663,298,10856,3105,13961,0
2019/01,402,26/01/2019,6,SP 18 da Pilastrello (bivio SP 513R) al bivio per la Pedemontana,11738,00,11640,98,8824,2914,0,11738
2019/01,402,27/01/2019,7,SP 18 da Pilastrello (bivio SP 513R) al bivio per la Pedemontana,8652,00,8616,36,6439,2213,0,8652
2019/01,402,28/01/2019,1,SP 18 da Pilastrello (bivio SP 513R) al bivio per la Pedemontana,13196,00,12882,314,10750,2446,13196,0
2019/01,403,26/01/2019,6,SP 72 tra Parma e Mezzani,5635,00,5551,84,4300,1335,0,5635
2019/01,403,27/01/2019,7,SP 72 tra Parma e Mezzani,4144,00,4119,25,3068,1076,0,4144
2019/01,403,28/01/2019,1,SP 72 tra Parma e Mezzani,7941,00,7273,668,6604,1337,7941,0
2019/01,404,15/01/2019,2,exSP 32 (via Dante Alighieri) da Felino a Pilastro,7010,00,6843,167,5630,1380,7010,0
2019/01,404,16/01/2019,3,exSP 32 (via Dante Alighieri) da Felino a Pilastro,7105,00,6915,190,5647,1458,7105,0
2019/01,404,17/01/2019,4,exSP 32 (via Dante Alighieri) da Felino a Pilastro,7089,10,6913,175,5670,1419,7089,0
2019/01,404,18/01/2019,5,exSP 32 (via Dante Alighieri) da Felino a Pilastro,7098,10,6892,205,5561,1537,7098,0
2019/01,404,19/01/2019,6,exSP 32 (via Dante Alighieri) da Felino a Pilastro,6055,10,5956,98,4621,1434,0,6055
2019/01,404,20/01/2019,7,exSP 32 (via Dante Alighieri) da Felino a Pilastro,4407,00,4380,27,3317,1090,0,4407
2019/01,404,21/01/2019,1,exSP 32 (via Dante Alighieri) da Felino a Pilastro,6932,50,6750,177,5684,1248,6932,0
2019/01,404,22/01/2019,2,exSP 32 (via Dante Alighieri) da Felino a Pilastro,7192,10,6994,197,5819,1373,7192,0
2019/01,404,23/01/2019,3,exSP 32 (via Dante Alighieri) da Felino a Pilastro,6811,00,6621,190,5538,1273,6811,0
2019/01,404,24/01/2019,4,exSP 32 (via Dante Alighieri) da Felino a Pilastro,6629,10,6459,169,5176,1453,6629,0
2019/01,404,25/01/2019,5,exSP 32 (via Dante Alighieri) da Felino a Pilastro,7131,30,6951,177,5608,1523,7131,0
2019/01,404,26/01/2019,6,exSP 32 (via Dante Alighieri) da Felino a Pilastro,6117,10,6047,69,4642,1475,0,6117
2019/01,404,27/01/2019,7,exSP 32 (via Dante Alighieri) da Felino a Pilastro,4459,10,4436,22,3299,1160,0,4459
2019/01,404,28/01/2019,1,exSP 32 (via Dante Alighieri) da Felino a Pilastro,6912,40,6739,169,5689,1223,6912,0
2019/01,405,15/01/2019,2,SP 15 fra SS62 e Sala Baganza,10679,00,9924,755,8602,2077,10679,0
2019/01,405,16/01/2019,3,SP 15 fra SS62 e Sala Baganza,10919,00,10091,828,8820,2099,10919,0
2019/01,405,17/01/2019,4,SP 15 fra SS62 e Sala Baganza,10523,00,9725,798,8434,2089,10523,0
2019/01,405,18/01/2019,5,SP 15 fra SS62 e Sala Baganza,10755,00,9966,789,8474,2281,10755,0
2019/01,405,19/01/2019,6,SP 15 fra SS62 e Sala Baganza,8219,00,8048,171,6081,2138,0,8219
2019/01,405,20/01/2019,7,SP 15 fra SS62 e Sala Baganza,6063,00,6042,21,4354,1709,0,6063
2019/01,405,21/01/2019,1,SP 15 fra SS62 e Sala Baganza,10826,00,9960,866,8763,2063,10826,0
2019/01,405,22/01/2019,2,SP 15 fra SS62 e Sala Baganza,10909,00,10090,819,8792,2117,10909,0
2019/01,405,23/01/2019,3,SP 15 fra SS62 e Sala Baganza,10483,00,9764,719,8560,1923,10483,0
2019/01,405,24/01/2019,4,SP 15 fra SS62 e Sala Baganza,10154,00,9445,709,8051,2103,10154,0
2019/01,405,25/01/2019,5,SP 15 fra SS62 e Sala Baganza,10924,00,10163,761,8635,2289,10924,0
2019/01,405,26/01/2019,6,SP 15 fra SS62 e Sala Baganza,8410,00,8253,157,6267,2143,0,8410
2019/01,405,27/01/2019,7,SP 15 fra SS62 e Sala Baganza,5714,00,5681,33,4088,1626,0,5714
2019/01,405,28/01/2019,1,SP 15 fra SS62 e Sala Baganza,10282,00,9562,720,8352,1930,10282,0
2019/01,410,15/01/2019,2,SP 54 fra Pomposa e Codigoro,4218,00,3969,249,3509,709,4218,0
2019/01,410,16/01/2019,3,SP 54 fra Pomposa e Codigoro,4295,00,4004,291,3577,718,4295,0
2019/01,410,17/01/2019,4,SP 54 fra Pomposa e Codigoro,4664,00,4347,317,3888,776,4664,0
2019/01,410,18/01/2019,5,SP 54 fra Pomposa e Codigoro,4470,00,4176,294,3585,885,4470,0
2019/01,410,19/01/2019,6,SP 54 fra Pomposa e Codigoro,3843,10,3736,106,2850,993,0,3843
2019/01,410,20/01/2019,7,SP 54 fra Pomposa e Codigoro,2967,00,2953,14,2080,887,0,2967
2019/01,410,21/01/2019,1,SP 54 fra Pomposa e Codigoro,4362,10,4091,270,3614,748,4362,0
2019/01,410,22/01/2019,2,SP 54 fra Pomposa e Codigoro,4387,00,4081,306,3644,743,4387,0
2019/01,410,23/01/2019,3,SP 54 fra Pomposa e Codigoro,4204,00,3942,262,3469,735,4204,0
2019/01,410,24/01/2019,4,SP 54 fra Pomposa e Codigoro,4414,00,4133,281,3619,795,4414,0
2019/01,410,25/01/2019,5,SP 54 fra Pomposa e Codigoro,4592,00,4301,291,3684,908,4592,0
2019/01,410,26/01/2019,6,SP 54 fra Pomposa e Codigoro,3939,00,3820,119,2907,1032,0,3939
2019/01,410,27/01/2019,7,SP 54 fra Pomposa e Codigoro,3028,00,3017,11,2101,927,0,3028
2019/01,410,28/01/2019,1,SP 54 fra Pomposa e Codigoro,4174,00,3901,273,3493,681,4174,0
2019/01,411,15/01/2019,2,SP 53 fra Codigoro e Marozzo,5293,00,5200,93,4387,906,5293,0
2019/01,411,16/01/2019,3,SP 53 fra Codigoro e Marozzo,5199,00,5120,79,4260,939,5199,0
2019/01,411,17/01/2019,4,SP 53 fra Codigoro e Marozzo,5412,00,5325,87,4427,985,5412,0
2019/01,411,18/01/2019,5,SP 53 fra Codigoro e Marozzo,5433,00,5312,121,4412,1021,5433,0
2019/01,411,19/01/2019,6,SP 53 fra Codigoro e Marozzo,4132,00,4073,59,3088,1044,0,4132
2019/01,411,20/01/2019,7,SP 53 fra Codigoro e Marozzo,3026,00,3022,4,2107,919,0,3026
2019/01,411,21/01/2019,1,SP 53 fra Codigoro e Marozzo,5365,10,5284,80,4388,977,5365,0
2019/01,411,22/01/2019,2,SP 53 fra Codigoro e Marozzo,5215,00,5145,70,4326,889,5215,0
2019/01,411,23/01/2019,3,SP 53 fra Codigoro e Marozzo,4940,00,4864,76,4056,884,4940,0
2019/01,411,24/01/2019,4,SP 53 fra Codigoro e Marozzo,5211,00,5102,109,4250,961,5211,0
2019/01,411,25/01/2019,5,SP 53 fra Codigoro e Marozzo,5310,00,5222,88,4286,1024,5310,0
2019/01,411,26/01/2019,6,SP 53 fra Codigoro e Marozzo,4216,00,4172,44,3185,1031,0,4216
2019/01,411,27/01/2019,7,SP 53 fra Codigoro e Marozzo,3120,00,3115,5,2251,869,0,3120
2019/01,411,28/01/2019,1,SP 53 fra Codigoro e Marozzo,5099,00,4985,114,4169,930,5099,0
2019/01,426,15/01/2019,2,SS 63 tra Casina e Vezzano sul Crostolo,14215,10,13781,433,11205,3010,14215,0
2019/01,426,16/01/2019,3,SS 63 tra Casina e Vezzano sul Crostolo,14411,10,13899,511,11319,3092,14411,0
2019/01,426,17/01/2019,4,SS 63 tra Casina e Vezzano sul Crostolo,14127,00,13660,467,10946,3181,14127,0
2019/01,426,18/01/2019,5,SS 63 tra Casina e Vezzano sul Crostolo,14577,20,14089,486,11102,3475,14577,0
2019/01,426,19/01/2019,6,SS 63 tra Casina e Vezzano sul Crostolo,13247,00,13088,159,9805,3442,0,13247
2019/01,426,20/01/2019,7,SS 63 tra Casina e Vezzano sul Crostolo,11094,00,11043,51,8234,2860,0,11094
2019/01,426,21/01/2019,1,SS 63 tra Casina e Vezzano sul Crostolo,13642,00,13154,488,10848,2794,13642,0
2019/01,426,22/01/2019,2,SS 63 tra Casina e Vezzano sul Crostolo,13917,00,13450,467,10963,2954,13917,0
2019/01,426,23/01/2019,3,SS 63 tra Casina e Vezzano sul Crostolo,12876,00,12476,400,10315,2561,12876,0
2019/01,426,24/01/2019,4,SS 63 tra Casina e Vezzano sul Crostolo,11882,00,11534,348,9087,2795,11882,0
2019/01,426,25/01/2019,5,SS 63 tra Casina e Vezzano sul Crostolo,14503,00,14078,425,11016,3487,14503,0
2019/01,426,26/01/2019,6,SS 63 tra Casina e Vezzano sul Crostolo,13912,00,13721,191,10471,3441,0,13912
2019/01,426,27/01/2019,7,SS 63 tra Casina e Vezzano sul Crostolo,11096,00,11032,64,8353,2743,0,11096
2019/01,426,28/01/2019,1,SS 63 tra Casina e Vezzano sul Crostolo,13144,00,12657,487,10354,2790,13144,0
2019/01,427,20/01/2019,7,SP 7 fra Viano e Scandiano (bivio SP 37),6998,10,6947,50,5116,1882,0,6998
2019/01,427,21/01/2019,1,SP 7 fra Viano e Scandiano (bivio SP 37),10069,00,9330,739,8093,1976,10069,0
2019/01,427,22/01/2019,2,SP 7 fra Viano e Scandiano (bivio SP 37),10249,10,9483,765,8204,2045,10249,0
2019/01,427,23/01/2019,3,SP 7 fra Viano e Scandiano (bivio SP 37),9748,10,9003,744,7868,1880,9748,0
2019/01,427,24/01/2019,4,SP 7 fra Viano e Scandiano (bivio SP 37),8753,40,8115,634,6842,1911,8753,0
2019/01,427,25/01/2019,5,SP 7 fra Viano e Scandiano (bivio SP 37),10190,20,9562,626,7928,2262,10190,0
2019/01,427,26/01/2019,6,SP 7 fra Viano e Scandiano (bivio SP 37),8998,10,8849,148,6561,2437,0,8998
2019/01,427,27/01/2019,7,SP 7 fra Viano e Scandiano (bivio SP 37),6582,00,6503,79,4802,1780,0,6582
2019/01,427,28/01/2019,1,SP 7 fra Viano e Scandiano (bivio SP 37),9760,10,9068,691,7933,1827,9760,0
2019/01,428,15/01/2019,2,SP 19 fra Colombaia (bivio SP 76) e il Bivio SP 486R al confine provinciale,3662,00,3225,437,2883,779,3662,0
2019/01,428,16/01/2019,3,SP 19 fra Colombaia (bivio SP 76) e il Bivio SP 486R al confine provinciale,3641,00,3140,501,2841,800,3641,0
2019/01,428,17/01/2019,4,SP 19 fra Colombaia (bivio SP 76) e il Bivio SP 486R al confine provinciale,3667,00,3164,503,2874,793,3667,0
2019/01,428,18/01/2019,5,SP 19 fra Colombaia (bivio SP 76) e il Bivio SP 486R al confine provinciale,3804,00,3448,356,2922,882,3804,0
2019/01,428,19/01/2019,6,SP 19 fra Colombaia (bivio SP 76) e il Bivio SP 486R al confine provinciale,2667,00,2611,56,1993,674,0,2667
2019/01,428,20/01/2019,7,SP 19 fra Colombaia (bivio SP 76) e il Bivio SP 486R al confine provinciale,2430,00,2409,21,1842,588,0,2430
2019/01,428,21/01/2019,1,SP 19 fra Colombaia (bivio SP 76) e il Bivio SP 486R al confine provinciale,3484,00,3042,442,2751,733,3484,0
2019/01,428,22/01/2019,2,SP 19 fra Colombaia (bivio SP 76) e il Bivio SP 486R al confine provinciale,3425,00,3011,414,2744,681,3425,0
2019/01,428,23/01/2019,3,SP 19 fra Colombaia (bivio SP 76) e il Bivio SP 486R al confine provinciale,2890,00,2489,401,2377,513,2890,0
2019/01,428,24/01/2019,4,SP 19 fra Colombaia (bivio SP 76) e il Bivio SP 486R al confine provinciale,2447,00,2126,321,1918,529,2447,0
2019/01,428,25/01/2019,5,SP 19 fra Colombaia (bivio SP 76) e il Bivio SP 486R al confine provinciale,3615,00,3226,389,2744,871,3615,0
2019/01,428,26/01/2019,6,SP 19 fra Colombaia (bivio SP 76) e il Bivio SP 486R al confine provinciale,2350,00,2308,42,1616,734,0,2350
2019/01,428,27/01/2019,7,SP 19 fra Colombaia (bivio SP 76) e il Bivio SP 486R al confine provinciale,2253,00,2233,20,1677,576,0,2253
2019/01,428,28/01/2019,1,SP 19 fra Colombaia (bivio SP 76) e il Bivio SP 486R al confine provinciale,3455,00,3016,439,2727,728,3455,0
2019/01,429,15/01/2019,2,SP 12 fra San Polo d'Enza e Montecchio Emilia (variante a sud abitato),7833,00,7062,771,6302,1531,7833,0
2019/01,429,16/01/2019,3,SP 12 fra San Polo d'Enza e Montecchio Emilia (variante a sud abitato),8037,10,7242,794,6555,1482,8037,0
2019/01,429,17/01/2019,4,SP 12 fra San Polo d'Enza e Montecchio Emilia (variante a sud abitato),7723,00,6937,786,6244,1479,7723,0
2019/01,429,18/01/2019,5,SP 12 fra San Polo d'Enza e Montecchio Emilia (variante a sud abitato),7984,00,7290,694,6354,1630,7984,0
2019/01,429,19/01/2019,6,SP 12 fra San Polo d'Enza e Montecchio Emilia (variante a sud abitato),6588,00,6409,179,5082,1506,0,6588
2019/01,429,20/01/2019,7,SP 12 fra San Polo d'Enza e Montecchio Emilia (variante a sud abitato),5399,00,5316,83,4125,1274,0,5399
2019/01,429,21/01/2019,1,SP 12 fra San Polo d'Enza e Montecchio Emilia (variante a sud abitato),7719,00,6964,755,6351,1368,7719,0
2019/01,429,22/01/2019,2,SP 12 fra San Polo d'Enza e Montecchio Emilia (variante a sud abitato),7900,00,7149,751,6517,1383,7900,0
2019/01,429,23/01/2019,3,SP 12 fra San Polo d'Enza e Montecchio Emilia (variante a sud abitato),7544,00,6809,735,6216,1328,7544,0
2019/01,429,24/01/2019,4,SP 12 fra San Polo d'Enza e Montecchio Emilia (variante a sud abitato),6999,00,6395,604,5651,1348,6999,0
2019/01,429,25/01/2019,5,SP 12 fra San Polo d'Enza e Montecchio Emilia (variante a sud abitato),7857,00,7092,765,6277,1580,7857,0
2019/01,429,26/01/2019,6,SP 12 fra San Polo d'Enza e Montecchio Emilia (variante a sud abitato),6803,10,6633,169,5270,1533,0,6803
2019/01,429,27/01/2019,7,SP 12 fra San Polo d'Enza e Montecchio Emilia (variante a sud abitato),5136,10,5063,72,3927,1209,0,5136
2019/01,429,28/01/2019,1,SP 12 fra San Polo d'Enza e Montecchio Emilia (variante a sud abitato),7667,10,6867,799,6299,1368,7667,0
2019/01,430,15/01/2019,2,SP 28 tra Montecchio Emilia e bivio circonvallazione,11017,00,10359,658,9136,1881,11017,0
2019/01,430,16/01/2019,3,SP 28 tra Montecchio Emilia e bivio circonvallazione,10801,00,10204,597,8954,1847,10801,0
2019/01,430,17/01/2019,4,SP 28 tra Montecchio Emilia e bivio circonvallazione,10620,10,9994,625,8646,1974,10620,0
2019/01,430,18/01/2019,5,SP 28 tra Montecchio Emilia e bivio circonvallazione,11059,00,10418,641,8869,2190,11059,0
2019/01,430,19/01/2019,6,SP 28 tra Montecchio Emilia e bivio circonvallazione,8591,00,8441,150,6338,2253,0,8591
2019/01,430,20/01/2019,7,SP 28 tra Montecchio Emilia e bivio circonvallazione,6025,00,5986,39,4334,1691,0,6025
2019/01,430,21/01/2019,1,SP 28 tra Montecchio Emilia e bivio circonvallazione,10473,00,9878,595,8738,1735,10473,0
2019/01,430,22/01/2019,2,SP 28 tra Montecchio Emilia e bivio circonvallazione,10741,00,10123,618,8902,1839,10741,0
2019/01,430,23/01/2019,3,SP 28 tra Montecchio Emilia e bivio circonvallazione,10387,00,9795,592,8616,1771,10387,0
2019/01,430,24/01/2019,4,SP 28 tra Montecchio Emilia e bivio circonvallazione,9645,00,9110,535,7850,1795,9645,0
2019/01,430,25/01/2019,5,SP 28 tra Montecchio Emilia e bivio circonvallazione,10911,10,10325,585,8590,2321,10911,0
2019/01,430,26/01/2019,6,SP 28 tra Montecchio Emilia e bivio circonvallazione,8155,00,8045,110,5992,2163,0,8155
2019/01,430,27/01/2019,7,SP 28 tra Montecchio Emilia e bivio circonvallazione,5789,00,5754,35,4237,1552,0,5789
2019/01,430,28/01/2019,1,SP 28 tra Montecchio Emilia e bivio circonvallazione,10307,00,9707,600,8606,1701,10307,0
2019/01,431,15/01/2019,2,SP 12 fra Sant'Ilario d'Enza (variante a sud) e Montecchio Emilia,6547,00,6257,290,5320,1227,6547,0
2019/01,431,16/01/2019,3,SP 12 fra Sant'Ilario d'Enza (variante a sud) e Montecchio Emilia,6762,00,6438,324,5471,1291,6762,0
2019/01,431,17/01/2019,4,SP 12 fra Sant'Ilario d'Enza (variante a sud) e Montecchio Emilia,6487,00,6159,328,5273,1214,6487,0
2019/01,431,18/01/2019,5,SP 12 fra Sant'Ilario d'Enza (variante a sud) e Montecchio Emilia,6741,00,6423,318,5391,1350,6741,0
2019/01,431,19/01/2019,6,SP 12 fra Sant'Ilario d'Enza (variante a sud) e Montecchio Emilia,6173,00,6096,77,4843,1330,0,6173
2019/01,431,20/01/2019,7,SP 12 fra Sant'Ilario d'Enza (variante a sud) e Montecchio Emilia,4299,00,4283,16,3135,1164,0,4299
2019/01,431,21/01/2019,1,SP 12 fra Sant'Ilario d'Enza (variante a sud) e Montecchio Emilia,6420,00,6104,316,5325,1095,6420,0
2019/01,431,22/01/2019,2,SP 12 fra Sant'Ilario d'Enza (variante a sud) e Montecchio Emilia,6535,00,6231,304,5390,1145,6535,0
2019/01,431,23/01/2019,3,SP 12 fra Sant'Ilario d'Enza (variante a sud) e Montecchio Emilia,6193,00,5906,287,5048,1145,6193,0
2019/01,431,24/01/2019,4,SP 12 fra Sant'Ilario d'Enza (variante a sud) e Montecchio Emilia,6047,10,5843,203,4940,1107,6047,0
2019/01,431,25/01/2019,5,SP 12 fra Sant'Ilario d'Enza (variante a sud) e Montecchio Emilia,6597,00,6405,192,5251,1346,6597,0
2019/01,431,26/01/2019,6,SP 12 fra Sant'Ilario d'Enza (variante a sud) e Montecchio Emilia,5773,00,5703,70,4447,1326,0,5773
2019/01,431,27/01/2019,7,SP 12 fra Sant'Ilario d'Enza (variante a sud) e Montecchio Emilia,4022,00,4001,21,3049,973,0,4022
2019/01,431,28/01/2019,1,SP 12 fra Sant'Ilario d'Enza (variante a sud) e Montecchio Emilia,6194,00,5925,269,5124,1070,6194,0
2019/01,432,15/01/2019,2,SP 67 fra Calerno e Montecchio Emilia,10621,10,9292,1328,8730,1891,10621,0
2019/01,432,16/01/2019,3,SP 67 fra Calerno e Montecchio Emilia,10694,00,9425,1269,8752,1942,10694,0
2019/01,432,17/01/2019,4,SP 67 fra Calerno e Montecchio Emilia,10464,00,9175,1289,8490,1974,10464,0
2019/01,432,18/01/2019,5,SP 67 fra Calerno e Montecchio Emilia,10714,00,9466,1248,8666,2048,10714,0
2019/01,432,19/01/2019,6,SP 67 fra Calerno e Montecchio Emilia,7261,00,7014,247,5371,1890,0,7261
2019/01,432,20/01/2019,7,SP 67 fra Calerno e Montecchio Emilia,6179,00,6072,107,4452,1727,0,6179
2019/01,432,21/01/2019,1,SP 67 fra Calerno e Montecchio Emilia,10238,00,9020,1218,8373,1865,10238,0
2019/01,432,22/01/2019,2,SP 67 fra Calerno e Montecchio Emilia,10327,00,9071,1256,8466,1861,10327,0
2019/01,432,23/01/2019,3,SP 67 fra Calerno e Montecchio Emilia,10182,00,8888,1294,8395,1787,10182,0
2019/01,432,24/01/2019,4,SP 67 fra Calerno e Montecchio Emilia,9796,10,8530,1265,7936,1860,9796,0
2019/01,432,25/01/2019,5,SP 67 fra Calerno e Montecchio Emilia,10672,00,9380,1292,8470,2202,10672,0
2019/01,432,26/01/2019,6,SP 67 fra Calerno e Montecchio Emilia,7261,00,7018,243,5439,1822,0,7261
2019/01,432,27/01/2019,7,SP 67 fra Calerno e Montecchio Emilia,5896,00,5802,94,4348,1548,0,5896
2019/01,432,28/01/2019,1,SP 67 fra Calerno e Montecchio Emilia,10186,00,8868,1318,8361,1825,10186,0
2019/01,434,15/01/2019,2,Via San Nicola (ex SP 39) tra bivio per Taneto a Caprara,3132,00,3063,69,2447,685,3132,0
2019/01,434,20/01/2019,7,Via San Nicola (ex SP 39) tra bivio per Taneto a Caprara,2239,00,2228,11,1637,602,0,2239
2019/01,434,21/01/2019,1,Via San Nicola (ex SP 39) tra bivio per Taneto a Caprara,3312,10,3234,77,2685,627,3312,0
2019/01,434,22/01/2019,2,Via San Nicola (ex SP 39) tra bivio per Taneto a Caprara,3279,10,3212,66,2618,661,3279,0
2019/01,434,23/01/2019,3,Via San Nicola (ex SP 39) tra bivio per Taneto a Caprara,3296,00,3219,77,2671,625,3296,0
2019/01,434,24/01/2019,4,Via San Nicola (ex SP 39) tra bivio per Taneto a Caprara,3144,00,3071,73,2487,657,3144,0
2019/01,434,25/01/2019,5,Via San Nicola (ex SP 39) tra bivio per Taneto a Caprara,3342,00,3254,88,2608,734,3342,0
2019/01,434,26/01/2019,6,Via San Nicola (ex SP 39) tra bivio per Taneto a Caprara,2905,00,2874,31,2165,740,0,2905
2019/01,434,27/01/2019,7,Via San Nicola (ex SP 39) tra bivio per Taneto a Caprara,1968,00,1959,9,1399,569,0,1968
2019/01,434,28/01/2019,1,Via San Nicola (ex SP 39) tra bivio per Taneto a Caprara,3282,00,3196,86,2633,649,3282,0
2019/01,436,15/01/2019,2,SP 26 da Santa Sofia a San Piero in Bagno,829,00,771,58,662,167,829,0
2019/01,436,16/01/2019,3,SP 26 da Santa Sofia a San Piero in Bagno,921,00,864,57,743,178,921,0
2019/01,436,17/01/2019,4,SP 26 da Santa Sofia a San Piero in Bagno,792,00,748,44,613,179,792,0
2019/01,436,18/01/2019,5,SP 26 da Santa Sofia a San Piero in Bagno,817,00,768,49,648,169,817,0
2019/01,436,19/01/2019,6,SP 26 da Santa Sofia a San Piero in Bagno,702,10,688,13,511,191,0,702
2019/01,436,20/01/2019,7,SP 26 da Santa Sofia a San Piero in Bagno,671,00,671,0,479,192,0,671
2019/01,436,21/01/2019,1,SP 26 da Santa Sofia a San Piero in Bagno,675,00,642,33,515,160,675,0
2019/01,436,22/01/2019,2,SP 26 da Santa Sofia a San Piero in Bagno,444,20,406,36,350,94,444,0
2019/01,436,23/01/2019,3,SP 26 da Santa Sofia a San Piero in Bagno,539,20,512,25,435,104,539,0
2019/01,436,24/01/2019,4,SP 26 da Santa Sofia a San Piero in Bagno,521,10,486,34,399,122,521,0
2019/01,436,25/01/2019,5,SP 26 da Santa Sofia a San Piero in Bagno,694,00,662,32,535,159,694,0
2019/01,436,26/01/2019,6,SP 26 da Santa Sofia a San Piero in Bagno,707,00,694,13,509,198,0,707
2019/01,436,27/01/2019,7,SP 26 da Santa Sofia a San Piero in Bagno,705,00,703,2,559,146,0,705
2019/01,436,28/01/2019,1,SP 26 da Santa Sofia a San Piero in Bagno,761,00,726,35,600,161,761,0
2019/01,437,15/01/2019,2,SP 13 tra SS 9 (Santarcangelo di Romagna) e SP 92 (località Camerano),6834,00,5818,1016,5582,1252,6834,0
2019/01,437,16/01/2019,3,SP 13 tra SS 9 (Santarcangelo di Romagna) e SP 92 (località Camerano),6917,10,5922,994,5629,1288,6917,0
2019/01,437,17/01/2019,4,SP 13 tra SS 9 (Santarcangelo di Romagna) e SP 92 (località Camerano),7157,00,6136,1021,5743,1414,7157,0
2019/01,437,18/01/2019,5,SP 13 tra SS 9 (Santarcangelo di Romagna) e SP 92 (località Camerano),7151,20,6188,961,5634,1517,7151,0
2019/01,437,19/01/2019,6,SP 13 tra SS 9 (Santarcangelo di Romagna) e SP 92 (località Camerano),5624,00,5409,215,4165,1459,0,5624
2019/01,437,20/01/2019,7,SP 13 tra SS 9 (Santarcangelo di Romagna) e SP 92 (località Camerano),4381,00,4369,12,3152,1229,0,4381
2019/01,437,21/01/2019,1,SP 13 tra SS 9 (Santarcangelo di Romagna) e SP 92 (località Camerano),6692,00,5690,1002,5518,1174,6692,0
2019/01,437,22/01/2019,2,SP 13 tra SS 9 (Santarcangelo di Romagna) e SP 92 (località Camerano),5778,20,4968,808,4780,998,5778,0
2019/01,437,23/01/2019,3,SP 13 tra SS 9 (Santarcangelo di Romagna) e SP 92 (località Camerano),6239,00,5475,764,5083,1156,6239,0
2019/01,437,24/01/2019,4,SP 13 tra SS 9 (Santarcangelo di Romagna) e SP 92 (località Camerano),6552,00,5699,853,5287,1265,6552,0
2019/01,437,25/01/2019,5,SP 13 tra SS 9 (Santarcangelo di Romagna) e SP 92 (località Camerano),6873,20,5953,918,5477,1396,6873,0
2019/01,437,26/01/2019,6,SP 13 tra SS 9 (Santarcangelo di Romagna) e SP 92 (località Camerano),5657,00,5464,193,4213,1444,0,5657
2019/01,437,27/01/2019,7,SP 13 tra SS 9 (Santarcangelo di Romagna) e SP 92 (località Camerano),4478,10,4453,24,3347,1131,0,4478
2019/01,437,28/01/2019,1,SP 13 tra SS 9 (Santarcangelo di Romagna) e SP 92 (località Camerano),6721,00,5738,983,5554,1167,6721,0
2019/01,438,15/01/2019,2,SP 14 tra Colombare (bivio SP 14Ter) e bivio SP 258R,7774,00,7084,690,6444,1330,7774,0
2019/01,438,16/01/2019,3,SP 14 tra Colombare (bivio SP 14Ter) e bivio SP 258R,8058,10,7499,558,6572,1486,8058,0
2019/01,438,17/01/2019,4,SP 14 tra Colombare (bivio SP 14Ter) e bivio SP 258R,8048,20,7326,720,6468,1580,8048,0
2019/01,438,18/01/2019,5,SP 14 tra Colombare (bivio SP 14Ter) e bivio SP 258R,8313,30,7676,634,6641,1672,8313,0
2019/01,438,19/01/2019,6,SP 14 tra Colombare (bivio SP 14Ter) e bivio SP 258R,6500,00,6394,106,4868,1632,0,6500
2019/01,438,20/01/2019,7,SP 14 tra Colombare (bivio SP 14Ter) e bivio SP 258R,5816,10,5789,26,4381,1435,0,5816
2019/01,438,21/01/2019,1,SP 14 tra Colombare (bivio SP 14Ter) e bivio SP 258R,7361,10,6782,578,6076,1285,7361,0
2019/01,438,22/01/2019,2,SP 14 tra Colombare (bivio SP 14Ter) e bivio SP 258R,6152,00,5759,393,5136,1016,6152,0
2019/01,438,23/01/2019,3,SP 14 tra Colombare (bivio SP 14Ter) e bivio SP 258R,6951,00,6519,432,5693,1258,6951,0
2019/01,438,24/01/2019,4,SP 14 tra Colombare (bivio SP 14Ter) e bivio SP 258R,6905,00,6480,425,5668,1237,6905,0
2019/01,438,25/01/2019,5,SP 14 tra Colombare (bivio SP 14Ter) e bivio SP 258R,7903,10,7392,510,6327,1576,7903,0
2019/01,438,26/01/2019,6,SP 14 tra Colombare (bivio SP 14Ter) e bivio SP 258R,6811,20,6696,113,5141,1670,0,6811
2019/01,438,27/01/2019,7,SP 14 tra Colombare (bivio SP 14Ter) e bivio SP 258R,6349,00,6328,21,4982,1367,0,6349
2019/01,438,28/01/2019,1,SP 14 tra Colombare (bivio SP 14Ter) e bivio SP 258R,7657,00,7030,627,6320,1337,7657,0
2019/01,439,15/01/2019,2,SP 49 da Santarcangelo di Romagna alla località Posta (bivio SP 258R),12192,00,11312,880,9744,2448,12192,0
2019/01,439,16/01/2019,3,SP 49 da Santarcangelo di Romagna alla località Posta (bivio SP 258R),12330,10,11480,849,9866,2464,12330,0
2019/01,439,17/01/2019,4,SP 49 da Santarcangelo di Romagna alla località Posta (bivio SP 258R),12493,20,11521,970,9999,2494,12493,0
2019/01,439,18/01/2019,5,SP 49 da Santarcangelo di Romagna alla località Posta (bivio SP 258R),13223,00,12354,869,10259,2964,13223,0
2019/01,439,19/01/2019,6,SP 49 da Santarcangelo di Romagna alla località Posta (bivio SP 258R),11581,00,11401,180,8583,2998,0,11581
2019/01,439,20/01/2019,7,SP 49 da Santarcangelo di Romagna alla località Posta (bivio SP 258R),9965,00,9941,24,7319,2646,0,9965
2019/01,439,21/01/2019,1,SP 49 da Santarcangelo di Romagna alla località Posta (bivio SP 258R),13284,20,12418,864,10809,2475,13284,0
2019/01,439,22/01/2019,2,SP 49 da Santarcangelo di Romagna alla località Posta (bivio SP 258R),11758,10,11053,704,9695,2063,11758,0
2019/01,439,23/01/2019,3,SP 49 da Santarcangelo di Romagna alla località Posta (bivio SP 258R),11968,00,11255,713,9668,2300,11968,0
2019/01,439,24/01/2019,4,SP 49 da Santarcangelo di Romagna alla località Posta (bivio SP 258R),12002,20,11223,777,9610,2392,12002,0
2019/01,439,25/01/2019,5,SP 49 da Santarcangelo di Romagna alla località Posta (bivio SP 258R),13059,00,12210,849,10268,2791,13059,0
2019/01,439,26/01/2019,6,SP 49 da Santarcangelo di Romagna alla località Posta (bivio SP 258R),11162,10,10998,163,8139,3023,0,11162
2019/01,439,27/01/2019,7,SP 49 da Santarcangelo di Romagna alla località Posta (bivio SP 258R),9076,10,9053,22,6622,2454,0,9076
2019/01,439,28/01/2019,1,SP 49 da Santarcangelo di Romagna alla località Posta (bivio SP 258R),11801,20,11034,765,9678,2123,11801,0
2019/01,440,15/01/2019,2,SP 35 tra bivio SP 50 (località Cella) e Sant'Andrea in Casale,12034,00,11729,305,9687,2347,12034,0
2019/01,440,16/01/2019,3,SP 35 tra bivio SP 50 (località Cella) e Sant'Andrea in Casale,11932,00,11619,313,9574,2358,11932,0
2019/01,440,17/01/2019,4,SP 35 tra bivio SP 50 (località Cella) e Sant'Andrea in Casale,12281,00,11917,364,9772,2509,12281,0
2019/01,440,18/01/2019,5,SP 35 tra bivio SP 50 (località Cella) e Sant'Andrea in Casale,12123,00,11836,287,9465,2658,12123,0
2019/01,440,19/01/2019,6,SP 35 tra bivio SP 50 (località Cella) e Sant'Andrea in Casale,11467,00,11349,118,8224,3243,0,11467
2019/01,440,20/01/2019,7,SP 35 tra bivio SP 50 (località Cella) e Sant'Andrea in Casale,8825,00,8792,33,5994,2831,0,8825
2019/01,440,21/01/2019,1,SP 35 tra bivio SP 50 (località Cella) e Sant'Andrea in Casale,11448,10,11166,281,9195,2253,11448,0
2019/01,440,22/01/2019,2,SP 35 tra bivio SP 50 (località Cella) e Sant'Andrea in Casale,10957,00,10710,247,8805,2152,10957,0
2019/01,440,23/01/2019,3,SP 35 tra bivio SP 50 (località Cella) e Sant'Andrea in Casale,11213,10,10940,272,8892,2321,11213,0
2019/01,440,24/01/2019,4,SP 35 tra bivio SP 50 (località Cella) e Sant'Andrea in Casale,11790,00,11495,295,9374,2416,11790,0
2019/01,440,25/01/2019,5,SP 35 tra bivio SP 50 (località Cella) e Sant'Andrea in Casale,12321,10,12016,304,9543,2778,12321,0
2019/01,440,26/01/2019,6,SP 35 tra bivio SP 50 (località Cella) e Sant'Andrea in Casale,11414,10,11270,143,8306,3108,0,11414
2019/01,440,27/01/2019,7,SP 35 tra bivio SP 50 (località Cella) e Sant'Andrea in Casale,8929,00,8906,23,6344,2585,0,8929
2019/01,440,28/01/2019,1,SP 35 tra bivio SP 50 (località Cella) e Sant'Andrea in Casale,11676,00,11393,283,9470,2206,11676,0
2019/01,441,15/01/2019,2,SP 58 tra San Giovanni in Marignano e il confine regionale (Marche),8717,00,8302,415,7045,1672,8717,0
2019/01,441,16/01/2019,3,SP 58 tra San Giovanni in Marignano e il confine regionale (Marche),8671,00,8235,436,7015,1656,8671,0
2019/01,441,17/01/2019,4,SP 58 tra San Giovanni in Marignano e il confine regionale (Marche),9036,10,8646,389,7124,1912,9036,0
2019/01,441,18/01/2019,5,SP 58 tra San Giovanni in Marignano e il confine regionale (Marche),8995,00,8513,482,7057,1938,8995,0
2019/01,441,19/01/2019,6,SP 58 tra San Giovanni in Marignano e il confine regionale (Marche),7263,00,7154,109,5256,2007,0,7263
2019/01,441,20/01/2019,7,SP 58 tra San Giovanni in Marignano e il confine regionale (Marche),6076,00,6068,8,4114,1962,0,6076
2019/01,441,21/01/2019,1,SP 58 tra San Giovanni in Marignano e il confine regionale (Marche),8685,00,8268,417,7014,1671,8685,0
2019/01,441,22/01/2019,2,SP 58 tra San Giovanni in Marignano e il confine regionale (Marche),7634,00,7293,341,6312,1322,7634,0
2019/01,441,23/01/2019,3,SP 58 tra San Giovanni in Marignano e il confine regionale (Marche),8169,10,7808,360,6562,1607,8169,0
2019/01,441,24/01/2019,4,SP 58 tra San Giovanni in Marignano e il confine regionale (Marche),8569,00,8196,373,6834,1735,8569,0
2019/01,441,25/01/2019,5,SP 58 tra San Giovanni in Marignano e il confine regionale (Marche),9022,00,8592,430,7098,1924,9022,0
2019/01,441,26/01/2019,6,SP 58 tra San Giovanni in Marignano e il confine regionale (Marche),7452,10,7349,102,5394,2058,0,7452
2019/01,441,27/01/2019,7,SP 58 tra San Giovanni in Marignano e il confine regionale (Marche),6059,00,6047,12,4242,1817,0,6059
2019/01,441,28/01/2019,1,SP 58 tra San Giovanni in Marignano e il confine regionale (Marche),8569,00,8219,350,6862,1707,8569,0
2019/01,442,15/01/2019,2,SP 118 tra Casemurate (bivio SP 254R) e il confine provinciale,3411,10,3084,326,2705,706,3411,0
2019/01,442,16/01/2019,3,SP 118 tra Casemurate (bivio SP 254R) e il confine provinciale,3529,00,3244,285,2828,701,3529,0
2019/01,442,17/01/2019,4,SP 118 tra Casemurate (bivio SP 254R) e il confine provinciale,3438,10,3122,315,2680,758,3438,0
2019/01,442,18/01/2019,5,SP 118 tra Casemurate (bivio SP 254R) e il confine provinciale,3636,00,3334,302,2835,801,3636,0
2019/01,442,19/01/2019,6,SP 118 tra Casemurate (bivio SP 254R) e il confine provinciale,3451,00,3342,109,2592,859,0,3451
2019/01,442,20/01/2019,7,SP 118 tra Casemurate (bivio SP 254R) e il confine provinciale,2698,10,2649,48,1924,774,0,2698
2019/01,442,21/01/2019,1,SP 118 tra Casemurate (bivio SP 254R) e il confine provinciale,3528,10,3235,292,2762,766,3528,0
2019/01,442,22/01/2019,2,SP 118 tra Casemurate (bivio SP 254R) e il confine provinciale,3220,10,2930,289,2644,576,3220,0
2019/01,442,23/01/2019,3,SP 118 tra Casemurate (bivio SP 254R) e il confine provinciale,3379,00,3096,283,2701,678,3379,0
2019/01,442,24/01/2019,4,SP 118 tra Casemurate (bivio SP 254R) e il confine provinciale,3453,00,3144,309,2713,740,3453,0
2019/01,442,25/01/2019,5,SP 118 tra Casemurate (bivio SP 254R) e il confine provinciale,3704,00,3394,310,2867,837,3704,0
2019/01,442,26/01/2019,6,SP 118 tra Casemurate (bivio SP 254R) e il confine provinciale,3410,00,3285,125,2522,888,0,3410
2019/01,442,27/01/2019,7,SP 118 tra Casemurate (bivio SP 254R) e il confine provinciale,2545,10,2506,38,1821,724,0,2545
2019/01,442,28/01/2019,1,SP 118 tra Casemurate (bivio SP 254R) e il confine provinciale,3416,00,3115,301,2755,661,3416,0
2019/01,443,15/01/2019,2,SP 16 tra Faenza e il confine provinciale,5590,10,5313,276,4510,1080,5590,0
2019/01,443,16/01/2019,3,SP 16 tra Faenza e il confine provinciale,5480,00,5199,281,4359,1121,5480,0
2019/01,443,17/01/2019,4,SP 16 tra Faenza e il confine provinciale,5655,00,5399,256,4501,1154,5655,0
2019/01,443,18/01/2019,5,SP 16 tra Faenza e il confine provinciale,5613,00,5355,258,4462,1151,5613,0
2019/01,443,19/01/2019,6,SP 16 tra Faenza e il confine provinciale,5058,00,4999,59,3842,1216,0,5058
2019/01,443,20/01/2019,7,SP 16 tra Faenza e il confine provinciale,4376,00,4359,17,3363,1013,0,4376
2019/01,443,21/01/2019,1,SP 16 tra Faenza e il confine provinciale,5248,00,5001,247,4239,1009,5248,0
2019/01,443,22/01/2019,2,SP 16 tra Faenza e il confine provinciale,4889,00,4654,235,4059,830,4889,0
2019/01,443,23/01/2019,3,SP 16 tra Faenza e il confine provinciale,4955,00,4706,249,3974,981,4955,0
2019/01,443,24/01/2019,4,SP 16 tra Faenza e il confine provinciale,4945,00,4731,214,3938,1007,4945,0
2019/01,443,25/01/2019,5,SP 16 tra Faenza e il confine provinciale,5446,00,5196,250,4274,1172,5446,0
2019/01,443,26/01/2019,6,SP 16 tra Faenza e il confine provinciale,5143,10,5055,87,3909,1234,0,5143
2019/01,443,27/01/2019,7,SP 16 tra Faenza e il confine provinciale,4421,00,4405,16,3438,983,0,4421
2019/01,443,28/01/2019,1,SP 16 tra Faenza e il confine provinciale,5251,10,4989,261,4163,1088,5251,0
2019/01,444,15/01/2019,2,SP 5 fra Russi e San Pancrazio,5835,10,5588,246,4715,1120,5835,0
2019/01,444,16/01/2019,3,SP 5 fra Russi e San Pancrazio,5450,00,5237,213,4430,1020,5450,0
2019/01,444,17/01/2019,4,SP 5 fra Russi e San Pancrazio,5628,00,5396,232,4480,1148,5628,0
2019/01,444,18/01/2019,5,SP 5 fra Russi e San Pancrazio,5889,10,5635,253,4752,1137,5889,0
2019/01,444,19/01/2019,6,SP 5 fra Russi e San Pancrazio,5013,00,4942,71,3949,1064,0,5013
2019/01,444,20/01/2019,7,SP 5 fra Russi e San Pancrazio,3481,00,3471,10,2571,910,0,3481
2019/01,444,21/01/2019,1,SP 5 fra Russi e San Pancrazio,5526,00,5310,216,4552,974,5526,0
2019/01,444,22/01/2019,2,SP 5 fra Russi e San Pancrazio,5509,10,5252,256,4556,953,5509,0
2019/01,444,23/01/2019,3,SP 5 fra Russi e San Pancrazio,5380,00,5138,242,4392,988,5380,0
2019/01,444,24/01/2019,4,SP 5 fra Russi e San Pancrazio,5463,20,5231,230,4371,1092,5463,0
2019/01,444,25/01/2019,5,SP 5 fra Russi e San Pancrazio,5744,00,5511,233,4628,1116,5744,0
2019/01,444,26/01/2019,6,SP 5 fra Russi e San Pancrazio,4817,00,4757,60,3767,1050,0,4817
2019/01,444,27/01/2019,7,SP 5 fra Russi e San Pancrazio,3552,00,3546,6,2683,869,0,3552
2019/01,444,28/01/2019,1,SP 5 fra Russi e San Pancrazio,5567,00,5332,235,4567,1000,5567,0
2019/01,445,15/01/2019,2,SP 610R fra SP 253R e Conselice,5621,10,4785,835,4463,1158,5621,0
2019/01,445,16/01/2019,3,SP 610R fra SP 253R e Conselice,5712,00,4908,804,4509,1203,5712,0
2019/01,445,17/01/2019,4,SP 610R fra SP 253R e Conselice,5882,10,5108,773,4679,1203,5882,0
2019/01,445,18/01/2019,5,SP 610R fra SP 253R e Conselice,6017,10,5203,813,4638,1379,6017,0
2019/01,445,19/01/2019,6,SP 610R fra SP 253R e Conselice,4446,10,4277,168,3249,1197,0,4446
2019/01,445,20/01/2019,7,SP 610R fra SP 253R e Conselice,3904,00,3871,33,2919,985,0,3904
2019/01,445,21/01/2019,1,SP 610R fra SP 253R e Conselice,5622,00,4790,832,4540,1082,5622,0
2019/01,445,22/01/2019,2,SP 610R fra SP 253R e Conselice,5448,10,4709,738,4322,1126,5448,0
2019/01,445,23/01/2019,3,SP 610R fra SP 253R e Conselice,5423,10,4578,844,4216,1207,5423,0
2019/01,445,24/01/2019,4,SP 610R fra SP 253R e Conselice,5630,00,4796,834,4441,1189,5630,0
2019/01,445,25/01/2019,5,SP 610R fra SP 253R e Conselice,5848,00,5066,782,4500,1348,5848,0
2019/01,445,26/01/2019,6,SP 610R fra SP 253R e Conselice,4678,10,4489,188,3447,1231,0,4678
2019/01,445,27/01/2019,7,SP 610R fra SP 253R e Conselice,3797,00,3758,39,2820,977,0,3797
2019/01,445,28/01/2019,1,SP 610R fra SP 253R e Conselice,5437,10,4587,849,4407,1030,5437,0
2019/01,446,15/01/2019,2,SP 13 in località Santa Maria di Fabriago,8759,10,8139,619,7007,1752,8759,0
2019/01,446,16/01/2019,3,SP 13 in località Santa Maria di Fabriago,9337,00,8608,729,7568,1769,9337,0
2019/01,446,17/01/2019,4,SP 13 in località Santa Maria di Fabriago,9073,00,8425,648,7224,1849,9073,0
2019/01,446,18/01/2019,5,SP 13 in località Santa Maria di Fabriago,9071,00,8488,583,7154,1917,9071,0
2019/01,446,19/01/2019,6,SP 13 in località Santa Maria di Fabriago,7206,00,7066,140,5280,1926,0,7206
2019/01,446,20/01/2019,7,SP 13 in località Santa Maria di Fabriago,5259,00,5231,28,3705,1554,0,5259
2019/01,446,21/01/2019,1,SP 13 in località Santa Maria di Fabriago,8803,00,8207,596,7135,1668,8803,0
2019/01,446,22/01/2019,2,SP 13 in località Santa Maria di Fabriago,8419,00,7851,568,6861,1558,8419,0
2019/01,446,23/01/2019,3,SP 13 in località Santa Maria di Fabriago,8622,00,8033,589,6913,1709,8622,0
2019/01,446,24/01/2019,4,SP 13 in località Santa Maria di Fabriago,8820,00,8273,547,6994,1826,8820,0
2019/01,446,25/01/2019,5,SP 13 in località Santa Maria di Fabriago,9067,00,8497,570,7158,1909,9067,0
2019/01,446,26/01/2019,6,SP 13 in località Santa Maria di Fabriago,7042,10,6898,143,5221,1821,0,7042
2019/01,446,27/01/2019,7,SP 13 in località Santa Maria di Fabriago,5046,00,5023,23,3607,1439,0,5046
2019/01,446,28/01/2019,1,SP 13 in località Santa Maria di Fabriago,8539,00,7952,587,6882,1657,8539,0
2019/01,447,24/01/2019,4,SP 28 in località Molinazzo (Comune di Gossolengo),4392,00,4285,107,3544,848,4392,0
2019/01,447,25/01/2019,5,SP 28 in località Molinazzo (Comune di Gossolengo),5206,00,5057,149,4118,1088,5206,0
2019/01,447,26/01/2019,6,SP 28 in località Molinazzo (Comune di Gossolengo),4590,00,4522,68,3472,1118,0,4590
2019/01,447,27/01/2019,7,SP 28 in località Molinazzo (Comune di Gossolengo),3648,00,3635,13,2853,795,0,3648
2019/01,447,28/01/2019,1,SP 28 in località Molinazzo (Comune di Gossolengo),4825,00,4625,200,3971,854,4825,0
2019/01,448,15/01/2019,2,SP 5 fra Reggiolo e intersezione SP 45 per Fabbrico,7366,20,6621,743,5918,1448,7366,0
2019/01,448,16/01/2019,3,SP 5 fra Reggiolo e intersezione SP 45 per Fabbrico,7475,00,6614,861,5971,1504,7475,0
2019/01,448,17/01/2019,4,SP 5 fra Reggiolo e intersezione SP 45 per Fabbrico,7547,00,6707,840,6031,1516,7547,0
2019/01,448,18/01/2019,5,SP 5 fra Reggiolo e intersezione SP 45 per Fabbrico,7789,10,7050,738,5956,1833,7789,0
2019/01,448,19/01/2019,6,SP 5 fra Reggiolo e intersezione SP 45 per Fabbrico,6255,00,6123,132,4353,1902,0,6255
2019/01,448,20/01/2019,7,SP 5 fra Reggiolo e intersezione SP 45 per Fabbrico,5689,00,5653,36,4014,1675,0,5689
2019/01,448,21/01/2019,1,SP 5 fra Reggiolo e intersezione SP 45 per Fabbrico,7160,20,6458,700,5750,1410,7160,0
2019/01,448,22/01/2019,2,SP 5 fra Reggiolo e intersezione SP 45 per Fabbrico,7350,00,6596,754,5879,1471,7350,0
2019/01,448,23/01/2019,3,SP 5 fra Reggiolo e intersezione SP 45 per Fabbrico,7234,00,6435,799,5852,1382,7234,0
2019/01,448,24/01/2019,4,SP 5 fra Reggiolo e intersezione SP 45 per Fabbrico,7305,00,6573,732,5726,1579,7305,0
2019/01,448,25/01/2019,5,SP 5 fra Reggiolo e intersezione SP 45 per Fabbrico,7701,00,6922,779,5971,1730,7701,0
2019/01,448,26/01/2019,6,SP 5 fra Reggiolo e intersezione SP 45 per Fabbrico,6214,00,6085,129,4329,1885,0,6214
2019/01,448,27/01/2019,7,SP 5 fra Reggiolo e intersezione SP 45 per Fabbrico,5112,00,5080,32,3645,1467,0,5112
2019/01,448,28/01/2019,1,SP 5 fra Reggiolo e intersezione SP 45 per Fabbrico,7029,00,6316,713,5697,1332,7029,0
2019/01,449,15/01/2019,2,SP 111 fra via Emilia e la variante Asse Val d'Enza,12114,00,10046,2068,9879,2235,12114,0
2019/01,449,16/01/2019,3,SP 111 fra via Emilia e la variante Asse Val d'Enza,12155,10,10072,2082,9943,2212,12155,0
2019/01,449,17/01/2019,4,SP 111 fra via Emilia e la variante Asse Val d'Enza,12098,10,9954,2143,9741,2357,12098,0
2019/01,449,18/01/2019,5,SP 111 fra via Emilia e la variante Asse Val d'Enza,12346,00,10279,2067,9847,2499,12346,0
2019/01,449,19/01/2019,6,SP 111 fra via Emilia e la variante Asse Val d'Enza,7809,00,7397,412,5673,2136,0,7809
2019/01,449,20/01/2019,7,SP 111 fra via Emilia e la variante Asse Val d'Enza,7293,00,7148,145,5327,1966,0,7293
2019/01,449,21/01/2019,1,SP 111 fra via Emilia e la variante Asse Val d'Enza,11757,00,9705,2052,9562,2195,11757,0
2019/01,449,22/01/2019,2,SP 111 fra via Emilia e la variante Asse Val d'Enza,11808,00,9754,2054,9694,2114,11808,0
2019/01,449,23/01/2019,3,SP 111 fra via Emilia e la variante Asse Val d'Enza,11812,30,9702,2107,9719,2093,11812,0
2019/01,449,24/01/2019,4,SP 111 fra via Emilia e la variante Asse Val d'Enza,11425,00,9378,2047,9237,2188,11425,0
2019/01,449,25/01/2019,5,SP 111 fra via Emilia e la variante Asse Val d'Enza,12214,30,10087,2124,9714,2500,12214,0
2019/01,449,26/01/2019,6,SP 111 fra via Emilia e la variante Asse Val d'Enza,7957,00,7553,404,5844,2113,0,7957
2019/01,449,27/01/2019,7,SP 111 fra via Emilia e la variante Asse Val d'Enza,6515,00,6364,151,4690,1825,0,6515
2019/01,449,28/01/2019,1,SP 111 fra via Emilia e la variante Asse Val d'Enza,11559,10,9529,2029,9498,2061,11559,0
2019/01,450,15/01/2019,2,SP 35 sul Ponte Po,8354,10,7340,1013,6713,1641,8354,0
2019/01,450,16/01/2019,3,SP 35 sul Ponte Po,9137,30,8033,1101,7460,1677,9137,0
2019/01,450,17/01/2019,4,SP 35 sul Ponte Po,8478,10,7435,1042,6817,1661,8478,0
2019/01,450,18/01/2019,5,SP 35 sul Ponte Po,8909,20,7944,963,6910,1999,8909,0
2019/01,450,19/01/2019,6,SP 35 sul Ponte Po,7390,00,7237,153,5301,2089,0,7390
2019/01,450,20/01/2019,7,SP 35 sul Ponte Po,5468,00,5431,37,3637,1831,0,5468
2019/01,450,21/01/2019,1,SP 35 sul Ponte Po,8044,20,7056,986,6527,1517,8044,0
2019/01,450,22/01/2019,2,SP 35 sul Ponte Po,8123,60,7098,1019,6566,1557,8123,0
2019/01,450,23/01/2019,3,SP 35 sul Ponte Po,8213,20,7258,953,6592,1621,8213,0
2019/01,450,24/01/2019,4,SP 35 sul Ponte Po,8134,30,7185,946,6601,1533,8134,0
2019/01,450,25/01/2019,5,SP 35 sul Ponte Po,8744,30,7854,887,6746,1998,8744,0
2019/01,450,26/01/2019,6,SP 35 sul Ponte Po,7105,10,6975,129,5124,1981,0,7105
2019/01,450,27/01/2019,7,SP 35 sul Ponte Po,5119,00,5089,30,3519,1600,0,5119
2019/01,450,28/01/2019,1,SP 35 sul Ponte Po,7911,40,6971,936,6411,1500,7911,0
2019/01,451,20/01/2019,7,SP 62RVar sulla variante di Luzzara (c/o Codisotto),8351,00,8208,143,5804,2547,0,8351
2019/01,451,21/01/2019,1,SP 62RVar sulla variante di Luzzara (c/o Codisotto),11707,00,8690,3017,9329,2378,11707,0
2019/01,451,22/01/2019,2,SP 62RVar sulla variante di Luzzara (c/o Codisotto),11802,00,8756,3046,9460,2342,11802,0
2019/01,451,23/01/2019,3,SP 62RVar sulla variante di Luzzara (c/o Codisotto),11597,10,8615,2981,9307,2290,11597,0
2019/01,451,24/01/2019,4,SP 62RVar sulla variante di Luzzara (c/o Codisotto),11830,10,8758,3071,9415,2415,11830,0
2019/01,451,25/01/2019,5,SP 62RVar sulla variante di Luzzara (c/o Codisotto),12538,20,9740,2796,9684,2854,12538,0
2019/01,451,26/01/2019,6,SP 62RVar sulla variante di Luzzara (c/o Codisotto),9319,10,8885,433,6800,2519,0,9319
2019/01,451,27/01/2019,7,SP 62RVar sulla variante di Luzzara (c/o Codisotto),7682,00,7565,117,5444,2238,0,7682
2019/01,451,28/01/2019,1,SP 62RVar sulla variante di Luzzara (c/o Codisotto),11430,00,8601,2829,9097,2333,11430,0
2019/01,452,15/01/2019,2,SP 3 sulla variante tra Bagnolo in Piano e il casello A 1 di Reggio Emilia,12270,00,11048,1222,9826,2444,12270,0
2019/01,452,16/01/2019,3,SP 3 sulla variante tra Bagnolo in Piano e il casello A 1 di Reggio Emilia,12625,00,11343,1282,10135,2490,12625,0
2019/01,452,17/01/2019,4,SP 3 sulla variante tra Bagnolo in Piano e il casello A 1 di Reggio Emilia,12441,00,11150,1291,9857,2584,12441,0
2019/01,452,18/01/2019,5,SP 3 sulla variante tra Bagnolo in Piano e il casello A 1 di Reggio Emilia,12884,00,11660,1224,9971,2913,12884,0
2019/01,452,19/01/2019,6,SP 3 sulla variante tra Bagnolo in Piano e il casello A 1 di Reggio Emilia,9236,00,9054,182,6343,2893,0,9236
2019/01,452,20/01/2019,7,SP 3 sulla variante tra Bagnolo in Piano e il casello A 1 di Reggio Emilia,7975,00,7925,50,5525,2450,0,7975
2019/01,452,21/01/2019,1,SP 3 sulla variante tra Bagnolo in Piano e il casello A 1 di Reggio Emilia,12144,00,10856,1288,9738,2406,12144,0
2019/01,452,22/01/2019,2,SP 3 sulla variante tra Bagnolo in Piano e il casello A 1 di Reggio Emilia,12373,00,11077,1296,10008,2365,12373,0
2019/01,452,23/01/2019,3,SP 3 sulla variante tra Bagnolo in Piano e il casello A 1 di Reggio Emilia,11925,00,10713,1212,9589,2336,11925,0
2019/01,452,24/01/2019,4,SP 3 sulla variante tra Bagnolo in Piano e il casello A 1 di Reggio Emilia,12042,00,10772,1270,9529,2513,12042,0
2019/01,452,25/01/2019,5,SP 3 sulla variante tra Bagnolo in Piano e il casello A 1 di Reggio Emilia,12705,00,11528,1177,9928,2777,12705,0
2019/01,452,26/01/2019,6,SP 3 sulla variante tra Bagnolo in Piano e il casello A 1 di Reggio Emilia,9579,00,9348,231,6831,2748,0,9579
2019/01,452,27/01/2019,7,SP 3 sulla variante tra Bagnolo in Piano e il casello A 1 di Reggio Emilia,8008,00,7952,56,5628,2380,0,8008
2019/01,452,28/01/2019,1,SP 3 sulla variante tra Bagnolo in Piano e il casello A 1 di Reggio Emilia,11815,00,10547,1268,9511,2304,11815,0
2019/01,453,15/01/2019,2,Asse viario Modena-Sassuolo tra Modena e Baggiovara,53868,10,48000,5867,43010,10858,53868,0
2019/01,453,16/01/2019,3,Asse viario Modena-Sassuolo tra Modena e Baggiovara,54308,20,48432,5874,43377,10931,54308,0
2019/01,453,17/01/2019,4,Asse viario Modena-Sassuolo tra Modena e Baggiovara,54495,10,48299,6195,43125,11370,54495,0
2019/01,453,18/01/2019,5,Asse viario Modena-Sassuolo tra Modena e Baggiovara,55628,30,50013,5612,43406,12222,55628,0
2019/01,453,19/01/2019,6,Asse viario Modena-Sassuolo tra Modena e Baggiovara,41197,00,40363,834,28951,12246,0,41197
2019/01,453,20/01/2019,7,Asse viario Modena-Sassuolo tra Modena e Baggiovara,33865,00,33676,189,23357,10508,0,33865
2019/01,453,21/01/2019,1,Asse viario Modena-Sassuolo tra Modena e Baggiovara,52445,30,46963,5479,42341,10104,52445,0
2019/01,453,22/01/2019,2,Asse viario Modena-Sassuolo tra Modena e Baggiovara,52981,10,47365,5615,42389,10592,52981,0
2019/01,453,23/01/2019,3,Asse viario Modena-Sassuolo tra Modena e Baggiovara,51800,60,46037,5757,41746,10054,51800,0
2019/01,453,24/01/2019,4,Asse viario Modena-Sassuolo tra Modena e Baggiovara,49718,40,43951,5763,39247,10471,49718,0
2019/01,453,25/01/2019,5,Asse viario Modena-Sassuolo tra Modena e Baggiovara,54738,00,49151,5587,42660,12078,54738,0
2019/01,453,26/01/2019,6,Asse viario Modena-Sassuolo tra Modena e Baggiovara,40445,10,39600,844,28629,11816,0,40445
2019/01,453,27/01/2019,7,Asse viario Modena-Sassuolo tra Modena e Baggiovara,31647,00,31480,167,22013,9634,0,31647
2019/01,453,28/01/2019,1,Asse viario Modena-Sassuolo tra Modena e Baggiovara,51750,00,46520,5230,41702,10048,51750,0
2019/01,500,27/01/2019,7,SP 513R fra San Polo d'Enza e Canossa (c/o bivio SP 54),,,,,,,,
2019/01,500,28/01/2019,1,SP 513R fra San Polo d'Enza e Canossa (c/o bivio SP 54),,,,,,,,
2019/01,502,15/01/2019,2,SP 26 tra località Pioppa e viadotto A 1 (c/o Zola Predosa),13985,00,12977,1008,11624,2361,13985,0
2019/01,502,16/01/2019,3,SP 26 tra località Pioppa e viadotto A 1 (c/o Zola Predosa),13723,00,12741,982,11381,2342,13723,0
2019/01,502,17/01/2019,4,SP 26 tra località Pioppa e viadotto A 1 (c/o Zola Predosa),13992,00,13046,946,11501,2491,13992,0
2019/01,502,18/01/2019,5,SP 26 tra località Pioppa e viadotto A 1 (c/o Zola Predosa),14337,00,13339,998,11678,2659,14337,0
2019/01,502,19/01/2019,6,SP 26 tra località Pioppa e viadotto A 1 (c/o Zola Predosa),8824,00,8698,126,6646,2178,0,8824
2019/01,502,20/01/2019,7,SP 26 tra località Pioppa e viadotto A 1 (c/o Zola Predosa),7087,00,7038,49,5384,1703,0,7087
2019/01,502,21/01/2019,1,SP 26 tra località Pioppa e viadotto A 1 (c/o Zola Predosa),13256,20,12298,956,11161,2095,13256,0
2019/01,502,22/01/2019,2,SP 26 tra località Pioppa e viadotto A 1 (c/o Zola Predosa),13176,30,12227,946,11066,2110,13176,0
2019/01,502,23/01/2019,3,SP 26 tra località Pioppa e viadotto A 1 (c/o Zola Predosa),13486,10,12500,985,11141,2345,13486,0
2019/01,502,24/01/2019,4,SP 26 tra località Pioppa e viadotto A 1 (c/o Zola Predosa),12833,10,11897,935,10643,2190,12833,0
2019/01,502,25/01/2019,5,SP 26 tra località Pioppa e viadotto A 1 (c/o Zola Predosa),13909,00,12930,979,11486,2423,13909,0
2019/01,502,26/01/2019,6,SP 26 tra località Pioppa e viadotto A 1 (c/o Zola Predosa),8746,00,8591,155,6474,2272,0,8746
2019/01,502,27/01/2019,7,SP 26 tra località Pioppa e viadotto A 1 (c/o Zola Predosa),6756,00,6709,47,5195,1561,0,6756
2019/01,502,28/01/2019,1,SP 26 tra località Pioppa e viadotto A 1 (c/o Zola Predosa),12759,10,11803,955,10802,1957,12759,0
2019/01,504,15/01/2019,2,SP 7 dalla località Ca de' Mandorli al bivio per Castel de Britti,11324,10,10953,370,8823,2501,11324,0
2019/01,504,16/01/2019,3,SP 7 dalla località Ca de' Mandorli al bivio per Castel de Britti,11338,00,10911,427,8922,2416,11338,0
2019/01,504,17/01/2019,4,SP 7 dalla località Ca de' Mandorli al bivio per Castel de Britti,11328,10,10877,450,8749,2579,11328,0
2019/01,504,18/01/2019,5,SP 7 dalla località Ca de' Mandorli al bivio per Castel de Britti,11376,00,11021,355,8791,2585,11376,0
2019/01,504,19/01/2019,6,SP 7 dalla località Ca de' Mandorli al bivio per Castel de Britti,9976,00,9829,147,7569,2407,0,9976
2019/01,504,20/01/2019,7,SP 7 dalla località Ca de' Mandorli al bivio per Castel de Britti,7597,00,7556,41,5719,1878,0,7597
2019/01,504,21/01/2019,1,SP 7 dalla località Ca de' Mandorli al bivio per Castel de Britti,10849,00,10539,310,8633,2216,10849,0
2019/01,504,22/01/2019,2,SP 7 dalla località Ca de' Mandorli al bivio per Castel de Britti,10308,00,10025,283,8281,2027,10308,0
2019/01,504,23/01/2019,3,SP 7 dalla località Ca de' Mandorli al bivio per Castel de Britti,10066,00,9793,273,7904,2162,10066,0
2019/01,504,24/01/2019,4,SP 7 dalla località Ca de' Mandorli al bivio per Castel de Britti,9418,00,9178,240,7217,2201,9418,0
2019/01,504,25/01/2019,5,SP 7 dalla località Ca de' Mandorli al bivio per Castel de Britti,11217,00,10953,264,8651,2566,11217,0
2019/01,504,26/01/2019,6,SP 7 dalla località Ca de' Mandorli al bivio per Castel de Britti,10041,00,9924,117,7558,2483,0,10041
2019/01,504,27/01/2019,7,SP 7 dalla località Ca de' Mandorli al bivio per Castel de Britti,7659,00,7636,23,5778,1881,0,7659
2019/01,504,28/01/2019,1,SP 7 dalla località Ca de' Mandorli al bivio per Castel de Britti,10526,00,10253,273,8242,2284,10526,0
2019/01,505,15/01/2019,2,SP 610 tra casello A 1 (Imola) e bivio SP 51 per Castel Guelfo di Bologna,13248,40,10978,2266,10424,2824,13248,0
2019/01,505,16/01/2019,3,SP 610 tra casello A 1 (Imola) e bivio SP 51 per Castel Guelfo di Bologna,13542,10,11242,2299,10623,2919,13542,0
2019/01,505,17/01/2019,4,SP 610 tra casello A 1 (Imola) e bivio SP 51 per Castel Guelfo di Bologna,13722,00,11415,2307,10711,3011,13722,0
2019/01,505,18/01/2019,5,SP 610 tra casello A 1 (Imola) e bivio SP 51 per Castel Guelfo di Bologna,14027,10,11880,2146,10733,3294,14027,0
2019/01,505,19/01/2019,6,SP 610 tra casello A 1 (Imola) e bivio SP 51 per Castel Guelfo di Bologna,10298,00,9931,367,7156,3142,0,10298
2019/01,505,20/01/2019,7,SP 610 tra casello A 1 (Imola) e bivio SP 51 per Castel Guelfo di Bologna,8269,00,8133,136,5776,2493,0,8269
2019/01,505,21/01/2019,1,SP 610 tra casello A 1 (Imola) e bivio SP 51 per Castel Guelfo di Bologna,13207,10,10971,2235,10591,2616,13207,0
2019/01,505,22/01/2019,2,SP 610 tra casello A 1 (Imola) e bivio SP 51 per Castel Guelfo di Bologna,13252,20,11051,2199,10588,2664,13252,0
2019/01,505,23/01/2019,3,SP 610 tra casello A 1 (Imola) e bivio SP 51 per Castel Guelfo di Bologna,13214,30,10954,2257,10358,2856,13214,0
2019/01,505,24/01/2019,4,SP 610 tra casello A 1 (Imola) e bivio SP 51 per Castel Guelfo di Bologna,13680,00,11396,2284,10728,2952,13680,0
2019/01,505,25/01/2019,5,SP 610 tra casello A 1 (Imola) e bivio SP 51 per Castel Guelfo di Bologna,13719,40,11640,2075,10607,3112,13719,0
2019/01,505,26/01/2019,6,SP 610 tra casello A 1 (Imola) e bivio SP 51 per Castel Guelfo di Bologna,10528,50,10121,402,7488,3040,0,10528
2019/01,505,27/01/2019,7,SP 610 tra casello A 1 (Imola) e bivio SP 51 per Castel Guelfo di Bologna,8266,00,8112,154,5712,2554,0,8266
2019/01,505,28/01/2019,1,SP 610 tra casello A 1 (Imola) e bivio SP 51 per Castel Guelfo di Bologna,12879,20,10765,2112,10253,2626,12879,0
2019/01,600,15/01/2019,2,SP 19 tra SP31 e Medicina,7798,10,6908,889,6452,1346,7798,0
2019/01,600,16/01/2019,3,SP 19 tra SP31 e Medicina,7569,00,6725,844,6265,1304,7569,0
2019/01,600,17/01/2019,4,SP 19 tra SP31 e Medicina,7618,10,6807,810,6258,1360,7618,0
2019/01,600,18/01/2019,5,SP 19 tra SP31 e Medicina,7742,20,6971,769,6132,1610,7742,0
2019/01,600,19/01/2019,6,SP 19 tra SP31 e Medicina,6161,00,6002,159,4686,1475,0,6161
2019/01,600,20/01/2019,7,SP 19 tra SP31 e Medicina,5452,00,5432,20,4252,1200,0,5452
2019/01,600,21/01/2019,1,SP 19 tra SP31 e Medicina,7611,00,6813,798,6293,1318,7611,0
2019/01,600,22/01/2019,2,SP 19 tra SP31 e Medicina,7127,10,6387,739,5901,1226,7127,0
2019/01,600,23/01/2019,3,SP 19 tra SP31 e Medicina,7054,10,6301,752,5812,1242,7054,0
2019/01,600,24/01/2019,4,SP 19 tra SP31 e Medicina,7227,00,6479,748,5927,1300,7227,0
2019/01,600,25/01/2019,5,SP 19 tra SP31 e Medicina,7545,00,6767,778,6123,1422,7545,0
2019/01,600,26/01/2019,6,SP 19 tra SP31 e Medicina,5065,00,4944,121,3619,1446,0,5065
2019/01,600,27/01/2019,7,SP 19 tra SP31 e Medicina,4697,00,4675,22,3525,1172,0,4697
2019/01,600,28/01/2019,1,SP 19 tra SP31 e Medicina,7230,00,6401,829,6034,1196,7230,0
2019/01,601,15/01/2019,2,SP 21 da Castel San Pietro al bivio SP 35 (c/o Sassoleone),3058,00,2970,88,2432,626,3058,0
2019/01,601,16/01/2019,3,SP 21 da Castel San Pietro al bivio SP 35 (c/o Sassoleone),3012,10,2935,76,2404,608,3012,0
2019/01,601,17/01/2019,4,SP 21 da Castel San Pietro al bivio SP 35 (c/o Sassoleone),3044,00,2948,96,2384,660,3044,0
2019/01,601,18/01/2019,5,SP 21 da Castel San Pietro al bivio SP 35 (c/o Sassoleone),3085,00,3012,73,2396,689,3085,0
2019/01,601,19/01/2019,6,SP 21 da Castel San Pietro al bivio SP 35 (c/o Sassoleone),3053,00,3014,39,2369,684,0,3053
2019/01,601,20/01/2019,7,SP 21 da Castel San Pietro al bivio SP 35 (c/o Sassoleone),2639,00,2626,13,2032,607,0,2639
2019/01,601,21/01/2019,1,SP 21 da Castel San Pietro al bivio SP 35 (c/o Sassoleone),2832,00,2766,66,2235,597,2832,0
2019/01,601,22/01/2019,2,SP 21 da Castel San Pietro al bivio SP 35 (c/o Sassoleone),2799,00,2729,70,2252,547,2799,0
2019/01,601,23/01/2019,3,SP 21 da Castel San Pietro al bivio SP 35 (c/o Sassoleone),2773,00,2719,54,2155,618,2773,0
2019/01,601,24/01/2019,4,SP 21 da Castel San Pietro al bivio SP 35 (c/o Sassoleone),2554,00,2483,71,1983,571,2554,0
2019/01,601,25/01/2019,5,SP 21 da Castel San Pietro al bivio SP 35 (c/o Sassoleone),3035,00,2983,52,2347,688,3035,0
2019/01,601,26/01/2019,6,SP 21 da Castel San Pietro al bivio SP 35 (c/o Sassoleone),3455,00,3430,25,2658,797,0,3455
2019/01,601,27/01/2019,7,SP 21 da Castel San Pietro al bivio SP 35 (c/o Sassoleone),2967,00,2960,7,2215,752,0,2967
2019/01,601,28/01/2019,1,SP 21 da Castel San Pietro al bivio SP 35 (c/o Sassoleone),3011,00,2957,54,2377,634,3011,0
2019/01,602,15/01/2019,2,SP 9_1 da Crevalcore alla località Caselle,1651,00,1576,75,1277,374,1651,0
2019/01,602,16/01/2019,3,SP 9_1 da Crevalcore alla località Caselle,1664,20,1583,79,1353,311,1664,0
2019/01,602,17/01/2019,4,SP 9_1 da Crevalcore alla località Caselle,1632,00,1576,56,1345,287,1632,0
2019/01,602,18/01/2019,5,SP 9_1 da Crevalcore alla località Caselle,1656,00,1584,72,1322,334,1656,0
2019/01,602,19/01/2019,6,SP 9_1 da Crevalcore alla località Caselle,1381,00,1356,25,1053,328,0,1381
2019/01,602,20/01/2019,7,SP 9_1 da Crevalcore alla località Caselle,1041,00,1038,3,800,241,0,1041
2019/01,602,21/01/2019,1,SP 9_1 da Crevalcore alla località Caselle,1654,00,1581,73,1361,293,1654,0
2019/01,602,22/01/2019,2,SP 9_1 da Crevalcore alla località Caselle,1629,00,1548,81,1343,286,1629,0
2019/01,602,23/01/2019,3,SP 9_1 da Crevalcore alla località Caselle,1612,00,1534,78,1281,331,1612,0
2019/01,602,24/01/2019,4,SP 9_1 da Crevalcore alla località Caselle,1535,00,1462,73,1244,291,1535,0
2019/01,602,25/01/2019,5,SP 9_1 da Crevalcore alla località Caselle,1724,00,1647,77,1397,327,1724,0
2019/01,602,26/01/2019,6,SP 9_1 da Crevalcore alla località Caselle,1465,00,1432,33,1120,345,0,1465
2019/01,602,27/01/2019,7,SP 9_1 da Crevalcore alla località Caselle,1125,00,1119,6,852,273,0,1125
2019/01,602,28/01/2019,1,SP 9_1 da Crevalcore alla località Caselle,1485,10,1418,66,1207,278,1485,0
2019/01,603,15/01/2019,2,SP 10 dalla località Decima ai confini provinciali di Bologna e Ferrara,3962,10,3808,153,3047,915,3962,0
2019/01,603,16/01/2019,3,SP 10 dalla località Decima ai confini provinciali di Bologna e Ferrara,3964,00,3788,176,3059,905,3964,0
2019/01,603,17/01/2019,4,SP 10 dalla località Decima ai confini provinciali di Bologna e Ferrara,4039,00,3865,174,3041,998,4039,0
2019/01,603,18/01/2019,5,SP 10 dalla località Decima ai confini provinciali di Bologna e Ferrara,4248,00,4083,165,3144,1104,4248,0
2019/01,603,19/01/2019,6,SP 10 dalla località Decima ai confini provinciali di Bologna e Ferrara,3214,00,3168,46,2237,977,0,3214
2019/01,603,20/01/2019,7,SP 10 dalla località Decima ai confini provinciali di Bologna e Ferrara,2353,00,2345,8,1608,745,0,2353
2019/01,603,21/01/2019,1,SP 10 dalla località Decima ai confini provinciali di Bologna e Ferrara,3699,00,3546,153,2883,816,3699,0
2019/01,603,22/01/2019,2,SP 10 dalla località Decima ai confini provinciali di Bologna e Ferrara,3953,00,3805,148,3077,876,3953,0
2019/01,603,23/01/2019,3,SP 10 dalla località Decima ai confini provinciali di Bologna e Ferrara,3915,10,3762,152,3008,907,3915,0
2019/01,603,24/01/2019,4,SP 10 dalla località Decima ai confini provinciali di Bologna e Ferrara,3914,00,3765,149,2914,1000,3914,0
2019/01,603,25/01/2019,5,SP 10 dalla località Decima ai confini provinciali di Bologna e Ferrara,4058,00,3904,154,3013,1045,4058,0
2019/01,603,26/01/2019,6,SP 10 dalla località Decima ai confini provinciali di Bologna e Ferrara,3181,00,3132,49,2219,962,0,3181
2019/01,603,27/01/2019,7,SP 10 dalla località Decima ai confini provinciali di Bologna e Ferrara,2513,00,2509,4,1768,745,0,2513
2019/01,603,28/01/2019,1,SP 10 dalla località Decima ai confini provinciali di Bologna e Ferrara,3738,00,3574,164,2848,890,3738,0
2019/01,604,15/01/2019,2,SP 37 da Sasso Marconi alla intersezione SP 58,5072,00,4860,212,4302,770,5072,0
2019/01,604,16/01/2019,3,SP 37 da Sasso Marconi alla intersezione SP 58,5187,10,4962,224,4437,750,5187,0
2019/01,604,17/01/2019,4,SP 37 da Sasso Marconi alla intersezione SP 58,5047,10,4818,228,4235,812,5047,0
2019/01,604,18/01/2019,5,SP 37 da Sasso Marconi alla intersezione SP 58,5144,10,4908,235,4267,877,5144,0
2019/01,604,19/01/2019,6,SP 37 da Sasso Marconi alla intersezione SP 58,3385,00,3354,31,2664,721,0,3385
2019/01,604,20/01/2019,7,SP 37 da Sasso Marconi alla intersezione SP 58,3100,00,3085,15,2494,606,0,3100
2019/01,604,21/01/2019,1,SP 37 da Sasso Marconi alla intersezione SP 58,4600,00,4404,196,3942,658,4600,0
2019/01,604,22/01/2019,2,SP 37 da Sasso Marconi alla intersezione SP 58,4337,00,4128,209,3785,552,4337,0
2019/01,604,23/01/2019,3,SP 37 da Sasso Marconi alla intersezione SP 58,4005,00,3841,164,3424,581,4005,0
2019/01,604,24/01/2019,4,SP 37 da Sasso Marconi alla intersezione SP 58,3447,10,3311,135,2865,582,3447,0
2019/01,604,25/01/2019,5,SP 37 da Sasso Marconi alla intersezione SP 58,4719,10,4545,173,3984,735,4719,0
2019/01,604,26/01/2019,6,SP 37 da Sasso Marconi alla intersezione SP 58,3408,00,3392,16,2676,732,0,3408
2019/01,604,27/01/2019,7,SP 37 da Sasso Marconi alla intersezione SP 58,2859,00,2852,7,2215,644,0,2859
2019/01,604,28/01/2019,1,SP 37 da Sasso Marconi alla intersezione SP 58,4462,10,4279,182,3758,704,4462,0
2019/01,605,15/01/2019,2,SP 324 da Silla alla intersezione SP 623,7391,10,7062,328,6111,1280,7391,0
2019/01,605,16/01/2019,3,SP 324 da Silla alla intersezione SP 623,7181,10,6852,328,5954,1227,7181,0
2019/01,605,17/01/2019,4,SP 324 da Silla alla intersezione SP 623,7171,00,6846,325,5918,1253,7171,0
2019/01,605,18/01/2019,5,SP 324 da Silla alla intersezione SP 623,7539,10,7218,320,6035,1504,7539,0
2019/01,605,19/01/2019,6,SP 324 da Silla alla intersezione SP 623,6224,00,6130,94,4618,1606,0,6224
2019/01,605,20/01/2019,7,SP 324 da Silla alla intersezione SP 623,4756,00,4721,35,3603,1153,0,4756
2019/01,605,21/01/2019,1,SP 324 da Silla alla intersezione SP 623,6819,00,6518,301,5756,1063,6819,0
2019/01,605,22/01/2019,2,SP 324 da Silla alla intersezione SP 623,6474,10,6165,308,5431,1043,6474,0
2019/01,605,23/01/2019,3,SP 324 da Silla alla intersezione SP 623,6172,00,5879,293,5133,1039,6172,0
2019/01,605,24/01/2019,4,SP 324 da Silla alla intersezione SP 623,5432,00,5198,234,4417,1015,5432,0
2019/01,605,25/01/2019,5,SP 324 da Silla alla intersezione SP 623,7669,20,7357,310,6127,1542,7669,0
2019/01,605,26/01/2019,6,SP 324 da Silla alla intersezione SP 623,7126,10,7039,86,5668,1458,0,7126
2019/01,605,27/01/2019,7,SP 324 da Silla alla intersezione SP 623,4861,00,4813,48,3829,1032,0,4861
2019/01,605,28/01/2019,1,SP 324 da Silla alla intersezione SP 623,6909,00,6626,283,5747,1162,6909,0
2019/01,606,15/01/2019,2,SP 70 Cispadana in località Sant'Agostino/San Carlo,5908,10,5453,454,4807,1101,5908,0
2019/01,606,16/01/2019,3,SP 70 Cispadana in località Sant'Agostino/San Carlo,5630,30,5191,436,4508,1122,5630,0
2019/01,606,17/01/2019,4,SP 70 Cispadana in località Sant'Agostino/San Carlo,5766,10,5315,450,4628,1138,5766,0
2019/01,606,18/01/2019,5,SP 70 Cispadana in località Sant'Agostino/San Carlo,5773,00,5343,430,4563,1210,5773,0
2019/01,606,20/01/2019,7,SP 70 Cispadana in località Sant'Agostino/San Carlo,3911,00,3899,12,2901,1010,0,3911
2019/01,606,21/01/2019,1,SP 70 Cispadana in località Sant'Agostino/San Carlo,5953,00,5467,486,4958,995,5953,0
2019/01,606,23/01/2019,3,SP 70 Cispadana in località Sant'Agostino/San Carlo,5681,30,5199,479,4721,960,5681,0
2019/01,606,24/01/2019,4,SP 70 Cispadana in località Sant'Agostino/San Carlo,5746,30,5311,432,4633,1113,5746,0
2019/01,606,25/01/2019,5,SP 70 Cispadana in località Sant'Agostino/San Carlo,6043,20,5588,453,4766,1277,6043,0
2019/01,606,26/01/2019,6,SP 70 Cispadana in località Sant'Agostino/San Carlo,4358,00,4296,62,3370,988,0,4358
2019/01,606,27/01/2019,7,SP 70 Cispadana in località Sant'Agostino/San Carlo,4032,20,4014,16,3136,896,0,4032
2019/01,607,15/01/2019,2,SP 1 da Villafranca di Forlì al confine provinciale,4212,10,3901,310,3400,812,4212,0
2019/01,607,16/01/2019,3,SP 1 da Villafranca di Forlì al confine provinciale,4286,00,4002,284,3432,854,4286,0
2019/01,607,17/01/2019,4,SP 1 da Villafranca di Forlì al confine provinciale,4183,00,3895,288,3324,859,4183,0
2019/01,607,18/01/2019,5,SP 1 da Villafranca di Forlì al confine provinciale,4261,00,3964,297,3330,931,4261,0
2019/01,607,19/01/2019,6,SP 1 da Villafranca di Forlì al confine provinciale,3259,00,3197,62,2364,895,0,3259
2019/01,607,20/01/2019,7,SP 1 da Villafranca di Forlì al confine provinciale,2842,00,2836,6,2132,710,0,2842
2019/01,607,21/01/2019,1,SP 1 da Villafranca di Forlì al confine provinciale,3907,00,3623,284,3228,679,3907,0
2019/01,607,22/01/2019,2,SP 1 da Villafranca di Forlì al confine provinciale,3798,00,3560,238,3168,630,3798,0
2019/01,607,23/01/2019,3,SP 1 da Villafranca di Forlì al confine provinciale,3913,00,3653,260,3187,726,3913,0
2019/01,607,24/01/2019,4,SP 1 da Villafranca di Forlì al confine provinciale,4054,00,3791,263,3249,805,4054,0
2019/01,607,25/01/2019,5,SP 1 da Villafranca di Forlì al confine provinciale,4156,10,3898,257,3296,860,4156,0
2019/01,607,26/01/2019,6,SP 1 da Villafranca di Forlì al confine provinciale,3214,00,3159,55,2337,877,0,3214
2019/01,607,27/01/2019,7,SP 1 da Villafranca di Forlì al confine provinciale,2930,00,2918,12,2231,699,0,2930
2019/01,607,28/01/2019,1,SP 1 da Villafranca di Forlì al confine provinciale,3924,00,3687,237,3183,741,3924,0
2019/01,608,15/01/2019,2,SP 140 da Diegaro (SS 9) a Pievesestina (E 45),13366,20,11990,1374,10688,2678,13366,0
2019/01,608,16/01/2019,3,SP 140 da Diegaro (SS 9) a Pievesestina (E 45),13338,10,12043,1294,10583,2755,13338,0
2019/01,608,17/01/2019,4,SP 140 da Diegaro (SS 9) a Pievesestina (E 45),13413,00,12084,1329,10420,2993,13413,0
2019/01,608,18/01/2019,5,SP 140 da Diegaro (SS 9) a Pievesestina (E 45),13703,00,12397,1306,10681,3022,13703,0
2019/01,608,19/01/2019,6,SP 140 da Diegaro (SS 9) a Pievesestina (E 45),10632,10,10154,477,7697,2935,0,10632
2019/01,608,20/01/2019,7,SP 140 da Diegaro (SS 9) a Pievesestina (E 45),8198,00,8056,142,5898,2300,0,8198
2019/01,608,21/01/2019,1,SP 140 da Diegaro (SS 9) a Pievesestina (E 45),13268,00,11996,1272,10576,2692,13268,0
2019/01,608,22/01/2019,2,SP 140 da Diegaro (SS 9) a Pievesestina (E 45),12206,10,11005,1200,9809,2397,12206,0
2019/01,608,23/01/2019,3,SP 140 da Diegaro (SS 9) a Pievesestina (E 45),12798,00,11534,1264,10246,2552,12798,0
2019/01,608,24/01/2019,4,SP 140 da Diegaro (SS 9) a Pievesestina (E 45),12994,00,11780,1214,10257,2737,12994,0
2019/01,608,25/01/2019,5,SP 140 da Diegaro (SS 9) a Pievesestina (E 45),13838,00,12503,1335,10707,3131,13838,0
2019/01,608,26/01/2019,6,SP 140 da Diegaro (SS 9) a Pievesestina (E 45),10772,00,10269,503,7789,2983,0,10772
2019/01,608,27/01/2019,7,SP 140 da Diegaro (SS 9) a Pievesestina (E 45),7928,20,7802,124,5692,2236,0,7928
2019/01,608,28/01/2019,1,SP 140 da Diegaro (SS 9) a Pievesestina (E 45),13197,00,11919,1278,10634,2563,13197,0
2019/01,609,15/01/2019,2,SP 4 dal bivio SP22 (per SS 12) al bivio SP 26 (per Pavullo nel Frignano),3518,10,3214,303,2794,724,3518,0
2019/01,609,16/01/2019,3,SP 4 dal bivio SP22 (per SS 12) al bivio SP 26 (per Pavullo nel Frignano),3765,20,3433,330,3020,745,3765,0
2019/01,609,17/01/2019,4,SP 4 dal bivio SP22 (per SS 12) al bivio SP 26 (per Pavullo nel Frignano),3418,00,3102,316,2714,704,3418,0
2019/01,609,18/01/2019,5,SP 4 dal bivio SP22 (per SS 12) al bivio SP 26 (per Pavullo nel Frignano),3813,20,3482,329,2900,913,3813,0
2019/01,609,19/01/2019,6,SP 4 dal bivio SP22 (per SS 12) al bivio SP 26 (per Pavullo nel Frignano),3806,00,3707,99,3030,776,0,3806
2019/01,609,20/01/2019,7,SP 4 dal bivio SP22 (per SS 12) al bivio SP 26 (per Pavullo nel Frignano),4858,00,4820,38,4073,785,0,4858
2019/01,609,21/01/2019,1,SP 4 dal bivio SP22 (per SS 12) al bivio SP 26 (per Pavullo nel Frignano),3242,00,2970,272,2588,654,3242,0
2019/01,609,22/01/2019,2,SP 4 dal bivio SP22 (per SS 12) al bivio SP 26 (per Pavullo nel Frignano),3041,00,2732,309,2455,586,3041,0
2019/01,609,23/01/2019,3,SP 4 dal bivio SP22 (per SS 12) al bivio SP 26 (per Pavullo nel Frignano),2925,00,2600,325,2309,616,2925,0
2019/01,609,24/01/2019,4,SP 4 dal bivio SP22 (per SS 12) al bivio SP 26 (per Pavullo nel Frignano),2274,00,2099,175,1768,506,2274,0
2019/01,609,25/01/2019,5,SP 4 dal bivio SP22 (per SS 12) al bivio SP 26 (per Pavullo nel Frignano),4196,00,3819,377,3311,885,4196,0
2019/01,609,26/01/2019,6,SP 4 dal bivio SP22 (per SS 12) al bivio SP 26 (per Pavullo nel Frignano),5858,00,5765,93,5012,846,0,5858
2019/01,609,27/01/2019,7,SP 4 dal bivio SP22 (per SS 12) al bivio SP 26 (per Pavullo nel Frignano),5350,00,5300,50,4557,793,0,5350
2019/01,609,28/01/2019,1,SP 4 dal bivio SP22 (per SS 12) al bivio SP 26 (per Pavullo nel Frignano),3269,10,2966,302,2630,639,3269,0
2019/01,610,15/01/2019,2,SP 11 da Soragna a Roncole Verdi,3625,10,3314,310,2943,682,3625,0
2019/01,610,16/01/2019,3,SP 11 da Soragna a Roncole Verdi,3625,00,3285,340,2958,667,3625,0
2019/01,610,17/01/2019,4,SP 11 da Soragna a Roncole Verdi,4306,00,3851,455,3633,673,4306,0
2019/01,610,18/01/2019,5,SP 11 da Soragna a Roncole Verdi,3741,00,3490,251,2930,811,3741,0
2019/01,610,19/01/2019,6,SP 11 da Soragna a Roncole Verdi,2894,10,2790,103,2127,767,0,2894
2019/01,610,20/01/2019,7,SP 11 da Soragna a Roncole Verdi,2560,00,2526,34,1911,649,0,2560
2019/01,610,21/01/2019,1,SP 11 da Soragna a Roncole Verdi,3683,10,3417,265,2997,686,3683,0
2019/01,610,22/01/2019,2,SP 11 da Soragna a Roncole Verdi,3524,00,3227,297,2854,670,3524,0
2019/01,610,23/01/2019,3,SP 11 da Soragna a Roncole Verdi,3594,00,3298,296,2944,650,3594,0
2019/01,610,24/01/2019,4,SP 11 da Soragna a Roncole Verdi,3577,00,3281,296,2909,668,3577,0
2019/01,610,25/01/2019,5,SP 11 da Soragna a Roncole Verdi,3560,00,3309,251,2760,800,3560,0
2019/01,610,26/01/2019,6,SP 11 da Soragna a Roncole Verdi,2768,00,2672,96,2022,746,0,2768
2019/01,610,27/01/2019,7,SP 11 da Soragna a Roncole Verdi,2352,00,2320,32,1740,612,0,2352
2019/01,610,28/01/2019,1,SP 11 da Soragna a Roncole Verdi,3427,10,3169,257,2739,688,3427,0
2019/01,611,15/01/2019,2,SP 357R da Fornovo di Taro al bivio SP 93 per Fidenza,,,,,,,,
2019/01,611,16/01/2019,3,SP 357R da Fornovo di Taro al bivio SP 93 per Fidenza,,,,,,,,
2019/01,611,17/01/2019,4,SP 357R da Fornovo di Taro al bivio SP 93 per Fidenza,,,,,,,,
2019/01,611,18/01/2019,5,SP 357R da Fornovo di Taro al bivio SP 93 per Fidenza,,,,,,,,
2019/01,611,19/01/2019,6,SP 357R da Fornovo di Taro al bivio SP 93 per Fidenza,,,,,,,,
2019/01,611,20/01/2019,7,SP 357R da Fornovo di Taro al bivio SP 93 per Fidenza,,,,,,,,
2019/01,611,21/01/2019,1,SP 357R da Fornovo di Taro al bivio SP 93 per Fidenza,,,,,,,,
2019/01,611,22/01/2019,2,SP 357R da Fornovo di Taro al bivio SP 93 per Fidenza,,,,,,,,
2019/01,611,23/01/2019,3,SP 357R da Fornovo di Taro al bivio SP 93 per Fidenza,,,,,,,,
2019/01,611,24/01/2019,4,SP 357R da Fornovo di Taro al bivio SP 93 per Fidenza,,,,,,,,
2019/01,611,25/01/2019,5,SP 357R da Fornovo di Taro al bivio SP 93 per Fidenza,,,,,,,,
2019/01,611,26/01/2019,6,SP 357R da Fornovo di Taro al bivio SP 93 per Fidenza,,,,,,,,
2019/01,611,27/01/2019,7,SP 357R da Fornovo di Taro al bivio SP 93 per Fidenza,,,,,,,,
2019/01,611,28/01/2019,1,SP 357R da Fornovo di Taro al bivio SP 93 per Fidenza,,,,,,,,
2019/01,612,15/01/2019,2,SP 665R dalla località Pilastro a Langhirano,17341,10,16312,1028,14141,3200,17341,0
2019/01,612,16/01/2019,3,SP 665R dalla località Pilastro a Langhirano,17373,00,16347,1026,14114,3259,17373,0
2019/01,612,17/01/2019,4,SP 665R dalla località Pilastro a Langhirano,17025,00,15970,1055,13739,3286,17025,0
2019/01,612,18/01/2019,5,SP 665R dalla località Pilastro a Langhirano,17571,00,16471,1100,14010,3561,17571,0
2019/01,612,19/01/2019,6,SP 665R dalla località Pilastro a Langhirano,13637,10,13388,248,10211,3426,0,13637
2019/01,612,20/01/2019,7,SP 665R dalla località Pilastro a Langhirano,10944,00,10893,51,8222,2722,0,10944
2019/01,612,21/01/2019,1,SP 665R dalla località Pilastro a Langhirano,16865,00,15866,999,13894,2971,16865,0
2019/01,612,22/01/2019,2,SP 665R dalla località Pilastro a Langhirano,17162,00,16109,1053,14107,3055,17162,0
2019/01,612,23/01/2019,3,SP 665R dalla località Pilastro a Langhirano,16131,10,15127,1003,13326,2805,16131,0
2019/01,612,24/01/2019,4,SP 665R dalla località Pilastro a Langhirano,15759,00,14817,942,12705,3054,15759,0
2019/01,612,25/01/2019,5,SP 665R dalla località Pilastro a Langhirano,17541,00,16492,1049,14022,3519,17541,0
2019/01,612,26/01/2019,6,SP 665R dalla località Pilastro a Langhirano,14368,20,14120,246,11061,3307,0,14368
2019/01,612,27/01/2019,7,SP 665R dalla località Pilastro a Langhirano,11170,00,11117,53,8549,2621,0,11170
2019/01,612,28/01/2019,1,SP 665R dalla località Pilastro a Langhirano,16535,00,15580,955,13662,2873,16535,0
2019/01,613,15/01/2019,2,SP 16 dalla località Basilicanova al bivio SP 32 centro abitato Mamiano,6687,00,6438,249,5297,1390,6687,0
2019/01,613,16/01/2019,3,SP 16 dalla località Basilicanova al bivio SP 32 centro abitato Mamiano,6602,00,6344,258,5266,1336,6602,0
2019/01,613,17/01/2019,4,SP 16 dalla località Basilicanova al bivio SP 32 centro abitato Mamiano,6641,10,6369,271,5278,1363,6641,0
2019/01,613,18/01/2019,5,SP 16 dalla località Basilicanova al bivio SP 32 centro abitato Mamiano,6797,00,6534,263,5255,1542,6797,0
2019/01,613,19/01/2019,6,SP 16 dalla località Basilicanova al bivio SP 32 centro abitato Mamiano,5564,30,5413,148,4047,1517,0,5564
2019/01,613,20/01/2019,7,SP 16 dalla località Basilicanova al bivio SP 32 centro abitato Mamiano,4277,00,4231,46,3075,1202,0,4277
2019/01,613,21/01/2019,1,SP 16 dalla località Basilicanova al bivio SP 32 centro abitato Mamiano,6568,00,6317,251,5243,1325,6568,0
2019/01,613,22/01/2019,2,SP 16 dalla località Basilicanova al bivio SP 32 centro abitato Mamiano,6531,00,6269,262,5197,1334,6531,0
2019/01,613,23/01/2019,3,SP 16 dalla località Basilicanova al bivio SP 32 centro abitato Mamiano,6354,00,6086,268,5162,1192,6354,0
2019/01,613,24/01/2019,4,SP 16 dalla località Basilicanova al bivio SP 32 centro abitato Mamiano,6027,00,5788,239,4762,1265,6027,0
2019/01,613,25/01/2019,5,SP 16 dalla località Basilicanova al bivio SP 32 centro abitato Mamiano,6669,00,6409,260,5153,1516,6669,0
2019/01,613,26/01/2019,6,SP 16 dalla località Basilicanova al bivio SP 32 centro abitato Mamiano,5546,00,5419,127,4092,1454,0,5546
2019/01,613,27/01/2019,7,SP 16 dalla località Basilicanova al bivio SP 32 centro abitato Mamiano,4080,00,4034,46,2961,1119,0,4080
2019/01,613,28/01/2019,1,SP 16 dalla località Basilicanova al bivio SP 32 centro abitato Mamiano,6123,00,5895,228,4905,1218,6123,0
2019/01,614,15/01/2019,2,SP 587R dal bivio SP 10R alla A 21Dir,6789,00,6273,516,5463,1326,6789,0
2019/01,614,16/01/2019,3,SP 587R dal bivio SP 10R alla A 21Dir,7043,00,6528,515,5760,1283,7043,0
2019/01,614,17/01/2019,4,SP 587R dal bivio SP 10R alla A 21Dir,7383,00,6762,621,5977,1406,7383,0
2019/01,614,18/01/2019,5,SP 587R dal bivio SP 10R alla A 21Dir,7288,00,6647,641,5642,1646,7288,0
2019/01,614,19/01/2019,6,SP 587R dal bivio SP 10R alla A 21Dir,5246,00,5062,184,3761,1485,0,5246
2019/01,614,20/01/2019,7,SP 587R dal bivio SP 10R alla A 21Dir,4098,10,4061,36,2955,1143,0,4098
2019/01,614,21/01/2019,1,SP 587R dal bivio SP 10R alla A 21Dir,6610,00,6053,557,5323,1287,6610,0
2019/01,614,22/01/2019,2,SP 587R dal bivio SP 10R alla A 21Dir,6628,00,5972,656,5432,1196,6628,0
2019/01,614,23/01/2019,3,SP 587R dal bivio SP 10R alla A 21Dir,6453,00,5923,530,5238,1215,6453,0
2019/01,614,24/01/2019,4,SP 587R dal bivio SP 10R alla A 21Dir,6256,10,5766,489,5042,1214,6256,0
2019/01,614,25/01/2019,5,SP 587R dal bivio SP 10R alla A 21Dir,6809,00,6325,484,5325,1484,6809,0
2019/01,614,26/01/2019,6,SP 587R dal bivio SP 10R alla A 21Dir,5190,00,5023,167,3813,1377,0,5190
2019/01,614,27/01/2019,7,SP 587R dal bivio SP 10R alla A 21Dir,3808,00,3764,44,2774,1034,0,3808
2019/01,614,28/01/2019,1,SP 587R dal bivio SP 10R alla A 21Dir,6493,00,5927,566,5263,1230,6493,0
2019/01,615,15/01/2019,2,Piazzale Milano (ex SS 9) c/o ponte fiume Po,25908,170,25329,562,19996,5912,25908,0
2019/01,615,16/01/2019,3,Piazzale Milano (ex SS 9) c/o ponte fiume Po,26252,210,25674,557,20282,5970,26252,0
2019/01,615,17/01/2019,4,Piazzale Milano (ex SS 9) c/o ponte fiume Po,26395,130,25881,501,20138,6257,26395,0
2019/01,615,18/01/2019,5,Piazzale Milano (ex SS 9) c/o ponte fiume Po,27931,170,27367,547,20832,7099,27931,0
2019/01,615,19/01/2019,6,Piazzale Milano (ex SS 9) c/o ponte fiume Po,27754,40,27422,328,20390,7364,0,27754
2019/01,615,20/01/2019,7,Piazzale Milano (ex SS 9) c/o ponte fiume Po,23572,30,23462,107,16975,6597,0,23572
2019/01,615,21/01/2019,1,Piazzale Milano (ex SS 9) c/o ponte fiume Po,25771,300,25241,500,19696,6075,25771,0
2019/01,615,22/01/2019,2,Piazzale Milano (ex SS 9) c/o ponte fiume Po,25164,120,24621,531,19467,5697,25164,0
2019/01,615,23/01/2019,3,Piazzale Milano (ex SS 9) c/o ponte fiume Po,24969,180,24385,566,19267,5702,24969,0
2019/01,615,24/01/2019,4,Piazzale Milano (ex SS 9) c/o ponte fiume Po,25287,160,24757,514,19073,6214,25287,0
2019/01,615,25/01/2019,5,Piazzale Milano (ex SS 9) c/o ponte fiume Po,27433,270,26858,548,20368,7065,27433,0
2019/01,615,26/01/2019,6,Piazzale Milano (ex SS 9) c/o ponte fiume Po,27289,50,26955,329,20077,7212,0,27289
2019/01,615,27/01/2019,7,Piazzale Milano (ex SS 9) c/o ponte fiume Po,21457,60,21361,90,15538,5919,0,21457
2019/01,615,28/01/2019,1,Piazzale Milano (ex SS 9) c/o ponte fiume Po,25493,80,24988,497,19269,6224,25493,0
2019/01,616,24/01/2019,4,SP 588R dal casello A 21 di Castelvetro Piacentino a Villanova d'Arda,3717,00,3415,302,3022,695,3717,0
2019/01,616,25/01/2019,5,SP 588R dal casello A 21 di Castelvetro Piacentino a Villanova d'Arda,4088,00,3795,293,3244,844,4088,0
2019/01,616,26/01/2019,6,SP 588R dal casello A 21 di Castelvetro Piacentino a Villanova d'Arda,3776,00,3700,76,2800,976,0,3776
2019/01,616,27/01/2019,7,SP 588R dal casello A 21 di Castelvetro Piacentino a Villanova d'Arda,3201,00,3173,28,2400,801,0,3201
2019/01,616,28/01/2019,1,SP 588R dal casello A 21 di Castelvetro Piacentino a Villanova d'Arda,3834,00,3525,309,3145,689,3834,0
2019/01,617,15/01/2019,2,SP 7 dalla intersezione tangenziale sud/ovest di Piacenza a San Nicolò,7671,00,7340,331,6299,1372,7671,0
2019/01,617,16/01/2019,3,SP 7 dalla intersezione tangenziale sud/ovest di Piacenza a San Nicolò,7594,10,7285,308,6194,1400,7594,0
2019/01,617,17/01/2019,4,SP 7 dalla intersezione tangenziale sud/ovest di Piacenza a San Nicolò,7443,00,7119,324,6064,1379,7443,0
2019/01,617,18/01/2019,5,SP 7 dalla intersezione tangenziale sud/ovest di Piacenza a San Nicolò,7818,00,7494,324,6249,1569,7818,0
2019/01,617,19/01/2019,6,SP 7 dalla intersezione tangenziale sud/ovest di Piacenza a San Nicolò,7071,00,6980,91,5399,1672,0,7071
2019/01,617,20/01/2019,7,SP 7 dalla intersezione tangenziale sud/ovest di Piacenza a San Nicolò,5184,00,5173,11,3993,1191,0,5184
2019/01,617,21/01/2019,1,SP 7 dalla intersezione tangenziale sud/ovest di Piacenza a San Nicolò,7478,00,7144,334,6187,1291,7478,0
2019/01,617,22/01/2019,2,SP 7 dalla intersezione tangenziale sud/ovest di Piacenza a San Nicolò,7729,10,7357,371,6437,1292,7729,0
2019/01,617,23/01/2019,3,SP 7 dalla intersezione tangenziale sud/ovest di Piacenza a San Nicolò,7107,00,6858,249,5825,1282,7107,0
2019/01,617,24/01/2019,4,SP 7 dalla intersezione tangenziale sud/ovest di Piacenza a San Nicolò,6893,00,6639,254,5572,1321,6893,0
2019/01,617,25/01/2019,5,SP 7 dalla intersezione tangenziale sud/ovest di Piacenza a San Nicolò,7649,10,7334,314,6030,1619,7649,0
2019/01,617,26/01/2019,6,SP 7 dalla intersezione tangenziale sud/ovest di Piacenza a San Nicolò,7048,00,6910,138,5412,1636,0,7048
2019/01,617,27/01/2019,7,SP 7 dalla intersezione tangenziale sud/ovest di Piacenza a San Nicolò,4776,00,4757,19,3557,1219,0,4776
2019/01,617,28/01/2019,1,SP 7 dalla intersezione tangenziale sud/ovest di Piacenza a San Nicolò,7596,00,7072,524,6272,1324,7596,0
2019/01,618,15/01/2019,2,SP 253R fra Bagnacavallo (A14 Dir) e Godo (bivio SP 302R),7448,00,6889,559,6030,1418,7448,0
2019/01,618,16/01/2019,3,SP 253R fra Bagnacavallo (A14 Dir) e Godo (bivio SP 302R),7616,00,6986,630,6192,1424,7616,0
2019/01,618,17/01/2019,4,SP 253R fra Bagnacavallo (A14 Dir) e Godo (bivio SP 302R),7800,00,7232,568,6265,1535,7800,0
2019/01,618,18/01/2019,5,SP 253R fra Bagnacavallo (A14 Dir) e Godo (bivio SP 302R),7926,00,7416,510,6201,1725,7926,0
2019/01,618,19/01/2019,6,SP 253R fra Bagnacavallo (A14 Dir) e Godo (bivio SP 302R),6952,10,6799,152,5294,1658,0,6952
2019/01,618,20/01/2019,7,SP 253R fra Bagnacavallo (A14 Dir) e Godo (bivio SP 302R),4114,00,4094,20,2920,1194,0,4114
2019/01,618,21/01/2019,1,SP 253R fra Bagnacavallo (A14 Dir) e Godo (bivio SP 302R),7109,00,6626,483,5852,1257,7109,0
2019/01,618,22/01/2019,2,SP 253R fra Bagnacavallo (A14 Dir) e Godo (bivio SP 302R),7217,00,6704,513,5965,1252,7217,0
2019/01,618,23/01/2019,3,SP 253R fra Bagnacavallo (A14 Dir) e Godo (bivio SP 302R),7169,00,6697,472,5742,1427,7169,0
2019/01,618,24/01/2019,4,SP 253R fra Bagnacavallo (A14 Dir) e Godo (bivio SP 302R),7396,00,6878,518,5912,1484,7396,0
2019/01,618,25/01/2019,5,SP 253R fra Bagnacavallo (A14 Dir) e Godo (bivio SP 302R),7700,00,7217,483,6074,1626,7700,0
2019/01,618,26/01/2019,6,SP 253R fra Bagnacavallo (A14 Dir) e Godo (bivio SP 302R),6075,00,5953,122,4630,1445,0,6075
2019/01,618,27/01/2019,7,SP 253R fra Bagnacavallo (A14 Dir) e Godo (bivio SP 302R),4188,00,4165,23,3090,1098,0,4188
2019/01,618,28/01/2019,1,SP 253R fra Bagnacavallo (A14 Dir) e Godo (bivio SP 302R),7165,00,6683,482,5839,1326,7165,0
2019/01,619,15/01/2019,2,SP 8 da Bagnacavallo al bivio SS 16,3237,10,3021,215,2564,673,3237,0
2019/01,619,16/01/2019,3,SP 8 da Bagnacavallo al bivio SS 16,3170,20,2954,214,2525,645,3170,0
2019/01,619,17/01/2019,4,SP 8 da Bagnacavallo al bivio SS 16,3098,10,2888,209,2427,671,3098,0
2019/01,619,18/01/2019,5,SP 8 da Bagnacavallo al bivio SS 16,3085,20,2903,180,2375,710,3085,0
2019/01,619,19/01/2019,6,SP 8 da Bagnacavallo al bivio SS 16,2636,00,2587,49,1935,701,0,2636
2019/01,619,20/01/2019,7,SP 8 da Bagnacavallo al bivio SS 16,2030,00,2018,12,1486,544,0,2030
2019/01,619,21/01/2019,1,SP 8 da Bagnacavallo al bivio SS 16,3053,00,2849,204,2460,593,3053,0
2019/01,619,22/01/2019,2,SP 8 da Bagnacavallo al bivio SS 16,3000,00,2804,196,2448,552,3000,0
2019/01,619,23/01/2019,3,SP 8 da Bagnacavallo al bivio SS 16,3073,10,2914,158,2412,661,3073,0
2019/01,619,24/01/2019,4,SP 8 da Bagnacavallo al bivio SS 16,3027,10,2872,154,2401,626,3027,0
2019/01,619,25/01/2019,5,SP 8 da Bagnacavallo al bivio SS 16,3036,00,2883,153,2374,662,3036,0
2019/01,619,26/01/2019,6,SP 8 da Bagnacavallo al bivio SS 16,2550,00,2500,50,1908,642,0,2550
2019/01,619,27/01/2019,7,SP 8 da Bagnacavallo al bivio SS 16,2216,00,2214,2,1630,586,0,2216
2019/01,619,28/01/2019,1,SP 8 da Bagnacavallo al bivio SS 16,3012,00,2872,140,2383,629,3012,0
2019/01,620,15/01/2019,2,SP 113 sulla variante di San Martino in Rio/Correggio c/o le località Prato/Gazzata,8437,00,7357,1080,6763,1674,8437,0
2019/01,620,16/01/2019,3,SP 113 sulla variante di San Martino in Rio/Correggio c/o le località Prato/Gazzata,8376,00,7254,1122,6787,1589,8376,0
2019/01,620,17/01/2019,4,SP 113 sulla variante di San Martino in Rio/Correggio c/o le località Prato/Gazzata,8442,00,7329,1113,6777,1665,8442,0
2019/01,620,18/01/2019,5,SP 113 sulla variante di San Martino in Rio/Correggio c/o le località Prato/Gazzata,8631,00,7503,1128,6802,1829,8631,0
2019/01,620,19/01/2019,6,SP 113 sulla variante di San Martino in Rio/Correggio c/o le località Prato/Gazzata,5934,00,5725,209,4214,1720,0,5934
2019/01,620,20/01/2019,7,SP 113 sulla variante di San Martino in Rio/Correggio c/o le località Prato/Gazzata,4888,00,4832,56,3354,1534,0,4888
2019/01,620,21/01/2019,1,SP 113 sulla variante di San Martino in Rio/Correggio c/o le località Prato/Gazzata,8016,00,6982,1034,6486,1530,8016,0
2019/01,620,22/01/2019,2,SP 113 sulla variante di San Martino in Rio/Correggio c/o le località Prato/Gazzata,8289,10,7130,1158,6680,1609,8289,0
2019/01,620,23/01/2019,3,SP 113 sulla variante di San Martino in Rio/Correggio c/o le località Prato/Gazzata,8061,00,7030,1031,6535,1526,8061,0
2019/01,620,24/01/2019,4,SP 113 sulla variante di San Martino in Rio/Correggio c/o le località Prato/Gazzata,7997,00,7005,992,6436,1561,7997,0
2019/01,620,25/01/2019,5,SP 113 sulla variante di San Martino in Rio/Correggio c/o le località Prato/Gazzata,8583,00,7498,1085,6718,1865,8583,0
2019/01,620,26/01/2019,6,SP 113 sulla variante di San Martino in Rio/Correggio c/o le località Prato/Gazzata,5817,00,5628,189,4103,1714,0,5817
2019/01,620,27/01/2019,7,SP 113 sulla variante di San Martino in Rio/Correggio c/o le località Prato/Gazzata,4624,00,4561,63,3235,1389,0,4624
2019/01,620,28/01/2019,1,SP 113 sulla variante di San Martino in Rio/Correggio c/o le località Prato/Gazzata,7843,00,6900,943,6432,1411,7843,0
2019/01,621,15/01/2019,2,SP 513R a nord di Vetto,1957,00,1856,101,1546,411,1957,0
2019/01,621,16/01/2019,3,SP 513R a nord di Vetto,1959,00,1831,128,1564,395,1959,0
2019/01,621,17/01/2019,4,SP 513R a nord di Vetto,1963,00,1803,160,1539,424,1963,0
2019/01,621,18/01/2019,5,SP 513R a nord di Vetto,2066,00,1918,148,1598,468,2066,0
2019/01,621,19/01/2019,6,SP 513R a nord di Vetto,1730,00,1687,43,1361,369,0,1730
2019/01,621,20/01/2019,7,SP 513R a nord di Vetto,1796,00,1782,14,1470,326,0,1796
2019/01,621,21/01/2019,1,SP 513R a nord di Vetto,1973,00,1836,137,1547,426,1973,0
2019/01,621,22/01/2019,2,SP 513R a nord di Vetto,1885,00,1761,124,1512,373,1885,0
2019/01,621,23/01/2019,3,SP 513R a nord di Vetto,1651,00,1544,107,1312,339,1651,0
2019/01,621,24/01/2019,4,SP 513R a nord di Vetto,1532,00,1447,85,1160,372,1532,0
2019/01,621,25/01/2019,5,SP 513R a nord di Vetto,1921,00,1812,109,1486,435,1921,0
2019/01,621,26/01/2019,6,SP 513R a nord di Vetto,2011,00,1963,48,1652,359,0,2011
2019/01,621,27/01/2019,7,SP 513R a nord di Vetto,1789,00,1784,5,1451,338,0,1789
2019/01,621,28/01/2019,1,SP 513R a nord di Vetto,1859,10,1742,116,1446,413,1859,0
2019/01,622,15/01/2019,2,SP 468R tra Correggio e il confine provinciale,19476,00,17840,1636,15574,3902,19476,0
2019/01,622,16/01/2019,3,SP 468R tra Correggio e il confine provinciale,19830,10,18198,1631,15752,4078,19830,0
2019/01,622,17/01/2019,4,SP 468R tra Correggio e il confine provinciale,19526,20,17934,1590,15549,3977,19526,0
2019/01,622,18/01/2019,5,SP 468R tra Correggio e il confine provinciale,20120,10,18529,1590,15596,4524,20120,0
2019/01,622,19/01/2019,6,SP 468R tra Correggio e il confine provinciale,15795,00,15462,333,11291,4504,0,15795
2019/01,622,20/01/2019,7,SP 468R tra Correggio e il confine provinciale,11426,00,11359,67,7842,3584,0,11426
2019/01,622,21/01/2019,1,SP 468R tra Correggio e il confine provinciale,18587,50,17118,1464,14974,3613,18587,0
2019/01,622,22/01/2019,2,SP 468R tra Correggio e il confine provinciale,18905,20,17369,1534,15029,3876,18905,0
2019/01,622,23/01/2019,3,SP 468R tra Correggio e il confine provinciale,19280,20,17724,1554,15376,3904,19280,0
2019/01,622,24/01/2019,4,SP 468R tra Correggio e il confine provinciale,18710,10,17229,1480,14754,3956,18710,0
2019/01,622,25/01/2019,5,SP 468R tra Correggio e il confine provinciale,19750,00,18267,1483,15190,4560,19750,0
2019/01,622,26/01/2019,6,SP 468R tra Correggio e il confine provinciale,15563,20,15235,326,11001,4562,0,15563
2019/01,622,27/01/2019,7,SP 468R tra Correggio e il confine provinciale,11275,00,11202,73,7822,3453,0,11275
2019/01,622,28/01/2019,1,SP 468R tra Correggio e il confine provinciale,,,,,,,,
2019/01,623,15/01/2019,2,SP 30 tra Campagnola Emilia e il confine provinciale,14956,00,13784,1172,12037,2919,14956,0
2019/01,623,16/01/2019,3,SP 30 tra Campagnola Emilia e il confine provinciale,15456,10,14306,1149,12356,3100,15456,0
2019/01,623,17/01/2019,4,SP 30 tra Campagnola Emilia e il confine provinciale,15247,00,14051,1196,12041,3206,15247,0
2019/01,623,18/01/2019,5,SP 30 tra Campagnola Emilia e il confine provinciale,15710,10,14598,1111,12253,3457,15710,0
2019/01,623,19/01/2019,6,SP 30 tra Campagnola Emilia e il confine provinciale,13127,00,12899,228,9505,3622,0,13127
2019/01,623,20/01/2019,7,SP 30 tra Campagnola Emilia e il confine provinciale,9450,00,9389,61,6616,2834,0,9450
2019/01,623,21/01/2019,1,SP 30 tra Campagnola Emilia e il confine provinciale,14506,00,13352,1154,11697,2809,14506,0
2019/01,623,22/01/2019,2,SP 30 tra Campagnola Emilia e il confine provinciale,14888,00,13830,1058,11960,2928,14888,0
2019/01,623,23/01/2019,3,SP 30 tra Campagnola Emilia e il confine provinciale,15033,00,13952,1081,11952,3081,15033,0
2019/01,623,24/01/2019,4,SP 30 tra Campagnola Emilia e il confine provinciale,14519,00,13494,1025,11521,2998,14519,0
2019/01,623,25/01/2019,5,SP 30 tra Campagnola Emilia e il confine provinciale,15651,20,14527,1122,12091,3560,15651,0
2019/01,623,26/01/2019,6,SP 30 tra Campagnola Emilia e il confine provinciale,12827,00,12603,224,9245,3582,0,12827
2019/01,623,27/01/2019,7,SP 30 tra Campagnola Emilia e il confine provinciale,9212,00,9155,57,6618,2594,0,9212
2019/01,623,28/01/2019,1,SP 30 tra Campagnola Emilia e il confine provinciale,14190,10,13075,1114,11389,2801,14190,0
2019/01,624,15/01/2019,2,SP 23 tra Rivalta e la variante di Montecavolo,11349,00,11017,332,9004,2345,11349,0
2019/01,624,16/01/2019,3,SP 23 tra Rivalta e la variante di Montecavolo,11453,00,11103,350,8943,2510,11453,0
2019/01,624,17/01/2019,4,SP 23 tra Rivalta e la variante di Montecavolo,11546,00,11200,346,8843,2703,11546,0
2019/01,624,18/01/2019,5,SP 23 tra Rivalta e la variante di Montecavolo,11567,00,11224,343,8881,2686,11567,0
2019/01,624,19/01/2019,6,SP 23 tra Rivalta e la variante di Montecavolo,11129,10,11028,100,8206,2923,0,11129
2019/01,624,20/01/2019,7,SP 23 tra Rivalta e la variante di Montecavolo,7973,00,7951,22,5774,2199,0,7973
2019/01,624,21/01/2019,1,SP 23 tra Rivalta e la variante di Montecavolo,10580,10,10247,332,8405,2175,10580,0
2019/01,624,22/01/2019,2,SP 23 tra Rivalta e la variante di Montecavolo,11178,00,10843,335,8812,2366,11178,0
2019/01,624,23/01/2019,3,SP 23 tra Rivalta e la variante di Montecavolo,10789,00,10471,318,8584,2205,10789,0
2019/01,624,24/01/2019,4,SP 23 tra Rivalta e la variante di Montecavolo,10253,00,9958,295,7863,2390,10253,0
2019/01,624,25/01/2019,5,SP 23 tra Rivalta e la variante di Montecavolo,11492,10,11197,294,8863,2629,11492,0
2019/01,624,26/01/2019,6,SP 23 tra Rivalta e la variante di Montecavolo,10778,00,10673,105,7982,2796,0,10778
2019/01,624,27/01/2019,7,SP 23 tra Rivalta e la variante di Montecavolo,7782,00,7755,27,5646,2136,0,7782
2019/01,624,28/01/2019,1,SP 23 tra Rivalta e la variante di Montecavolo,10595,00,10300,295,8434,2161,10595,0
2019/01,625,15/01/2019,2,SP 14 da Poggio Berni (bivio SP 73) a Sant'Arcangelo di Romagna,,,,,,,,
2019/01,625,16/01/2019,3,SP 14 da Poggio Berni (bivio SP 73) a Sant'Arcangelo di Romagna,,,,,,,,
2019/01,625,17/01/2019,4,SP 14 da Poggio Berni (bivio SP 73) a Sant'Arcangelo di Romagna,,,,,,,,
2019/01,625,18/01/2019,5,SP 14 da Poggio Berni (bivio SP 73) a Sant'Arcangelo di Romagna,,,,,,,,
2019/01,625,19/01/2019,6,SP 14 da Poggio Berni (bivio SP 73) a Sant'Arcangelo di Romagna,,,,,,,,
2019/01,625,20/01/2019,7,SP 14 da Poggio Berni (bivio SP 73) a Sant'Arcangelo di Romagna,,,,,,,,
2019/01,625,21/01/2019,1,SP 14 da Poggio Berni (bivio SP 73) a Sant'Arcangelo di Romagna,,,,,,,,
2019/01,625,22/01/2019,2,SP 14 da Poggio Berni (bivio SP 73) a Sant'Arcangelo di Romagna,,,,,,,,
2019/01,625,23/01/2019,3,SP 14 da Poggio Berni (bivio SP 73) a Sant'Arcangelo di Romagna,,,,,,,,
2019/01,625,24/01/2019,4,SP 14 da Poggio Berni (bivio SP 73) a Sant'Arcangelo di Romagna,,,,,,,,
2019/01,625,25/01/2019,5,SP 14 da Poggio Berni (bivio SP 73) a Sant'Arcangelo di Romagna,,,,,,,,
2019/01,625,26/01/2019,6,SP 14 da Poggio Berni (bivio SP 73) a Sant'Arcangelo di Romagna,,,,,,,,
2019/01,625,27/01/2019,7,SP 14 da Poggio Berni (bivio SP 73) a Sant'Arcangelo di Romagna,,,,,,,,
2019/01,625,28/01/2019,1,SP 14 da Poggio Berni (bivio SP 73) a Sant'Arcangelo di Romagna,,,,,,,,
2019/01,626,15/01/2019,2,SP 18 da San Clemente al bivio SP 132 (località Osteria Nuova),7621,00,7268,353,6193,1428,7621,0
2019/01,626,16/01/2019,3,SP 18 da San Clemente al bivio SP 132 (località Osteria Nuova),7787,00,7385,402,6377,1410,7787,0
2019/01,626,17/01/2019,4,SP 18 da San Clemente al bivio SP 132 (località Osteria Nuova),7945,10,7587,357,6419,1526,7945,0
2019/01,626,18/01/2019,5,SP 18 da San Clemente al bivio SP 132 (località Osteria Nuova),7695,00,7341,354,6149,1546,7695,0
2019/01,626,19/01/2019,6,SP 18 da San Clemente al bivio SP 132 (località Osteria Nuova),7137,00,7013,124,5402,1735,0,7137
2019/01,626,20/01/2019,7,SP 18 da San Clemente al bivio SP 132 (località Osteria Nuova),5189,20,5166,21,3824,1365,0,5189
2019/01,626,21/01/2019,1,SP 18 da San Clemente al bivio SP 132 (località Osteria Nuova),7251,00,6888,363,6043,1208,7251,0
2019/01,626,22/01/2019,2,SP 18 da San Clemente al bivio SP 132 (località Osteria Nuova),6267,00,5971,296,5152,1115,6267,0
2019/01,626,23/01/2019,3,SP 18 da San Clemente al bivio SP 132 (località Osteria Nuova),6852,00,6550,302,5557,1295,6852,0
2019/01,626,24/01/2019,4,SP 18 da San Clemente al bivio SP 132 (località Osteria Nuova),7166,00,6852,314,5774,1392,7166,0
2019/01,626,25/01/2019,5,SP 18 da San Clemente al bivio SP 132 (località Osteria Nuova),8048,00,7655,393,6446,1602,8048,0
2019/01,626,26/01/2019,6,SP 18 da San Clemente al bivio SP 132 (località Osteria Nuova),7340,00,7194,146,5691,1649,0,7340
2019/01,626,27/01/2019,7,SP 18 da San Clemente al bivio SP 132 (località Osteria Nuova),5961,00,5945,16,4522,1439,0,5961
2019/01,626,28/01/2019,1,SP 18 da San Clemente al bivio SP 132 (località Osteria Nuova),7547,00,7184,363,6189,1358,7547,0
2019/01,627,15/01/2019,2,SS 64 variante di Riola di Vergato,7810,00,7355,455,6339,1471,7810,0
2019/01,627,16/01/2019,3,SS 64 variante di Riola di Vergato,8113,50,7611,497,6609,1504,8113,0
2019/01,627,17/01/2019,4,SS 64 variante di Riola di Vergato,7986,20,7476,508,6474,1512,7986,0
2019/01,627,18/01/2019,5,SS 64 variante di Riola di Vergato,8343,10,7858,484,6524,1819,8343,0
2019/01,627,19/01/2019,6,SS 64 variante di Riola di Vergato,7254,00,7134,120,5548,1706,0,7254
2019/01,627,20/01/2019,7,SS 64 variante di Riola di Vergato,5976,10,5952,23,4548,1428,0,5976
2019/01,627,21/01/2019,1,SS 64 variante di Riola di Vergato,7715,10,7247,467,6313,1402,7715,0
2019/01,627,22/01/2019,2,SS 64 variante di Riola di Vergato,6976,10,6544,431,5733,1243,6976,0
2019/01,627,23/01/2019,3,SS 64 variante di Riola di Vergato,6720,00,6314,406,5524,1196,6720,0
2019/01,627,24/01/2019,4,SS 64 variante di Riola di Vergato,5816,10,5466,349,4633,1183,5816,0
2019/01,627,25/01/2019,5,SS 64 variante di Riola di Vergato,7815,00,7397,418,6157,1658,7815,0
2019/01,627,26/01/2019,6,SS 64 variante di Riola di Vergato,7500,10,7376,123,5843,1657,0,7500
2019/01,627,27/01/2019,7,SS 64 variante di Riola di Vergato,5717,00,5693,24,4386,1331,0,5717
2019/01,627,28/01/2019,1,SS 64 variante di Riola di Vergato,7744,00,7326,418,6289,1455,7744,0
2019/01,629,15/01/2019,2,SS 727 (tg Forli') tra intersezione SS 9 e l'intersezione SS 67,16225,00,15049,1176,12977,3248,16225,0
2019/01,629,16/01/2019,3,SS 727 (tg Forli') tra intersezione SS 9 e l'intersezione SS 67,16387,10,15196,1190,13178,3209,16387,0
2019/01,629,17/01/2019,4,SS 727 (tg Forli') tra intersezione SS 9 e l'intersezione SS 67,16243,10,15063,1179,12999,3244,16243,0
2019/01,629,18/01/2019,5,SS 727 (tg Forli') tra intersezione SS 9 e l'intersezione SS 67,16698,00,15648,1050,13202,3496,16698,0
2019/01,629,19/01/2019,6,SS 727 (tg Forli') tra intersezione SS 9 e l'intersezione SS 67,11864,00,11608,256,8597,3267,0,11864
2019/01,629,20/01/2019,7,SS 727 (tg Forli') tra intersezione SS 9 e l'intersezione SS 67,9216,00,9171,45,6779,2437,0,9216
2019/01,629,21/01/2019,1,SS 727 (tg Forli') tra intersezione SS 9 e l'intersezione SS 67,15969,00,14846,1123,12876,3093,15969,0
2019/01,629,22/01/2019,2,SS 727 (tg Forli') tra intersezione SS 9 e l'intersezione SS 67,15101,10,13880,1220,12249,2852,15101,0
2019/01,629,23/01/2019,3,SS 727 (tg Forli') tra intersezione SS 9 e l'intersezione SS 67,15961,00,14876,1085,12783,3178,15961,0
2019/01,629,24/01/2019,4,SS 727 (tg Forli') tra intersezione SS 9 e l'intersezione SS 67,15752,00,14806,946,12492,3260,15752,0
2019/01,629,25/01/2019,5,SS 727 (tg Forli') tra intersezione SS 9 e l'intersezione SS 67,16965,00,15833,1132,13264,3701,16965,0
2019/01,629,26/01/2019,6,SS 727 (tg Forli') tra intersezione SS 9 e l'intersezione SS 67,11895,00,11617,278,8556,3339,0,11895
2019/01,629,27/01/2019,7,SS 727 (tg Forli') tra intersezione SS 9 e l'intersezione SS 67,9690,00,9642,48,7110,2580,0,9690
2019/01,629,28/01/2019,1,SS 727 (tg Forli') tra intersezione SS 9 e l'intersezione SS 67,15676,20,14653,1021,12710,2966,15676,0
2019/01,630,15/01/2019,2,SS 726 (tg Cesena) tra intersezione ex SS 71BIS e l'intersezione SP 304R,,,,,,,,
2019/01,630,16/01/2019,3,SS 726 (tg Cesena) tra intersezione ex SS 71BIS e l'intersezione SP 304R,,,,,,,,
2019/01,630,17/01/2019,4,SS 726 (tg Cesena) tra intersezione ex SS 71BIS e l'intersezione SP 304R,,,,,,,,
2019/01,630,18/01/2019,5,SS 726 (tg Cesena) tra intersezione ex SS 71BIS e l'intersezione SP 304R,,,,,,,,
2019/01,630,19/01/2019,6,SS 726 (tg Cesena) tra intersezione ex SS 71BIS e l'intersezione SP 304R,,,,,,,,
2019/01,630,20/01/2019,7,SS 726 (tg Cesena) tra intersezione ex SS 71BIS e l'intersezione SP 304R,,,,,,,,
2019/01,630,21/01/2019,1,SS 726 (tg Cesena) tra intersezione ex SS 71BIS e l'intersezione SP 304R,,,,,,,,
2019/01,630,22/01/2019,2,SS 726 (tg Cesena) tra intersezione ex SS 71BIS e l'intersezione SP 304R,,,,,,,,
2019/01,630,23/01/2019,3,SS 726 (tg Cesena) tra intersezione ex SS 71BIS e l'intersezione SP 304R,,,,,,,,
2019/01,630,24/01/2019,4,SS 726 (tg Cesena) tra intersezione ex SS 71BIS e l'intersezione SP 304R,,,,,,,,
2019/01,630,25/01/2019,5,SS 726 (tg Cesena) tra intersezione ex SS 71BIS e l'intersezione SP 304R,,,,,,,,
2019/01,630,26/01/2019,6,SS 726 (tg Cesena) tra intersezione ex SS 71BIS e l'intersezione SP 304R,,,,,,,,
2019/01,630,27/01/2019,7,SS 726 (tg Cesena) tra intersezione ex SS 71BIS e l'intersezione SP 304R,,,,,,,,
2019/01,630,28/01/2019,1,SS 726 (tg Cesena) tra intersezione ex SS 71BIS e l'intersezione SP 304R,,,,,,,,
2019/01,631,15/01/2019,2,SS 3Bis/E 45 tra Sarsina e San Piero in Bagno,,,,,,,,
2019/01,631,16/01/2019,3,SS 3Bis/E 45 tra Sarsina e San Piero in Bagno,,,,,,,,
2019/01,631,17/01/2019,4,SS 3Bis/E 45 tra Sarsina e San Piero in Bagno,,,,,,,,
2019/01,631,18/01/2019,5,SS 3Bis/E 45 tra Sarsina e San Piero in Bagno,,,,,,,,
2019/01,631,19/01/2019,6,SS 3Bis/E 45 tra Sarsina e San Piero in Bagno,,,,,,,,
2019/01,631,20/01/2019,7,SS 3Bis/E 45 tra Sarsina e San Piero in Bagno,,,,,,,,
2019/01,631,21/01/2019,1,SS 3Bis/E 45 tra Sarsina e San Piero in Bagno,,,,,,,,
2019/01,631,22/01/2019,2,SS 3Bis/E 45 tra Sarsina e San Piero in Bagno,,,,,,,,
2019/01,631,23/01/2019,3,SS 3Bis/E 45 tra Sarsina e San Piero in Bagno,,,,,,,,
2019/01,631,24/01/2019,4,SS 3Bis/E 45 tra Sarsina e San Piero in Bagno,,,,,,,,
2019/01,631,25/01/2019,5,SS 3Bis/E 45 tra Sarsina e San Piero in Bagno,,,,,,,,
2019/01,631,26/01/2019,6,SS 3Bis/E 45 tra Sarsina e San Piero in Bagno,,,,,,,,
2019/01,631,27/01/2019,7,SS 3Bis/E 45 tra Sarsina e San Piero in Bagno,,,,,,,,
2019/01,631,28/01/2019,1,SS 3Bis/E 45 tra Sarsina e San Piero in Bagno,,,,,,,,
2019/01,632,18/01/2019,5,SS 724Dir/tangenziale complanare sud alla A 1 in direzione Reggio Emilia - tra intersezione Modena/Sassuolo e intersezione SS 12,6326,00,6007,319,4863,1463,6326,0
2019/01,632,19/01/2019,6,SS 724Dir/tangenziale complanare sud alla A 1 in direzione Reggio Emilia - tra intersezione Modena/Sassuolo e intersezione SS 12,5458,00,5385,73,3851,1607,0,5458
2019/01,633,15/01/2019,2,SS 724Dir/tangenziale complanare sud alla A 1 in direzione Bologna - tra intersezione Modena/Sassuolo e intersezione SS12,7755,00,7262,493,5993,1762,7755,0
2019/01,633,16/01/2019,3,SS 724Dir/tangenziale complanare sud alla A 1 in direzione Bologna - tra intersezione Modena/Sassuolo e intersezione SS12,7795,00,7274,521,5986,1809,7795,0
2019/01,633,17/01/2019,4,SS 724Dir/tangenziale complanare sud alla A 1 in direzione Bologna - tra intersezione Modena/Sassuolo e intersezione SS12,7754,00,7256,498,5867,1887,7754,0
2019/01,633,18/01/2019,5,SS 724Dir/tangenziale complanare sud alla A 1 in direzione Bologna - tra intersezione Modena/Sassuolo e intersezione SS12,7899,10,7461,437,6027,1872,7899,0
2019/01,633,19/01/2019,6,SS 724Dir/tangenziale complanare sud alla A 1 in direzione Bologna - tra intersezione Modena/Sassuolo e intersezione SS12,6257,00,6154,103,4364,1893,0,6257
2019/01,633,20/01/2019,7,SS 724Dir/tangenziale complanare sud alla A 1 in direzione Bologna - tra intersezione Modena/Sassuolo e intersezione SS12,4974,00,4947,27,3416,1558,0,4974
2019/01,633,21/01/2019,1,SS 724Dir/tangenziale complanare sud alla A 1 in direzione Bologna - tra intersezione Modena/Sassuolo e intersezione SS12,7538,00,7011,527,5851,1687,7538,0
2019/01,633,22/01/2019,2,SS 724Dir/tangenziale complanare sud alla A 1 in direzione Bologna - tra intersezione Modena/Sassuolo e intersezione SS12,7594,00,7084,510,5891,1703,7594,0
2019/01,633,23/01/2019,3,SS 724Dir/tangenziale complanare sud alla A 1 in direzione Bologna - tra intersezione Modena/Sassuolo e intersezione SS12,7538,00,7026,512,5812,1726,7538,0
2019/01,633,24/01/2019,4,SS 724Dir/tangenziale complanare sud alla A 1 in direzione Bologna - tra intersezione Modena/Sassuolo e intersezione SS12,7357,00,6844,513,5683,1674,7357,0
2019/01,633,25/01/2019,5,SS 724Dir/tangenziale complanare sud alla A 1 in direzione Bologna - tra intersezione Modena/Sassuolo e intersezione SS12,7923,10,7347,575,5987,1936,7923,0
2019/01,633,26/01/2019,6,SS 724Dir/tangenziale complanare sud alla A 1 in direzione Bologna - tra intersezione Modena/Sassuolo e intersezione SS12,6261,00,6151,110,4424,1837,0,6261
2019/01,633,27/01/2019,7,SS 724Dir/tangenziale complanare sud alla A 1 in direzione Bologna - tra intersezione Modena/Sassuolo e intersezione SS12,4687,00,4659,28,3153,1534,0,4687
2019/01,633,28/01/2019,1,SS 724Dir/tangenziale complanare sud alla A 1 in direzione Bologna - tra intersezione Modena/Sassuolo e intersezione SS12,7622,10,7063,558,6022,1600,7622,0
2019/01,634,15/01/2019,2,SS 12 tra Pavullo e intersezione SP 31,,,,,,,,
2019/01,634,16/01/2019,3,SS 12 tra Pavullo e intersezione SP 31,,,,,,,,
2019/01,634,17/01/2019,4,SS 12 tra Pavullo e intersezione SP 31,,,,,,,,
2019/01,634,18/01/2019,5,SS 12 tra Pavullo e intersezione SP 31,,,,,,,,
2019/01,634,19/01/2019,6,SS 12 tra Pavullo e intersezione SP 31,,,,,,,,
2019/01,634,20/01/2019,7,SS 12 tra Pavullo e intersezione SP 31,,,,,,,,
2019/01,634,21/01/2019,1,SS 12 tra Pavullo e intersezione SP 31,,,,,,,,
2019/01,634,22/01/2019,2,SS 12 tra Pavullo e intersezione SP 31,,,,,,,,
2019/01,634,23/01/2019,3,SS 12 tra Pavullo e intersezione SP 31,,,,,,,,
2019/01,634,24/01/2019,4,SS 12 tra Pavullo e intersezione SP 31,,,,,,,,
2019/01,634,25/01/2019,5,SS 12 tra Pavullo e intersezione SP 31,,,,,,,,
2019/01,634,26/01/2019,6,SS 12 tra Pavullo e intersezione SP 31,,,,,,,,
2019/01,634,27/01/2019,7,SS 12 tra Pavullo e intersezione SP 31,,,,,,,,
2019/01,634,28/01/2019,1,SS 12 tra Pavullo e intersezione SP 31,,,,,,,,
2019/01,635,15/01/2019,2,SS 725 (tg sud Piacenza) tra intersezione SS 45 e l'intersezione SP 6,44032,20,40907,3123,35687,8345,44032,0
2019/01,635,16/01/2019,3,SS 725 (tg sud Piacenza) tra intersezione SS 45 e l'intersezione SP 6,44708,00,41355,3353,36265,8443,44708,0
2019/01,635,17/01/2019,4,SS 725 (tg sud Piacenza) tra intersezione SS 45 e l'intersezione SP 6,44038,20,40732,3304,35534,8504,44038,0
2019/01,635,18/01/2019,5,SS 725 (tg sud Piacenza) tra intersezione SS 45 e l'intersezione SP 6,46940,00,43603,3337,37221,9719,46940,0
2019/01,635,19/01/2019,6,SS 725 (tg sud Piacenza) tra intersezione SS 45 e l'intersezione SP 6,38372,10,37520,851,29267,9105,0,38372
2019/01,635,20/01/2019,7,SS 725 (tg sud Piacenza) tra intersezione SS 45 e l'intersezione SP 6,30280,00,30072,208,22900,7380,0,30280
2019/01,635,21/01/2019,1,SS 725 (tg sud Piacenza) tra intersezione SS 45 e l'intersezione SP 6,44020,10,40625,3394,35746,8274,44020,0
2019/01,635,22/01/2019,2,SS 725 (tg sud Piacenza) tra intersezione SS 45 e l'intersezione SP 6,43734,00,40268,3466,35634,8100,43734,0
2019/01,635,23/01/2019,3,SS 725 (tg sud Piacenza) tra intersezione SS 45 e l'intersezione SP 6,42630,00,39599,3031,34837,7793,42630,0
2019/01,635,24/01/2019,4,SS 725 (tg sud Piacenza) tra intersezione SS 45 e l'intersezione SP 6,42250,50,39368,2877,33960,8290,42250,0
2019/01,635,25/01/2019,5,SS 725 (tg sud Piacenza) tra intersezione SS 45 e l'intersezione SP 6,45819,30,42850,2966,36315,9504,45819,0
2019/01,635,26/01/2019,6,SS 725 (tg sud Piacenza) tra intersezione SS 45 e l'intersezione SP 6,38604,00,37753,851,29710,8894,0,38604
2019/01,635,27/01/2019,7,SS 725 (tg sud Piacenza) tra intersezione SS 45 e l'intersezione SP 6,28423,00,28258,165,21423,7000,0,28423
2019/01,635,28/01/2019,1,SS 725 (tg sud Piacenza) tra intersezione SS 45 e l'intersezione SP 6,43370,20,40389,2979,35147,8223,43370,0
2019/01,636,15/01/2019,2,SS 9Var tra la tangenziale nord di Parma (intersezione SP 343R) e l'intersezione SP 62R,51906,70,48813,3086,41928,9978,51906,0
2019/01,636,26/01/2019,6,SS 9Var tra la tangenziale nord di Parma (intersezione SP 343R) e l'intersezione SP 62R,48813,40,47914,895,35828,12985,0,48813
2019/01,636,27/01/2019,7,SS 9Var tra la tangenziale nord di Parma (intersezione SP 343R) e l'intersezione SP 62R,37691,20,37423,266,27704,9987,0,37691
2019/01,636,28/01/2019,1,SS 9Var tra la tangenziale nord di Parma (intersezione SP 343R) e l'intersezione SP 62R,53241,40,50010,3227,43010,10231,53241,0
2019/01,637,25/01/2019,5,SS 62 tra Fornovo di Taro e Collecchio,14105,00,13271,834,10945,3160,14105,0
2019/01,637,26/01/2019,6,SS 62 tra Fornovo di Taro e Collecchio,11463,00,11235,228,8648,2815,0,11463
2019/01,637,27/01/2019,7,SS 62 tra Fornovo di Taro e Collecchio,8899,00,8843,56,6496,2403,0,8899
2019/01,637,28/01/2019,1,SS 62 tra Fornovo di Taro e Collecchio,13096,00,12288,808,10471,2625,13096,0
2019/01,638,15/01/2019,2,SS 9 tra la tangenziale nord di Reggio Emilia e Sant'Ilario d'Enza,19471,10,17899,1571,14521,4950,19471,0
2019/01,638,16/01/2019,3,SS 9 tra la tangenziale nord di Reggio Emilia e Sant'Ilario d'Enza,19478,00,17796,1682,14621,4857,19478,0
2019/01,638,17/01/2019,4,SS 9 tra la tangenziale nord di Reggio Emilia e Sant'Ilario d'Enza,19349,00,17695,1654,14389,4960,19349,0
2019/01,638,18/01/2019,5,SS 9 tra la tangenziale nord di Reggio Emilia e Sant'Ilario d'Enza,19933,00,18237,1696,14399,5534,19933,0
2019/01,638,19/01/2019,6,SS 9 tra la tangenziale nord di Reggio Emilia e Sant'Ilario d'Enza,18346,00,17876,470,12311,6035,0,18346
2019/01,638,20/01/2019,7,SS 9 tra la tangenziale nord di Reggio Emilia e Sant'Ilario d'Enza,16486,00,16331,155,11199,5287,0,16486
2019/01,638,21/01/2019,1,SS 9 tra la tangenziale nord di Reggio Emilia e Sant'Ilario d'Enza,18453,00,16864,1589,13966,4487,18453,0
2019/01,638,22/01/2019,2,SS 9 tra la tangenziale nord di Reggio Emilia e Sant'Ilario d'Enza,18884,00,17255,1629,14381,4503,18884,0
2019/01,638,23/01/2019,3,SS 9 tra la tangenziale nord di Reggio Emilia e Sant'Ilario d'Enza,18443,00,16900,1543,14149,4294,18443,0
2019/01,638,24/01/2019,4,SS 9 tra la tangenziale nord di Reggio Emilia e Sant'Ilario d'Enza,18235,10,16667,1567,13522,4713,18235,0
2019/01,638,25/01/2019,5,SS 9 tra la tangenziale nord di Reggio Emilia e Sant'Ilario d'Enza,19981,00,18254,1727,14342,5639,19981,0
2019/01,638,26/01/2019,6,SS 9 tra la tangenziale nord di Reggio Emilia e Sant'Ilario d'Enza,18365,00,17920,445,12258,6107,0,18365
2019/01,638,27/01/2019,7,SS 9 tra la tangenziale nord di Reggio Emilia e Sant'Ilario d'Enza,14645,00,14485,160,9952,4693,0,14645
2019/01,638,28/01/2019,1,SS 9 tra la tangenziale nord di Reggio Emilia e Sant'Ilario d'Enza,17979,00,16326,1653,13681,4298,17979,0
2019/01,639,15/01/2019,2,SS 63 località Casina (variante abitato),6371,10,6094,276,5007,1364,6371,0
2019/01,639,16/01/2019,3,SS 63 località Casina (variante abitato),6690,00,6369,321,5160,1530,6690,0
2019/01,639,17/01/2019,4,SS 63 località Casina (variante abitato),6318,10,6018,299,4887,1431,6318,0
2019/01,639,18/01/2019,5,SS 63 località Casina (variante abitato),6786,00,6471,315,5078,1708,6786,0
2019/01,639,19/01/2019,6,SS 63 località Casina (variante abitato),5828,00,5719,109,4288,1540,0,5828
2019/01,639,20/01/2019,7,SS 63 località Casina (variante abitato),5227,00,5190,37,3842,1385,0,5227
2019/01,639,21/01/2019,1,SS 63 località Casina (variante abitato),6386,00,6071,315,5039,1347,6386,0
2019/01,639,22/01/2019,2,SS 63 località Casina (variante abitato),6220,00,5925,295,4933,1287,6220,0
2019/01,639,23/01/2019,3,SS 63 località Casina (variante abitato),5536,10,5302,233,4445,1091,5536,0
2019/01,639,24/01/2019,4,SS 63 località Casina (variante abitato),4938,20,4741,195,3753,1185,4938,0
2019/01,639,25/01/2019,5,SS 63 località Casina (variante abitato),6814,00,6537,277,5158,1656,6814,0
2019/01,639,26/01/2019,6,SS 63 località Casina (variante abitato),6692,00,6568,124,5188,1504,0,6692
2019/01,639,27/01/2019,7,SS 63 località Casina (variante abitato),5505,00,5458,47,4155,1350,0,5505
2019/01,639,28/01/2019,1,SS 63 località Casina (variante abitato),6068,00,5756,312,4801,1267,6068,0
2019/01,651,15/01/2019,2,SS 9 da Imola a Castelbolognese (al confine provinciale),16405,00,15629,776,12662,3743,16405,0
2019/01,651,16/01/2019,3,SS 9 da Imola a Castelbolognese (al confine provinciale),16390,00,15641,749,12576,3814,16390,0
2019/01,651,17/01/2019,4,SS 9 da Imola a Castelbolognese (al confine provinciale),16755,00,16010,745,12805,3950,16755,0
2019/01,651,18/01/2019,5,SS 9 da Imola a Castelbolognese (al confine provinciale),17116,00,16461,655,12597,4519,17116,0
2019/01,651,19/01/2019,6,SS 9 da Imola a Castelbolognese (al confine provinciale),15517,00,15341,176,10394,5123,0,15517
2019/01,651,20/01/2019,7,SS 9 da Imola a Castelbolognese (al confine provinciale),13404,00,13348,56,9616,3788,0,13404
2019/01,651,21/01/2019,1,SS 9 da Imola a Castelbolognese (al confine provinciale),15730,00,15024,706,12239,3491,15730,0
2019/01,651,22/01/2019,2,SS 9 da Imola a Castelbolognese (al confine provinciale),15422,00,14771,651,12121,3301,15422,0
2019/01,651,23/01/2019,3,SS 9 da Imola a Castelbolognese (al confine provinciale),15682,00,14957,725,12046,3636,15682,0
2019/01,651,24/01/2019,4,SS 9 da Imola a Castelbolognese (al confine provinciale),15680,00,15040,640,12039,3641,15680,0
2019/01,651,25/01/2019,5,SS 9 da Imola a Castelbolognese (al confine provinciale),17469,00,16710,759,12913,4556,17469,0
2019/01,651,26/01/2019,6,SS 9 da Imola a Castelbolognese (al confine provinciale),15704,00,15486,218,10492,5212,0,15704
2019/01,651,27/01/2019,7,SS 9 da Imola a Castelbolognese (al confine provinciale),12651,00,12606,45,8908,3743,0,12651
2019/01,651,28/01/2019,1,SS 9 da Imola a Castelbolognese (al confine provinciale),15878,00,15194,684,12346,3532,15878,0
2019/01,652,15/01/2019,2,SS 16 dal bivio SP 610R ad Argenta,12220,00,10751,1469,9961,2259,12220,0
2019/01,652,16/01/2019,3,SS 16 dal bivio SP 610R ad Argenta,12031,00,10646,1385,9729,2302,12031,0
2019/01,652,17/01/2019,4,SS 16 dal bivio SP 610R ad Argenta,12132,00,10824,1308,9632,2500,12132,0
2019/01,652,18/01/2019,5,SS 16 dal bivio SP 610R ad Argenta,12661,00,11348,1313,9925,2736,12661,0
2019/01,652,19/01/2019,6,SS 16 dal bivio SP 610R ad Argenta,10106,00,9803,303,7619,2487,0,10106
2019/01,652,20/01/2019,7,SS 16 dal bivio SP 610R ad Argenta,8108,00,8038,70,5959,2149,0,8108
2019/01,652,21/01/2019,1,SS 16 dal bivio SP 610R ad Argenta,11814,00,10490,1324,9464,2350,11814,0
2019/01,652,22/01/2019,2,SS 16 dal bivio SP 610R ad Argenta,11485,00,10086,1399,9332,2153,11485,0
2019/01,652,23/01/2019,3,SS 16 dal bivio SP 610R ad Argenta,11305,00,10014,1291,9074,2231,11305,0
2019/01,652,24/01/2019,4,SS 16 dal bivio SP 610R ad Argenta,11939,00,10622,1317,9581,2358,11939,0
2019/01,652,25/01/2019,5,SS 16 dal bivio SP 610R ad Argenta,12226,00,11028,1198,9505,2721,12226,0
2019/01,652,26/01/2019,6,SS 16 dal bivio SP 610R ad Argenta,10521,00,10198,323,8136,2385,0,10521
2019/01,652,27/01/2019,7,SS 16 dal bivio SP 610R ad Argenta,8180,00,8104,76,6162,2018,0,8180
2019/01,652,28/01/2019,1,SS 16 dal bivio SP 610R ad Argenta,11558,00,10267,1291,9392,2166,11558,0
2019/01,653,17/01/2019,4,SP 254R dal ponte sul fiume Savio alla SS 16,7924,00,7751,173,6353,1571,7924,0
2019/01,653,18/01/2019,5,SP 254R dal ponte sul fiume Savio alla SS 16,7694,00,7556,138,6039,1655,7694,0
2019/01,653,19/01/2019,6,SP 254R dal ponte sul fiume Savio alla SS 16,6954,00,6900,54,4866,2088,0,6954
2019/01,653,20/01/2019,7,SP 254R dal ponte sul fiume Savio alla SS 16,6976,00,6965,11,5048,1928,0,6976
2019/01,653,21/01/2019,1,SP 254R dal ponte sul fiume Savio alla SS 16,6950,00,6796,154,5724,1226,6950,0
2019/01,653,22/01/2019,2,SP 254R dal ponte sul fiume Savio alla SS 16,6157,00,5843,314,5157,1000,6157,0
2019/01,653,23/01/2019,3,SP 254R dal ponte sul fiume Savio alla SS 16,6955,00,6792,163,5648,1307,6955,0
2019/01,653,24/01/2019,4,SP 254R dal ponte sul fiume Savio alla SS 16,7228,00,7079,149,5855,1373,7228,0
2019/01,653,25/01/2019,5,SP 254R dal ponte sul fiume Savio alla SS 16,7948,00,7778,170,6203,1745,7948,0
2019/01,653,26/01/2019,6,SP 254R dal ponte sul fiume Savio alla SS 16,8237,00,8178,59,6086,2151,0,8237
2019/01,653,27/01/2019,7,SP 254R dal ponte sul fiume Savio alla SS 16,7779,00,7769,10,6010,1769,0,7779
2019/01,653,28/01/2019,1,SP 254R dal ponte sul fiume Savio alla SS 16,6908,00,6731,177,5726,1182,6908,0
2019/01,654,15/01/2019,2,SP 7IBisR dal bivio SSPP 32/33ter alla SS 16,10992,00,10512,480,8923,2069,10992,0
2019/01,654,16/01/2019,3,SP 7IBisR dal bivio SSPP 32/33ter alla SS 16,11191,00,10666,525,9116,2075,11191,0
2019/01,654,17/01/2019,4,SP 7IBisR dal bivio SSPP 32/33ter alla SS 16,11106,00,10662,444,9104,2002,11106,0
2019/01,654,18/01/2019,5,SP 7IBisR dal bivio SSPP 32/33ter alla SS 16,11363,00,10952,411,8801,2562,11363,0
2019/01,654,19/01/2019,6,SP 7IBisR dal bivio SSPP 32/33ter alla SS 16,10105,00,9972,133,6728,3377,0,10105
2019/01,654,20/01/2019,7,SP 7IBisR dal bivio SSPP 32/33ter alla SS 16,9188,00,9166,22,6197,2991,0,9188
2019/01,654,21/01/2019,1,SP 7IBisR dal bivio SSPP 32/33ter alla SS 16,10647,00,10220,427,8690,1957,10647,0
2019/01,654,22/01/2019,2,SP 7IBisR dal bivio SSPP 32/33ter alla SS 16,9716,00,9356,360,8049,1667,9716,0
2019/01,654,23/01/2019,3,SP 7IBisR dal bivio SSPP 32/33ter alla SS 16,10031,00,9589,442,8137,1894,10031,0
2019/01,654,24/01/2019,4,SP 7IBisR dal bivio SSPP 32/33ter alla SS 16,10490,00,10080,410,8295,2195,10490,0
2019/01,654,25/01/2019,5,SP 7IBisR dal bivio SSPP 32/33ter alla SS 16,11233,00,10897,336,8597,2636,11233,0
2019/01,654,26/01/2019,6,SP 7IBisR dal bivio SSPP 32/33ter alla SS 16,10506,00,10379,127,7487,3019,0,10506
2019/01,654,27/01/2019,7,SP 7IBisR dal bivio SSPP 32/33ter alla SS 16,9132,00,9108,24,6614,2518,0,9132
2019/01,654,28/01/2019,1,SP 7IBisR dal bivio SSPP 32/33ter alla SS 16,10433,00,9985,448,8604,1829,10433,0
2019/01,655,15/01/2019,2,SP 253R dal bivio SP 302R allo svincolo A 14dir a Fornace Zarattini,17415,00,16498,917,14040,3375,17415,0
2019/01,655,16/01/2019,3,SP 253R dal bivio SP 302R allo svincolo A 14dir a Fornace Zarattini,17516,00,16724,792,14051,3465,17516,0
2019/01,655,17/01/2019,4,SP 253R dal bivio SP 302R allo svincolo A 14dir a Fornace Zarattini,17543,00,16625,918,13914,3629,17543,0
2019/01,655,18/01/2019,5,SP 253R dal bivio SP 302R allo svincolo A 14dir a Fornace Zarattini,18035,00,17180,855,14153,3882,18035,0
2019/01,655,19/01/2019,6,SP 253R dal bivio SP 302R allo svincolo A 14dir a Fornace Zarattini,15600,00,15357,243,11532,4068,0,15600
2019/01,655,20/01/2019,7,SP 253R dal bivio SP 302R allo svincolo A 14dir a Fornace Zarattini,10828,00,10778,50,7811,3017,0,10828
2019/01,655,21/01/2019,1,SP 253R dal bivio SP 302R allo svincolo A 14dir a Fornace Zarattini,17097,00,16248,849,13972,3125,17097,0
2019/01,655,22/01/2019,2,SP 253R dal bivio SP 302R allo svincolo A 14dir a Fornace Zarattini,16711,00,15844,867,13738,2973,16711,0
2019/01,655,23/01/2019,3,SP 253R dal bivio SP 302R allo svincolo A 14dir a Fornace Zarattini,16888,00,16094,794,13554,3334,16888,0
2019/01,655,24/01/2019,4,SP 253R dal bivio SP 302R allo svincolo A 14dir a Fornace Zarattini,17398,00,16534,864,13896,3502,17398,0
2019/01,655,25/01/2019,5,SP 253R dal bivio SP 302R allo svincolo A 14dir a Fornace Zarattini,17633,00,16774,859,13752,3881,17633,0
2019/01,655,26/01/2019,6,SP 253R dal bivio SP 302R allo svincolo A 14dir a Fornace Zarattini,14549,00,14303,246,10656,3893,0,14549
2019/01,655,27/01/2019,7,SP 253R dal bivio SP 302R allo svincolo A 14dir a Fornace Zarattini,10608,00,10556,52,7834,2774,0,10608
2019/01,655,28/01/2019,1,SP 253R dal bivio SP 302R allo svincolo A 14dir a Fornace Zarattini,16763,00,15938,825,13651,3112,16763,0
2019/01,660,15/01/2019,2,SP 25 tra intersezione con SS 64 e confine provinciale,,,,,,,,
2019/01,660,16/01/2019,3,SP 25 tra intersezione con SS 64 e confine provinciale,,,,,,,,
2019/01,660,17/01/2019,4,SP 25 tra intersezione con SS 64 e confine provinciale,,,,,,,,
2019/01,660,18/01/2019,5,SP 25 tra intersezione con SS 64 e confine provinciale,,,,,,,,
2019/01,660,19/01/2019,6,SP 25 tra intersezione con SS 64 e confine provinciale,,,,,,,,
2019/01,660,20/01/2019,7,SP 25 tra intersezione con SS 64 e confine provinciale,,,,,,,,
2019/01,660,21/01/2019,1,SP 25 tra intersezione con SS 64 e confine provinciale,,,,,,,,
2019/01,660,22/01/2019,2,SP 25 tra intersezione con SS 64 e confine provinciale,,,,,,,,
2019/01,660,23/01/2019,3,SP 25 tra intersezione con SS 64 e confine provinciale,,,,,,,,
2019/01,660,24/01/2019,4,SP 25 tra intersezione con SS 64 e confine provinciale,,,,,,,,
2019/01,660,25/01/2019,5,SP 25 tra intersezione con SS 64 e confine provinciale,,,,,,,,
2019/01,660,26/01/2019,6,SP 25 tra intersezione con SS 64 e confine provinciale,,,,,,,,
2019/01,660,27/01/2019,7,SP 25 tra intersezione con SS 64 e confine provinciale,,,,,,,,
2019/01,660,28/01/2019,1,SP 25 tra intersezione con SS 64 e confine provinciale,,,,,,,,
2019/01,661,15/01/2019,2,SP 15 tra Tresigallo e Massa Fiscaglia,3315,00,3172,143,2704,611,3315,0
2019/01,661,16/01/2019,3,SP 15 tra Tresigallo e Massa Fiscaglia,3322,10,3187,134,2663,659,3322,0
2019/01,661,17/01/2019,4,SP 15 tra Tresigallo e Massa Fiscaglia,3331,00,3146,185,2657,674,3331,0
2019/01,661,18/01/2019,5,SP 15 tra Tresigallo e Massa Fiscaglia,3432,50,3236,191,2713,719,3432,0
2019/01,661,19/01/2019,6,SP 15 tra Tresigallo e Massa Fiscaglia,2771,10,2713,57,2000,771,0,2771
2019/01,661,20/01/2019,7,SP 15 tra Tresigallo e Massa Fiscaglia,2293,10,2279,13,1709,584,0,2293
2019/01,661,21/01/2019,1,SP 15 tra Tresigallo e Massa Fiscaglia,3159,20,3028,129,2549,610,3159,0
2019/01,661,22/01/2019,2,SP 15 tra Tresigallo e Massa Fiscaglia,3163,20,3058,103,2535,628,3163,0
2019/01,661,23/01/2019,3,SP 15 tra Tresigallo e Massa Fiscaglia,3178,00,3067,111,2541,637,3178,0
2019/01,661,24/01/2019,4,SP 15 tra Tresigallo e Massa Fiscaglia,3273,10,3156,116,2592,681,3273,0
2019/01,661,25/01/2019,5,SP 15 tra Tresigallo e Massa Fiscaglia,3286,10,3140,145,2529,757,3286,0
2019/01,661,26/01/2019,6,SP 15 tra Tresigallo e Massa Fiscaglia,2724,00,2671,53,1989,735,0,2724
2019/01,661,27/01/2019,7,SP 15 tra Tresigallo e Massa Fiscaglia,2212,00,2205,7,1632,580,0,2212
2019/01,661,28/01/2019,1,SP 15 tra Tresigallo e Massa Fiscaglia,3177,10,3052,124,2574,603,3177,0
2019/01,662,15/01/2019,2,SP 2 tra intersezione SP 14 e Copparo,13673,00,13063,610,11187,2486,13673,0
2019/01,662,16/01/2019,3,SP 2 tra intersezione SP 14 e Copparo,13372,00,12809,563,10843,2529,13372,0
2019/01,662,17/01/2019,4,SP 2 tra intersezione SP 14 e Copparo,13319,00,12751,568,10702,2617,13319,0
2019/01,662,18/01/2019,5,SP 2 tra intersezione SP 14 e Copparo,13665,10,13100,564,10976,2689,13665,0
2019/01,662,19/01/2019,6,SP 2 tra intersezione SP 14 e Copparo,10790,00,10600,190,8214,2576,0,10790
2019/01,662,20/01/2019,7,SP 2 tra intersezione SP 14 e Copparo,8097,00,8064,33,5728,2369,0,8097
2019/01,662,21/01/2019,1,SP 2 tra intersezione SP 14 e Copparo,13429,00,12873,556,11014,2415,13429,0
2019/01,662,22/01/2019,2,SP 2 tra intersezione SP 14 e Copparo,13198,00,12621,577,10793,2405,13198,0
2019/01,662,23/01/2019,3,SP 2 tra intersezione SP 14 e Copparo,12939,00,12369,570,10474,2465,12939,0
2019/01,662,24/01/2019,4,SP 2 tra intersezione SP 14 e Copparo,13138,10,12624,513,10576,2562,13138,0
2019/01,662,25/01/2019,5,SP 2 tra intersezione SP 14 e Copparo,13797,00,13246,551,11002,2795,13797,0
2019/01,662,26/01/2019,6,SP 2 tra intersezione SP 14 e Copparo,10543,00,10369,174,7965,2578,0,10543
2019/01,662,27/01/2019,7,SP 2 tra intersezione SP 14 e Copparo,8254,00,8222,32,5807,2447,0,8254
2019/01,662,28/01/2019,1,SP 2 tra intersezione SP 14 e Copparo,12942,00,12343,599,10583,2359,12942,0
2019/01,663,15/01/2019,2,SP 60 tra intersezione SP 68 e SP62,3034,00,2550,484,2459,575,3034,0
2019/01,663,16/01/2019,3,SP 60 tra intersezione SP 68 e SP62,3006,00,2587,419,2407,599,3006,0
2019/01,663,17/01/2019,4,SP 60 tra intersezione SP 68 e SP62,3018,00,2591,427,2409,609,3018,0
2019/01,663,18/01/2019,5,SP 60 tra intersezione SP 68 e SP62,3060,00,2615,445,2344,716,3060,0
2019/01,663,19/01/2019,6,SP 60 tra intersezione SP 68 e SP62,2562,00,2430,132,1928,634,0,2562
2019/01,663,20/01/2019,7,SP 60 tra intersezione SP 68 e SP62,2482,00,2465,17,1883,599,0,2482
2019/01,663,21/01/2019,1,SP 60 tra intersezione SP 68 e SP62,2997,00,2556,441,2374,623,2997,0
2019/01,663,22/01/2019,2,SP 60 tra intersezione SP 68 e SP62,2951,00,2538,413,2363,588,2951,0
2019/01,663,23/01/2019,3,SP 60 tra intersezione SP 68 e SP62,2941,00,2523,418,2320,621,2941,0
2019/01,663,24/01/2019,4,SP 60 tra intersezione SP 68 e SP62,2901,00,2440,461,2277,624,2901,0
2019/01,663,25/01/2019,5,SP 60 tra intersezione SP 68 e SP62,3129,10,2684,444,2425,704,3129,0
2019/01,663,26/01/2019,6,SP 60 tra intersezione SP 68 e SP62,2607,00,2481,126,1963,644,0,2607
2019/01,663,27/01/2019,7,SP 60 tra intersezione SP 68 e SP62,2322,00,2302,20,1754,568,0,2322
2019/01,663,28/01/2019,1,SP 60 tra intersezione SP 68 e SP62,2771,00,2333,438,2193,578,2771,0
2019/01,665,15/01/2019,2,SP 1 tra intersezione SP7 a Piacenza,11818,00,11169,649,9536,2282,11818,0
2019/01,665,16/01/2019,3,SP 1 tra intersezione SP7 a Piacenza,11980,00,11283,697,9645,2335,11980,0
2019/01,665,17/01/2019,4,SP 1 tra intersezione SP7 a Piacenza,6154,00,5734,420,5419,735,6154,0
2019/01,665,24/01/2019,4,SP 1 tra intersezione SP7 a Piacenza,10868,10,10216,651,8621,2247,10868,0
2019/01,665,25/01/2019,5,SP 1 tra intersezione SP7 a Piacenza,11839,10,11276,562,9366,2473,11839,0
2019/01,665,26/01/2019,6,SP 1 tra intersezione SP7 a Piacenza,9327,00,9155,172,6901,2426,0,9327
2019/01,665,27/01/2019,7,SP 1 tra intersezione SP7 a Piacenza,6619,00,6569,50,4680,1939,0,6619
2019/01,665,28/01/2019,1,SP 1 tra intersezione SP7 a Piacenza,11404,00,10784,620,9246,2158,11404,0
2019/01,666,15/01/2019,2,SP 3 tra via Monda e via Caminate,7693,00,7231,462,6174,1519,7693,0
2019/01,666,16/01/2019,3,SP 3 tra via Monda e via Caminate,7697,10,7242,454,6139,1558,7697,0
2019/01,666,17/01/2019,4,SP 3 tra via Monda e via Caminate,7829,00,7357,472,6210,1619,7829,0
2019/01,666,18/01/2019,5,SP 3 tra via Monda e via Caminate,7834,00,7334,500,6217,1617,7834,0
2019/01,666,19/01/2019,6,SP 3 tra via Monda e via Caminate,6143,10,6041,101,4442,1701,0,6143
2019/01,666,21/01/2019,1,SP 3 tra via Monda e via Caminate,7287,00,6853,434,5934,1353,7287,0
2019/01,666,22/01/2019,2,SP 3 tra via Monda e via Caminate,6762,10,6321,440,5613,1149,6762,0
2019/01,666,23/01/2019,3,SP 3 tra via Monda e via Caminate,7049,10,6675,373,5711,1338,7049,0
2019/01,666,24/01/2019,4,SP 3 tra via Monda e via Caminate,7225,00,6789,436,5823,1402,7225,0
2019/01,666,25/01/2019,5,SP 3 tra via Monda e via Caminate,7709,10,7292,416,6130,1579,7709,0
2019/01,666,26/01/2019,6,SP 3 tra via Monda e via Caminate,6172,00,6081,91,4590,1582,0,6172
2019/01,666,27/01/2019,7,SP 3 tra via Monda e via Caminate,5020,00,4995,25,3777,1243,0,5020
2019/01,666,28/01/2019,1,SP 3 tra via Monda e via Caminate,7292,00,6850,442,5964,1328,7292,0
2019/01,670,15/01/2019,2,SP 114 dalla rotatoria SP 114/viale Parisoli alla rotatoria SP467,16776,00,15927,849,13739,3037,16776,0
2019/01,670,16/01/2019,3,SP 114 dalla rotatoria SP 114/viale Parisoli alla rotatoria SP467,17079,00,16225,854,13910,3169,17079,0
2019/01,670,17/01/2019,4,SP 114 dalla rotatoria SP 114/viale Parisoli alla rotatoria SP467,17373,10,16535,837,14032,3341,17373,0
2019/01,670,18/01/2019,5,SP 114 dalla rotatoria SP 114/viale Parisoli alla rotatoria SP467,17475,00,16685,790,14034,3441,17475,0
2019/01,670,19/01/2019,6,SP 114 dalla rotatoria SP 114/viale Parisoli alla rotatoria SP467,13201,00,13039,162,9668,3533,0,13201
2019/01,670,20/01/2019,7,SP 114 dalla rotatoria SP 114/viale Parisoli alla rotatoria SP467,9077,10,9014,62,6319,2758,0,9077
2019/01,670,21/01/2019,1,SP 114 dalla rotatoria SP 114/viale Parisoli alla rotatoria SP467,16203,20,15439,762,13368,2835,16203,0
2019/01,670,22/01/2019,2,SP 114 dalla rotatoria SP 114/viale Parisoli alla rotatoria SP467,16568,00,15748,820,13573,2995,16568,0
2019/01,670,23/01/2019,3,SP 114 dalla rotatoria SP 114/viale Parisoli alla rotatoria SP467,16248,00,15498,750,13396,2852,16248,0
2019/01,670,24/01/2019,4,SP 114 dalla rotatoria SP 114/viale Parisoli alla rotatoria SP467,15975,00,15282,693,12881,3094,15975,0
2019/01,670,25/01/2019,5,SP 114 dalla rotatoria SP 114/viale Parisoli alla rotatoria SP467,17211,10,16492,718,13777,3434,17211,0
2019/01,670,26/01/2019,6,SP 114 dalla rotatoria SP 114/viale Parisoli alla rotatoria SP467,13426,00,13288,138,9890,3536,0,13426
2019/01,670,27/01/2019,7,SP 114 dalla rotatoria SP 114/viale Parisoli alla rotatoria SP467,8861,00,8818,43,6256,2605,0,8861
2019/01,670,28/01/2019,1,SP 114 dalla rotatoria SP 114/viale Parisoli alla rotatoria SP467,15992,00,15257,735,13196,2796,15992,0
2019/01,6,29/01/2019,2,SS 12 tra Fiumalbo e Abetone,1422,00,1378,44,1250,172,1422,0
2019/01,6,30/01/2019,3,SS 12 tra Fiumalbo e Abetone,1153,00,1109,44,989,164,1153,0
2019/01,6,31/01/2019,4,SS 12 tra Fiumalbo e Abetone,1269,10,1223,45,1088,181,1269,0
2019/01,7,29/01/2019,2,SS 64 tra Porretta Terme e Sambuca Pistoiese,6687,10,6432,254,5611,1076,6687,0
2019/01,7,30/01/2019,3,SS 64 tra Porretta Terme e Sambuca Pistoiese,5971,10,5698,272,5099,872,5971,0
2019/01,7,31/01/2019,4,SS 64 tra Porretta Terme e Sambuca Pistoiese,5195,00,4978,217,4266,929,5195,0
2019/01,9,29/01/2019,2,SS 67 tra Rocca San Casciano e Portico San Benedetto,1107,00,1025,82,920,187,1107,0
2019/01,9,30/01/2019,3,SS 67 tra Rocca San Casciano e Portico San Benedetto,1065,10,992,72,899,166,1065,0
2019/01,9,31/01/2019,4,SS 67 tra Rocca San Casciano e Portico San Benedetto,883,10,795,87,724,159,883,0
2019/01,12,29/01/2019,2,SS 16 al Confine regionale (Marche),15525,10,14891,633,12329,3196,15525,0
2019/01,12,30/01/2019,3,SS 16 al Confine regionale (Marche),15346,20,14712,632,12181,3165,15346,0
2019/01,12,31/01/2019,4,SS 16 al Confine regionale (Marche),15964,00,15319,645,12547,3417,15964,0
2019/01,16,29/01/2019,2,SP 69 in località Pilastri al Confine regionale,1443,00,1290,153,1191,252,1443,0
2019/01,16,30/01/2019,3,SP 69 in località Pilastri al Confine regionale,1362,00,1224,138,1115,247,1362,0
2019/01,16,31/01/2019,4,SP 69 in località Pilastri al Confine regionale,1307,00,1200,107,1069,238,1307,0
2019/01,17,29/01/2019,2,SS 12 al Confine regionale (Lombardia),10366,00,9286,1080,8245,2121,10366,0
2019/01,17,30/01/2019,3,SS 12 al Confine regionale (Lombardia),10263,00,9114,1149,8242,2021,10263,0
2019/01,17,31/01/2019,4,SS 12 al Confine regionale (Lombardia),10055,10,9076,978,7893,2162,10055,0
2019/01,19,29/01/2019,2,SP 343R tra Colorno e Casalmaggiore,1092,00,889,203,923,169,1092,0
2019/01,19,30/01/2019,3,SP 343R tra Colorno e Casalmaggiore,864,00,800,64,741,123,864,0
2019/01,19,31/01/2019,4,SP 343R tra Colorno e Casalmaggiore,976,00,881,95,830,146,976,0
2019/01,25,29/01/2019,2,SS 9 tra San Prospero (Case Crostolo) e Sant'Ilario d'Enza,28607,180,26603,1986,21648,6959,28607,0
2019/01,25,30/01/2019,3,SS 9 tra San Prospero (Case Crostolo) e Sant'Ilario d'Enza,26511,50,24547,1959,21234,5277,26511,0
2019/01,25,31/01/2019,4,SS 9 tra San Prospero (Case Crostolo) e Sant'Ilario d'Enza,27292,40,25435,1853,21044,6248,27292,0
2019/01,29,29/01/2019,2,SS 9 tra Modena e Rubiera,23975,10,21516,2458,18318,5657,23975,0
2019/01,29,30/01/2019,3,SS 9 tra Modena e Rubiera,22026,70,19541,2478,17623,4403,22026,0
2019/01,29,31/01/2019,4,SS 9 tra Modena e Rubiera,18404,20,16340,2062,13750,4654,18404,0
2019/01,52,29/01/2019,2,SP 253 tra Sesto Imolese e Medicina,6042,10,5355,686,4771,1271,6042,0
2019/01,52,30/01/2019,3,SP 253 tra Sesto Imolese e Medicina,5789,00,5138,651,4620,1169,5789,0
2019/01,52,31/01/2019,4,SP 253 tra Sesto Imolese e Medicina,5542,00,4935,607,4334,1208,5542,0
2019/01,53,29/01/2019,2,SS 309 a San Giuseppe di Comacchio,9433,00,5704,3729,7398,2035,9433,0
2019/01,53,30/01/2019,3,SS 309 a San Giuseppe di Comacchio,9447,10,5759,3687,7366,2081,9447,0
2019/01,53,31/01/2019,4,SS 309 a San Giuseppe di Comacchio,9069,10,5646,3422,7053,2016,9069,0
2019/01,95,29/01/2019,2,SP 10R tra Castel San Giovanni e Sarmato,,,,,,,,
2019/01,95,30/01/2019,3,SP 10R tra Castel San Giovanni e Sarmato,,,,,,,,
2019/01,95,31/01/2019,4,SP 10R tra Castel San Giovanni e Sarmato,,,,,,,,
2019/01,98,29/01/2019,2,SP 302R tra Brisighella e Marradi,2855,00,2759,96,2256,599,2855,0
2019/01,98,30/01/2019,3,SP 302R tra Brisighella e Marradi,2746,00,2653,93,2185,561,2746,0
2019/01,98,31/01/2019,4,SP 302R tra Brisighella e Marradi,2560,00,2473,87,1984,576,2560,0
2019/01,100,29/01/2019,2,SP 258R tra Villa Verucchio ed ex Confine regionale (località Dogana),14185,00,13057,1128,11513,2672,14185,0
2019/01,100,30/01/2019,3,SP 258R tra Villa Verucchio ed ex Confine regionale (località Dogana),14487,00,13412,1075,11779,2708,14487,0
2019/01,100,31/01/2019,4,SP 258R tra Villa Verucchio ed ex Confine regionale (località Dogana),14013,00,13006,1007,11282,2731,14013,0
2019/01,104,29/01/2019,2,SP 10 nuovo ponte sul Po tra innesto variante Zibello e confine regionale (Lombardia),4320,00,3063,1257,3504,816,4320,0
2019/01,104,30/01/2019,3,SP 10 nuovo ponte sul Po tra innesto variante Zibello e confine regionale (Lombardia),4044,20,2859,1183,3272,772,4044,0
2019/01,104,31/01/2019,4,SP 10 nuovo ponte sul Po tra innesto variante Zibello e confine regionale (Lombardia),3933,00,2849,1084,3175,758,3933,0
2019/01,107,29/01/2019,2,SP 85 tra Rubiera e bivio SP 13MO (c/o Campogalliano),8833,00,7813,1020,6921,1912,8833,0
2019/01,107,30/01/2019,3,SP 85 tra Rubiera e bivio SP 13MO (c/o Campogalliano),8413,00,7503,910,6958,1455,8413,0
2019/01,107,31/01/2019,4,SP 85 tra Rubiera e bivio SP 13MO (c/o Campogalliano),8021,00,7191,830,6325,1696,8021,0
2019/01,108,29/01/2019,2,SP 412R tra Castel San Giovanni (Casello A 21) e ponte fiume Po,11637,130,11260,364,8699,2938,11637,0
2019/01,108,30/01/2019,3,SP 412R tra Castel San Giovanni (Casello A 21) e ponte fiume Po,10285,140,9937,334,7756,2529,10285,0
2019/01,108,31/01/2019,4,SP 412R tra Castel San Giovanni (Casello A 21) e ponte fiume Po,11393,170,10961,415,8671,2722,11393,0
2019/01,112,29/01/2019,2,SP 111 tra Boretto e Viadana sul ponte Po,19797,10,17071,2725,15635,4162,19797,0
2019/01,112,30/01/2019,3,SP 111 tra Boretto e Viadana sul ponte Po,18709,10,16085,2623,14957,3752,18709,0
2019/01,112,31/01/2019,4,SP 111 tra Boretto e Viadana sul ponte Po,18784,20,16236,2546,14676,4108,18784,0
2019/01,115,29/01/2019,2,SP 68 ad Ariano Polesine al Confine regionale (Veneto),2488,00,2254,234,1978,510,2488,0
2019/01,115,30/01/2019,3,SP 68 ad Ariano Polesine al Confine regionale (Veneto),2519,10,2259,259,2012,507,2519,0
2019/01,115,31/01/2019,4,SP 68 ad Ariano Polesine al Confine regionale (Veneto),2575,00,2326,249,2042,533,2575,0
2019/01,116,29/01/2019,2,SP 138 tra SPiero in Bagno (E 45) e Bagno di Romagna,4665,00,4513,152,3797,868,4665,0
2019/01,116,30/01/2019,3,SP 138 tra SPiero in Bagno (E 45) e Bagno di Romagna,4817,20,4630,185,4014,803,4817,0
2019/01,116,31/01/2019,4,SP 138 tra SPiero in Bagno (E 45) e Bagno di Romagna,4380,10,4234,145,3556,824,4380,0
2019/01,117,29/01/2019,2,SS 63 tra Collagna e Sassalbo (Passo del Cerreto),438,00,414,24,392,46,438,0
2019/01,117,30/01/2019,3,SS 63 tra Collagna e Sassalbo (Passo del Cerreto),273,00,246,27,218,55,273,0
2019/01,117,31/01/2019,4,SS 63 tra Collagna e Sassalbo (Passo del Cerreto),328,00,303,25,265,63,328,0
2019/01,118,30/01/2019,3,SS 45 tra Ottone e Gorreto,251,00,237,14,217,34,251,0
2019/01,118,31/01/2019,4,SS 45 tra Ottone e Gorreto,379,10,366,12,332,47,379,0
2019/01,122,29/01/2019,2,SP 10R tra Piacenza (ponte fiume Trebbia) e San Nicolo',26972,30,25857,1112,20924,6048,26972,0
2019/01,122,30/01/2019,3,SP 10R tra Piacenza (ponte fiume Trebbia) e San Nicolo',24040,20,23077,961,18760,5280,24040,0
2019/01,122,31/01/2019,4,SP 10R tra Piacenza (ponte fiume Trebbia) e San Nicolo',25996,90,24966,1021,20193,5803,25996,0
2019/01,123,29/01/2019,2,SP 28 tra Piacenza (Tangenziale Sud) e Gossolengo,16605,00,16205,400,13345,3260,16605,0
2019/01,123,30/01/2019,3,SP 28 tra Piacenza (Tangenziale Sud) e Gossolengo,14452,00,14064,388,11620,2832,14452,0
2019/01,123,31/01/2019,4,SP 28 tra Piacenza (Tangenziale Sud) e Gossolengo,15747,00,15370,377,12709,3038,15747,0
2019/01,124,29/01/2019,2,SS 45 tra Piacenza e Settima,16185,00,15311,874,12937,3248,16185,0
2019/01,124,30/01/2019,3,SS 45 tra Piacenza e Settima,13577,10,12974,602,10774,2803,13577,0
2019/01,124,31/01/2019,4,SS 45 tra Piacenza e Settima,14577,00,13753,824,11691,2886,14577,0
2019/01,126,29/01/2019,2,SP 6 tra Piacenza (Tangenziale Sud) e bivio SP 42/ponte fiume Nure in località San Giorgio Piacentino,15403,10,14742,660,12261,3142,15403,0
2019/01,126,30/01/2019,3,SP 6 tra Piacenza (Tangenziale Sud) e bivio SP 42/ponte fiume Nure in località San Giorgio Piacentino,13283,00,12733,550,10542,2741,13283,0
2019/01,126,31/01/2019,4,SP 6 tra Piacenza (Tangenziale Sud) e bivio SP 42/ponte fiume Nure in località San Giorgio Piacentino,14687,10,14098,588,11809,2878,14687,0
2019/01,127,29/01/2019,2,SS 9 tra Piacenza e Pontenure,24527,10,22740,1786,19429,5098,24527,0
2019/01,127,30/01/2019,3,SS 9 tra Piacenza e Pontenure,21686,00,20067,1619,17290,4396,21686,0
2019/01,127,31/01/2019,4,SS 9 tra Piacenza e Pontenure,23069,10,21421,1647,18453,4616,23069,0
2019/01,128,29/01/2019,2,SP 10R tra Piacenza (Casello A 1/A 21) e il bivio SP 10R e SP 587R,17226,00,15281,1945,13595,3631,17226,0
2019/01,128,30/01/2019,3,SP 10R tra Piacenza (Casello A 1/A 21) e il bivio SP 10R e SP 587R,15838,00,13946,1892,12343,3495,15838,0
2019/01,128,31/01/2019,4,SP 10R tra Piacenza (Casello A 1/A 21) e il bivio SP 10R e SP 587R,16649,00,14809,1840,13221,3428,16649,0
2019/01,129,29/01/2019,2,SS 9Var tra Parma e ponte fiume Taro (Tangenziale nord di Parma),,,,,,,,
2019/01,129,30/01/2019,3,SS 9Var tra Parma e ponte fiume Taro (Tangenziale nord di Parma),,,,,,,,
2019/01,129,31/01/2019,4,SS 9Var tra Parma e ponte fiume Taro (Tangenziale nord di Parma),,,,,,,,
2019/01,130,29/01/2019,2,SS 62 tra Parma e Collecchio,21486,00,20187,1299,16815,4671,21486,0
2019/01,130,30/01/2019,3,SS 62 tra Parma e Collecchio,18601,40,17478,1119,15236,3365,18601,0
2019/01,130,31/01/2019,4,SS 62 tra Parma e Collecchio,19359,50,18326,1028,15102,4257,19359,0
2019/01,131,29/01/2019,2,SP 665R tra Parma e Corcagnano,20446,50,19351,1090,16377,4069,20446,0
2019/01,131,30/01/2019,3,SP 665R tra Parma e Corcagnano,18225,30,17153,1069,15062,3163,18225,0
2019/01,131,31/01/2019,4,SP 665R tra Parma e Corcagnano,18411,00,17388,1023,14547,3864,18411,0
2019/01,132,29/01/2019,2,SP 513R tra Parma e Pilastrello,21078,10,20110,967,16869,4209,21078,0
2019/01,132,30/01/2019,3,SP 513R tra Parma e Pilastrello,18291,10,17379,911,15211,3080,18291,0
2019/01,132,31/01/2019,4,SP 513R tra Parma e Pilastrello,18740,00,17935,805,14819,3921,18740,0
2019/01,133,29/01/2019,2,SP 62R tra Parma (viadotto A 1) e Sorbolo,18564,20,16446,2116,14487,4077,18564,0
2019/01,133,30/01/2019,3,SP 62R tra Parma (viadotto A 1) e Sorbolo,17484,20,15343,2139,13947,3537,17484,0
2019/01,133,31/01/2019,4,SP 62R tra Parma (viadotto A 1) e Sorbolo,17908,30,15898,2007,13948,3960,17908,0
2019/01,134,29/01/2019,2,SP 343R tra Parma e San Polo,18297,00,15878,2419,14297,4000,18297,0
2019/01,134,30/01/2019,3,SP 343R tra Parma e San Polo,17333,10,15063,2269,13784,3549,17333,0
2019/01,134,31/01/2019,4,SP 343R tra Parma e San Polo,17756,00,15444,2312,13926,3830,17756,0
2019/01,135,29/01/2019,2,SP 10 tra Parma (Tangenziale) e Viarolo,,,,,,,,
2019/01,135,30/01/2019,3,SP 10 tra Parma (Tangenziale) e Viarolo,,,,,,,,
2019/01,135,31/01/2019,4,SP 10 tra Parma (Tangenziale) e Viarolo,,,,,,,,
2019/01,138,29/01/2019,2,SS 63 tra Reggio Emilia e Puianello,11846,10,11421,424,9217,2629,11846,0
2019/01,138,30/01/2019,3,SS 63 tra Reggio Emilia e Puianello,10417,00,10061,356,8454,1963,10417,0
2019/01,138,31/01/2019,4,SS 63 tra Reggio Emilia e Puianello,10491,00,10150,341,8085,2406,10491,0
2019/01,139,29/01/2019,2,SP 467R tra Fogliano e località Pratissolo (c/o Scandiano),17575,10,16839,735,14200,3375,17575,0
2019/01,139,30/01/2019,3,SP 467R tra Fogliano e località Pratissolo (c/o Scandiano),16498,00,15820,678,13886,2612,16498,0
2019/01,139,31/01/2019,4,SP 467R tra Fogliano e località Pratissolo (c/o Scandiano),16423,00,15798,625,13225,3198,16423,0
2019/01,140,29/01/2019,2,SS 9 tra Masone e Rubiera,25273,00,22468,2805,19088,6185,25273,0
2019/01,140,30/01/2019,3,SS 9 tra Masone e Rubiera,23786,00,21005,2781,18933,4853,23786,0
2019/01,140,31/01/2019,4,SS 9 tra Masone e Rubiera,22620,20,20255,2363,17209,5411,22620,0
2019/01,143,29/01/2019,2,SP 63R tra Sesso e Cadelbosco di Sopra (bivio SP 358R),25248,00,23870,1378,20157,5091,25248,0
2019/01,143,30/01/2019,3,SP 63R tra Sesso e Cadelbosco di Sopra (bivio SP 358R),23910,00,22528,1382,19791,4119,23910,0
2019/01,143,31/01/2019,4,SP 63R tra Sesso e Cadelbosco di Sopra (bivio SP 358R),23531,00,22278,1253,18665,4866,23531,0
2019/01,146,29/01/2019,2,SS 12 tra Montale e Modena,21195,00,19876,1319,16596,4599,21195,0
2019/01,146,30/01/2019,3,SS 12 tra Montale e Modena,20035,40,18730,1301,16077,3958,20035,0
2019/01,146,31/01/2019,4,SS 12 tra Montale e Modena,14722,10,13677,1044,11334,3388,14722,0
2019/01,147,29/01/2019,2,SP 623 tra Modena Sud/casello A 1 e Spilamberto,19085,00,15788,3297,15031,4054,19085,0
2019/01,147,30/01/2019,3,SP 623 tra Modena Sud/casello A 1 e Spilamberto,17949,10,14634,3314,14481,3468,17949,0
2019/01,147,31/01/2019,4,SP 623 tra Modena Sud/casello A 1 e Spilamberto,15085,20,12503,2580,11734,3351,15085,0
2019/01,149,29/01/2019,2,SP 255 tra Modena e Navicello,35620,610,32241,3318,27726,7894,35620,0
2019/01,149,30/01/2019,3,SP 255 tra Modena e Navicello,34464,520,31081,3331,27319,7145,34464,0
2019/01,149,31/01/2019,4,SP 255 tra Modena e Navicello,25044,10,22488,2555,19317,5727,25044,0
2019/01,150,29/01/2019,2,SS 12 tra Modena e Bastiglia,23574,10,21637,1936,18617,4957,23574,0
2019/01,150,30/01/2019,3,SS 12 tra Modena e Bastiglia,22597,00,20693,1904,18416,4181,22597,0
2019/01,150,31/01/2019,4,SS 12 tra Modena e Bastiglia,16000,00,14416,1584,12434,3566,16000,0
2019/01,153,29/01/2019,2,Via Porrettana (ex SS 64) tra Bologna e Pontecchio Marconi,11973,10,11713,259,9335,2638,11973,0
2019/01,153,30/01/2019,3,Via Porrettana (ex SS 64) tra Bologna e Pontecchio Marconi,11292,10,11017,274,8951,2341,11292,0
2019/01,153,31/01/2019,4,Via Porrettana (ex SS 64) tra Bologna e Pontecchio Marconi,11109,10,10850,258,8545,2564,11109,0
2019/01,154,29/01/2019,2,Tra Rastignano e Pian di Macina (SP85 Fondo Valle Savena),11729,00,11468,261,9334,2395,11729,0
2019/01,154,30/01/2019,3,Tra Rastignano e Pian di Macina (SP85 Fondo Valle Savena),10706,30,10460,243,8904,1802,10706,0
2019/01,154,31/01/2019,4,Tra Rastignano e Pian di Macina (SP85 Fondo Valle Savena),10087,00,9834,253,8022,2065,10087,0
2019/01,155,29/01/2019,2,Via Emilia tra San Lazzaro e Idice,14549,10,14072,476,11516,3033,14549,0
2019/01,155,30/01/2019,3,Via Emilia tra San Lazzaro e Idice,14754,00,14240,514,11704,3050,14754,0
2019/01,155,31/01/2019,4,Via Emilia tra San Lazzaro e Idice,14649,00,14139,510,11400,3249,14649,0
2019/01,156,29/01/2019,2,SP 253 tra la località Villanova e inizio variante Castenaso,21275,10,20557,717,16893,4382,21275,0
2019/01,156,30/01/2019,3,SP 253 tra la località Villanova e inizio variante Castenaso,20671,20,20006,663,16775,3896,20671,0
2019/01,156,31/01/2019,4,SP 253 tra la località Villanova e inizio variante Castenaso,19936,00,19346,590,15646,4290,19936,0
2019/01,157,29/01/2019,2,Via San Donato (ex SP 5) tra Granarolo dell'Emilia e Quarto Inferiore,11756,00,11478,278,9285,2471,11756,0
2019/01,157,30/01/2019,3,Via San Donato (ex SP 5) tra Granarolo dell'Emilia e Quarto Inferiore,11645,00,11379,266,9327,2318,11645,0
2019/01,157,31/01/2019,4,Via San Donato (ex SP 5) tra Granarolo dell'Emilia e Quarto Inferiore,10803,00,10538,265,8529,2274,10803,0
2019/01,158,29/01/2019,2,SS 64 tra Bologna e Lovoleto,11512,10,10841,670,8965,2547,11512,0
2019/01,158,30/01/2019,3,SS 64 tra Bologna e Lovoleto,11339,00,10654,685,9173,2166,11339,0
2019/01,158,31/01/2019,4,SS 64 tra Bologna e Lovoleto,10183,40,9575,604,7834,2349,10183,0
2019/01,160,29/01/2019,2,SP 18 tra Bargellino e Calderara di Reno (c/o Variante SP18),17986,00,16430,1556,14253,3733,17986,0
2019/01,160,30/01/2019,3,SP 18 tra Bargellino e Calderara di Reno (c/o Variante SP18),17453,10,15812,1640,14163,3290,17453,0
2019/01,160,31/01/2019,4,SP 18 tra Bargellino e Calderara di Reno (c/o Variante SP18),16949,10,15375,1573,13350,3599,16949,0
2019/01,161,29/01/2019,2,SP 568 da Tavernelle all'intersezione della SP3,18271,00,17229,1042,14074,4197,18271,0
2019/01,161,30/01/2019,3,SP 568 da Tavernelle all'intersezione della SP3,18102,00,17031,1071,14428,3674,18102,0
2019/01,161,31/01/2019,4,SP 568 da Tavernelle all'intersezione della SP3,16968,20,15994,972,13019,3949,16968,0
2019/01,162,29/01/2019,2,SS 9 località Cavazzona,16421,00,14725,1696,11835,4586,16421,0
2019/01,162,30/01/2019,3,SS 9 località Cavazzona,15323,00,13677,1646,11723,3600,15323,0
2019/01,162,31/01/2019,4,SS 9 località Cavazzona,14787,70,13444,1336,10846,3941,14787,0
2019/01,170,29/01/2019,2,SS 67 tra Rovere e Forlì,9159,00,8773,386,7336,1823,9159,0
2019/01,170,30/01/2019,3,SS 67 tra Rovere e Forlì,9009,00,8611,398,7123,1886,9009,0
2019/01,170,31/01/2019,4,SS 67 tra Rovere e Forlì,8764,00,8339,425,6878,1886,8764,0
2019/01,171,29/01/2019,2,SP 56 tra Forlì e bivio SS67 (Castrocaro Terme),6604,10,6410,193,5295,1309,6604,0
2019/01,171,30/01/2019,3,SP 56 tra Forlì e bivio SS67 (Castrocaro Terme),6753,00,6546,207,5356,1397,6753,0
2019/01,171,31/01/2019,4,SP 56 tra Forlì e bivio SS67 (Castrocaro Terme),6558,00,6391,167,5186,1372,6558,0
2019/01,173,29/01/2019,2,SP 4 tra Ronco (SS9) e bivio SP 72 (Para),8049,10,7586,462,6549,1500,8049,0
2019/01,173,30/01/2019,3,SP 4 tra Ronco (SS9) e bivio SP 72 (Para),7779,00,7361,418,6201,1578,7779,0
2019/01,173,31/01/2019,4,SP 4 tra Ronco (SS9) e bivio SP 72 (Para),7747,10,7344,402,6224,1523,7747,0
2019/01,174,29/01/2019,2,SS 9 tra Ronco e Forlimpopoli,,,,,,,,
2019/01,174,30/01/2019,3,SS 9 tra Ronco e Forlimpopoli,,,,,,,,
2019/01,174,31/01/2019,4,SS 9 tra Ronco e Forlimpopoli,,,,,,,,
2019/01,176,29/01/2019,2,SP 2 in località La Caserma al Confine Provinciale,7659,00,7063,596,6222,1437,7659,0
2019/01,176,30/01/2019,3,SP 2 in località La Caserma al Confine Provinciale,7689,00,7035,654,6240,1449,7689,0
2019/01,176,31/01/2019,4,SP 2 in località La Caserma al Confine Provinciale,7388,00,6790,598,5919,1469,7388,0
2019/01,177,29/01/2019,2,NSA 313 - Prosecuzione tangenziale di Bologna complanare sud alla A 14 nel tratto San Lazzaro/Idice,16494,00,15687,807,12674,3820,16494,0
2019/01,177,30/01/2019,3,NSA 313 - Prosecuzione tangenziale di Bologna complanare sud alla A 14 nel tratto San Lazzaro/Idice,15563,10,14771,791,12439,3124,15563,0
2019/01,177,31/01/2019,4,NSA 313 - Prosecuzione tangenziale di Bologna complanare sud alla A 14 nel tratto San Lazzaro/Idice,15052,00,14410,642,11497,3555,15052,0
2019/01,182,29/01/2019,2,SP 258R tra Rimini e A 14,16741,00,16090,651,13053,3688,16741,0
2019/01,182,30/01/2019,3,SP 258R tra Rimini e A 14,16693,00,16047,646,12987,3706,16693,0
2019/01,182,31/01/2019,4,SP 258R tra Rimini e A 14,16575,00,15929,646,12942,3633,16575,0
2019/01,186,29/01/2019,2,SS 16 tra Rimini e Igea Marina-Viserba,26152,10,25002,1149,20571,5581,26152,0
2019/01,186,30/01/2019,3,SS 16 tra Rimini e Igea Marina-Viserba,26177,20,25002,1173,20690,5487,26177,0
2019/01,186,31/01/2019,4,SS 16 tra Rimini e Igea Marina-Viserba,26271,00,25157,1114,20418,5853,26271,0
2019/01,215,29/01/2019,2,SP 3_1 tra accesso interporto Bologna e viadotto A 13,28030,80,21136,6886,20927,7103,28030,0
2019/01,215,30/01/2019,3,SP 3_1 tra accesso interporto Bologna e viadotto A 13,27923,50,21196,6722,21114,6809,27923,0
2019/01,215,31/01/2019,4,SP 3_1 tra accesso interporto Bologna e viadotto A 13,25784,30,19264,6517,18724,7060,25784,0
2019/01,218,29/01/2019,2,SP 10 tra Polesine e Roccabianca su variante Zibello,2401,00,2008,393,1924,477,2401,0
2019/01,218,30/01/2019,3,SP 10 tra Polesine e Roccabianca su variante Zibello,2183,00,1849,334,1755,428,2183,0
2019/01,218,31/01/2019,4,SP 10 tra Polesine e Roccabianca su variante Zibello,2213,00,1893,320,1749,464,2213,0
2019/01,219,29/01/2019,2,SS 9 tra Fiorenzuola d'Arda e Pontenure,16466,130,14983,1470,13394,3072,16466,0
2019/01,219,30/01/2019,3,SS 9 tra Fiorenzuola d'Arda e Pontenure,14618,50,13338,1275,11873,2745,14618,0
2019/01,219,31/01/2019,4,SS 9 tra Fiorenzuola d'Arda e Pontenure,15521,30,14293,1225,12536,2985,15521,0
2019/01,220,29/01/2019,2,SS 9 tra Fiorenzuola d'Arda e Fidenza al confine provinciale,,,,,,,,
2019/01,220,30/01/2019,3,SS 9 tra Fiorenzuola d'Arda e Fidenza al confine provinciale,11142,610,9631,1450,9163,1979,11142,0
2019/01,220,31/01/2019,4,SS 9 tra Fiorenzuola d'Arda e Fidenza al confine provinciale,11915,10,10619,1295,9633,2282,11915,0
2019/01,221,29/01/2019,2,SS 9 tra Fidenza e A 15,24372,10,21500,2871,19229,5143,24372,0
2019/01,221,30/01/2019,3,SS 9 tra Fidenza e A 15,21306,00,18603,2703,17285,4021,21306,0
2019/01,221,31/01/2019,4,SS 9 tra Fidenza e A 15,22610,20,19999,2609,17943,4667,22610,0
2019/01,222,29/01/2019,2,SP 359R tra Fidenza e Salsomaggiore Terme,16164,80,15667,489,12686,3478,16164,0
2019/01,222,30/01/2019,3,SP 359R tra Fidenza e Salsomaggiore Terme,13893,40,13539,350,11099,2794,13893,0
2019/01,222,31/01/2019,4,SP 359R tra Fidenza e Salsomaggiore Terme,15077,40,14730,343,11659,3418,15077,0
2019/01,223,29/01/2019,2,SP 357R tra SS 9 e Noceto,10931,00,9605,1326,8751,2180,10931,0
2019/01,223,30/01/2019,3,SP 357R tra SS 9 e Noceto,10012,00,8800,1212,8198,1814,10012,0
2019/01,223,31/01/2019,4,SP 357R tra SS 9 e Noceto,10606,00,9436,1170,8366,2240,10606,0
2019/01,226,29/01/2019,2,SP 32 dal bivio SP 16 (per Langhirano) al bivio SP 665R,11304,00,10534,770,9135,2169,11304,0
2019/01,226,30/01/2019,3,SP 32 dal bivio SP 16 (per Langhirano) al bivio SP 665R,10122,00,9373,749,8524,1598,10122,0
2019/01,226,31/01/2019,4,SP 32 dal bivio SP 16 (per Langhirano) al bivio SP 665R,9783,00,9154,629,7924,1859,9783,0
2019/01,227,29/01/2019,2,SP 34 da Colorno al bivio SP 60 (al confine provinciale),5858,10,5634,223,4726,1132,5858,0
2019/01,227,30/01/2019,3,SP 34 da Colorno al bivio SP 60 (al confine provinciale),5591,00,5409,182,4522,1069,5591,0
2019/01,227,31/01/2019,4,SP 34 da Colorno al bivio SP 60 (al confine provinciale),5392,00,5218,174,4284,1108,5392,0
2019/01,228,29/01/2019,2,SP 62R tra Brescello (bivio SP 41) e Sorbolo (bivio SP 20),10844,30,8973,1868,8660,2184,10844,0
2019/01,228,30/01/2019,3,SP 62R tra Brescello (bivio SP 41) e Sorbolo (bivio SP 20),10159,30,8321,1835,8343,1816,10159,0
2019/01,228,31/01/2019,4,SP 62R tra Brescello (bivio SP 41) e Sorbolo (bivio SP 20),10104,00,8346,1758,8086,2018,10104,0
2019/01,229,29/01/2019,2,SP 111 tra bivio SP 1 (a nord di Poviglio) e Boretto (innesto variante),,,,,,,,
2019/01,229,30/01/2019,3,SP 111 tra bivio SP 1 (a nord di Poviglio) e Boretto (innesto variante),,,,,,,,
2019/01,229,31/01/2019,4,SP 111 tra bivio SP 1 (a nord di Poviglio) e Boretto (innesto variante),,,,,,,,
2019/01,230,29/01/2019,2,SP 62RVar Cispadana da Boretto (bivio Variante SP 358R) a Gualtieri (bivio SP 63R),11073,00,8521,2552,8891,2182,11073,0
2019/01,230,30/01/2019,3,SP 62RVar Cispadana da Boretto (bivio Variante SP 358R) a Gualtieri (bivio SP 63R),10722,00,8157,2565,8733,1989,10722,0
2019/01,230,31/01/2019,4,SP 62RVar Cispadana da Boretto (bivio Variante SP 358R) a Gualtieri (bivio SP 63R),10539,00,8072,2467,8456,2083,10539,0
2019/01,231,29/01/2019,2,SP 63R tra la località Santa Vittoria (c/o bivio SP 81) e la Cispadana,7015,50,6539,471,5854,1161,7015,0
2019/01,231,30/01/2019,3,SP 63R tra la località Santa Vittoria (c/o bivio SP 81) e la Cispadana,6722,10,6267,454,5585,1137,6722,0
2019/01,231,31/01/2019,4,SP 63R tra la località Santa Vittoria (c/o bivio SP 81) e la Cispadana,6505,30,6068,434,5336,1169,6505,0
2019/01,236,29/01/2019,2,SP 468 tra Casumaro e Reno Centese,5325,00,4783,542,4318,1007,5325,0
2019/01,236,30/01/2019,3,SP 468 tra Casumaro e Reno Centese,5224,00,4668,556,4264,960,5224,0
2019/01,236,31/01/2019,4,SP 468 tra Casumaro e Reno Centese,5233,00,4655,578,4251,982,5233,0
2019/01,237,29/01/2019,2,SP 23 tra Quattro Castella e la Variante di Montecavolo (c/o bivio SP 21),14648,00,13893,755,11906,2742,14648,0
2019/01,237,30/01/2019,3,SP 23 tra Quattro Castella e la Variante di Montecavolo (c/o bivio SP 21),12912,00,12224,688,10990,1922,12912,0
2019/01,237,31/01/2019,4,SP 23 tra Quattro Castella e la Variante di Montecavolo (c/o bivio SP 21),12948,00,12397,551,10295,2653,12948,0
2019/01,238,29/01/2019,2,SP 37 fra Albinea e Scandiano (bivio SP 7),11008,00,10364,644,8902,2106,11008,0
2019/01,238,30/01/2019,3,SP 37 fra Albinea e Scandiano (bivio SP 7),9787,00,9201,586,8345,1442,9787,0
2019/01,238,31/01/2019,4,SP 37 fra Albinea e Scandiano (bivio SP 7),9317,00,8826,491,7385,1932,9317,0
2019/01,239,29/01/2019,2,SP 486R fra Sassuolo e Castellarano,26643,30,23092,3548,21382,5261,26643,0
2019/01,239,30/01/2019,3,SP 486R fra Sassuolo e Castellarano,24167,00,20685,3482,20207,3960,24167,0
2019/01,239,31/01/2019,4,SP 486R fra Sassuolo e Castellarano,22635,10,19555,3079,18043,4592,22635,0
2019/01,242,29/01/2019,2,SS 12 tra Maranello e Pavullo nel Frignano,14594,00,13347,1247,11552,3042,14594,0
2019/01,242,30/01/2019,3,SS 12 tra Maranello e Pavullo nel Frignano,12922,10,11678,1243,10450,2472,12922,0
2019/01,242,31/01/2019,4,SS 12 tra Maranello e Pavullo nel Frignano,11315,00,10390,925,8849,2466,11315,0
2019/01,243,29/01/2019,2,SP 27 tra Ponte Samoggia e Muffa,10693,10,9930,762,8616,2077,10693,0
2019/01,243,30/01/2019,3,SP 27 tra Ponte Samoggia e Muffa,10200,00,9443,757,8568,1632,10200,0
2019/01,243,31/01/2019,4,SP 27 tra Ponte Samoggia e Muffa,9279,00,8672,607,7440,1839,9279,0
2019/01,244,29/01/2019,2,SP 569 tra Pragatto e innesto variante Ponte Ronca,27677,00,25972,1705,21792,5885,27677,0
2019/01,244,30/01/2019,3,SP 569 tra Pragatto e innesto variante Ponte Ronca,25658,10,23980,1677,20969,4689,25658,0
2019/01,244,31/01/2019,4,SP 569 tra Pragatto e innesto variante Ponte Ronca,24328,00,22960,1368,18962,5366,24328,0
2019/01,245,29/01/2019,2,SP 569 da intersezione Pedemontana a Savignano sul Panaro,7077,00,6665,412,5562,1515,7077,0
2019/01,245,30/01/2019,3,SP 569 da intersezione Pedemontana a Savignano sul Panaro,6382,10,5987,394,5173,1209,6382,0
2019/01,245,31/01/2019,4,SP 569 da intersezione Pedemontana a Savignano sul Panaro,6301,10,5958,342,4876,1425,6301,0
2019/01,246,29/01/2019,2,SP 255 da Decima a San Giovanni in Persiceto,14384,00,13298,1086,11301,3083,14384,0
2019/01,246,30/01/2019,3,SP 255 da Decima a San Giovanni in Persiceto,14469,00,13325,1144,11631,2838,14469,0
2019/01,246,31/01/2019,4,SP 255 da Decima a San Giovanni in Persiceto,12987,00,12068,919,10230,2757,12987,0
2019/01,247,29/01/2019,2,SP 255 fra Nonantola e Sant'Agata Bolognese,10180,00,8617,1563,7983,2197,10180,0
2019/01,247,30/01/2019,3,SP 255 fra Nonantola e Sant'Agata Bolognese,10176,00,8589,1587,8118,2058,10176,0
2019/01,247,31/01/2019,4,SP 255 fra Nonantola e Sant'Agata Bolognese,8278,10,7087,1190,6488,1790,8278,0
2019/01,251,29/01/2019,2,SP 610 tra Imola e Casalfiumanese in località Ca' Miseria,12526,20,11891,633,9758,2768,12526,0
2019/01,251,30/01/2019,3,SP 610 tra Imola e Casalfiumanese in località Ca' Miseria,12586,00,11897,689,9922,2664,12586,0
2019/01,251,31/01/2019,4,SP 610 tra Imola e Casalfiumanese in località Ca' Miseria,12193,10,11616,576,9360,2833,12193,0
2019/01,252,29/01/2019,2,SP 3_2 tra Budrio e bivio SP 29 per Medicina,9058,00,8279,779,7307,1751,9058,0
2019/01,252,30/01/2019,3,SP 3_2 tra Budrio e bivio SP 29 per Medicina,8541,00,7812,729,7071,1470,8541,0
2019/01,252,31/01/2019,4,SP 3_2 tra Budrio e bivio SP 29 per Medicina,8093,00,7417,676,6501,1592,8093,0
2019/01,255,29/01/2019,2,SS 9 tra Castel San Pietro e Imola,19449,20,18772,675,15464,3985,19449,0
2019/01,255,30/01/2019,3,SS 9 tra Castel San Pietro e Imola,19360,40,18636,720,15498,3862,19360,0
2019/01,255,31/01/2019,4,SS 9 tra Castel San Pietro e Imola,18582,20,17876,704,14740,3842,18582,0
2019/01,256,29/01/2019,2,SP 302R tra Faenza (bivio SP 66) e Brisighella,7820,00,7598,222,6223,1597,7820,0
2019/01,256,30/01/2019,3,SP 302R tra Faenza (bivio SP 66) e Brisighella,7737,00,7484,253,6153,1584,7737,0
2019/01,256,31/01/2019,4,SP 302R tra Faenza (bivio SP 66) e Brisighella,7362,00,7156,206,5815,1547,7362,0
2019/01,257,29/01/2019,2,SP 302R tra Faenza e il bivio SP 4 (a sud di Russi),6204,00,6004,200,4929,1275,6204,0
2019/01,257,30/01/2019,3,SP 302R tra Faenza e il bivio SP 4 (a sud di Russi),6081,00,5885,196,4887,1194,6081,0
2019/01,257,31/01/2019,4,SP 302R tra Faenza e il bivio SP 4 (a sud di Russi),6031,00,5853,178,4751,1280,6031,0
2019/01,258,29/01/2019,2,SS 9 tra Forlimpopoli e Cesena,24280,120,22274,1994,18905,5375,24280,0
2019/01,258,30/01/2019,3,SS 9 tra Forlimpopoli e Cesena,23937,10,22014,1922,18716,5221,23937,0
2019/01,258,31/01/2019,4,SS 9 tra Forlimpopoli e Cesena,23730,40,21739,1987,18467,5263,23730,0
2019/01,259,29/01/2019,2,SP 7 in località Calabrina al Confine Provinciale,7400,00,6982,418,5801,1599,7400,0
2019/01,259,30/01/2019,3,SP 7 in località Calabrina al Confine Provinciale,7375,00,6933,442,5772,1603,7375,0
2019/01,259,31/01/2019,4,SP 7 in località Calabrina al Confine Provinciale,7699,00,7255,444,6042,1657,7699,0
2019/01,260,29/01/2019,2,SP 8 tra Cesena e A 14,11252,00,10942,310,9120,2132,11252,0
2019/01,260,30/01/2019,3,SP 8 tra Cesena e A 14,11081,00,10769,312,8817,2264,11081,0
2019/01,260,31/01/2019,4,SP 8 tra Cesena e A 14,10989,10,10695,293,8907,2082,10989,0
2019/01,261,29/01/2019,2,SS 9 tra Cesena e Savignano sul Rubicone,28047,00,26032,2015,22443,5604,28047,0
2019/01,261,30/01/2019,3,SS 9 tra Cesena e Savignano sul Rubicone,28162,00,25990,2172,22265,5897,28162,0
2019/01,261,31/01/2019,4,SS 9 tra Cesena e Savignano sul Rubicone,27887,00,25860,2027,22043,5844,27887,0
2019/01,262,29/01/2019,2,SS 9 tra Savignano sul Rubicone e Santarcangelo di Romagna,,,,,,,,
2019/01,262,30/01/2019,3,SS 9 tra Savignano sul Rubicone e Santarcangelo di Romagna,,,,,,,,
2019/01,262,31/01/2019,4,SS 9 tra Savignano sul Rubicone e Santarcangelo di Romagna,,,,,,,,
2019/01,263,29/01/2019,2,Via Adriatica (ex SS 16) tra Riccione e Misano Adriatico,15834,00,15453,381,12555,3279,15834,0
2019/01,263,30/01/2019,3,Via Adriatica (ex SS 16) tra Riccione e Misano Adriatico,16092,00,15736,356,12700,3392,16092,0
2019/01,263,31/01/2019,4,Via Adriatica (ex SS 16) tra Riccione e Misano Adriatico,16249,00,15866,383,12781,3468,16249,0
2019/01,269,29/01/2019,2,SS 12 a Medolla,19222,00,17393,1829,15626,3596,19222,0
2019/01,269,30/01/2019,3,SS 12 a Medolla,19280,10,17479,1800,15835,3445,19280,0
2019/01,269,31/01/2019,4,SS 12 a Medolla,17351,00,15746,1605,14022,3329,17351,0
2019/01,275,30/01/2019,3,SP 5 dall'intersezione SP 3 a intersezione per Ca' de Fabbri,10632,00,10158,474,8699,1933,10632,0
2019/01,275,31/01/2019,4,SP 5 dall'intersezione SP 3 a intersezione per Ca' de Fabbri,9360,00,8983,377,7282,2078,9360,0
2019/01,276,29/01/2019,2,SP 3_2 tra intersezione SP 5 e ponte torrente Idice,12167,00,11035,1132,9856,2311,12167,0
2019/01,276,30/01/2019,3,SP 3_2 tra intersezione SP 5 e ponte torrente Idice,11469,00,10459,1010,9401,2068,11469,0
2019/01,276,31/01/2019,4,SP 3_2 tra intersezione SP 5 e ponte torrente Idice,11120,00,10160,960,8955,2165,11120,0
2019/01,277,29/01/2019,2,SP 6 tra Budrio e San Martino in Argine,7939,00,7477,462,6299,1640,7939,0
2019/01,277,30/01/2019,3,SP 6 tra Budrio e San Martino in Argine,7612,00,7182,430,6100,1512,7612,0
2019/01,277,31/01/2019,4,SP 6 tra Budrio e San Martino in Argine,7303,00,6880,423,5685,1618,7303,0
2019/01,278,29/01/2019,2,SP 6 tra Budrio e bivio SP 253,14333,00,13569,764,11544,2789,14333,0
2019/01,278,30/01/2019,3,SP 6 tra Budrio e bivio SP 253,13780,00,13128,652,11124,2656,13780,0
2019/01,278,31/01/2019,4,SP 6 tra Budrio e bivio SP 253,13561,10,12907,653,10680,2881,13561,0
2019/01,279,29/01/2019,2,SP 31 dal bivio SP 28 per Castenaso a Ponte Rizzoli,13745,00,12777,968,11514,2231,13745,0
2019/01,279,30/01/2019,3,SP 31 dal bivio SP 28 per Castenaso a Ponte Rizzoli,13300,00,12374,926,11522,1778,13300,0
2019/01,279,31/01/2019,4,SP 31 dal bivio SP 28 per Castenaso a Ponte Rizzoli,11751,10,11068,682,9745,2006,11751,0
2019/01,280,29/01/2019,2,SP 26 tra Gesso e Ponte Rivabella,20731,00,20240,491,16075,4656,20731,0
2019/01,280,30/01/2019,3,SP 26 tra Gesso e Ponte Rivabella,19340,00,18881,459,15968,3372,19340,0
2019/01,280,31/01/2019,4,SP 26 tra Gesso e Ponte Rivabella,17368,00,17002,366,13407,3961,17368,0
2019/01,281,29/01/2019,2,SP 78_1 tra Bazzano e Intersezione SP 27 a Monteveglio,6595,20,6353,240,5309,1286,6595,0
2019/01,281,30/01/2019,3,SP 78_1 tra Bazzano e Intersezione SP 27 a Monteveglio,5990,20,5780,208,5086,904,5990,0
2019/01,281,31/01/2019,4,SP 78_1 tra Bazzano e Intersezione SP 27 a Monteveglio,5560,10,5402,157,4381,1179,5560,0
2019/01,282,29/01/2019,2,SS 9 tra Anzola dell'Emilia e Bologna,23477,10,21217,2259,17748,5729,23477,0
2019/01,282,30/01/2019,3,SS 9 tra Anzola dell'Emilia e Bologna,22328,00,20012,2316,17754,4574,22328,0
2019/01,282,31/01/2019,4,SS 9 tra Anzola dell'Emilia e Bologna,21379,10,19365,2013,16360,5019,21379,0
2019/01,285,29/01/2019,2,SP 1 fra Crevalcore e Decima,6136,10,5701,434,4899,1237,6136,0
2019/01,285,30/01/2019,3,SP 1 fra Crevalcore e Decima,5779,00,5314,465,4683,1096,5779,0
2019/01,285,31/01/2019,4,SP 1 fra Crevalcore e Decima,5321,00,4956,365,4215,1106,5321,0
2019/01,287,30/01/2019,3,SP 6 fra Cento e Pilastrello,7520,00,7025,495,6195,1325,7520,0
2019/01,288,29/01/2019,2,SP 42 fra Pieve di Cento e Castello d'Argile,18552,00,17692,860,14480,4072,18552,0
2019/01,288,30/01/2019,3,SP 42 fra Pieve di Cento e Castello d'Argile,18093,00,17188,905,14323,3770,18093,0
2019/01,288,31/01/2019,4,SP 42 fra Pieve di Cento e Castello d'Argile,17995,10,17181,813,13848,4147,17995,0
2019/01,289,29/01/2019,2,SP 66 fra Cento e Sant'Agostino,14452,00,13666,786,11640,2812,14452,0
2019/01,289,30/01/2019,3,SP 66 fra Cento e Sant'Agostino,14385,00,13578,807,11591,2794,14385,0
2019/01,289,31/01/2019,4,SP 66 fra Cento e Sant'Agostino,13999,10,13241,757,11371,2628,13999,0
2019/01,290,29/01/2019,2,SP 11 fra Pieve di Cento e San Pietro in Casale,6252,00,5867,385,5021,1231,6252,0
2019/01,290,30/01/2019,3,SP 11 fra Pieve di Cento e San Pietro in Casale,6179,00,5846,333,5039,1140,6179,0
2019/01,290,31/01/2019,4,SP 11 fra Pieve di Cento e San Pietro in Casale,6143,00,5825,318,4947,1196,6143,0
2019/01,291,29/01/2019,2,SP 4 tra San Pietro in Casale e San Vincenzo/San Venanzio,10291,00,9903,388,7922,2369,10291,0
2019/01,291,30/01/2019,3,SP 4 tra San Pietro in Casale e San Vincenzo/San Venanzio,9973,00,9563,410,7763,2210,9973,0
2019/01,291,31/01/2019,4,SP 4 tra San Pietro in Casale e San Vincenzo/San Venanzio,9828,00,9459,369,7558,2270,9828,0
2019/01,292,29/01/2019,2,SP 4 tra San Giorgio di Piano e Intersezione SP 11 c/o San Pietro in Casale,17723,10,17059,663,13718,4005,17723,0
2019/01,292,30/01/2019,3,SP 4 tra San Giorgio di Piano e Intersezione SP 11 c/o San Pietro in Casale,17160,00,16542,618,13257,3903,17160,0
2019/01,292,31/01/2019,4,SP 4 tra San Giorgio di Piano e Intersezione SP 11 c/o San Pietro in Casale,16183,00,15670,513,12289,3894,16183,0
2019/01,295,29/01/2019,2,SP 9 fra Colorno e Torrile centro abitato di Bezze,3591,00,3194,397,2907,684,3591,0
2019/01,295,30/01/2019,3,SP 9 fra Colorno e Torrile centro abitato di Bezze,3420,10,3051,368,2809,611,3420,0
2019/01,295,31/01/2019,4,SP 9 fra Colorno e Torrile centro abitato di Bezze,3250,00,2901,349,2651,599,3250,0
2019/01,298,29/01/2019,2,SP 588R da Castione Marchesi (A 1) a Busseto,2808,00,2611,197,2343,465,2808,0
2019/01,298,30/01/2019,3,SP 588R da Castione Marchesi (A 1) a Busseto,2517,00,2353,164,2148,369,2517,0
2019/01,298,31/01/2019,4,SP 588R da Castione Marchesi (A 1) a Busseto,2625,10,2462,162,2148,477,2625,0
2019/01,300,29/01/2019,2,SP 462R fra Fiorenzuola d'Arda e Cortemaggiore,8084,20,7073,1009,6527,1557,8084,0
2019/01,300,30/01/2019,3,SP 462R fra Fiorenzuola d'Arda e Cortemaggiore,7341,10,6439,901,5967,1374,7341,0
2019/01,300,31/01/2019,4,SP 462R fra Fiorenzuola d'Arda e Cortemaggiore,7844,10,6861,982,6433,1411,7844,0
2019/01,301,29/01/2019,2,SP 4 tra Fiorenzuola d'Arda (Tg Sud) e Castell'Arquato,8010,00,7360,650,6420,1590,8010,0
2019/01,301,30/01/2019,3,SP 4 tra Fiorenzuola d'Arda (Tg Sud) e Castell'Arquato,6749,00,6200,549,5456,1293,6749,0
2019/01,301,31/01/2019,4,SP 4 tra Fiorenzuola d'Arda (Tg Sud) e Castell'Arquato,7540,00,6988,552,6101,1439,7540,0
2019/01,302,29/01/2019,2,SP 12 da Fidenza (Casello A 1) a Soragna,7545,20,6570,973,6195,1350,7545,0
2019/01,302,30/01/2019,3,SP 12 da Fidenza (Casello A 1) a Soragna,6842,10,5929,912,5779,1063,6842,0
2019/01,302,31/01/2019,4,SP 12 da Fidenza (Casello A 1) a Soragna,7305,00,6412,893,6022,1283,7305,0
2019/01,303,29/01/2019,2,SP 11 fra Borgonovo e Gragnano,9059,00,8576,483,7306,1753,9059,0
2019/01,303,30/01/2019,3,SP 11 fra Borgonovo e Gragnano,7473,00,7168,305,6047,1426,7473,0
2019/01,303,31/01/2019,4,SP 11 fra Borgonovo e Gragnano,8555,00,8148,407,6992,1563,8555,0
2019/01,304,29/01/2019,2,SP 42 fra Podenzano e bivio SP 6/ponte fiume Nure in località San Giorgio Piacentino,6870,00,6394,476,5489,1381,6870,0
2019/01,304,30/01/2019,3,SP 42 fra Podenzano e bivio SP 6/ponte fiume Nure in località San Giorgio Piacentino,5706,00,5389,317,4576,1130,5706,0
2019/01,304,31/01/2019,4,SP 42 fra Podenzano e bivio SP 6/ponte fiume Nure in località San Giorgio Piacentino,5804,00,5515,289,4689,1115,5804,0
2019/01,305,29/01/2019,2,SP 6Bis fra Carpaneto e Castell'Arquato,4195,20,3756,437,3367,828,4195,0
2019/01,305,30/01/2019,3,SP 6Bis fra Carpaneto e Castell'Arquato,3120,00,2793,327,2537,583,3120,0
2019/01,305,31/01/2019,4,SP 6Bis fra Carpaneto e Castell'Arquato,3647,00,3302,345,3003,644,3647,0
2019/01,306,29/01/2019,2,SP 654R fra Ponte dell'Olio e Bettola,4280,00,4111,169,3450,830,4280,0
2019/01,306,30/01/2019,3,SP 654R fra Ponte dell'Olio e Bettola,2817,00,2740,77,2186,631,2817,0
2019/01,306,31/01/2019,4,SP 654R fra Ponte dell'Olio e Bettola,3483,00,3366,117,2893,590,3483,0
2019/01,307,29/01/2019,2,SS 45 tra Rivergaro e Perino,3863,10,3659,203,3123,740,3863,0
2019/01,307,30/01/2019,3,SS 45 tra Rivergaro e Perino,2660,00,2535,125,2112,548,2660,0
2019/01,307,31/01/2019,4,SS 45 tra Rivergaro e Perino,3310,00,3160,150,2686,624,3310,0
2019/01,308,29/01/2019,2,SP 412R fra Pianello Val Tidone e Borgonovo Val Tidone,6456,00,6134,322,5222,1234,6456,0
2019/01,308,30/01/2019,3,SP 412R fra Pianello Val Tidone e Borgonovo Val Tidone,5113,10,4912,200,4162,951,5113,0
2019/01,308,31/01/2019,4,SP 412R fra Pianello Val Tidone e Borgonovo Val Tidone,5818,00,5540,278,4804,1014,5818,0
2019/01,309,29/01/2019,2,SP 10R fra Castelvetro Piacentino e Monticelli d'Ongina,10629,10,10164,464,8537,2092,10629,0
2019/01,309,30/01/2019,3,SP 10R fra Castelvetro Piacentino e Monticelli d'Ongina,10120,00,9633,487,8039,2081,10120,0
2019/01,309,31/01/2019,4,SP 10R fra Castelvetro Piacentino e Monticelli d'Ongina,10435,00,9950,485,8352,2083,10435,0
2019/01,310,29/01/2019,2,SP 358R fra Cadelbosco di Sopra e Castelnovo di Sotto,15833,00,14987,846,12666,3167,15833,0
2019/01,310,30/01/2019,3,SP 358R fra Cadelbosco di Sopra e Castelnovo di Sotto,14520,00,13677,843,11984,2536,14520,0
2019/01,310,31/01/2019,4,SP 358R fra Cadelbosco di Sopra e Castelnovo di Sotto,14337,10,13540,796,11353,2984,14337,0
2019/01,311,29/01/2019,2,SP 62RVar tra la località San Giacomo (bivio SP 42) ed SP 2 (c/o Tagliata),11137,00,8480,2657,9024,2113,11137,0
2019/01,311,30/01/2019,3,SP 62RVar tra la località San Giacomo (bivio SP 42) ed SP 2 (c/o Tagliata),10814,00,8166,2648,8810,2004,10814,0
2019/01,311,31/01/2019,4,SP 62RVar tra la località San Giacomo (bivio SP 42) ed SP 2 (c/o Tagliata),10531,00,8042,2489,8552,1979,10531,0
2019/01,312,29/01/2019,2,SP 42 fra Novellara e San Giacomo (SP 62R),13630,00,12394,1236,10979,2651,13630,0
2019/01,312,30/01/2019,3,SP 42 fra Novellara e San Giacomo (SP 62R),13249,00,12120,1129,10782,2467,13249,0
2019/01,312,31/01/2019,4,SP 42 fra Novellara e San Giacomo (SP 62R),13019,00,11923,1096,10404,2615,13019,0
2019/01,314,29/01/2019,2,SP 2 fra Reggiolo (bivio SP 2) e località Villarotta (SP 84),8532,00,8127,405,6886,1646,8532,0
2019/01,314,30/01/2019,3,SP 2 fra Reggiolo (bivio SP 2) e località Villarotta (SP 84),8397,00,7991,406,6767,1630,8397,0
2019/01,314,31/01/2019,4,SP 2 fra Reggiolo (bivio SP 2) e località Villarotta (SP 84),8229,00,7852,377,6643,1586,8229,0
2019/01,318,29/01/2019,2,SP 51 fra Sassuolo (bivio SP 467R) e Rubiera,10902,20,8120,2780,8834,2068,10902,0
2019/01,318,30/01/2019,3,SP 51 fra Sassuolo (bivio SP 467R) e Rubiera,10135,20,7473,2660,8529,1606,10135,0
2019/01,318,31/01/2019,4,SP 51 fra Sassuolo (bivio SP 467R) e Rubiera,9891,10,7390,2500,7933,1958,9891,0
2019/01,319,29/01/2019,2,SP 15 tra Sassuolo e Magreta,,,,,,,,
2019/01,319,30/01/2019,3,SP 15 tra Sassuolo e Magreta,,,,,,,,
2019/01,319,31/01/2019,4,SP 15 tra Sassuolo e Magreta,,,,,,,,
2019/01,321,29/01/2019,2,SP 467 tra SP 486 e confine provinciale,,,,,,,,
2019/01,321,30/01/2019,3,SP 467 tra SP 486 e confine provinciale,,,,,,,,
2019/01,321,31/01/2019,4,SP 467 tra SP 486 e confine provinciale,,,,,,,,
2019/01,323,29/01/2019,2,SP 467 fra SP 3 e SS 12,26256,00,22691,3565,20675,5581,26256,0
2019/01,323,30/01/2019,3,SP 467 fra SP 3 e SS 12,24635,00,20913,3722,20283,4352,24635,0
2019/01,323,31/01/2019,4,SP 467 fra SP 3 e SS 12,20264,20,17355,2907,16057,4207,20264,0
2019/01,328,29/01/2019,2,SP 486 tra Modena e Baggiovara,25044,10,24457,586,19659,5385,25044,0
2019/01,328,30/01/2019,3,SP 486 tra Modena e Baggiovara,24112,10,23527,584,19067,5045,24112,0
2019/01,328,31/01/2019,4,SP 486 tra Modena e Baggiovara,18910,30,18359,548,14370,4540,18910,0
2019/01,332,29/01/2019,2,SP 306R fra Castel Bolognese e Riolo Terme,8269,10,7747,521,6522,1747,8269,0
2019/01,332,30/01/2019,3,SP 306R fra Castel Bolognese e Riolo Terme,8001,10,7555,445,6353,1648,8001,0
2019/01,332,31/01/2019,4,SP 306R fra Castel Bolognese e Riolo Terme,8134,00,7706,428,6392,1742,8134,0
2019/01,333,29/01/2019,2,SS 9 tra Castel Bolognese e Faenza,21949,00,21189,760,16778,5171,21949,0
2019/01,333,30/01/2019,3,SS 9 tra Castel Bolognese e Faenza,21407,10,20636,770,16582,4825,21407,0
2019/01,333,31/01/2019,4,SS 9 tra Castel Bolognese e Faenza,21645,00,20935,710,16661,4984,21645,0
2019/01,334,29/01/2019,2,SP 8 dal Casello A 1 (Faenza) a Cotignola,14137,00,13172,965,11117,3020,14137,0
2019/01,334,30/01/2019,3,SP 8 dal Casello A 1 (Faenza) a Cotignola,14396,00,13497,899,11528,2868,14396,0
2019/01,334,31/01/2019,4,SP 8 dal Casello A 1 (Faenza) a Cotignola,14381,00,13611,770,11398,2983,14381,0
2019/01,335,29/01/2019,2,SP 7 tra l'A 14 (bivio SP 29) e l'A 14dir (Barbiano),7050,00,6519,531,5722,1328,7050,0
2019/01,335,30/01/2019,3,SP 7 tra l'A 14 (bivio SP 29) e l'A 14dir (Barbiano),7357,00,6725,632,6022,1335,7357,0
2019/01,335,31/01/2019,4,SP 7 tra l'A 14 (bivio SP 29) e l'A 14dir (Barbiano),7071,00,6573,498,5638,1433,7071,0
2019/01,336,29/01/2019,2,SP 253R tra Lugo (ponte fiume Senio) e Bagnacavallo,11044,00,10382,662,8826,2218,11044,0
2019/01,336,30/01/2019,3,SP 253R tra Lugo (ponte fiume Senio) e Bagnacavallo,11051,00,10459,592,9004,2047,11051,0
2019/01,336,31/01/2019,4,SP 253R tra Lugo (ponte fiume Senio) e Bagnacavallo,11125,10,10513,611,8917,2208,11125,0
2019/01,337,29/01/2019,2,SP 14 fra Lugo (bivio SSPP 41/46) e Fusignano,11677,00,11080,597,9531,2146,11677,0
2019/01,337,30/01/2019,3,SP 14 fra Lugo (bivio SSPP 41/46) e Fusignano,11961,00,11391,570,9727,2234,11961,0
2019/01,337,31/01/2019,4,SP 14 fra Lugo (bivio SSPP 41/46) e Fusignano,11549,00,11019,530,9333,2216,11549,0
2019/01,339,29/01/2019,2,SP 3 tra San Lorenzo in Noceto e Predappio,7389,00,7046,343,5928,1461,7389,0
2019/01,339,30/01/2019,3,SP 3 tra San Lorenzo in Noceto e Predappio,7514,00,7177,337,6039,1475,7514,0
2019/01,339,31/01/2019,4,SP 3 tra San Lorenzo in Noceto e Predappio,7295,00,6972,323,5861,1434,7295,0
2019/01,340,29/01/2019,2,SP 72 tra San Martino in Strada e bivio ex SS 310R (Meldola),10011,00,9608,403,8059,1952,10011,0
2019/01,340,30/01/2019,3,SP 72 tra San Martino in Strada e bivio ex SS 310R (Meldola),9914,00,9545,369,7964,1950,9914,0
2019/01,340,31/01/2019,4,SP 72 tra San Martino in Strada e bivio ex SS 310R (Meldola),9704,00,9290,414,7743,1961,9704,0
2019/01,342,29/01/2019,2,SP 33 in località Gatteo,16427,00,14865,1562,13299,3128,16427,0
2019/01,342,30/01/2019,3,SP 33 in località Gatteo,16217,00,14676,1541,12965,3252,16217,0
2019/01,342,31/01/2019,4,SP 33 in località Gatteo,16227,00,14737,1490,12778,3449,16227,0
2019/01,343,29/01/2019,2,SP 4 tra Galeata e Santa Sofia,5310,00,4982,328,4153,1157,5310,0
2019/01,343,30/01/2019,3,SP 4 tra Galeata e Santa Sofia,5331,00,5053,278,4160,1171,5331,0
2019/01,343,31/01/2019,4,SP 4 tra Galeata e Santa Sofia,4830,00,4548,282,3701,1129,4830,0
2019/01,344,29/01/2019,2,SS 3Bis/E 45 tra Borello e Mercato Saraceno,11435,10,10593,841,9161,2274,11435,0
2019/01,344,30/01/2019,3,SS 3Bis/E 45 tra Borello e Mercato Saraceno,11514,00,10599,915,9278,2236,11514,0
2019/01,344,31/01/2019,4,SS 3Bis/E 45 tra Borello e Mercato Saraceno,10814,10,9980,833,8544,2270,10814,0
2019/01,348,29/01/2019,2,SP 10 dal bivio con SP 89 (San Mauro Pascoli) c/o A 14  al bivio SS 16 (San Mauro Mare),,,,,,,,
2019/01,348,30/01/2019,3,SP 10 dal bivio con SP 89 (San Mauro Pascoli) c/o A 14  al bivio SS 16 (San Mauro Mare),,,,,,,,
2019/01,348,31/01/2019,4,SP 10 dal bivio con SP 89 (San Mauro Pascoli) c/o A 14  al bivio SS 16 (San Mauro Mare),,,,,,,,
2019/01,349,29/01/2019,2,SS 16 tra Cervia e Cesenatico,18680,20,16543,2135,14666,4014,18680,0
2019/01,349,30/01/2019,3,SS 16 tra Cervia e Cesenatico,18580,00,16522,2058,14646,3934,18580,0
2019/01,349,31/01/2019,4,SS 16 tra Cervia e Cesenatico,18909,10,16738,2170,14705,4204,18909,0
2019/01,351,29/01/2019,2,SS 72 tra Rimini e  San Marino,,,,,,,,
2019/01,351,30/01/2019,3,SS 72 tra Rimini e  San Marino,,,,,,,,
2019/01,351,31/01/2019,4,SS 72 tra Rimini e  San Marino,,,,,,,,
2019/01,354,29/01/2019,2,SP 31 tra Viadotto A 14 e Coriano,12103,00,11789,314,9676,2427,12103,0
2019/01,354,30/01/2019,3,SP 31 tra Viadotto A 14 e Coriano,12138,10,11843,294,9706,2432,12138,0
2019/01,354,31/01/2019,4,SP 31 tra Viadotto A 14 e Coriano,12176,00,11834,342,9752,2424,12176,0
2019/01,355,29/01/2019,2,SP 17V tra San Giovanni in Marignano e Morciano di Romagna (variante),14511,00,13840,671,11744,2767,14511,0
2019/01,355,30/01/2019,3,SP 17V tra San Giovanni in Marignano e Morciano di Romagna (variante),14431,00,13801,630,11605,2826,14431,0
2019/01,355,31/01/2019,4,SP 17V tra San Giovanni in Marignano e Morciano di Romagna (variante),14946,00,14350,596,12051,2895,14946,0
2019/01,356,29/01/2019,2,SP 2 fra Reggiolo c/o bivio variante nord e confine regionale,7150,00,6261,889,5676,1474,7150,0
2019/01,356,30/01/2019,3,SP 2 fra Reggiolo c/o bivio variante nord e confine regionale,7126,00,6191,935,5744,1382,7126,0
2019/01,356,31/01/2019,4,SP 2 fra Reggiolo c/o bivio variante nord e confine regionale,6816,00,6018,798,5471,1345,6816,0
2019/01,357,29/01/2019,2,SP 306R fra Casola Valsenio e bivio SP 65 c/o località Isola,3362,00,3036,326,2727,635,3362,0
2019/01,357,30/01/2019,3,SP 306R fra Casola Valsenio e bivio SP 65 c/o località Isola,3087,30,2802,282,2544,543,3087,0
2019/01,357,31/01/2019,4,SP 306R fra Casola Valsenio e bivio SP 65 c/o località Isola,2972,00,2708,264,2377,595,2972,0
2019/01,376,29/01/2019,2,SP 68 tra Portomaggiore e la Superstrada Ferrara-Mare,3207,00,3022,185,2623,584,3207,0
2019/01,376,30/01/2019,3,SP 68 tra Portomaggiore e la Superstrada Ferrara-Mare,3133,00,2937,196,2548,585,3133,0
2019/01,376,31/01/2019,4,SP 68 tra Portomaggiore e la Superstrada Ferrara-Mare,2982,00,2827,155,2425,557,2982,0
2019/01,377,29/01/2019,2,SP 18 tra Bondeno e il confine regionale (Lombardia),4901,00,4547,354,3968,933,4901,0
2019/01,377,30/01/2019,3,SP 18 tra Bondeno e il confine regionale (Lombardia),4852,00,4480,372,3909,943,4852,0
2019/01,377,31/01/2019,4,SP 18 tra Bondeno e il confine regionale (Lombardia),4805,00,4467,338,3901,904,4805,0
2019/01,381,29/01/2019,2,SS 724 Tangenziale nord di Modena,,,,,,,,
2019/01,381,30/01/2019,3,SS 724 Tangenziale nord di Modena,,,,,,,,
2019/01,381,31/01/2019,4,SS 724 Tangenziale nord di Modena,,,,,,,,
2019/01,383,29/01/2019,2,SS 722 Tangenziale nord di Reggio Emilia,33048,120,29137,3899,26704,6344,33048,0
2019/01,383,30/01/2019,3,SS 722 Tangenziale nord di Reggio Emilia,31029,100,27066,3953,26091,4938,31029,0
2019/01,383,31/01/2019,4,SS 722 Tangenziale nord di Reggio Emilia,30029,80,26453,3568,24361,5668,30029,0
2019/01,385,29/01/2019,2,SP 10R fra Castel San Giovanni e Confine regionale (Lombardia),12631,00,11304,1327,9818,2813,12631,0
2019/01,385,30/01/2019,3,SP 10R fra Castel San Giovanni e Confine regionale (Lombardia),11194,00,9996,1198,8701,2493,11194,0
2019/01,385,31/01/2019,4,SP 10R fra Castel San Giovanni e Confine regionale (Lombardia),11844,00,10668,1176,9325,2519,11844,0
2019/01,388,29/01/2019,2,SP 31 fra bivio SP 12 in località Castelnuovo Fogliani e il confine provinciale,4259,00,4145,114,3528,731,4259,0
2019/01,388,30/01/2019,3,SP 31 fra bivio SP 12 in località Castelnuovo Fogliani e il confine provinciale,3359,00,3255,104,2756,603,3359,0
2019/01,388,31/01/2019,4,SP 31 fra bivio SP 12 in località Castelnuovo Fogliani e il confine provinciale,3805,00,3722,83,3178,627,3805,0
2019/01,389,29/01/2019,2,SP 588R fra Villanova d’Arda e confine provinciale,3929,00,3590,339,3225,704,3929,0
2019/01,389,30/01/2019,3,SP 588R fra Villanova d’Arda e confine provinciale,3543,00,3221,322,2881,662,3543,0
2019/01,389,31/01/2019,4,SP 588R fra Villanova d’Arda e confine provinciale,3611,00,3312,299,2928,683,3611,0
2019/01,390,29/01/2019,2,SP 462R dal bivio SP 10R in località Monticelli a Cortemaggiore,2857,00,2715,142,2284,573,2857,0
2019/01,390,30/01/2019,3,SP 462R dal bivio SP 10R in località Monticelli a Cortemaggiore,2534,00,2382,152,2032,502,2534,0
2019/01,390,31/01/2019,4,SP 462R dal bivio SP 10R in località Monticelli a Cortemaggiore,2621,00,2504,117,2134,487,2621,0
2019/01,391,29/01/2019,2,SP 10R fra Castelvetro Piacentino e confine regionale (Lombardia),19750,00,19242,508,15574,4176,19750,0
2019/01,391,30/01/2019,3,SP 10R fra Castelvetro Piacentino e confine regionale (Lombardia),18646,00,18117,529,14602,4044,18646,0
2019/01,391,31/01/2019,4,SP 10R fra Castelvetro Piacentino e confine regionale (Lombardia),18822,00,18323,499,14803,4019,18822,0
2019/01,393,29/01/2019,2,SP 10R fra Caorso e Roncaglia,11110,20,9567,1541,8815,2295,11110,0
2019/01,393,30/01/2019,3,SP 10R fra Caorso e Roncaglia,10440,00,8970,1470,8152,2288,10440,0
2019/01,393,31/01/2019,4,SP 10R fra Caorso e Roncaglia,10726,00,9258,1468,8477,2249,10726,0
2019/01,394,29/01/2019,2,SP 523R da Roccamurata (bivio SP 308R) a Borgo Val di Taro,4552,00,4102,450,3639,913,4552,0
2019/01,394,30/01/2019,3,SP 523R da Roccamurata (bivio SP 308R) a Borgo Val di Taro,3303,00,3018,285,2611,692,3303,0
2019/01,394,31/01/2019,4,SP 523R da Roccamurata (bivio SP 308R) a Borgo Val di Taro,3633,10,3338,294,2929,704,3633,0
2019/01,395,29/01/2019,2,SP 308R da Fornovo di Taro (bivio SS 62) a Solignano,4368,00,4149,219,3478,890,4368,0
2019/01,395,30/01/2019,3,SP 308R da Fornovo di Taro (bivio SS 62) a Solignano,3190,10,3052,137,2536,654,3190,0
2019/01,395,31/01/2019,4,SP 308R da Fornovo di Taro (bivio SS 62) a Solignano,3186,00,3061,125,2545,641,3186,0
2019/01,396,29/01/2019,2,SP 28 fra Fornovo di Taro e Varano de Melegari centro abitato Viazzano,7706,00,7413,293,6324,1382,7706,0
2019/01,396,30/01/2019,3,SP 28 fra Fornovo di Taro e Varano de Melegari centro abitato Viazzano,6113,00,5919,194,5131,982,6113,0
2019/01,396,31/01/2019,4,SP 28 fra Fornovo di Taro e Varano de Melegari centro abitato Viazzano,6353,00,6157,196,5221,1132,6353,0
2019/01,397,29/01/2019,2,SP 12 fra casello A 1 e Fidenza,,,,,,,,
2019/01,397,30/01/2019,3,SP 12 fra casello A 1 e Fidenza,,,,,,,,
2019/01,397,31/01/2019,4,SP 12 fra casello A 1 e Fidenza,,,,,,,,
2019/01,398,29/01/2019,2,SP 11 tra Fontevivo e Cispadana (tangenziale),,,,,,,,
2019/01,398,30/01/2019,3,SP 11 tra Fontevivo e Cispadana (tangenziale),,,,,,,,
2019/01,398,31/01/2019,4,SP 11 tra Fontevivo e Cispadana (tangenziale),,,,,,,,
2019/01,401,29/01/2019,2,SP 513R fra Traversetolo e confine provinciale,6998,20,6332,664,5761,1237,6998,0
2019/01,401,30/01/2019,3,SP 513R fra Traversetolo e confine provinciale,5841,10,5262,578,5021,820,5841,0
2019/01,401,31/01/2019,4,SP 513R fra Traversetolo e confine provinciale,5646,20,5230,414,4588,1058,5646,0
2019/01,402,29/01/2019,2,SP 18 da Pilastrello (bivio SP 513R) al bivio per la Pedemontana,13872,00,13557,315,11192,2680,13872,0
2019/01,402,30/01/2019,3,SP 18 da Pilastrello (bivio SP 513R) al bivio per la Pedemontana,11998,00,11652,346,10173,1825,11998,0
2019/01,402,31/01/2019,4,SP 18 da Pilastrello (bivio SP 513R) al bivio per la Pedemontana,12381,00,12119,262,9989,2392,12381,0
2019/01,403,29/01/2019,2,SP 72 tra Parma e Mezzani,8084,00,7399,685,6701,1383,8084,0
2019/01,403,30/01/2019,3,SP 72 tra Parma e Mezzani,7424,00,6787,637,6338,1086,7424,0
2019/01,403,31/01/2019,4,SP 72 tra Parma e Mezzani,7435,00,6865,570,6148,1287,7435,0
2019/01,404,29/01/2019,2,exSP 32 (via Dante Alighieri) da Felino a Pilastro,7082,20,6902,178,5716,1366,7082,0
2019/01,404,30/01/2019,3,exSP 32 (via Dante Alighieri) da Felino a Pilastro,6351,20,6214,135,5238,1113,6351,0
2019/01,404,31/01/2019,4,exSP 32 (via Dante Alighieri) da Felino a Pilastro,6573,20,6430,141,5182,1391,6573,0
2019/01,405,29/01/2019,2,SP 15 fra SS62 e Sala Baganza,10708,00,9953,755,8676,2032,10708,0
2019/01,405,30/01/2019,3,SP 15 fra SS62 e Sala Baganza,9805,00,9046,759,8186,1619,9805,0
2019/01,405,31/01/2019,4,SP 15 fra SS62 e Sala Baganza,9803,00,9071,732,7898,1905,9803,0
2019/01,410,29/01/2019,2,SP 54 fra Pomposa e Codigoro,4366,00,4082,284,3654,712,4366,0
2019/01,410,30/01/2019,3,SP 54 fra Pomposa e Codigoro,4100,00,3812,288,3392,708,4100,0
2019/01,410,31/01/2019,4,SP 54 fra Pomposa e Codigoro,4441,00,4174,267,3667,774,4441,0
2019/01,411,29/01/2019,2,SP 53 fra Codigoro e Marozzo,5329,00,5225,104,4349,980,5329,0
2019/01,411,30/01/2019,3,SP 53 fra Codigoro e Marozzo,5115,00,5018,97,4167,948,5115,0
2019/01,411,31/01/2019,4,SP 53 fra Codigoro e Marozzo,5145,00,5062,83,4169,976,5145,0
2019/01,426,29/01/2019,2,SS 63 tra Casina e Vezzano sul Crostolo,14022,00,13539,483,11104,2918,14022,0
2019/01,426,30/01/2019,3,SS 63 tra Casina e Vezzano sul Crostolo,12189,00,11769,420,10095,2094,12189,0
2019/01,426,31/01/2019,4,SS 63 tra Casina e Vezzano sul Crostolo,11822,10,11458,363,9311,2511,11822,0
2019/01,427,29/01/2019,2,SP 7 fra Viano e Scandiano (bivio SP 37),10133,10,9399,733,8101,2032,10133,0
2019/01,427,30/01/2019,3,SP 7 fra Viano e Scandiano (bivio SP 37),9212,20,8515,695,7746,1466,9212,0
2019/01,427,31/01/2019,4,SP 7 fra Viano e Scandiano (bivio SP 37),8965,30,8393,569,7105,1860,8965,0
2019/01,428,29/01/2019,2,SP 19 fra Colombaia (bivio SP 76) e il Bivio SP 486R al confine provinciale,3696,00,3174,522,2884,812,3696,0
2019/01,428,30/01/2019,3,SP 19 fra Colombaia (bivio SP 76) e il Bivio SP 486R al confine provinciale,3124,00,2697,427,2554,570,3124,0
2019/01,428,31/01/2019,4,SP 19 fra Colombaia (bivio SP 76) e il Bivio SP 486R al confine provinciale,2738,00,2450,288,2111,627,2738,0
2019/01,429,29/01/2019,2,SP 12 fra San Polo d'Enza e Montecchio Emilia (variante a sud abitato),7715,10,6967,747,6351,1364,7715,0
2019/01,429,30/01/2019,3,SP 12 fra San Polo d'Enza e Montecchio Emilia (variante a sud abitato),6840,00,6093,747,5787,1053,6840,0
2019/01,429,31/01/2019,4,SP 12 fra San Polo d'Enza e Montecchio Emilia (variante a sud abitato),6655,00,6057,598,5384,1271,6655,0
2019/01,430,29/01/2019,2,SP 28 tra Montecchio Emilia e bivio circonvallazione,10580,10,9972,607,8690,1890,10580,0
2019/01,430,30/01/2019,3,SP 28 tra Montecchio Emilia e bivio circonvallazione,9594,00,8940,654,8219,1375,9594,0
2019/01,430,31/01/2019,4,SP 28 tra Montecchio Emilia e bivio circonvallazione,9436,00,8897,539,7740,1696,9436,0
2019/01,431,29/01/2019,2,SP 12 fra Sant'Ilario d'Enza (variante a sud) e Montecchio Emilia,6492,00,6208,284,5299,1193,6492,0
2019/01,431,30/01/2019,3,SP 12 fra Sant'Ilario d'Enza (variante a sud) e Montecchio Emilia,5879,00,5668,211,5007,872,5879,0
2019/01,431,31/01/2019,4,SP 12 fra Sant'Ilario d'Enza (variante a sud) e Montecchio Emilia,5913,10,5732,180,4757,1156,5913,0
2019/01,432,29/01/2019,2,SP 67 fra Calerno e Montecchio Emilia,10465,00,9151,1314,8662,1803,10465,0
2019/01,432,30/01/2019,3,SP 67 fra Calerno e Montecchio Emilia,9667,00,8364,1303,8149,1518,9667,0
2019/01,432,31/01/2019,4,SP 67 fra Calerno e Montecchio Emilia,9494,00,8326,1168,7725,1769,9494,0
2019/01,434,29/01/2019,2,Via San Nicola (ex SP 39) tra bivio per Taneto a Caprara,3255,00,3186,69,2618,637,3255,0
2019/01,434,30/01/2019,3,Via San Nicola (ex SP 39) tra bivio per Taneto a Caprara,3114,00,3025,89,2605,509,3114,0
2019/01,434,31/01/2019,4,Via San Nicola (ex SP 39) tra bivio per Taneto a Caprara,2920,00,2853,67,2326,594,2920,0
2019/01,436,29/01/2019,2,SP 26 da Santa Sofia a San Piero in Bagno,750,00,708,42,601,149,750,0
2019/01,436,30/01/2019,3,SP 26 da Santa Sofia a San Piero in Bagno,791,20,746,43,645,146,791,0
2019/01,436,31/01/2019,4,SP 26 da Santa Sofia a San Piero in Bagno,604,10,572,31,467,137,604,0
2019/01,437,29/01/2019,2,SP 13 tra SS 9 (Santarcangelo di Romagna) e SP 92 (località Camerano),6862,10,5861,1000,5635,1227,6862,0
2019/01,437,30/01/2019,3,SP 13 tra SS 9 (Santarcangelo di Romagna) e SP 92 (località Camerano),6828,00,5825,1003,5566,1262,6828,0
2019/01,437,31/01/2019,4,SP 13 tra SS 9 (Santarcangelo di Romagna) e SP 92 (località Camerano),6831,00,5869,962,5524,1307,6831,0
2019/01,438,29/01/2019,2,SP 14 tra Colombare (bivio SP 14Ter) e bivio SP 258R,7690,00,7125,565,6324,1366,7690,0
2019/01,438,30/01/2019,3,SP 14 tra Colombare (bivio SP 14Ter) e bivio SP 258R,7661,10,7078,582,6232,1429,7661,0
2019/01,438,31/01/2019,4,SP 14 tra Colombare (bivio SP 14Ter) e bivio SP 258R,7562,00,7046,516,6110,1452,7562,0
2019/01,439,29/01/2019,2,SP 49 da Santarcangelo di Romagna alla località Posta (bivio SP 258R),12508,10,11683,824,10011,2497,12508,0
2019/01,439,30/01/2019,3,SP 49 da Santarcangelo di Romagna alla località Posta (bivio SP 258R),12122,00,11286,836,9706,2416,12122,0
2019/01,439,31/01/2019,4,SP 49 da Santarcangelo di Romagna alla località Posta (bivio SP 258R),11964,00,11103,861,9553,2411,11964,0
2019/01,440,29/01/2019,2,SP 35 tra bivio SP 50 (località Cella) e Sant'Andrea in Casale,11869,10,11558,310,9538,2331,11869,0
2019/01,440,30/01/2019,3,SP 35 tra bivio SP 50 (località Cella) e Sant'Andrea in Casale,11760,00,11435,325,9396,2364,11760,0
2019/01,440,31/01/2019,4,SP 35 tra bivio SP 50 (località Cella) e Sant'Andrea in Casale,11870,00,11500,370,9464,2406,11870,0
2019/01,441,29/01/2019,2,SP 58 tra San Giovanni in Marignano e il confine regionale (Marche),8428,00,8047,381,6789,1639,8428,0
2019/01,441,30/01/2019,3,SP 58 tra San Giovanni in Marignano e il confine regionale (Marche),8562,00,8124,438,6873,1689,8562,0
2019/01,441,31/01/2019,4,SP 58 tra San Giovanni in Marignano e il confine regionale (Marche),8754,00,8345,409,6969,1785,8754,0
2019/01,442,29/01/2019,2,SP 118 tra Casemurate (bivio SP 254R) e il confine provinciale,3443,00,3111,332,2772,671,3443,0
2019/01,442,30/01/2019,3,SP 118 tra Casemurate (bivio SP 254R) e il confine provinciale,3576,10,3273,302,2881,695,3576,0
2019/01,442,31/01/2019,4,SP 118 tra Casemurate (bivio SP 254R) e il confine provinciale,3462,00,3131,331,2732,730,3462,0
2019/01,443,29/01/2019,2,SP 16 tra Faenza e il confine provinciale,5381,00,5122,259,4345,1036,5381,0
2019/01,443,30/01/2019,3,SP 16 tra Faenza e il confine provinciale,5374,00,5089,285,4279,1095,5374,0
2019/01,443,31/01/2019,4,SP 16 tra Faenza e il confine provinciale,5286,00,5045,241,4301,985,5286,0
2019/01,444,29/01/2019,2,SP 5 fra Russi e San Pancrazio,5914,10,5660,253,4803,1111,5914,0
2019/01,444,30/01/2019,3,SP 5 fra Russi e San Pancrazio,5359,00,5078,281,4326,1033,5359,0
2019/01,444,31/01/2019,4,SP 5 fra Russi e San Pancrazio,5578,00,5361,217,4510,1068,5578,0
2019/01,445,29/01/2019,2,SP 610R fra SP 253R e Conselice,5682,00,4888,794,4484,1198,5682,0
2019/01,445,30/01/2019,3,SP 610R fra SP 253R e Conselice,5601,10,4765,835,4446,1155,5601,0
2019/01,445,31/01/2019,4,SP 610R fra SP 253R e Conselice,5696,10,4893,802,4499,1197,5696,0
2019/01,446,29/01/2019,2,SP 13 in località Santa Maria di Fabriago,8668,00,8118,550,6920,1748,8668,0
2019/01,446,30/01/2019,3,SP 13 in località Santa Maria di Fabriago,8824,00,8248,576,7154,1670,8824,0
2019/01,446,31/01/2019,4,SP 13 in località Santa Maria di Fabriago,8393,00,7845,548,6694,1699,8393,0
2019/01,447,29/01/2019,2,SP 28 in località Molinazzo (Comune di Gossolengo),5019,10,4795,223,4087,932,5019,0
2019/01,447,30/01/2019,3,SP 28 in località Molinazzo (Comune di Gossolengo),3786,00,3658,128,3061,725,3786,0
2019/01,447,31/01/2019,4,SP 28 in località Molinazzo (Comune di Gossolengo),4415,00,4308,107,3627,788,4415,0
2019/01,448,29/01/2019,2,SP 5 fra Reggiolo e intersezione SP 45 per Fabbrico,7147,00,6423,724,5699,1448,7147,0
2019/01,448,30/01/2019,3,SP 5 fra Reggiolo e intersezione SP 45 per Fabbrico,7130,00,6388,742,5798,1332,7130,0
2019/01,448,31/01/2019,4,SP 5 fra Reggiolo e intersezione SP 45 per Fabbrico,7061,00,6376,685,5691,1370,7061,0
2019/01,449,29/01/2019,2,SP 111 fra via Emilia e la variante Asse Val d'Enza,11958,10,9867,2090,9822,2136,11958,0
2019/01,449,30/01/2019,3,SP 111 fra via Emilia e la variante Asse Val d'Enza,11371,10,9261,2109,9474,1897,11371,0
2019/01,449,31/01/2019,4,SP 111 fra via Emilia e la variante Asse Val d'Enza,11157,10,9192,1964,9027,2130,11157,0
2019/01,450,29/01/2019,2,SP 35 sul Ponte Po,8319,10,7317,1001,6838,1481,8319,0
2019/01,450,30/01/2019,3,SP 35 sul Ponte Po,7981,30,6988,990,6439,1542,7981,0
2019/01,450,31/01/2019,4,SP 35 sul Ponte Po,7871,30,6974,894,6363,1508,7871,0
2019/01,451,29/01/2019,2,SP 62RVar sulla variante di Luzzara (c/o Codisotto),12074,00,9047,3027,9700,2374,12074,0
2019/01,451,30/01/2019,3,SP 62RVar sulla variante di Luzzara (c/o Codisotto),11540,10,8623,2916,9246,2294,11540,0
2019/01,451,31/01/2019,4,SP 62RVar sulla variante di Luzzara (c/o Codisotto),11415,00,8582,2833,9086,2329,11415,0
2019/01,452,29/01/2019,2,SP 3 sulla variante tra Bagnolo in Piano e il casello A 1 di Reggio Emilia,12306,10,11036,1269,9854,2452,12306,0
2019/01,452,30/01/2019,3,SP 3 sulla variante tra Bagnolo in Piano e il casello A 1 di Reggio Emilia,11420,00,10271,1149,9526,1894,11420,0
2019/01,452,31/01/2019,4,SP 3 sulla variante tra Bagnolo in Piano e il casello A 1 di Reggio Emilia,11630,00,10450,1180,9411,2219,11630,0
2019/01,453,29/01/2019,2,Asse viario Modena-Sassuolo tra Modena e Baggiovara,53368,10,47585,5782,42601,10767,53368,0
2019/01,453,30/01/2019,3,Asse viario Modena-Sassuolo tra Modena e Baggiovara,50122,20,44173,5947,41975,8147,50122,0
2019/01,453,31/01/2019,4,Asse viario Modena-Sassuolo tra Modena e Baggiovara,38244,20,33150,5092,29863,8381,38244,0
2019/01,500,29/01/2019,2,SP 513R fra San Polo d'Enza e Canossa (c/o bivio SP 54),,,,,,,,
2019/01,500,30/01/2019,3,SP 513R fra San Polo d'Enza e Canossa (c/o bivio SP 54),,,,,,,,
2019/01,502,29/01/2019,2,SP 26 tra località Pioppa e viadotto A 1 (c/o Zola Predosa),13337,00,12422,915,11075,2262,13337,0
2019/01,502,30/01/2019,3,SP 26 tra località Pioppa e viadotto A 1 (c/o Zola Predosa),13033,20,12056,975,11275,1758,13033,0
2019/01,502,31/01/2019,4,SP 26 tra località Pioppa e viadotto A 1 (c/o Zola Predosa),12168,10,11327,840,10139,2029,12168,0
2019/01,504,29/01/2019,2,SP 7 dalla località Ca de' Mandorli al bivio per Castel de Britti,10878,00,10556,322,8553,2325,10878,0
2019/01,504,30/01/2019,3,SP 7 dalla località Ca de' Mandorli al bivio per Castel de Britti,10524,00,10203,321,8542,1982,10524,0
2019/01,504,31/01/2019,4,SP 7 dalla località Ca de' Mandorli al bivio per Castel de Britti,9511,00,9297,214,7382,2129,9511,0
2019/01,505,29/01/2019,2,SP 610 tra casello A 1 (Imola) e bivio SP 51 per Castel Guelfo di Bologna,13401,30,11145,2253,10495,2906,13401,0
2019/01,505,30/01/2019,3,SP 610 tra casello A 1 (Imola) e bivio SP 51 per Castel Guelfo di Bologna,13461,30,11172,2286,10603,2858,13461,0
2019/01,505,31/01/2019,4,SP 610 tra casello A 1 (Imola) e bivio SP 51 per Castel Guelfo di Bologna,13804,30,11652,2149,10777,3027,13804,0
2019/01,600,29/01/2019,2,SP 19 tra SP31 e Medicina,7430,10,6612,817,6102,1328,7430,0
2019/01,600,30/01/2019,3,SP 19 tra SP31 e Medicina,7282,00,6491,791,6050,1232,7282,0
2019/01,600,31/01/2019,4,SP 19 tra SP31 e Medicina,7127,00,6401,726,5863,1264,7127,0
2019/01,601,29/01/2019,2,SP 21 da Castel San Pietro al bivio SP 35 (c/o Sassoleone),3033,00,2965,68,2371,662,3033,0
2019/01,601,30/01/2019,3,SP 21 da Castel San Pietro al bivio SP 35 (c/o Sassoleone),3169,00,3090,79,2567,602,3169,0
2019/01,601,31/01/2019,4,SP 21 da Castel San Pietro al bivio SP 35 (c/o Sassoleone),2840,00,2791,49,2186,654,2840,0
2019/01,602,29/01/2019,2,SP 9_1 da Crevalcore alla località Caselle,1615,00,1532,83,1324,291,1615,0
2019/01,602,30/01/2019,3,SP 9_1 da Crevalcore alla località Caselle,1544,00,1479,65,1285,259,1544,0
2019/01,602,31/01/2019,4,SP 9_1 da Crevalcore alla località Caselle,1381,00,1320,61,1124,257,1381,0
2019/01,603,29/01/2019,2,SP 10 dalla località Decima ai confini provinciali di Bologna e Ferrara,3925,10,3794,130,3038,887,3925,0
2019/01,603,30/01/2019,3,SP 10 dalla località Decima ai confini provinciali di Bologna e Ferrara,3860,10,3686,173,3016,844,3860,0
2019/01,603,31/01/2019,4,SP 10 dalla località Decima ai confini provinciali di Bologna e Ferrara,3593,00,3457,136,2737,856,3593,0
2019/01,604,29/01/2019,2,SP 37 da Sasso Marconi alla intersezione SP 58,4957,00,4725,232,4171,786,4957,0
2019/01,604,30/01/2019,3,SP 37 da Sasso Marconi alla intersezione SP 58,4331,10,4158,172,3901,430,4331,0
2019/01,604,31/01/2019,4,SP 37 da Sasso Marconi alla intersezione SP 58,3538,10,3404,133,2974,564,3538,0
2019/01,605,29/01/2019,2,SP 324 da Silla alla intersezione SP 623,7586,10,7272,313,6308,1278,7586,0
2019/01,605,30/01/2019,3,SP 324 da Silla alla intersezione SP 623,6573,20,6250,321,5588,985,6573,0
2019/01,605,31/01/2019,4,SP 324 da Silla alla intersezione SP 623,6291,00,6014,277,5162,1129,6291,0
2019/01,606,29/01/2019,2,SP 70 Cispadana in località Sant'Agostino/San Carlo,5884,20,5399,483,4757,1127,5884,0
2019/01,606,30/01/2019,3,SP 70 Cispadana in località Sant'Agostino/San Carlo,6028,10,5482,545,4987,1041,6028,0
2019/01,606,31/01/2019,4,SP 70 Cispadana in località Sant'Agostino/San Carlo,5368,10,4900,467,4356,1012,5368,0
2019/01,607,29/01/2019,2,SP 1 da Villafranca di Forlì al confine provinciale,4079,00,3839,240,3315,764,4079,0
2019/01,607,30/01/2019,3,SP 1 da Villafranca di Forlì al confine provinciale,4017,00,3784,233,3232,785,4017,0
2019/01,607,31/01/2019,4,SP 1 da Villafranca di Forlì al confine provinciale,4020,00,3771,249,3224,796,4020,0
2019/01,608,29/01/2019,2,SP 140 da Diegaro (SS 9) a Pievesestina (E 45),13294,00,11945,1349,10494,2800,13294,0
2019/01,608,30/01/2019,3,SP 140 da Diegaro (SS 9) a Pievesestina (E 45),13201,10,11979,1221,10379,2822,13201,0
2019/01,608,31/01/2019,4,SP 140 da Diegaro (SS 9) a Pievesestina (E 45),13178,00,11875,1303,10281,2897,13178,0
2019/01,609,29/01/2019,2,SP 4 dal bivio SP22 (per SS 12) al bivio SP 26 (per Pavullo nel Frignano),4093,00,3686,407,3418,675,4093,0
2019/01,609,30/01/2019,3,SP 4 dal bivio SP22 (per SS 12) al bivio SP 26 (per Pavullo nel Frignano),3293,00,2897,396,2701,592,3293,0
2019/01,609,31/01/2019,4,SP 4 dal bivio SP22 (per SS 12) al bivio SP 26 (per Pavullo nel Frignano),2785,00,2586,199,2303,482,2785,0
2019/01,610,29/01/2019,2,SP 11 da Soragna a Roncole Verdi,3557,00,3287,270,2869,688,3557,0
2019/01,610,30/01/2019,3,SP 11 da Soragna a Roncole Verdi,3249,10,2978,270,2654,595,3249,0
2019/01,610,31/01/2019,4,SP 11 da Soragna a Roncole Verdi,3406,00,3143,263,2747,659,3406,0
2019/01,611,29/01/2019,2,SP 357R da Fornovo di Taro al bivio SP 93 per Fidenza,,,,,,,,
2019/01,611,30/01/2019,3,SP 357R da Fornovo di Taro al bivio SP 93 per Fidenza,,,,,,,,
2019/01,611,31/01/2019,4,SP 357R da Fornovo di Taro al bivio SP 93 per Fidenza,,,,,,,,
2019/01,612,29/01/2019,2,SP 665R dalla località Pilastro a Langhirano,17419,10,16343,1075,14304,3115,17419,0
2019/01,612,30/01/2019,3,SP 665R dalla località Pilastro a Langhirano,15182,10,14200,981,12714,2468,15182,0
2019/01,612,31/01/2019,4,SP 665R dalla località Pilastro a Langhirano,15242,00,14353,889,12369,2873,15242,0
2019/01,613,29/01/2019,2,SP 16 dalla località Basilicanova al bivio SP 32 centro abitato Mamiano,6502,00,6240,262,5175,1327,6502,0
2019/01,613,30/01/2019,3,SP 16 dalla località Basilicanova al bivio SP 32 centro abitato Mamiano,5901,20,5646,253,4898,1003,5901,0
2019/01,613,31/01/2019,4,SP 16 dalla località Basilicanova al bivio SP 32 centro abitato Mamiano,5934,00,5728,206,4663,1271,5934,0
2019/01,614,29/01/2019,2,SP 587R dal bivio SP 10R alla A 21Dir,6814,00,6180,634,5533,1281,6814,0
2019/01,614,30/01/2019,3,SP 587R dal bivio SP 10R alla A 21Dir,5741,20,5307,432,4621,1120,5741,0
2019/01,614,31/01/2019,4,SP 587R dal bivio SP 10R alla A 21Dir,6077,00,5637,440,4954,1123,6077,0
2019/01,615,29/01/2019,2,Piazzale Milano (ex SS 9) c/o ponte fiume Po,25854,120,25286,556,19751,6103,25854,0
2019/01,615,30/01/2019,3,Piazzale Milano (ex SS 9) c/o ponte fiume Po,24019,160,23459,544,18511,5508,24019,0
2019/01,615,31/01/2019,4,Piazzale Milano (ex SS 9) c/o ponte fiume Po,25108,120,24586,510,19359,5749,25108,0
2019/01,616,29/01/2019,2,SP 588R dal casello A 21 di Castelvetro Piacentino a Villanova d'Arda,3909,00,3607,302,3231,678,3909,0
2019/01,616,30/01/2019,3,SP 588R dal casello A 21 di Castelvetro Piacentino a Villanova d'Arda,3717,00,3406,311,3073,644,3717,0
2019/01,616,31/01/2019,4,SP 588R dal casello A 21 di Castelvetro Piacentino a Villanova d'Arda,3763,00,3486,277,3078,685,3763,0
2019/01,617,29/01/2019,2,SP 7 dalla intersezione tangenziale sud/ovest di Piacenza a San Nicolò,7787,10,7241,545,6461,1326,7787,0
2019/01,617,30/01/2019,3,SP 7 dalla intersezione tangenziale sud/ovest di Piacenza a San Nicolò,6287,00,6090,197,5128,1159,6287,0
2019/01,617,31/01/2019,4,SP 7 dalla intersezione tangenziale sud/ovest di Piacenza a San Nicolò,7145,00,6872,273,5890,1255,7145,0
2019/01,618,29/01/2019,2,SP 253R fra Bagnacavallo (A14 Dir) e Godo (bivio SP 302R),7232,00,6694,538,5866,1366,7232,0
2019/01,618,30/01/2019,3,SP 253R fra Bagnacavallo (A14 Dir) e Godo (bivio SP 302R),7386,00,6909,477,5942,1444,7386,0
2019/01,618,31/01/2019,4,SP 253R fra Bagnacavallo (A14 Dir) e Godo (bivio SP 302R),7393,00,6938,455,5875,1518,7393,0
2019/01,619,29/01/2019,2,SP 8 da Bagnacavallo al bivio SS 16,3048,00,2854,194,2427,621,3048,0
2019/01,619,30/01/2019,3,SP 8 da Bagnacavallo al bivio SS 16,3060,30,2877,180,2444,616,3060,0
2019/01,619,31/01/2019,4,SP 8 da Bagnacavallo al bivio SS 16,2925,00,2774,151,2306,619,2925,0
2019/01,620,29/01/2019,2,SP 113 sulla variante di San Martino in Rio/Correggio c/o le località Prato/Gazzata,8158,00,7090,1068,6609,1549,8158,0
2019/01,620,30/01/2019,3,SP 113 sulla variante di San Martino in Rio/Correggio c/o le località Prato/Gazzata,7564,10,6549,1014,6331,1233,7564,0
2019/01,620,31/01/2019,4,SP 113 sulla variante di San Martino in Rio/Correggio c/o le località Prato/Gazzata,7907,00,6930,977,6439,1468,7907,0
2019/01,621,29/01/2019,2,SP 513R a nord di Vetto,2010,00,1866,144,1583,427,2010,0
2019/01,621,30/01/2019,3,SP 513R a nord di Vetto,1544,00,1454,90,1244,300,1544,0
2019/01,621,31/01/2019,4,SP 513R a nord di Vetto,1568,00,1483,85,1248,320,1568,0
2019/01,622,29/01/2019,2,SP 468R tra Correggio e il confine provinciale,,,,,,,,
2019/01,622,30/01/2019,3,SP 468R tra Correggio e il confine provinciale,,,,,,,,
2019/01,622,31/01/2019,4,SP 468R tra Correggio e il confine provinciale,,,,,,,,
2019/01,623,29/01/2019,2,SP 30 tra Campagnola Emilia e il confine provinciale,14695,00,13601,1094,11840,2855,14695,0
2019/01,623,30/01/2019,3,SP 30 tra Campagnola Emilia e il confine provinciale,14576,10,13504,1071,11820,2756,14576,0
2019/01,623,31/01/2019,4,SP 30 tra Campagnola Emilia e il confine provinciale,14023,10,13026,996,11288,2735,14023,0
2019/01,624,29/01/2019,2,SP 23 tra Rivalta e la variante di Montecavolo,10897,00,10572,325,8611,2286,10897,0
2019/01,624,30/01/2019,3,SP 23 tra Rivalta e la variante di Montecavolo,9904,00,9600,304,8253,1651,9904,0
2019/01,624,31/01/2019,4,SP 23 tra Rivalta e la variante di Montecavolo,10166,10,9885,280,7990,2176,10166,0
2019/01,625,29/01/2019,2,SP 14 da Poggio Berni (bivio SP 73) a Sant'Arcangelo di Romagna,,,,,,,,
2019/01,625,30/01/2019,3,SP 14 da Poggio Berni (bivio SP 73) a Sant'Arcangelo di Romagna,,,,,,,,
2019/01,625,31/01/2019,4,SP 14 da Poggio Berni (bivio SP 73) a Sant'Arcangelo di Romagna,,,,,,,,
2019/01,626,29/01/2019,2,SP 18 da San Clemente al bivio SP 132 (località Osteria Nuova),7284,00,6932,352,5905,1379,7284,0
2019/01,626,30/01/2019,3,SP 18 da San Clemente al bivio SP 132 (località Osteria Nuova),7358,00,7023,335,6027,1331,7358,0
2019/01,626,31/01/2019,4,SP 18 da San Clemente al bivio SP 132 (località Osteria Nuova),8002,00,7625,377,6439,1563,8002,0
2019/01,627,29/01/2019,2,SS 64 variante di Riola di Vergato,7755,00,7335,420,6290,1465,7755,0
2019/01,627,30/01/2019,3,SS 64 variante di Riola di Vergato,7132,00,6718,414,5923,1209,7132,0
2019/01,627,31/01/2019,4,SS 64 variante di Riola di Vergato,6554,00,6201,353,5310,1244,6554,0
2019/01,629,29/01/2019,2,SS 727 (tg Forli') tra intersezione SS 9 e l'intersezione SS 67,16192,00,15113,1079,13005,3187,16192,0
2019/01,629,30/01/2019,3,SS 727 (tg Forli') tra intersezione SS 9 e l'intersezione SS 67,16334,10,15195,1138,13127,3207,16334,0
2019/01,629,31/01/2019,4,SS 727 (tg Forli') tra intersezione SS 9 e l'intersezione SS 67,15655,00,14653,1002,12513,3142,15655,0
2019/01,630,29/01/2019,2,SS 726 (tg Cesena) tra intersezione ex SS 71BIS e l'intersezione SP 304R,,,,,,,,
2019/01,630,30/01/2019,3,SS 726 (tg Cesena) tra intersezione ex SS 71BIS e l'intersezione SP 304R,,,,,,,,
2019/01,630,31/01/2019,4,SS 726 (tg Cesena) tra intersezione ex SS 71BIS e l'intersezione SP 304R,,,,,,,,
2019/01,631,29/01/2019,2,SS 3Bis/E 45 tra Sarsina e San Piero in Bagno,,,,,,,,
2019/01,631,30/01/2019,3,SS 3Bis/E 45 tra Sarsina e San Piero in Bagno,,,,,,,,
2019/01,631,31/01/2019,4,SS 3Bis/E 45 tra Sarsina e San Piero in Bagno,,,,,,,,
2019/01,633,29/01/2019,2,SS 724Dir/tangenziale complanare sud alla A 1 in direzione Bologna - tra intersezione Modena/Sassuolo e intersezione SS12,8108,00,7585,523,6280,1828,8108,0
2019/01,633,30/01/2019,3,SS 724Dir/tangenziale complanare sud alla A 1 in direzione Bologna - tra intersezione Modena/Sassuolo e intersezione SS12,7465,20,6965,498,6117,1348,7465,0
2019/01,633,31/01/2019,4,SS 724Dir/tangenziale complanare sud alla A 1 in direzione Bologna - tra intersezione Modena/Sassuolo e intersezione SS12,5353,10,4913,439,3979,1374,5353,0
2019/01,634,29/01/2019,2,SS 12 tra Pavullo e intersezione SP 31,,,,,,,,
2019/01,634,30/01/2019,3,SS 12 tra Pavullo e intersezione SP 31,,,,,,,,
2019/01,634,31/01/2019,4,SS 12 tra Pavullo e intersezione SP 31,,,,,,,,
2019/01,635,29/01/2019,2,SS 725 (tg sud Piacenza) tra intersezione SS 45 e l'intersezione SP 6,44199,10,41015,3183,35908,8291,44199,0
2019/01,635,30/01/2019,3,SS 725 (tg sud Piacenza) tra intersezione SS 45 e l'intersezione SP 6,39435,30,36778,2654,32036,7399,39435,0
2019/01,635,31/01/2019,4,SS 725 (tg sud Piacenza) tra intersezione SS 45 e l'intersezione SP 6,42168,00,39097,3071,34783,7385,42168,0
2019/01,636,29/01/2019,2,SS 9Var tra la tangenziale nord di Parma (intersezione SP 343R) e l'intersezione SP 62R,54581,60,51320,3255,43757,10824,54581,0
2019/01,636,30/01/2019,3,SS 9Var tra la tangenziale nord di Parma (intersezione SP 343R) e l'intersezione SP 62R,48880,70,45658,3215,40492,8388,48880,0
2019/01,636,31/01/2019,4,SS 9Var tra la tangenziale nord di Parma (intersezione SP 343R) e l'intersezione SP 62R,50755,20,47740,3013,41031,9724,50755,0
2019/01,637,29/01/2019,2,SS 62 tra Fornovo di Taro e Collecchio,13786,00,12896,890,11052,2734,13786,0
2019/01,637,30/01/2019,3,SS 62 tra Fornovo di Taro e Collecchio,11430,10,10715,714,9366,2064,11430,0
2019/01,637,31/01/2019,4,SS 62 tra Fornovo di Taro e Collecchio,11609,00,10949,660,9287,2322,11609,0
2019/01,638,29/01/2019,2,SS 9 tra la tangenziale nord di Reggio Emilia e Sant'Ilario d'Enza,19087,00,17381,1706,14447,4640,19087,0
2019/01,638,30/01/2019,3,SS 9 tra la tangenziale nord di Reggio Emilia e Sant'Ilario d'Enza,17316,10,15715,1600,13664,3652,17316,0
2019/01,638,31/01/2019,4,SS 9 tra la tangenziale nord di Reggio Emilia e Sant'Ilario d'Enza,17233,00,15699,1534,13036,4197,17233,0
2019/01,639,29/01/2019,2,SS 63 località Casina (variante abitato),6515,10,6194,320,5176,1339,6515,0
2019/01,639,30/01/2019,3,SS 63 località Casina (variante abitato),5479,10,5221,257,4483,996,5479,0
2019/01,639,31/01/2019,4,SS 63 località Casina (variante abitato),5145,00,4930,215,4029,1116,5145,0
2019/01,651,29/01/2019,2,SS 9 da Imola a Castelbolognese (al confine provinciale),16311,00,15653,658,12563,3748,16311,0
2019/01,651,30/01/2019,3,SS 9 da Imola a Castelbolognese (al confine provinciale),15463,00,14802,661,11790,3673,15463,0
2019/01,651,31/01/2019,4,SS 9 da Imola a Castelbolognese (al confine provinciale),15790,00,15171,619,12420,3370,15790,0
2019/01,652,29/01/2019,2,SS 16 dal bivio SP 610R ad Argenta,11815,00,10559,1256,9580,2235,11815,0
2019/01,652,30/01/2019,3,SS 16 dal bivio SP 610R ad Argenta,11325,00,10043,1282,9284,2041,11325,0
2019/01,652,31/01/2019,4,SS 16 dal bivio SP 610R ad Argenta,11334,00,10108,1226,9120,2214,11334,0
2019/01,653,29/01/2019,2,SP 254R dal ponte sul fiume Savio alla SS 16,7591,00,7429,162,6146,1445,7591,0
2019/01,653,30/01/2019,3,SP 254R dal ponte sul fiume Savio alla SS 16,7131,00,6981,150,5867,1264,7131,0
2019/01,653,31/01/2019,4,SP 254R dal ponte sul fiume Savio alla SS 16,7376,00,7166,210,6056,1320,7376,0
2019/01,654,29/01/2019,2,SP 7IBisR dal bivio SSPP 32/33ter alla SS 16,10701,00,10252,449,8649,2052,10701,0
2019/01,654,30/01/2019,3,SP 7IBisR dal bivio SSPP 32/33ter alla SS 16,10825,00,10389,436,8791,2034,10825,0
2019/01,654,31/01/2019,4,SP 7IBisR dal bivio SSPP 32/33ter alla SS 16,10890,00,10444,446,8829,2061,10890,0
2019/01,655,29/01/2019,2,SP 253R dal bivio SP 302R allo svincolo A 14dir a Fornace Zarattini,16695,00,15880,815,13446,3249,16695,0
2019/01,655,30/01/2019,3,SP 253R dal bivio SP 302R allo svincolo A 14dir a Fornace Zarattini,17523,00,16609,914,14128,3395,17523,0
2019/01,655,31/01/2019,4,SP 253R dal bivio SP 302R allo svincolo A 14dir a Fornace Zarattini,17346,00,16527,819,13823,3523,17346,0
2019/01,660,29/01/2019,2,SP 25 tra intersezione con SS 64 e confine provinciale,,,,,,,,
2019/01,660,30/01/2019,3,SP 25 tra intersezione con SS 64 e confine provinciale,,,,,,,,
2019/01,660,31/01/2019,4,SP 25 tra intersezione con SS 64 e confine provinciale,,,,,,,,
2019/01,661,29/01/2019,2,SP 15 tra Tresigallo e Massa Fiscaglia,3228,00,3099,129,2629,599,3228,0
2019/01,661,30/01/2019,3,SP 15 tra Tresigallo e Massa Fiscaglia,3182,40,3043,135,2549,633,3182,0
2019/01,661,31/01/2019,4,SP 15 tra Tresigallo e Massa Fiscaglia,3207,10,3107,99,2559,648,3207,0
2019/01,662,29/01/2019,2,SP 2 tra intersezione SP 14 e Copparo,13138,00,12579,559,10694,2444,13138,0
2019/01,662,30/01/2019,3,SP 2 tra intersezione SP 14 e Copparo,13154,00,12527,627,10697,2457,13154,0
2019/01,662,31/01/2019,4,SP 2 tra intersezione SP 14 e Copparo,13021,10,12510,510,10443,2578,13021,0
2019/01,663,29/01/2019,2,SP 60 tra intersezione SP 68 e SP62,2832,10,2421,410,2247,585,2832,0
2019/01,663,30/01/2019,3,SP 60 tra intersezione SP 68 e SP62,2996,00,2519,477,2378,618,2996,0
2019/01,663,31/01/2019,4,SP 60 tra intersezione SP 68 e SP62,2767,00,2402,365,2199,568,2767,0
2019/01,665,29/01/2019,2,SP 1 tra intersezione SP7 a Piacenza,11732,10,11104,627,9439,2293,11732,0
2019/01,665,30/01/2019,3,SP 1 tra intersezione SP7 a Piacenza,10046,00,9528,518,8182,1864,10046,0
2019/01,665,31/01/2019,4,SP 1 tra intersezione SP7 a Piacenza,10918,10,10304,613,8938,1980,10918,0
2019/01,666,29/01/2019,2,SP 3 tra via Monda e via Caminate,7432,00,6985,447,5988,1444,7432,0
2019/01,666,30/01/2019,3,SP 3 tra via Monda e via Caminate,7475,00,7029,446,6043,1432,7475,0
2019/01,666,31/01/2019,4,SP 3 tra via Monda e via Caminate,7258,00,6828,430,5889,1369,7258,0
2019/01,670,29/01/2019,2,SP 114 dalla rotatoria SP 114/viale Parisoli alla rotatoria SP467,16769,10,15904,864,13710,3059,16769,0
2019/01,670,30/01/2019,3,SP 114 dalla rotatoria SP 114/viale Parisoli alla rotatoria SP467,15688,00,14952,736,13444,2244,15688,0
2019/01,670,31/01/2019,4,SP 114 dalla rotatoria SP 114/viale Parisoli alla rotatoria SP467,15454,00,14828,626,12612,2842,15454,0
2019/02,7,01/02/2019,5,SS 64 tra Porretta Terme e Sambuca Pistoiese,6637,00,6408,229,5380,1257,6637,0
2019/02,7,02/02/2019,6,SS 64 tra Porretta Terme e Sambuca Pistoiese,6567,10,6471,95,5341,1226,0,6567
2019/02,7,03/02/2019,7,SS 64 tra Porretta Terme e Sambuca Pistoiese,5282,00,5261,21,4254,1028,0,5282
2019/02,7,04/02/2019,1,SS 64 tra Porretta Terme e Sambuca Pistoiese,6502,00,6309,193,5398,1104,6502,0
2019/02,7,05/02/2019,2,SS 64 tra Porretta Terme e Sambuca Pistoiese,6672,00,6470,202,5543,1129,6672,0
2019/02,7,06/02/2019,3,SS 64 tra Porretta Terme e Sambuca Pistoiese,6493,20,6248,243,5362,1131,6493,0
2019/02,7,07/02/2019,4,SS 64 tra Porretta Terme e Sambuca Pistoiese,6528,10,6313,214,5342,1186,6528,0
2019/02,7,08/02/2019,5,SS 64 tra Porretta Terme e Sambuca Pistoiese,7261,10,7035,225,5805,1456,7261,0
2019/02,7,09/02/2019,6,SS 64 tra Porretta Terme e Sambuca Pistoiese,7456,10,7351,104,6148,1308,0,7456
2019/02,7,10/02/2019,7,SS 64 tra Porretta Terme e Sambuca Pistoiese,5385,00,5354,31,4433,952,0,5385
2019/02,7,11/02/2019,1,SS 64 tra Porretta Terme e Sambuca Pistoiese,6393,10,6173,219,5341,1052,6393,0
2019/02,7,12/02/2019,2,SS 64 tra Porretta Terme e Sambuca Pistoiese,6469,10,6269,199,5308,1161,6469,0
2019/02,7,13/02/2019,3,SS 64 tra Porretta Terme e Sambuca Pistoiese,6572,00,6300,272,5397,1175,6572,0
2019/02,7,14/02/2019,4,SS 64 tra Porretta Terme e Sambuca Pistoiese,6886,00,6680,206,5581,1305,6886,0
2019/02,9,01/02/2019,5,SS 67 tra Rocca San Casciano e Portico San Benedetto,1038,00,969,69,862,176,1038,0
2019/02,9,02/02/2019,6,SS 67 tra Rocca San Casciano e Portico San Benedetto,897,10,868,28,713,184,0,897
2019/02,9,03/02/2019,7,SS 67 tra Rocca San Casciano e Portico San Benedetto,939,00,935,4,765,174,0,939
2019/02,9,04/02/2019,1,SS 67 tra Rocca San Casciano e Portico San Benedetto,1032,00,965,67,866,166,1032,0
2019/02,9,05/02/2019,2,SS 67 tra Rocca San Casciano e Portico San Benedetto,1130,00,1047,83,956,174,1130,0
2019/02,9,06/02/2019,3,SS 67 tra Rocca San Casciano e Portico San Benedetto,1057,00,980,77,866,191,1057,0
2019/02,9,07/02/2019,4,SS 67 tra Rocca San Casciano e Portico San Benedetto,1059,00,975,84,860,199,1059,0
2019/02,9,08/02/2019,5,SS 67 tra Rocca San Casciano e Portico San Benedetto,1115,00,1049,66,913,202,1115,0
2019/02,9,09/02/2019,6,SS 67 tra Rocca San Casciano e Portico San Benedetto,1005,00,976,29,818,187,0,1005
2019/02,9,10/02/2019,7,SS 67 tra Rocca San Casciano e Portico San Benedetto,975,00,973,2,812,163,0,975
2019/02,9,11/02/2019,1,SS 67 tra Rocca San Casciano e Portico San Benedetto,1107,10,1026,80,932,175,1107,0
2019/02,9,12/02/2019,2,SS 67 tra Rocca San Casciano e Portico San Benedetto,1096,00,1020,76,900,196,1096,0
2019/02,9,13/02/2019,3,SS 67 tra Rocca San Casciano e Portico San Benedetto,1139,00,1046,93,929,210,1139,0
2019/02,9,14/02/2019,4,SS 67 tra Rocca San Casciano e Portico San Benedetto,1224,00,1149,75,959,265,1224,0
2019/02,12,01/02/2019,5,SS 16 al Confine regionale (Marche),16647,00,16041,606,12736,3911,16647,0
2019/02,12,02/02/2019,6,SS 16 al Confine regionale (Marche),14865,10,14638,226,10707,4158,0,14865
2019/02,12,03/02/2019,7,SS 16 al Confine regionale (Marche),12776,10,12714,61,8904,3872,0,12776
2019/02,12,04/02/2019,1,SS 16 al Confine regionale (Marche),15605,20,15032,571,12412,3193,15605,0
2019/02,12,05/02/2019,2,SS 16 al Confine regionale (Marche),15910,20,15309,599,12669,3241,15910,0
2019/02,12,06/02/2019,3,SS 16 al Confine regionale (Marche),15770,00,15101,669,12569,3201,15770,0
2019/02,12,07/02/2019,4,SS 16 al Confine regionale (Marche),16600,10,15990,609,13041,3559,16600,0
2019/02,12,08/02/2019,5,SS 16 al Confine regionale (Marche),17142,00,16470,672,13088,4054,17142,0
2019/02,12,09/02/2019,6,SS 16 al Confine regionale (Marche),16363,10,16125,237,11770,4593,0,16363
2019/02,12,10/02/2019,7,SS 16 al Confine regionale (Marche),13788,10,13739,48,9721,4067,0,13788
2019/02,12,11/02/2019,1,SS 16 al Confine regionale (Marche),15836,10,15223,612,12610,3226,15836,0
2019/02,12,12/02/2019,2,SS 16 al Confine regionale (Marche),16122,10,15420,701,12766,3356,16122,0
2019/02,12,13/02/2019,3,SS 16 al Confine regionale (Marche),16190,10,15535,654,12792,3398,16190,0
2019/02,12,14/02/2019,4,SS 16 al Confine regionale (Marche),17242,00,16558,684,13304,3938,17242,0
2019/02,16,01/02/2019,5,SP 69 in località Pilastri al Confine regionale,1396,10,1279,116,1076,320,1396,0
2019/02,16,02/02/2019,6,SP 69 in località Pilastri al Confine regionale,1120,00,1088,32,833,287,0,1120
2019/02,16,03/02/2019,7,SP 69 in località Pilastri al Confine regionale,1039,00,1030,9,713,326,0,1039
2019/02,16,04/02/2019,1,SP 69 in località Pilastri al Confine regionale,1303,00,1189,114,1063,240,1303,0
2019/02,16,05/02/2019,2,SP 69 in località Pilastri al Confine regionale,1396,00,1258,138,1143,253,1396,0
2019/02,16,06/02/2019,3,SP 69 in località Pilastri al Confine regionale,1384,00,1267,117,1104,280,1384,0
2019/02,16,07/02/2019,4,SP 69 in località Pilastri al Confine regionale,1472,00,1329,143,1186,286,1472,0
2019/02,16,08/02/2019,5,SP 69 in località Pilastri al Confine regionale,1494,00,1375,119,1170,324,1494,0
2019/02,16,09/02/2019,6,SP 69 in località Pilastri al Confine regionale,1342,00,1295,47,1003,339,0,1342
2019/02,16,10/02/2019,7,SP 69 in località Pilastri al Confine regionale,1251,10,1233,17,925,326,0,1251
2019/02,16,11/02/2019,1,SP 69 in località Pilastri al Confine regionale,1374,00,1250,124,1095,279,1374,0
2019/02,16,12/02/2019,2,SP 69 in località Pilastri al Confine regionale,1543,10,1369,173,1265,278,1543,0
2019/02,16,13/02/2019,3,SP 69 in località Pilastri al Confine regionale,1479,00,1349,130,1180,299,1479,0
2019/02,16,14/02/2019,4,SP 69 in località Pilastri al Confine regionale,1565,20,1398,165,1242,323,1565,0
2019/02,17,01/02/2019,5,SS 12 al Confine regionale (Lombardia),10499,00,9522,977,8169,2330,10499,0
2019/02,17,02/02/2019,6,SS 12 al Confine regionale (Lombardia),8947,10,8509,437,6627,2320,0,8947
2019/02,17,03/02/2019,7,SS 12 al Confine regionale (Lombardia),6663,00,6618,45,4698,1965,0,6663
2019/02,17,04/02/2019,1,SS 12 al Confine regionale (Lombardia),10330,10,9323,1006,8288,2042,10330,0
2019/02,17,05/02/2019,2,SS 12 al Confine regionale (Lombardia),10334,00,9259,1075,8258,2076,10334,0
2019/02,17,06/02/2019,3,SS 12 al Confine regionale (Lombardia),10809,00,9695,1114,8497,2312,10809,0
2019/02,17,07/02/2019,4,SS 12 al Confine regionale (Lombardia),10577,00,9483,1094,8386,2191,10577,0
2019/02,17,08/02/2019,5,SS 12 al Confine regionale (Lombardia),11131,00,10023,1108,8674,2457,11131,0
2019/02,17,09/02/2019,6,SS 12 al Confine regionale (Lombardia),9286,00,9048,238,6718,2568,0,9286
2019/02,17,10/02/2019,7,SS 12 al Confine regionale (Lombardia),7447,00,7398,49,5557,1890,0,7447
2019/02,17,11/02/2019,1,SS 12 al Confine regionale (Lombardia),10497,00,9451,1046,8421,2076,10497,0
2019/02,17,12/02/2019,2,SS 12 al Confine regionale (Lombardia),10721,10,9610,1110,8482,2239,10721,0
2019/02,17,13/02/2019,3,SS 12 al Confine regionale (Lombardia),10544,00,9487,1057,8259,2285,10544,0
2019/02,17,14/02/2019,4,SS 12 al Confine regionale (Lombardia),11036,00,9962,1074,8525,2511,11036,0
2019/02,19,01/02/2019,5,SP 343R tra Colorno e Casalmaggiore,925,00,831,94,765,160,925,0
2019/02,19,02/02/2019,6,SP 343R tra Colorno e Casalmaggiore,609,00,594,15,511,98,0,609
2019/02,19,03/02/2019,7,SP 343R tra Colorno e Casalmaggiore,483,00,481,2,410,73,0,483
2019/02,19,04/02/2019,1,SP 343R tra Colorno e Casalmaggiore,998,00,893,105,859,139,998,0
2019/02,19,05/02/2019,2,SP 343R tra Colorno e Casalmaggiore,1006,00,906,100,872,134,1006,0
2019/02,19,06/02/2019,3,SP 343R tra Colorno e Casalmaggiore,946,00,835,111,806,140,946,0
2019/02,19,07/02/2019,4,SP 343R tra Colorno e Casalmaggiore,1105,00,968,137,940,165,1105,0
2019/02,19,08/02/2019,5,SP 343R tra Colorno e Casalmaggiore,991,10,880,110,847,144,991,0
2019/02,19,09/02/2019,6,SP 343R tra Colorno e Casalmaggiore,745,00,734,11,615,130,0,745
2019/02,19,10/02/2019,7,SP 343R tra Colorno e Casalmaggiore,522,00,516,6,442,80,0,522
2019/02,19,11/02/2019,1,SP 343R tra Colorno e Casalmaggiore,953,00,855,98,815,138,953,0
2019/02,19,12/02/2019,2,SP 343R tra Colorno e Casalmaggiore,972,00,880,92,813,159,972,0
2019/02,19,13/02/2019,3,SP 343R tra Colorno e Casalmaggiore,981,00,885,96,822,159,981,0
2019/02,19,14/02/2019,4,SP 343R tra Colorno e Casalmaggiore,1063,00,960,103,888,175,1063,0
2019/02,25,01/02/2019,5,SS 9 tra San Prospero (Case Crostolo) e Sant'Ilario d'Enza,29150,40,27323,1823,21486,7664,29150,0
2019/02,25,02/02/2019,6,SS 9 tra San Prospero (Case Crostolo) e Sant'Ilario d'Enza,28602,10,28125,476,19335,9267,0,28602
2019/02,25,03/02/2019,7,SS 9 tra San Prospero (Case Crostolo) e Sant'Ilario d'Enza,24274,10,24138,135,15795,8479,0,24274
2019/02,25,04/02/2019,1,SS 9 tra San Prospero (Case Crostolo) e Sant'Ilario d'Enza,29119,10,27076,2042,22349,6770,29119,0
2019/02,25,05/02/2019,2,SS 9 tra San Prospero (Case Crostolo) e Sant'Ilario d'Enza,29538,30,27472,2063,22516,7022,29538,0
2019/02,25,06/02/2019,3,SS 9 tra San Prospero (Case Crostolo) e Sant'Ilario d'Enza,30205,40,27990,2211,22642,7563,30205,0
2019/02,25,07/02/2019,4,SS 9 tra San Prospero (Case Crostolo) e Sant'Ilario d'Enza,30486,20,28352,2132,22802,7684,30486,0
2019/02,25,08/02/2019,5,SS 9 tra San Prospero (Case Crostolo) e Sant'Ilario d'Enza,31633,30,29495,2135,22900,8733,31633,0
2019/02,25,09/02/2019,6,SS 9 tra San Prospero (Case Crostolo) e Sant'Ilario d'Enza,30032,20,29481,549,20381,9651,0,30032
2019/02,25,10/02/2019,7,SS 9 tra San Prospero (Case Crostolo) e Sant'Ilario d'Enza,24898,00,24744,154,17184,7714,0,24898
2019/02,25,11/02/2019,1,SS 9 tra San Prospero (Case Crostolo) e Sant'Ilario d'Enza,29220,40,27143,2073,22234,6986,29220,0
2019/02,25,12/02/2019,2,SS 9 tra San Prospero (Case Crostolo) e Sant'Ilario d'Enza,26642,110,24602,2029,19413,7229,26642,0
2019/02,25,13/02/2019,3,SS 9 tra San Prospero (Case Crostolo) e Sant'Ilario d'Enza,30552,50,28423,2124,22857,7695,30552,0
2019/02,25,14/02/2019,4,SS 9 tra San Prospero (Case Crostolo) e Sant'Ilario d'Enza,31527,20,29438,2087,23044,8483,31527,0
2019/02,29,01/02/2019,5,SS 9 tra Modena e Rubiera,23191,00,21020,2171,17174,6017,23191,0
2019/02,29,02/02/2019,6,SS 9 tra Modena e Rubiera,22800,20,22419,379,15914,6886,0,22800
2019/02,29,03/02/2019,7,SS 9 tra Modena e Rubiera,21194,10,21081,112,14856,6338,0,21194
2019/02,29,04/02/2019,1,SS 9 tra Modena e Rubiera,23977,10,21588,2388,18097,5880,23977,0
2019/02,29,05/02/2019,2,SS 9 tra Modena e Rubiera,23923,10,21425,2497,18278,5645,23923,0
2019/02,29,06/02/2019,3,SS 9 tra Modena e Rubiera,24105,30,21615,2487,18202,5903,24105,0
2019/02,29,07/02/2019,4,SS 9 tra Modena e Rubiera,25360,40,22608,2748,19197,6163,25360,0
2019/02,29,08/02/2019,5,SS 9 tra Modena e Rubiera,26115,10,23539,2575,18918,7197,26115,0
2019/02,29,09/02/2019,6,SS 9 tra Modena e Rubiera,24138,00,23729,409,16393,7745,0,24138
2019/02,29,10/02/2019,7,SS 9 tra Modena e Rubiera,22934,00,22807,127,15843,7091,0,22934
2019/02,29,11/02/2019,1,SS 9 tra Modena e Rubiera,24029,20,21725,2302,18216,5813,24029,0
2019/02,29,12/02/2019,2,SS 9 tra Modena e Rubiera,24170,40,21581,2585,18482,5688,24170,0
2019/02,29,13/02/2019,3,SS 9 tra Modena e Rubiera,25194,50,22517,2672,18855,6339,25194,0
2019/02,29,14/02/2019,4,SS 9 tra Modena e Rubiera,25643,40,23116,2523,19039,6604,25643,0
2019/02,52,01/02/2019,5,SP 253 tra Sesto Imolese e Medicina,6053,00,5449,604,4667,1386,6053,0
2019/02,52,02/02/2019,6,SP 253 tra Sesto Imolese e Medicina,4501,00,4370,131,3345,1156,0,4501
2019/02,52,03/02/2019,7,SP 253 tra Sesto Imolese e Medicina,4286,00,4252,34,3255,1031,0,4286
2019/02,52,04/02/2019,1,SP 253 tra Sesto Imolese e Medicina,5810,10,5192,617,4566,1244,5810,0
2019/02,52,05/02/2019,2,SP 253 tra Sesto Imolese e Medicina,6020,10,5384,635,4711,1309,6020,0
2019/02,52,06/02/2019,3,SP 253 tra Sesto Imolese e Medicina,6208,00,5515,693,4849,1359,6208,0
2019/02,52,07/02/2019,4,SP 253 tra Sesto Imolese e Medicina,6242,00,5564,678,4906,1336,6242,0
2019/02,52,08/02/2019,5,SP 253 tra Sesto Imolese e Medicina,6386,00,5700,686,4851,1535,6386,0
2019/02,52,09/02/2019,6,SP 253 tra Sesto Imolese e Medicina,5086,00,4931,155,3751,1335,0,5086
2019/02,52,10/02/2019,7,SP 253 tra Sesto Imolese e Medicina,4151,00,4094,57,3100,1051,0,4151
2019/02,52,11/02/2019,1,SP 253 tra Sesto Imolese e Medicina,5972,00,5366,606,4672,1300,5972,0
2019/02,52,12/02/2019,2,SP 253 tra Sesto Imolese e Medicina,6045,00,5424,621,4704,1341,6045,0
2019/02,52,13/02/2019,3,SP 253 tra Sesto Imolese e Medicina,6297,00,5584,713,4896,1401,6297,0
2019/02,52,14/02/2019,4,SP 253 tra Sesto Imolese e Medicina,6442,00,5770,672,4967,1475,6442,0
2019/02,53,01/02/2019,5,SS 309 a San Giuseppe di Comacchio,9136,00,6202,2934,6981,2155,9136,0
2019/02,53,02/02/2019,6,SS 309 a San Giuseppe di Comacchio,7017,00,6181,836,5021,1996,0,7017
2019/02,53,03/02/2019,7,SS 309 a San Giuseppe di Comacchio,7041,00,6735,306,4916,2125,0,7041
2019/02,53,04/02/2019,1,SS 309 a San Giuseppe di Comacchio,9062,00,5782,3280,6983,2079,9062,0
2019/02,53,05/02/2019,2,SS 309 a San Giuseppe di Comacchio,9573,00,5851,3722,7529,2044,9573,0
2019/02,53,06/02/2019,3,SS 309 a San Giuseppe di Comacchio,9658,00,5816,3842,7572,2086,9658,0
2019/02,53,07/02/2019,4,SS 309 a San Giuseppe di Comacchio,9696,00,5966,3730,7626,2070,9696,0
2019/02,53,08/02/2019,5,SS 309 a San Giuseppe di Comacchio,10052,00,6574,3478,7688,2364,10052,0
2019/02,53,09/02/2019,6,SS 309 a San Giuseppe di Comacchio,8093,00,7038,1055,5966,2127,0,8093
2019/02,53,10/02/2019,7,SS 309 a San Giuseppe di Comacchio,7665,10,7364,300,5600,2065,0,7665
2019/02,53,11/02/2019,1,SS 309 a San Giuseppe di Comacchio,9425,10,5896,3528,7266,2159,9425,0
2019/02,53,12/02/2019,2,SS 309 a San Giuseppe di Comacchio,9967,00,6061,3906,7822,2145,9967,0
2019/02,53,13/02/2019,3,SS 309 a San Giuseppe di Comacchio,10124,00,6033,4091,7987,2137,10124,0
2019/02,53,14/02/2019,4,SS 309 a San Giuseppe di Comacchio,10530,00,6651,3879,8010,2520,10530,0
2019/02,95,01/02/2019,5,SP 10R tra Castel San Giovanni e Sarmato,,,,,,,,
2019/02,95,02/02/2019,6,SP 10R tra Castel San Giovanni e Sarmato,,,,,,,,
2019/02,95,03/02/2019,7,SP 10R tra Castel San Giovanni e Sarmato,,,,,,,,
2019/02,95,04/02/2019,1,SP 10R tra Castel San Giovanni e Sarmato,,,,,,,,
2019/02,95,05/02/2019,2,SP 10R tra Castel San Giovanni e Sarmato,,,,,,,,
2019/02,95,06/02/2019,3,SP 10R tra Castel San Giovanni e Sarmato,,,,,,,,
2019/02,95,07/02/2019,4,SP 10R tra Castel San Giovanni e Sarmato,,,,,,,,
2019/02,95,08/02/2019,5,SP 10R tra Castel San Giovanni e Sarmato,,,,,,,,
2019/02,95,09/02/2019,6,SP 10R tra Castel San Giovanni e Sarmato,,,,,,,,
2019/02,95,10/02/2019,7,SP 10R tra Castel San Giovanni e Sarmato,,,,,,,,
2019/02,95,11/02/2019,1,SP 10R tra Castel San Giovanni e Sarmato,,,,,,,,
2019/02,95,12/02/2019,2,SP 10R tra Castel San Giovanni e Sarmato,,,,,,,,
2019/02,95,13/02/2019,3,SP 10R tra Castel San Giovanni e Sarmato,,,,,,,,
2019/02,95,14/02/2019,4,SP 10R tra Castel San Giovanni e Sarmato,,,,,,,,
2019/02,98,01/02/2019,5,SP 302R tra Brisighella e Marradi,2866,00,2790,76,2222,644,2866,0
2019/02,98,02/02/2019,6,SP 302R tra Brisighella e Marradi,2454,00,2438,16,1852,602,0,2454
2019/02,98,03/02/2019,7,SP 302R tra Brisighella e Marradi,2485,10,2480,4,2019,466,0,2485
2019/02,98,04/02/2019,1,SP 302R tra Brisighella e Marradi,2817,10,2727,89,2236,581,2817,0
2019/02,98,05/02/2019,2,SP 302R tra Brisighella e Marradi,2735,00,2660,75,2153,582,2735,0
2019/02,98,06/02/2019,3,SP 302R tra Brisighella e Marradi,2955,00,2856,99,2337,618,2955,0
2019/02,98,07/02/2019,4,SP 302R tra Brisighella e Marradi,2981,00,2879,102,2343,638,2981,0
2019/02,98,08/02/2019,5,SP 302R tra Brisighella e Marradi,3100,00,3005,95,2411,689,3100,0
2019/02,98,09/02/2019,6,SP 302R tra Brisighella e Marradi,2975,00,2939,36,2269,706,0,2975
2019/02,98,10/02/2019,7,SP 302R tra Brisighella e Marradi,2658,00,2648,10,2121,537,0,2658
2019/02,98,11/02/2019,1,SP 302R tra Brisighella e Marradi,2790,00,2706,84,2172,618,2790,0
2019/02,98,12/02/2019,2,SP 302R tra Brisighella e Marradi,2943,10,2831,111,2332,611,2943,0
2019/02,98,13/02/2019,3,SP 302R tra Brisighella e Marradi,3092,00,2987,105,2430,662,3092,0
2019/02,98,14/02/2019,4,SP 302R tra Brisighella e Marradi,3093,00,2988,105,2381,712,3093,0
2019/02,100,01/02/2019,5,SP 258R tra Villa Verucchio ed ex Confine regionale (località Dogana),14789,00,13782,1007,11758,3031,14789,0
2019/02,100,02/02/2019,6,SP 258R tra Villa Verucchio ed ex Confine regionale (località Dogana),12662,00,12389,273,9553,3109,0,12662
2019/02,100,03/02/2019,7,SP 258R tra Villa Verucchio ed ex Confine regionale (località Dogana),10866,00,10797,69,8233,2633,0,10866
2019/02,100,04/02/2019,1,SP 258R tra Villa Verucchio ed ex Confine regionale (località Dogana),13886,00,12869,1017,11236,2650,13886,0
2019/02,100,05/02/2019,2,SP 258R tra Villa Verucchio ed ex Confine regionale (località Dogana),14234,00,13337,897,11552,2682,14234,0
2019/02,100,06/02/2019,3,SP 258R tra Villa Verucchio ed ex Confine regionale (località Dogana),15088,10,13798,1289,12212,2876,15088,0
2019/02,100,07/02/2019,4,SP 258R tra Villa Verucchio ed ex Confine regionale (località Dogana),14989,00,13726,1263,12074,2915,14989,0
2019/02,100,08/02/2019,5,SP 258R tra Villa Verucchio ed ex Confine regionale (località Dogana),16063,00,14861,1202,12727,3336,16063,0
2019/02,100,09/02/2019,6,SP 258R tra Villa Verucchio ed ex Confine regionale (località Dogana),13865,00,13558,307,10531,3334,0,13865
2019/02,100,10/02/2019,7,SP 258R tra Villa Verucchio ed ex Confine regionale (località Dogana),11868,00,11790,78,9061,2807,0,11868
2019/02,100,11/02/2019,1,SP 258R tra Villa Verucchio ed ex Confine regionale (località Dogana),14656,10,13436,1219,11899,2757,14656,0
2019/02,100,12/02/2019,2,SP 258R tra Villa Verucchio ed ex Confine regionale (località Dogana),15187,00,13861,1326,12299,2888,15187,0
2019/02,100,13/02/2019,3,SP 258R tra Villa Verucchio ed ex Confine regionale (località Dogana),15676,00,14299,1377,12608,3068,15676,0
2019/02,100,14/02/2019,4,SP 258R tra Villa Verucchio ed ex Confine regionale (località Dogana),15716,00,14462,1254,12307,3409,15716,0
2019/02,104,01/02/2019,5,SP 10 nuovo ponte sul Po tra innesto variante Zibello e confine regionale (Lombardia),3752,00,2840,912,2910,842,3752,0
2019/02,104,02/02/2019,6,SP 10 nuovo ponte sul Po tra innesto variante Zibello e confine regionale (Lombardia),3021,00,2773,248,2287,734,0,3021
2019/02,104,03/02/2019,7,SP 10 nuovo ponte sul Po tra innesto variante Zibello e confine regionale (Lombardia),2966,00,2915,51,2194,772,0,2966
2019/02,104,04/02/2019,1,SP 10 nuovo ponte sul Po tra innesto variante Zibello e confine regionale (Lombardia),4127,10,3032,1094,3241,886,4127,0
2019/02,104,05/02/2019,2,SP 10 nuovo ponte sul Po tra innesto variante Zibello e confine regionale (Lombardia),4241,00,3105,1136,3370,871,4241,0
2019/02,104,06/02/2019,3,SP 10 nuovo ponte sul Po tra innesto variante Zibello e confine regionale (Lombardia),4408,00,3249,1159,3500,908,4408,0
2019/02,104,07/02/2019,4,SP 10 nuovo ponte sul Po tra innesto variante Zibello e confine regionale (Lombardia),4480,00,3263,1217,3579,901,4480,0
2019/02,104,08/02/2019,5,SP 10 nuovo ponte sul Po tra innesto variante Zibello e confine regionale (Lombardia),4664,10,3426,1237,3620,1044,4664,0
2019/02,104,09/02/2019,6,SP 10 nuovo ponte sul Po tra innesto variante Zibello e confine regionale (Lombardia),3461,00,3206,255,2653,808,0,3461
2019/02,104,10/02/2019,7,SP 10 nuovo ponte sul Po tra innesto variante Zibello e confine regionale (Lombardia),3290,00,3227,63,2503,787,0,3290
2019/02,104,11/02/2019,1,SP 10 nuovo ponte sul Po tra innesto variante Zibello e confine regionale (Lombardia),4214,00,3041,1173,3340,874,4214,0
2019/02,104,12/02/2019,2,SP 10 nuovo ponte sul Po tra innesto variante Zibello e confine regionale (Lombardia),4547,10,3302,1244,3674,873,4547,0
2019/02,104,13/02/2019,3,SP 10 nuovo ponte sul Po tra innesto variante Zibello e confine regionale (Lombardia),4483,00,3200,1283,3558,925,4483,0
2019/02,104,14/02/2019,4,SP 10 nuovo ponte sul Po tra innesto variante Zibello e confine regionale (Lombardia),4564,00,3341,1223,3635,929,4564,0
2019/02,107,01/02/2019,5,SP 85 tra Rubiera e bivio SP 13MO (c/o Campogalliano),8581,00,7745,836,6589,1992,8581,0
2019/02,107,02/02/2019,6,SP 85 tra Rubiera e bivio SP 13MO (c/o Campogalliano),7468,00,7338,130,5435,2033,0,7468
2019/02,107,03/02/2019,7,SP 85 tra Rubiera e bivio SP 13MO (c/o Campogalliano),5977,00,5943,34,4385,1592,0,5977
2019/02,107,04/02/2019,1,SP 85 tra Rubiera e bivio SP 13MO (c/o Campogalliano),8592,00,7702,890,6868,1724,8592,0
2019/02,107,05/02/2019,2,SP 85 tra Rubiera e bivio SP 13MO (c/o Campogalliano),8601,00,7615,986,6854,1747,8601,0
2019/02,107,06/02/2019,3,SP 85 tra Rubiera e bivio SP 13MO (c/o Campogalliano),9196,00,8146,1050,7230,1966,9196,0
2019/02,107,07/02/2019,4,SP 85 tra Rubiera e bivio SP 13MO (c/o Campogalliano),9118,00,8119,999,7115,2003,9118,0
2019/02,107,08/02/2019,5,SP 85 tra Rubiera e bivio SP 13MO (c/o Campogalliano),9269,00,8325,944,7144,2125,9269,0
2019/02,107,09/02/2019,6,SP 85 tra Rubiera e bivio SP 13MO (c/o Campogalliano),7672,00,7517,155,5666,2006,0,7672
2019/02,107,10/02/2019,7,SP 85 tra Rubiera e bivio SP 13MO (c/o Campogalliano),6079,00,6032,47,4568,1511,0,6079
2019/02,107,11/02/2019,1,SP 85 tra Rubiera e bivio SP 13MO (c/o Campogalliano),8680,00,7694,986,6871,1809,8680,0
2019/02,107,12/02/2019,2,SP 85 tra Rubiera e bivio SP 13MO (c/o Campogalliano),8674,00,7678,996,6978,1696,8674,0
2019/02,107,13/02/2019,3,SP 85 tra Rubiera e bivio SP 13MO (c/o Campogalliano),8861,00,7816,1045,6915,1946,8861,0
2019/02,107,14/02/2019,4,SP 85 tra Rubiera e bivio SP 13MO (c/o Campogalliano),9377,00,8370,1007,7215,2162,9377,0
2019/02,108,01/02/2019,5,SP 412R tra Castel San Giovanni (Casello A 21) e ponte fiume Po,8989,220,8671,296,6444,2545,8989,0
2019/02,108,02/02/2019,6,SP 412R tra Castel San Giovanni (Casello A 21) e ponte fiume Po,9170,10,9082,87,7098,2072,0,9170
2019/02,108,03/02/2019,7,SP 412R tra Castel San Giovanni (Casello A 21) e ponte fiume Po,8135,00,8106,29,6105,2030,0,8135
2019/02,108,04/02/2019,1,SP 412R tra Castel San Giovanni (Casello A 21) e ponte fiume Po,10714,30,10388,323,7980,2734,10714,0
2019/02,108,05/02/2019,2,SP 412R tra Castel San Giovanni (Casello A 21) e ponte fiume Po,11466,150,11095,356,8695,2771,11466,0
2019/02,108,06/02/2019,3,SP 412R tra Castel San Giovanni (Casello A 21) e ponte fiume Po,11534,110,11140,383,8725,2809,11534,0
2019/02,108,07/02/2019,4,SP 412R tra Castel San Giovanni (Casello A 21) e ponte fiume Po,11712,180,11306,388,8759,2953,11712,0
2019/02,108,08/02/2019,5,SP 412R tra Castel San Giovanni (Casello A 21) e ponte fiume Po,12079,110,11726,342,8980,3099,12079,0
2019/02,108,09/02/2019,6,SP 412R tra Castel San Giovanni (Casello A 21) e ponte fiume Po,10942,10,10845,96,8367,2575,0,10942
2019/02,108,10/02/2019,7,SP 412R tra Castel San Giovanni (Casello A 21) e ponte fiume Po,9031,00,8977,54,6999,2032,0,9031
2019/02,108,11/02/2019,1,SP 412R tra Castel San Giovanni (Casello A 21) e ponte fiume Po,11180,30,10846,331,8479,2701,11180,0
2019/02,108,12/02/2019,2,SP 412R tra Castel San Giovanni (Casello A 21) e ponte fiume Po,11610,120,11202,396,8773,2837,11610,0
2019/02,108,13/02/2019,3,SP 412R tra Castel San Giovanni (Casello A 21) e ponte fiume Po,11809,230,11410,376,8821,2988,11809,0
2019/02,108,14/02/2019,4,SP 412R tra Castel San Giovanni (Casello A 21) e ponte fiume Po,12338,120,11949,377,9266,3072,12338,0
2019/02,112,01/02/2019,5,SP 111 tra Boretto e Viadana sul ponte Po,19445,10,17086,2358,14865,4580,19445,0
2019/02,112,02/02/2019,6,SP 111 tra Boretto e Viadana sul ponte Po,16666,00,16186,480,12317,4349,0,16666
2019/02,112,03/02/2019,7,SP 111 tra Boretto e Viadana sul ponte Po,13663,00,13513,150,9788,3875,0,13663
2019/02,112,04/02/2019,1,SP 111 tra Boretto e Viadana sul ponte Po,19239,30,16652,2584,15086,4153,19239,0
2019/02,112,05/02/2019,2,SP 111 tra Boretto e Viadana sul ponte Po,19597,30,16858,2736,15275,4322,19597,0
2019/02,112,06/02/2019,3,SP 111 tra Boretto e Viadana sul ponte Po,19987,40,17231,2752,15534,4453,19987,0
2019/02,112,07/02/2019,4,SP 111 tra Boretto e Viadana sul ponte Po,20399,40,17570,2825,15904,4495,20399,0
2019/02,112,08/02/2019,5,SP 111 tra Boretto e Viadana sul ponte Po,21179,30,18548,2628,16214,4965,21179,0
2019/02,112,09/02/2019,6,SP 111 tra Boretto e Viadana sul ponte Po,18090,00,17588,502,13396,4694,0,18090
2019/02,112,10/02/2019,7,SP 111 tra Boretto e Viadana sul ponte Po,14036,00,13872,164,10064,3972,0,14036
2019/02,112,11/02/2019,1,SP 111 tra Boretto e Viadana sul ponte Po,19653,10,16892,2760,15377,4276,19653,0
2019/02,112,12/02/2019,2,SP 111 tra Boretto e Viadana sul ponte Po,20127,30,17287,2837,15769,4358,20127,0
2019/02,112,13/02/2019,3,SP 111 tra Boretto e Viadana sul ponte Po,20130,40,17296,2830,15622,4508,20130,0
2019/02,112,14/02/2019,4,SP 111 tra Boretto e Viadana sul ponte Po,21319,60,18405,2908,16308,5011,21319,0
2019/02,115,01/02/2019,5,SP 68 ad Ariano Polesine al Confine regionale (Veneto),2628,00,2399,229,2024,604,2628,0
2019/02,115,02/02/2019,6,SP 68 ad Ariano Polesine al Confine regionale (Veneto),2158,00,2124,34,1615,543,0,2158
2019/02,115,03/02/2019,7,SP 68 ad Ariano Polesine al Confine regionale (Veneto),1789,00,1771,18,1182,607,0,1789
2019/02,115,04/02/2019,1,SP 68 ad Ariano Polesine al Confine regionale (Veneto),2533,00,2262,271,2015,518,2533,0
2019/02,115,05/02/2019,2,SP 68 ad Ariano Polesine al Confine regionale (Veneto),2613,00,2304,309,2096,517,2613,0
2019/02,115,06/02/2019,3,SP 68 ad Ariano Polesine al Confine regionale (Veneto),2608,00,2317,291,2044,564,2608,0
2019/02,115,07/02/2019,4,SP 68 ad Ariano Polesine al Confine regionale (Veneto),2568,00,2263,305,2029,539,2568,0
2019/02,115,08/02/2019,5,SP 68 ad Ariano Polesine al Confine regionale (Veneto),2821,00,2528,293,2164,657,2821,0
2019/02,115,09/02/2019,6,SP 68 ad Ariano Polesine al Confine regionale (Veneto),2360,00,2294,66,1789,571,0,2360
2019/02,115,10/02/2019,7,SP 68 ad Ariano Polesine al Confine regionale (Veneto),1954,00,1941,13,1380,574,0,1954
2019/02,115,11/02/2019,1,SP 68 ad Ariano Polesine al Confine regionale (Veneto),2587,00,2316,271,2064,523,2587,0
2019/02,115,12/02/2019,2,SP 68 ad Ariano Polesine al Confine regionale (Veneto),2696,00,2390,306,2144,552,2696,0
2019/02,115,13/02/2019,3,SP 68 ad Ariano Polesine al Confine regionale (Veneto),2654,10,2361,292,2099,555,2654,0
2019/02,115,14/02/2019,4,SP 68 ad Ariano Polesine al Confine regionale (Veneto),2891,00,2553,338,2210,681,2891,0
2019/02,116,01/02/2019,5,SP 138 tra SPiero in Bagno (E 45) e Bagno di Romagna,5096,00,4934,162,4127,969,5096,0
2019/02,116,02/02/2019,6,SP 138 tra SPiero in Bagno (E 45) e Bagno di Romagna,4988,00,4873,115,3908,1080,0,4988
2019/02,116,03/02/2019,7,SP 138 tra SPiero in Bagno (E 45) e Bagno di Romagna,4510,00,4497,13,3505,1005,0,4510
2019/02,116,04/02/2019,1,SP 138 tra SPiero in Bagno (E 45) e Bagno di Romagna,5272,10,5062,209,4379,893,5272,0
2019/02,116,05/02/2019,2,SP 138 tra SPiero in Bagno (E 45) e Bagno di Romagna,5052,00,4782,270,4187,865,5052,0
2019/02,116,06/02/2019,3,SP 138 tra SPiero in Bagno (E 45) e Bagno di Romagna,5153,10,4881,271,4254,899,5153,0
2019/02,116,07/02/2019,4,SP 138 tra SPiero in Bagno (E 45) e Bagno di Romagna,5073,00,4775,298,4156,917,5073,0
2019/02,116,08/02/2019,5,SP 138 tra SPiero in Bagno (E 45) e Bagno di Romagna,5622,00,5346,276,4520,1102,5622,0
2019/02,116,09/02/2019,6,SP 138 tra SPiero in Bagno (E 45) e Bagno di Romagna,5631,00,5496,135,4263,1368,0,5631
2019/02,116,10/02/2019,7,SP 138 tra SPiero in Bagno (E 45) e Bagno di Romagna,5023,00,5002,21,3947,1076,0,5023
2019/02,116,11/02/2019,1,SP 138 tra SPiero in Bagno (E 45) e Bagno di Romagna,5108,00,4854,254,4247,861,5108,0
2019/02,116,12/02/2019,2,SP 138 tra SPiero in Bagno (E 45) e Bagno di Romagna,5101,10,4808,292,4212,889,5101,0
2019/02,116,13/02/2019,3,SP 138 tra SPiero in Bagno (E 45) e Bagno di Romagna,5397,00,5135,262,4426,971,5397,0
2019/02,116,14/02/2019,4,SP 138 tra SPiero in Bagno (E 45) e Bagno di Romagna,5563,10,5287,275,4497,1066,5563,0
2019/02,117,01/02/2019,5,SS 63 tra Collagna e Sassalbo (Passo del Cerreto),321,00,292,29,274,47,321,0
2019/02,117,02/02/2019,6,SS 63 tra Collagna e Sassalbo (Passo del Cerreto),415,10,395,19,348,67,0,415
2019/02,117,03/02/2019,7,SS 63 tra Collagna e Sassalbo (Passo del Cerreto),663,00,656,7,583,80,0,663
2019/02,117,04/02/2019,1,SS 63 tra Collagna e Sassalbo (Passo del Cerreto),379,00,346,33,330,49,379,0
2019/02,117,05/02/2019,2,SS 63 tra Collagna e Sassalbo (Passo del Cerreto),441,00,418,23,391,50,441,0
2019/02,117,06/02/2019,3,SS 63 tra Collagna e Sassalbo (Passo del Cerreto),514,00,492,22,468,46,514,0
2019/02,117,07/02/2019,4,SS 63 tra Collagna e Sassalbo (Passo del Cerreto),514,00,491,23,444,70,514,0
2019/02,117,08/02/2019,5,SS 63 tra Collagna e Sassalbo (Passo del Cerreto),554,00,527,27,473,81,554,0
2019/02,117,09/02/2019,6,SS 63 tra Collagna e Sassalbo (Passo del Cerreto),725,00,710,15,653,72,0,725
2019/02,117,10/02/2019,7,SS 63 tra Collagna e Sassalbo (Passo del Cerreto),562,00,562,0,488,74,0,562
2019/02,117,11/02/2019,1,SS 63 tra Collagna e Sassalbo (Passo del Cerreto),432,00,404,28,376,56,432,0
2019/02,117,12/02/2019,2,SS 63 tra Collagna e Sassalbo (Passo del Cerreto),449,00,414,35,403,46,449,0
2019/02,117,13/02/2019,3,SS 63 tra Collagna e Sassalbo (Passo del Cerreto),539,00,509,30,482,57,539,0
2019/02,117,14/02/2019,4,SS 63 tra Collagna e Sassalbo (Passo del Cerreto),579,00,546,33,515,64,579,0
2019/02,118,01/02/2019,5,SS 45 tra Ottone e Gorreto,277,00,251,26,210,67,277,0
2019/02,118,02/02/2019,6,SS 45 tra Ottone e Gorreto,344,10,326,17,288,56,0,344
2019/02,118,03/02/2019,7,SS 45 tra Ottone e Gorreto,392,00,383,9,320,72,0,392
2019/02,118,04/02/2019,1,SS 45 tra Ottone e Gorreto,341,10,324,16,279,62,341,0
2019/02,118,09/02/2019,6,SS 45 tra Ottone e Gorreto,410,00,393,17,313,97,0,410
2019/02,118,10/02/2019,7,SS 45 tra Ottone e Gorreto,405,00,402,3,348,57,0,405
2019/02,122,01/02/2019,5,SP 10R tra Piacenza (ponte fiume Trebbia) e San Nicolo',23099,60,22207,886,17135,5964,23099,0
2019/02,122,02/02/2019,6,SP 10R tra Piacenza (ponte fiume Trebbia) e San Nicolo',24628,00,24314,314,17434,7194,0,24628
2019/02,122,03/02/2019,7,SP 10R tra Piacenza (ponte fiume Trebbia) e San Nicolo',17062,10,17001,60,11857,5205,0,17062
2019/02,122,04/02/2019,1,SP 10R tra Piacenza (ponte fiume Trebbia) e San Nicolo',26786,130,25654,1119,20638,6148,26786,0
2019/02,122,05/02/2019,2,SP 10R tra Piacenza (ponte fiume Trebbia) e San Nicolo',25988,100,24918,1060,20212,5776,25988,0
2019/02,122,06/02/2019,3,SP 10R tra Piacenza (ponte fiume Trebbia) e San Nicolo',27312,90,26129,1174,20707,6605,27312,0
2019/02,122,07/02/2019,4,SP 10R tra Piacenza (ponte fiume Trebbia) e San Nicolo',26645,120,25470,1163,20612,6033,26645,0
2019/02,122,08/02/2019,5,SP 10R tra Piacenza (ponte fiume Trebbia) e San Nicolo',28479,100,27286,1183,21147,7332,28479,0
2019/02,122,09/02/2019,6,SP 10R tra Piacenza (ponte fiume Trebbia) e San Nicolo',25261,20,24912,347,17793,7468,0,25261
2019/02,122,10/02/2019,7,SP 10R tra Piacenza (ponte fiume Trebbia) e San Nicolo',19081,30,19011,67,13003,6078,0,19081
2019/02,122,11/02/2019,1,SP 10R tra Piacenza (ponte fiume Trebbia) e San Nicolo',26280,80,25109,1163,20365,5915,26280,0
2019/02,122,12/02/2019,2,SP 10R tra Piacenza (ponte fiume Trebbia) e San Nicolo',26801,50,25608,1188,20626,6175,26801,0
2019/02,122,13/02/2019,3,SP 10R tra Piacenza (ponte fiume Trebbia) e San Nicolo',26982,70,25885,1090,20693,6289,26982,0
2019/02,122,14/02/2019,4,SP 10R tra Piacenza (ponte fiume Trebbia) e San Nicolo',28162,100,27020,1132,21094,7068,28162,0
2019/02,123,01/02/2019,5,SP 28 tra Piacenza (Tangenziale Sud) e Gossolengo,13804,00,13513,291,10610,3194,13804,0
2019/02,123,02/02/2019,6,SP 28 tra Piacenza (Tangenziale Sud) e Gossolengo,14593,00,14417,176,11407,3186,0,14593
2019/02,123,03/02/2019,7,SP 28 tra Piacenza (Tangenziale Sud) e Gossolengo,10096,00,10056,40,7621,2475,0,10096
2019/02,123,04/02/2019,1,SP 28 tra Piacenza (Tangenziale Sud) e Gossolengo,16374,00,15930,444,13185,3189,16374,0
2019/02,123,05/02/2019,2,SP 28 tra Piacenza (Tangenziale Sud) e Gossolengo,16310,00,15871,439,13025,3285,16310,0
2019/02,123,06/02/2019,3,SP 28 tra Piacenza (Tangenziale Sud) e Gossolengo,16483,00,16040,443,13129,3354,16483,0
2019/02,123,07/02/2019,4,SP 28 tra Piacenza (Tangenziale Sud) e Gossolengo,16356,00,15911,445,13051,3305,16356,0
2019/02,123,08/02/2019,5,SP 28 tra Piacenza (Tangenziale Sud) e Gossolengo,17540,00,17077,463,13700,3840,17540,0
2019/02,123,09/02/2019,6,SP 28 tra Piacenza (Tangenziale Sud) e Gossolengo,15858,10,15678,179,12355,3503,0,15858
2019/02,123,10/02/2019,7,SP 28 tra Piacenza (Tangenziale Sud) e Gossolengo,10665,00,10627,38,7932,2733,0,10665
2019/02,123,11/02/2019,1,SP 28 tra Piacenza (Tangenziale Sud) e Gossolengo,16285,10,15811,473,13110,3175,16285,0
2019/02,123,12/02/2019,2,SP 28 tra Piacenza (Tangenziale Sud) e Gossolengo,16938,00,16461,477,13644,3294,16938,0
2019/02,123,13/02/2019,3,SP 28 tra Piacenza (Tangenziale Sud) e Gossolengo,17072,00,16567,505,13711,3361,17072,0
2019/02,123,14/02/2019,4,SP 28 tra Piacenza (Tangenziale Sud) e Gossolengo,17409,00,16921,488,13787,3622,17409,0
2019/02,124,01/02/2019,5,SS 45 tra Piacenza e Settima,14038,00,13443,595,10619,3419,14038,0
2019/02,124,02/02/2019,6,SS 45 tra Piacenza e Settima,13874,00,13714,160,10112,3762,0,13874
2019/02,124,03/02/2019,7,SS 45 tra Piacenza e Settima,10921,10,10870,50,7974,2947,0,10921
2019/02,124,04/02/2019,1,SS 45 tra Piacenza e Settima,16352,20,15396,954,13010,3342,16352,0
2019/02,124,05/02/2019,2,SS 45 tra Piacenza e Settima,15536,00,14652,884,12333,3203,15536,0
2019/02,124,06/02/2019,3,SS 45 tra Piacenza e Settima,16512,00,15616,896,12940,3572,16512,0
2019/02,124,07/02/2019,4,SS 45 tra Piacenza e Settima,15576,00,14682,894,12267,3309,15576,0
2019/02,124,08/02/2019,5,SS 45 tra Piacenza e Settima,17453,10,16457,995,13397,4056,17453,0
2019/02,124,09/02/2019,6,SS 45 tra Piacenza e Settima,15852,00,15638,214,11484,4368,0,15852
2019/02,124,10/02/2019,7,SS 45 tra Piacenza e Settima,11803,00,11765,38,8601,3202,0,11803
2019/02,124,11/02/2019,1,SS 45 tra Piacenza e Settima,16092,10,15470,621,12659,3433,16092,0
2019/02,124,12/02/2019,2,SS 45 tra Piacenza e Settima,16224,00,15473,751,12824,3400,16224,0
2019/02,124,13/02/2019,3,SS 45 tra Piacenza e Settima,14330,00,13696,634,11839,2491,14330,0
2019/02,124,14/02/2019,4,SS 45 tra Piacenza e Settima,17292,00,16602,690,13222,4070,17292,0
2019/02,126,01/02/2019,5,SP 6 tra Piacenza (Tangenziale Sud) e bivio SP 42/ponte fiume Nure in località San Giorgio Piacentino,13379,10,12878,500,10258,3121,13379,0
2019/02,126,02/02/2019,6,SP 6 tra Piacenza (Tangenziale Sud) e bivio SP 42/ponte fiume Nure in località San Giorgio Piacentino,13696,10,13473,222,10247,3449,0,13696
2019/02,126,03/02/2019,7,SP 6 tra Piacenza (Tangenziale Sud) e bivio SP 42/ponte fiume Nure in località San Giorgio Piacentino,10263,00,10212,51,7375,2888,0,10263
2019/02,126,04/02/2019,1,SP 6 tra Piacenza (Tangenziale Sud) e bivio SP 42/ponte fiume Nure in località San Giorgio Piacentino,15173,00,14578,595,12166,3007,15173,0
2019/02,126,05/02/2019,2,SP 6 tra Piacenza (Tangenziale Sud) e bivio SP 42/ponte fiume Nure in località San Giorgio Piacentino,15672,00,14990,682,12448,3224,15672,0
2019/02,126,06/02/2019,3,SP 6 tra Piacenza (Tangenziale Sud) e bivio SP 42/ponte fiume Nure in località San Giorgio Piacentino,15826,00,15190,636,12448,3378,15826,0
2019/02,126,07/02/2019,4,SP 6 tra Piacenza (Tangenziale Sud) e bivio SP 42/ponte fiume Nure in località San Giorgio Piacentino,15864,10,15229,634,12492,3372,15864,0
2019/02,126,08/02/2019,5,SP 6 tra Piacenza (Tangenziale Sud) e bivio SP 42/ponte fiume Nure in località San Giorgio Piacentino,16622,10,15975,646,12661,3961,16622,0
2019/02,126,09/02/2019,6,SP 6 tra Piacenza (Tangenziale Sud) e bivio SP 42/ponte fiume Nure in località San Giorgio Piacentino,14886,10,14653,232,10977,3909,0,14886
2019/02,126,10/02/2019,7,SP 6 tra Piacenza (Tangenziale Sud) e bivio SP 42/ponte fiume Nure in località San Giorgio Piacentino,11320,00,11274,46,8247,3073,0,11320
2019/02,126,11/02/2019,1,SP 6 tra Piacenza (Tangenziale Sud) e bivio SP 42/ponte fiume Nure in località San Giorgio Piacentino,15572,00,14917,655,12409,3163,15572,0
2019/02,126,12/02/2019,2,SP 6 tra Piacenza (Tangenziale Sud) e bivio SP 42/ponte fiume Nure in località San Giorgio Piacentino,15838,20,15156,680,12451,3387,15838,0
2019/02,126,13/02/2019,3,SP 6 tra Piacenza (Tangenziale Sud) e bivio SP 42/ponte fiume Nure in località San Giorgio Piacentino,16284,00,15638,646,12779,3505,16284,0
2019/02,126,14/02/2019,4,SP 6 tra Piacenza (Tangenziale Sud) e bivio SP 42/ponte fiume Nure in località San Giorgio Piacentino,16851,10,16165,685,13058,3793,16851,0
2019/02,127,01/02/2019,5,SS 9 tra Piacenza e Pontenure,21407,10,19866,1540,16305,5102,21407,0
2019/02,127,02/02/2019,6,SS 9 tra Piacenza e Pontenure,19398,00,18887,511,14327,5071,0,19398
2019/02,127,03/02/2019,7,SS 9 tra Piacenza e Pontenure,14374,00,14262,112,10181,4193,0,14374
2019/02,127,04/02/2019,1,SS 9 tra Piacenza e Pontenure,24409,10,22720,1688,19525,4884,24409,0
2019/02,127,05/02/2019,2,SS 9 tra Piacenza e Pontenure,24329,00,22482,1847,19351,4978,24329,0
2019/02,127,06/02/2019,3,SS 9 tra Piacenza e Pontenure,24577,10,22754,1822,19394,5183,24577,0
2019/02,127,07/02/2019,4,SS 9 tra Piacenza e Pontenure,24382,20,22588,1792,19275,5107,24382,0
2019/02,127,08/02/2019,5,SS 9 tra Piacenza e Pontenure,25493,00,23655,1838,19657,5836,25493,0
2019/02,127,09/02/2019,6,SS 9 tra Piacenza e Pontenure,20721,10,20171,549,14942,5779,0,20721
2019/02,127,10/02/2019,7,SS 9 tra Piacenza e Pontenure,16343,00,16235,108,11895,4448,0,16343
2019/02,127,11/02/2019,1,SS 9 tra Piacenza e Pontenure,24253,00,22459,1794,19335,4918,24253,0
2019/02,127,12/02/2019,2,SS 9 tra Piacenza e Pontenure,24543,00,22701,1842,19504,5039,24543,0
2019/02,127,13/02/2019,3,SS 9 tra Piacenza e Pontenure,24764,10,22965,1798,19299,5465,24764,0
2019/02,127,14/02/2019,4,SS 9 tra Piacenza e Pontenure,25361,20,23522,1837,19700,5661,25361,0
2019/02,128,01/02/2019,5,SP 10R tra Piacenza (Casello A 1/A 21) e il bivio SP 10R e SP 587R,14594,00,13025,1569,10899,3695,14594,0
2019/02,128,02/02/2019,6,SP 10R tra Piacenza (Casello A 1/A 21) e il bivio SP 10R e SP 587R,12132,00,11731,401,8724,3408,0,12132
2019/02,128,03/02/2019,7,SP 10R tra Piacenza (Casello A 1/A 21) e il bivio SP 10R e SP 587R,10025,00,9955,70,7091,2934,0,10025
2019/02,128,04/02/2019,1,SP 10R tra Piacenza (Casello A 1/A 21) e il bivio SP 10R e SP 587R,16010,00,14171,1839,12421,3589,16010,0
2019/02,128,05/02/2019,2,SP 10R tra Piacenza (Casello A 1/A 21) e il bivio SP 10R e SP 587R,17112,00,15105,2007,13449,3663,17112,0
2019/02,128,06/02/2019,3,SP 10R tra Piacenza (Casello A 1/A 21) e il bivio SP 10R e SP 587R,17567,00,15555,2012,13771,3796,17567,0
2019/02,128,07/02/2019,4,SP 10R tra Piacenza (Casello A 1/A 21) e il bivio SP 10R e SP 587R,17615,00,15522,2093,13722,3893,17615,0
2019/02,128,08/02/2019,5,SP 10R tra Piacenza (Casello A 1/A 21) e il bivio SP 10R e SP 587R,18064,00,16229,1835,13660,4404,18064,0
2019/02,128,09/02/2019,6,SP 10R tra Piacenza (Casello A 1/A 21) e il bivio SP 10R e SP 587R,13776,00,13355,421,9651,4125,0,13776
2019/02,128,10/02/2019,7,SP 10R tra Piacenza (Casello A 1/A 21) e il bivio SP 10R e SP 587R,10238,00,10176,62,7108,3130,0,10238
2019/02,128,11/02/2019,1,SP 10R tra Piacenza (Casello A 1/A 21) e il bivio SP 10R e SP 587R,17270,00,15364,1906,13631,3639,17270,0
2019/02,128,12/02/2019,2,SP 10R tra Piacenza (Casello A 1/A 21) e il bivio SP 10R e SP 587R,17623,00,15477,2146,13752,3871,17623,0
2019/02,128,13/02/2019,3,SP 10R tra Piacenza (Casello A 1/A 21) e il bivio SP 10R e SP 587R,18063,00,15973,2090,14040,4023,18063,0
2019/02,128,14/02/2019,4,SP 10R tra Piacenza (Casello A 1/A 21) e il bivio SP 10R e SP 587R,18138,00,16012,2126,13840,4298,18138,0
2019/02,129,01/02/2019,5,SS 9Var tra Parma e ponte fiume Taro (Tangenziale nord di Parma),,,,,,,,
2019/02,129,02/02/2019,6,SS 9Var tra Parma e ponte fiume Taro (Tangenziale nord di Parma),,,,,,,,
2019/02,129,03/02/2019,7,SS 9Var tra Parma e ponte fiume Taro (Tangenziale nord di Parma),,,,,,,,
2019/02,129,04/02/2019,1,SS 9Var tra Parma e ponte fiume Taro (Tangenziale nord di Parma),,,,,,,,
2019/02,129,05/02/2019,2,SS 9Var tra Parma e ponte fiume Taro (Tangenziale nord di Parma),,,,,,,,
2019/02,129,06/02/2019,3,SS 9Var tra Parma e ponte fiume Taro (Tangenziale nord di Parma),,,,,,,,
2019/02,129,07/02/2019,4,SS 9Var tra Parma e ponte fiume Taro (Tangenziale nord di Parma),,,,,,,,
2019/02,129,08/02/2019,5,SS 9Var tra Parma e ponte fiume Taro (Tangenziale nord di Parma),,,,,,,,
2019/02,129,09/02/2019,6,SS 9Var tra Parma e ponte fiume Taro (Tangenziale nord di Parma),,,,,,,,
2019/02,129,10/02/2019,7,SS 9Var tra Parma e ponte fiume Taro (Tangenziale nord di Parma),,,,,,,,
2019/02,129,11/02/2019,1,SS 9Var tra Parma e ponte fiume Taro (Tangenziale nord di Parma),,,,,,,,
2019/02,129,12/02/2019,2,SS 9Var tra Parma e ponte fiume Taro (Tangenziale nord di Parma),,,,,,,,
2019/02,129,13/02/2019,3,SS 9Var tra Parma e ponte fiume Taro (Tangenziale nord di Parma),,,,,,,,
2019/02,129,14/02/2019,4,SS 9Var tra Parma e ponte fiume Taro (Tangenziale nord di Parma),,,,,,,,
2019/02,130,01/02/2019,5,SS 62 tra Parma e Collecchio,20667,20,19572,1093,15777,4890,20667,0
2019/02,130,02/02/2019,6,SS 62 tra Parma e Collecchio,17353,00,17083,270,12474,4879,0,17353
2019/02,130,03/02/2019,7,SS 62 tra Parma e Collecchio,13743,00,13677,66,9464,4279,0,13743
2019/02,130,04/02/2019,1,SS 62 tra Parma e Collecchio,21050,00,19788,1262,16480,4570,21050,0
2019/02,130,05/02/2019,2,SS 62 tra Parma e Collecchio,21419,10,20210,1208,16690,4729,21419,0
2019/02,130,06/02/2019,3,SS 62 tra Parma e Collecchio,21950,00,20674,1276,17085,4865,21950,0
2019/02,130,07/02/2019,4,SS 62 tra Parma e Collecchio,21883,10,20625,1257,16811,5072,21883,0
2019/02,130,08/02/2019,5,SS 62 tra Parma e Collecchio,22440,00,21212,1228,17192,5248,22440,0
2019/02,130,09/02/2019,6,SS 62 tra Parma e Collecchio,19647,00,19310,337,14141,5506,0,19647
2019/02,130,10/02/2019,7,SS 62 tra Parma e Collecchio,14032,00,13956,76,9649,4383,0,14032
2019/02,130,11/02/2019,1,SS 62 tra Parma e Collecchio,20996,10,19794,1201,16459,4537,20996,0
2019/02,130,12/02/2019,2,SS 62 tra Parma e Collecchio,21852,00,20505,1347,17074,4778,21852,0
2019/02,130,13/02/2019,3,SS 62 tra Parma e Collecchio,22167,00,20752,1415,17232,4935,22167,0
2019/02,130,14/02/2019,4,SS 62 tra Parma e Collecchio,22832,10,21565,1266,17465,5367,22832,0
2019/02,131,01/02/2019,5,SP 665R tra Parma e Corcagnano,19422,10,18443,978,15145,4277,19422,0
2019/02,131,02/02/2019,6,SP 665R tra Parma e Corcagnano,17401,10,17144,256,12944,4457,0,17401
2019/02,131,03/02/2019,7,SP 665R tra Parma e Corcagnano,13683,00,13611,72,9951,3732,0,13683
2019/02,131,04/02/2019,1,SP 665R tra Parma e Corcagnano,19822,20,18742,1078,15806,4016,19822,0
2019/02,131,05/02/2019,2,SP 665R tra Parma e Corcagnano,20569,10,19525,1043,16426,4143,20569,0
2019/02,131,06/02/2019,3,SP 665R tra Parma e Corcagnano,20914,10,19804,1109,16468,4446,20914,0
2019/02,131,07/02/2019,4,SP 665R tra Parma e Corcagnano,20933,20,19836,1095,16353,4580,20933,0
2019/02,131,08/02/2019,5,SP 665R tra Parma e Corcagnano,21374,10,20209,1164,16465,4909,21374,0
2019/02,131,09/02/2019,6,SP 665R tra Parma e Corcagnano,19293,30,19006,284,14188,5105,0,19293
2019/02,131,10/02/2019,7,SP 665R tra Parma e Corcagnano,13490,10,13415,74,9722,3768,0,13490
2019/02,131,11/02/2019,1,SP 665R tra Parma e Corcagnano,19954,20,18847,1105,16047,3907,19954,0
2019/02,131,12/02/2019,2,SP 665R tra Parma e Corcagnano,20277,00,19159,1118,16060,4217,20277,0
2019/02,131,13/02/2019,3,SP 665R tra Parma e Corcagnano,20992,50,19876,1111,16587,4405,20992,0
2019/02,131,14/02/2019,4,SP 665R tra Parma e Corcagnano,21491,50,20392,1094,16659,4832,21491,0
2019/02,132,01/02/2019,5,SP 513R tra Parma e Pilastrello,19637,00,18886,751,15175,4462,19637,0
2019/02,132,02/02/2019,6,SP 513R tra Parma e Pilastrello,16939,00,16718,221,12741,4198,0,16939
2019/02,132,03/02/2019,7,SP 513R tra Parma e Pilastrello,13493,00,13444,49,9968,3525,0,13493
2019/02,132,04/02/2019,1,SP 513R tra Parma e Pilastrello,19959,00,19090,869,15971,3988,19959,0
2019/02,132,05/02/2019,2,SP 513R tra Parma e Pilastrello,20703,00,19798,905,16505,4198,20703,0
2019/02,132,06/02/2019,3,SP 513R tra Parma e Pilastrello,21165,10,20165,999,16671,4494,21165,0
2019/02,132,07/02/2019,4,SP 513R tra Parma e Pilastrello,20909,00,19940,969,16442,4467,20909,0
2019/02,132,08/02/2019,5,SP 513R tra Parma e Pilastrello,21221,00,20288,933,16415,4806,21221,0
2019/02,132,09/02/2019,6,SP 513R tra Parma e Pilastrello,18291,00,18002,289,13437,4854,0,18291
2019/02,132,10/02/2019,7,SP 513R tra Parma e Pilastrello,13600,00,13538,62,9977,3623,0,13600
2019/02,132,11/02/2019,1,SP 513R tra Parma e Pilastrello,20058,00,19134,924,16148,3910,20058,0
2019/02,132,12/02/2019,2,SP 513R tra Parma e Pilastrello,21511,00,20511,1000,17282,4229,21511,0
2019/02,132,13/02/2019,3,SP 513R tra Parma e Pilastrello,21316,30,20335,978,16836,4480,21316,0
2019/02,132,14/02/2019,4,SP 513R tra Parma e Pilastrello,21839,00,20945,894,17058,4781,21839,0
2019/02,133,01/02/2019,5,SP 62R tra Parma (viadotto A 1) e Sorbolo,18454,10,16533,1920,14011,4443,18454,0
2019/02,133,02/02/2019,6,SP 62R tra Parma (viadotto A 1) e Sorbolo,16581,10,16110,470,11970,4611,0,16581
2019/02,133,03/02/2019,7,SP 62R tra Parma (viadotto A 1) e Sorbolo,14373,10,14261,111,10214,4159,0,14373
2019/02,133,04/02/2019,1,SP 62R tra Parma (viadotto A 1) e Sorbolo,18187,20,16177,2008,14154,4033,18187,0
2019/02,133,05/02/2019,2,SP 62R tra Parma (viadotto A 1) e Sorbolo,18883,10,16748,2134,14632,4251,18883,0
2019/02,133,06/02/2019,3,SP 62R tra Parma (viadotto A 1) e Sorbolo,19001,00,16743,2258,14528,4473,19001,0
2019/02,133,07/02/2019,4,SP 62R tra Parma (viadotto A 1) e Sorbolo,19049,00,16757,2292,14581,4468,19049,0
2019/02,133,08/02/2019,5,SP 62R tra Parma (viadotto A 1) e Sorbolo,19794,00,17616,2178,14830,4964,19794,0
2019/02,133,09/02/2019,6,SP 62R tra Parma (viadotto A 1) e Sorbolo,17906,30,17442,461,12634,5272,0,17906
2019/02,133,10/02/2019,7,SP 62R tra Parma (viadotto A 1) e Sorbolo,14383,00,14264,119,9970,4413,0,14383
2019/02,133,11/02/2019,1,SP 62R tra Parma (viadotto A 1) e Sorbolo,18741,50,16545,2191,14604,4137,18741,0
2019/02,133,12/02/2019,2,SP 62R tra Parma (viadotto A 1) e Sorbolo,18902,10,16681,2220,14642,4260,18902,0
2019/02,133,13/02/2019,3,SP 62R tra Parma (viadotto A 1) e Sorbolo,19018,20,16684,2332,14535,4483,19018,0
2019/02,133,14/02/2019,4,SP 62R tra Parma (viadotto A 1) e Sorbolo,20125,10,17833,2291,15206,4919,20125,0
2019/02,134,01/02/2019,5,SP 343R tra Parma e San Polo,18187,00,16075,2112,14056,4131,18187,0
2019/02,134,02/02/2019,6,SP 343R tra Parma e San Polo,13081,00,12632,449,9608,3473,0,13081
2019/02,134,03/02/2019,7,SP 343R tra Parma e San Polo,9340,00,9218,122,6444,2896,0,9340
2019/02,134,04/02/2019,1,SP 343R tra Parma e San Polo,17823,00,15579,2244,13972,3851,17823,0
2019/02,134,05/02/2019,2,SP 343R tra Parma e San Polo,18448,00,16036,2412,14363,4085,18448,0
2019/02,134,06/02/2019,3,SP 343R tra Parma e San Polo,18512,10,16175,2336,14236,4276,18512,0
2019/02,134,07/02/2019,4,SP 343R tra Parma e San Polo,18837,00,16398,2439,14586,4251,18837,0
2019/02,134,08/02/2019,5,SP 343R tra Parma e San Polo,18795,10,16434,2360,14393,4402,18795,0
2019/02,134,09/02/2019,6,SP 343R tra Parma e San Polo,13707,00,13174,533,9817,3890,0,13707
2019/02,134,10/02/2019,7,SP 343R tra Parma e San Polo,10008,00,9884,124,7236,2772,0,10008
2019/02,134,11/02/2019,1,SP 343R tra Parma e San Polo,17694,00,15483,2211,13828,3866,17694,0
2019/02,134,12/02/2019,2,SP 343R tra Parma e San Polo,18508,00,16091,2417,14419,4089,18508,0
2019/02,134,13/02/2019,3,SP 343R tra Parma e San Polo,18871,00,16481,2390,14687,4184,18871,0
2019/02,134,14/02/2019,4,SP 343R tra Parma e San Polo,19125,10,16767,2357,14679,4446,19125,0
2019/02,135,01/02/2019,5,SP 10 tra Parma (Tangenziale) e Viarolo,,,,,,,,
2019/02,135,02/02/2019,6,SP 10 tra Parma (Tangenziale) e Viarolo,,,,,,,,
2019/02,135,03/02/2019,7,SP 10 tra Parma (Tangenziale) e Viarolo,,,,,,,,
2019/02,135,04/02/2019,1,SP 10 tra Parma (Tangenziale) e Viarolo,,,,,,,,
2019/02,135,05/02/2019,2,SP 10 tra Parma (Tangenziale) e Viarolo,,,,,,,,
2019/02,135,06/02/2019,3,SP 10 tra Parma (Tangenziale) e Viarolo,,,,,,,,
2019/02,135,07/02/2019,4,SP 10 tra Parma (Tangenziale) e Viarolo,,,,,,,,
2019/02,135,08/02/2019,5,SP 10 tra Parma (Tangenziale) e Viarolo,,,,,,,,
2019/02,135,09/02/2019,6,SP 10 tra Parma (Tangenziale) e Viarolo,,,,,,,,
2019/02,135,10/02/2019,7,SP 10 tra Parma (Tangenziale) e Viarolo,,,,,,,,
2019/02,135,11/02/2019,1,SP 10 tra Parma (Tangenziale) e Viarolo,,,,,,,,
2019/02,135,12/02/2019,2,SP 10 tra Parma (Tangenziale) e Viarolo,,,,,,,,
2019/02,135,13/02/2019,3,SP 10 tra Parma (Tangenziale) e Viarolo,,,,,,,,
2019/02,135,14/02/2019,4,SP 10 tra Parma (Tangenziale) e Viarolo,,,,,,,,
2019/02,138,01/02/2019,5,SS 63 tra Reggio Emilia e Puianello,11477,10,11161,315,8570,2907,11477,0
2019/02,138,02/02/2019,6,SS 63 tra Reggio Emilia e Puianello,11306,00,11158,148,8242,3064,0,11306
2019/02,138,03/02/2019,7,SS 63 tra Reggio Emilia e Puianello,9135,00,9094,41,6649,2486,0,9135
2019/02,138,04/02/2019,1,SS 63 tra Reggio Emilia e Puianello,11401,30,11037,361,8812,2589,11401,0
2019/02,138,05/02/2019,2,SS 63 tra Reggio Emilia e Puianello,11839,30,11426,410,9132,2707,11839,0
2019/02,138,06/02/2019,3,SS 63 tra Reggio Emilia e Puianello,12052,00,11641,411,9128,2924,12052,0
2019/02,138,07/02/2019,4,SS 63 tra Reggio Emilia e Puianello,11994,10,11570,423,9028,2966,11994,0
2019/02,138,08/02/2019,5,SS 63 tra Reggio Emilia e Puianello,12642,00,12215,427,9291,3351,12642,0
2019/02,138,09/02/2019,6,SS 63 tra Reggio Emilia e Puianello,12592,00,12432,160,9119,3473,0,12592
2019/02,138,10/02/2019,7,SS 63 tra Reggio Emilia e Puianello,9862,00,9820,42,7085,2777,0,9862
2019/02,138,11/02/2019,1,SS 63 tra Reggio Emilia e Puianello,11448,10,11057,390,8848,2600,11448,0
2019/02,138,12/02/2019,2,SS 63 tra Reggio Emilia e Puianello,11960,10,11529,430,9155,2805,11960,0
2019/02,138,13/02/2019,3,SS 63 tra Reggio Emilia e Puianello,12389,20,11968,419,9314,3075,12389,0
2019/02,138,14/02/2019,4,SS 63 tra Reggio Emilia e Puianello,12601,00,12155,446,9233,3368,12601,0
2019/02,139,01/02/2019,5,SP 467R tra Fogliano e località Pratissolo (c/o Scandiano),17589,00,16983,606,13792,3797,17589,0
2019/02,139,02/02/2019,6,SP 467R tra Fogliano e località Pratissolo (c/o Scandiano),13952,00,13820,132,10116,3836,0,13952
2019/02,139,03/02/2019,7,SP 467R tra Fogliano e località Pratissolo (c/o Scandiano),10238,00,10192,46,7091,3147,0,10238
2019/02,139,04/02/2019,1,SP 467R tra Fogliano e località Pratissolo (c/o Scandiano),17272,00,16641,631,13922,3350,17272,0
2019/02,139,05/02/2019,2,SP 467R tra Fogliano e località Pratissolo (c/o Scandiano),17734,00,17038,696,14328,3406,17734,0
2019/02,139,06/02/2019,3,SP 467R tra Fogliano e località Pratissolo (c/o Scandiano),17844,00,17104,740,14210,3634,17844,0
2019/02,139,07/02/2019,4,SP 467R tra Fogliano e località Pratissolo (c/o Scandiano),17554,00,16841,713,13761,3793,17554,0
2019/02,139,08/02/2019,5,SP 467R tra Fogliano e località Pratissolo (c/o Scandiano),18140,00,17455,685,14118,4022,18140,0
2019/02,139,09/02/2019,6,SP 467R tra Fogliano e località Pratissolo (c/o Scandiano),14838,00,14686,152,10605,4233,0,14838
2019/02,139,10/02/2019,7,SP 467R tra Fogliano e località Pratissolo (c/o Scandiano),11307,00,11254,53,7737,3570,0,11307
2019/02,139,11/02/2019,1,SP 467R tra Fogliano e località Pratissolo (c/o Scandiano),17344,00,16705,639,13981,3363,17344,0
2019/02,139,12/02/2019,2,SP 467R tra Fogliano e località Pratissolo (c/o Scandiano),17633,00,16873,760,14169,3464,17633,0
2019/02,139,13/02/2019,3,SP 467R tra Fogliano e località Pratissolo (c/o Scandiano),18475,00,17743,732,14653,3822,18475,0
2019/02,139,14/02/2019,4,SP 467R tra Fogliano e località Pratissolo (c/o Scandiano),18675,00,17965,710,14647,4028,18675,0
2019/02,140,01/02/2019,5,SS 9 tra Masone e Rubiera,25094,00,22699,2395,18363,6731,25094,0
2019/02,140,02/02/2019,6,SS 9 tra Masone e Rubiera,23430,00,22899,531,16069,7361,0,23430
2019/02,140,03/02/2019,7,SS 9 tra Masone e Rubiera,19666,00,19522,144,13313,6353,0,19666
2019/02,140,04/02/2019,1,SS 9 tra Masone e Rubiera,24864,20,22281,2581,18765,6099,24864,0
2019/02,140,05/02/2019,2,SS 9 tra Masone e Rubiera,25338,10,22456,2881,19154,6184,25338,0
2019/02,140,06/02/2019,3,SS 9 tra Masone e Rubiera,25542,20,22640,2900,19042,6500,25542,0
2019/02,140,07/02/2019,4,SS 9 tra Masone e Rubiera,26086,10,22991,3094,19575,6511,26086,0
2019/02,140,08/02/2019,5,SS 9 tra Masone e Rubiera,26949,10,24108,2840,19430,7519,26949,0
2019/02,140,09/02/2019,6,SS 9 tra Masone e Rubiera,24421,20,23837,582,16426,7995,0,24421
2019/02,140,10/02/2019,7,SS 9 tra Masone e Rubiera,22974,00,22809,165,15200,7774,0,22974
2019/02,140,11/02/2019,1,SS 9 tra Masone e Rubiera,24754,00,22230,2524,18700,6054,24754,0
2019/02,140,12/02/2019,2,SS 9 tra Masone e Rubiera,25326,20,22633,2691,19083,6243,25326,0
2019/02,140,13/02/2019,3,SS 9 tra Masone e Rubiera,25934,00,23021,2913,19419,6515,25934,0
2019/02,140,14/02/2019,4,SS 9 tra Masone e Rubiera,26663,10,23836,2826,19428,7235,26663,0
2019/02,143,01/02/2019,5,SP 63R tra Sesso e Cadelbosco di Sopra (bivio SP 358R),24627,00,23342,1285,19173,5454,24627,0
2019/02,143,02/02/2019,6,SP 63R tra Sesso e Cadelbosco di Sopra (bivio SP 358R),21016,00,20686,330,15165,5851,0,21016
2019/02,143,03/02/2019,7,SP 63R tra Sesso e Cadelbosco di Sopra (bivio SP 358R),15699,00,15634,65,11016,4683,0,15699
2019/02,143,04/02/2019,1,SP 63R tra Sesso e Cadelbosco di Sopra (bivio SP 358R),24569,00,23191,1378,19520,5049,24569,0
2019/02,143,05/02/2019,2,SP 63R tra Sesso e Cadelbosco di Sopra (bivio SP 358R),25012,00,23639,1373,19883,5129,25012,0
2019/02,143,06/02/2019,3,SP 63R tra Sesso e Cadelbosco di Sopra (bivio SP 358R),25378,00,23983,1395,19809,5569,25378,0
2019/02,143,07/02/2019,4,SP 63R tra Sesso e Cadelbosco di Sopra (bivio SP 358R),24924,00,23538,1386,19577,5347,24924,0
2019/02,143,08/02/2019,5,SP 63R tra Sesso e Cadelbosco di Sopra (bivio SP 358R),26097,10,24641,1455,20042,6055,26097,0
2019/02,143,09/02/2019,6,SP 63R tra Sesso e Cadelbosco di Sopra (bivio SP 358R),22427,00,22074,353,15924,6503,0,22427
2019/02,143,10/02/2019,7,SP 63R tra Sesso e Cadelbosco di Sopra (bivio SP 358R),16747,00,16657,90,11553,5194,0,16747
2019/02,143,11/02/2019,1,SP 63R tra Sesso e Cadelbosco di Sopra (bivio SP 358R),24781,00,23356,1425,19745,5036,24781,0
2019/02,143,12/02/2019,2,SP 63R tra Sesso e Cadelbosco di Sopra (bivio SP 358R),25299,00,23938,1361,20008,5291,25299,0
2019/02,143,13/02/2019,3,SP 63R tra Sesso e Cadelbosco di Sopra (bivio SP 358R),25774,00,24390,1384,20160,5614,25774,0
2019/02,143,14/02/2019,4,SP 63R tra Sesso e Cadelbosco di Sopra (bivio SP 358R),26479,10,25041,1437,20344,6135,26479,0
2019/02,146,01/02/2019,5,SS 12 tra Montale e Modena,18615,20,17470,1143,14213,4402,18615,0
2019/02,146,02/02/2019,6,SS 12 tra Montale e Modena,15936,10,15695,240,11262,4674,0,15936
2019/02,146,03/02/2019,7,SS 12 tra Montale e Modena,14315,20,14237,76,10187,4128,0,14315
2019/02,146,04/02/2019,1,SS 12 tra Montale e Modena,20661,10,19354,1306,16158,4503,20661,0
2019/02,146,05/02/2019,2,SS 12 tra Montale e Modena,21338,30,20042,1293,16777,4561,21338,0
2019/02,146,06/02/2019,3,SS 12 tra Montale e Modena,21686,30,20406,1277,16806,4880,21686,0
2019/02,146,07/02/2019,4,SS 12 tra Montale e Modena,21712,30,20401,1308,16639,5073,21712,0
2019/02,146,08/02/2019,5,SS 12 tra Montale e Modena,22503,40,21206,1293,16939,5564,22503,0
2019/02,146,09/02/2019,6,SS 12 tra Montale e Modena,18992,30,18677,312,13428,5564,0,18992
2019/02,146,10/02/2019,7,SS 12 tra Montale e Modena,14959,00,14889,70,10729,4230,0,14959
2019/02,146,11/02/2019,1,SS 12 tra Montale e Modena,20421,20,19118,1301,15859,4562,20421,0
2019/02,146,12/02/2019,2,SS 12 tra Montale e Modena,21398,20,20080,1316,16682,4716,21398,0
2019/02,146,13/02/2019,3,SS 12 tra Montale e Modena,21740,20,20446,1292,16702,5038,21740,0
2019/02,146,14/02/2019,4,SS 12 tra Montale e Modena,22558,10,21241,1316,16941,5617,22558,0
2019/02,147,01/02/2019,5,SP 623 tra Modena Sud/casello A 1 e Spilamberto,17782,00,15092,2690,13457,4325,17782,0
2019/02,147,02/02/2019,6,SP 623 tra Modena Sud/casello A 1 e Spilamberto,19011,00,18481,530,13756,5255,0,19011
2019/02,147,03/02/2019,7,SP 623 tra Modena Sud/casello A 1 e Spilamberto,12551,00,12367,184,8623,3928,0,12551
2019/02,147,04/02/2019,1,SP 623 tra Modena Sud/casello A 1 e Spilamberto,18774,20,15761,3011,14578,4196,18774,0
2019/02,147,05/02/2019,2,SP 623 tra Modena Sud/casello A 1 e Spilamberto,19169,00,15988,3181,14957,4212,19169,0
2019/02,147,06/02/2019,3,SP 623 tra Modena Sud/casello A 1 e Spilamberto,19685,30,16492,3190,15116,4569,19685,0
2019/02,147,07/02/2019,4,SP 623 tra Modena Sud/casello A 1 e Spilamberto,19896,00,16502,3394,15207,4689,19896,0
2019/02,147,08/02/2019,5,SP 623 tra Modena Sud/casello A 1 e Spilamberto,20162,10,16945,3216,15205,4957,20162,0
2019/02,147,09/02/2019,6,SP 623 tra Modena Sud/casello A 1 e Spilamberto,16357,00,15762,595,11264,5093,0,16357
2019/02,147,10/02/2019,7,SP 623 tra Modena Sud/casello A 1 e Spilamberto,13183,00,13012,171,9445,3738,0,13183
2019/02,147,11/02/2019,1,SP 623 tra Modena Sud/casello A 1 e Spilamberto,18803,00,15591,3212,14551,4252,18803,0
2019/02,147,12/02/2019,2,SP 623 tra Modena Sud/casello A 1 e Spilamberto,19464,00,16099,3365,15171,4293,19464,0
2019/02,147,13/02/2019,3,SP 623 tra Modena Sud/casello A 1 e Spilamberto,19630,10,16323,3306,15100,4530,19630,0
2019/02,147,14/02/2019,4,SP 623 tra Modena Sud/casello A 1 e Spilamberto,20200,00,16906,3294,15183,5017,20200,0
2019/02,149,01/02/2019,5,SP 255 tra Modena e Navicello,33468,300,30601,2837,25719,7749,33468,0
2019/02,149,02/02/2019,6,SP 255 tra Modena e Navicello,32353,10,31788,564,24061,8292,0,32353
2019/02,149,03/02/2019,7,SP 255 tra Modena e Navicello,21361,10,21246,114,14722,6639,0,21361
2019/02,149,04/02/2019,1,SP 255 tra Modena e Navicello,34727,480,31631,3048,27051,7676,34727,0
2019/02,149,05/02/2019,2,SP 255 tra Modena e Navicello,35113,580,31922,3133,27288,7825,35113,0
2019/02,149,06/02/2019,3,SP 255 tra Modena e Navicello,36285,390,33060,3186,27863,8422,36285,0
2019/02,149,07/02/2019,4,SP 255 tra Modena e Navicello,36335,400,33065,3230,28093,8242,36335,0
2019/02,149,08/02/2019,5,SP 255 tra Modena e Navicello,37234,290,34055,3150,28066,9168,37234,0
2019/02,149,09/02/2019,6,SP 255 tra Modena e Navicello,30621,00,30033,588,20908,9713,0,30621
2019/02,149,10/02/2019,7,SP 255 tra Modena e Navicello,21943,00,21809,134,15330,6613,0,21943
2019/02,149,11/02/2019,1,SP 255 tra Modena e Navicello,35238,480,32008,3182,27495,7743,35238,0
2019/02,149,12/02/2019,2,SP 255 tra Modena e Navicello,36085,650,32789,3231,27956,8129,36085,0
2019/02,149,13/02/2019,3,SP 255 tra Modena e Navicello,36630,410,33324,3265,27961,8669,36630,0
2019/02,149,14/02/2019,4,SP 255 tra Modena e Navicello,37706,430,34288,3375,28484,9222,37706,0
2019/02,150,01/02/2019,5,SS 12 tra Modena e Bastiglia,21903,00,20090,1813,16707,5196,21903,0
2019/02,150,02/02/2019,6,SS 12 tra Modena e Bastiglia,16185,00,15811,374,11176,5009,0,16185
2019/02,150,03/02/2019,7,SS 12 tra Modena e Bastiglia,14215,00,14139,76,9606,4609,0,14215
2019/02,150,04/02/2019,1,SS 12 tra Modena e Bastiglia,23665,20,21636,2027,18617,5048,23665,0
2019/02,150,05/02/2019,2,SS 12 tra Modena e Bastiglia,23974,30,21927,2044,18867,5107,23974,0
2019/02,150,06/02/2019,3,SS 12 tra Modena e Bastiglia,24242,10,22232,2009,18973,5269,24242,0
2019/02,150,07/02/2019,4,SS 12 tra Modena e Bastiglia,24446,20,22436,2008,19230,5216,24446,0
2019/02,150,08/02/2019,5,SS 12 tra Modena e Bastiglia,25425,00,23422,2003,19308,6117,25425,0
2019/02,150,09/02/2019,6,SS 12 tra Modena e Bastiglia,19912,00,19541,371,13550,6362,0,19912
2019/02,150,10/02/2019,7,SS 12 tra Modena e Bastiglia,15995,00,15935,60,10894,5101,0,15995
2019/02,150,11/02/2019,1,SS 12 tra Modena e Bastiglia,23730,10,21766,1963,18813,4917,23730,0
2019/02,150,12/02/2019,2,SS 12 tra Modena e Bastiglia,24305,30,22313,1989,19196,5109,24305,0
2019/02,150,13/02/2019,3,SS 12 tra Modena e Bastiglia,25040,00,23027,2013,19403,5637,25040,0
2019/02,150,14/02/2019,4,SS 12 tra Modena e Bastiglia,25540,10,23467,2072,19441,6099,25540,0
2019/02,153,01/02/2019,5,Via Porrettana (ex SS 64) tra Bologna e Pontecchio Marconi,11209,00,10977,232,8397,2812,11209,0
2019/02,153,02/02/2019,6,Via Porrettana (ex SS 64) tra Bologna e Pontecchio Marconi,10451,00,10355,96,7734,2717,0,10451
2019/02,153,04/02/2019,1,Via Porrettana (ex SS 64) tra Bologna e Pontecchio Marconi,11240,00,10980,260,8758,2482,11240,0
2019/02,153,05/02/2019,2,Via Porrettana (ex SS 64) tra Bologna e Pontecchio Marconi,10674,00,10402,272,8473,2201,10674,0
2019/02,153,06/02/2019,3,Via Porrettana (ex SS 64) tra Bologna e Pontecchio Marconi,11834,10,11535,298,9159,2675,11834,0
2019/02,153,07/02/2019,4,Via Porrettana (ex SS 64) tra Bologna e Pontecchio Marconi,11607,00,11335,272,9004,2603,11607,0
2019/02,153,08/02/2019,5,Via Porrettana (ex SS 64) tra Bologna e Pontecchio Marconi,12392,00,12122,270,9462,2930,12392,0
2019/02,153,09/02/2019,6,Via Porrettana (ex SS 64) tra Bologna e Pontecchio Marconi,11421,00,11309,112,8465,2956,0,11421
2019/02,153,10/02/2019,7,Via Porrettana (ex SS 64) tra Bologna e Pontecchio Marconi,8383,10,8363,19,6172,2211,0,8383
2019/02,153,11/02/2019,1,Via Porrettana (ex SS 64) tra Bologna e Pontecchio Marconi,10114,10,9909,204,8236,1878,10114,0
2019/02,153,13/02/2019,3,Via Porrettana (ex SS 64) tra Bologna e Pontecchio Marconi,11934,00,11668,266,9323,2611,11934,0
2019/02,153,14/02/2019,4,Via Porrettana (ex SS 64) tra Bologna e Pontecchio Marconi,12652,10,12373,278,9555,3097,12652,0
2019/02,154,01/02/2019,5,Tra Rastignano e Pian di Macina (SP85 Fondo Valle Savena),11421,00,11189,232,8817,2604,11421,0
2019/02,154,02/02/2019,6,Tra Rastignano e Pian di Macina (SP85 Fondo Valle Savena),9288,20,9224,62,7117,2171,0,9288
2019/02,154,03/02/2019,7,Tra Rastignano e Pian di Macina (SP85 Fondo Valle Savena),7280,00,7265,15,5490,1790,0,7280
2019/02,154,04/02/2019,1,Tra Rastignano e Pian di Macina (SP85 Fondo Valle Savena),10864,20,10650,212,8600,2264,10864,0
2019/02,154,05/02/2019,2,Tra Rastignano e Pian di Macina (SP85 Fondo Valle Savena),11606,20,11350,254,9225,2381,11606,0
2019/02,154,06/02/2019,3,Tra Rastignano e Pian di Macina (SP85 Fondo Valle Savena),12046,40,11737,305,9483,2563,12046,0
2019/02,154,07/02/2019,4,Tra Rastignano e Pian di Macina (SP85 Fondo Valle Savena),11920,30,11676,241,9375,2545,11920,0
2019/02,154,08/02/2019,5,Tra Rastignano e Pian di Macina (SP85 Fondo Valle Savena),12369,10,12102,266,9728,2641,12369,0
2019/02,154,09/02/2019,6,Tra Rastignano e Pian di Macina (SP85 Fondo Valle Savena),10139,00,10075,64,7713,2426,0,10139
2019/02,154,10/02/2019,7,Tra Rastignano e Pian di Macina (SP85 Fondo Valle Savena),8158,10,8146,11,6177,1981,0,8158
2019/02,154,11/02/2019,1,Tra Rastignano e Pian di Macina (SP85 Fondo Valle Savena),11356,20,11108,246,9015,2341,11356,0
2019/02,154,12/02/2019,2,Tra Rastignano e Pian di Macina (SP85 Fondo Valle Savena),12048,00,11753,295,9513,2535,12048,0
2019/02,154,13/02/2019,3,Tra Rastignano e Pian di Macina (SP85 Fondo Valle Savena),12102,10,11863,238,9466,2636,12102,0
2019/02,154,14/02/2019,4,Tra Rastignano e Pian di Macina (SP85 Fondo Valle Savena),12261,20,12003,256,9535,2726,12261,0
2019/02,155,01/02/2019,5,Via Emilia tra San Lazzaro e Idice,14916,00,14461,455,11552,3364,14916,0
2019/02,155,02/02/2019,6,Via Emilia tra San Lazzaro e Idice,13711,00,13462,249,10188,3523,0,13711
2019/02,155,03/02/2019,7,Via Emilia tra San Lazzaro e Idice,10178,10,10105,72,7331,2847,0,10178
2019/02,155,04/02/2019,1,Via Emilia tra San Lazzaro e Idice,14090,00,13611,479,11253,2837,14090,0
2019/02,155,05/02/2019,2,Via Emilia tra San Lazzaro e Idice,14441,20,13962,477,11407,3034,14441,0
2019/02,155,06/02/2019,3,Via Emilia tra San Lazzaro e Idice,15069,00,14574,495,11818,3251,15069,0
2019/02,155,07/02/2019,4,Via Emilia tra San Lazzaro e Idice,15037,40,14555,478,11892,3145,15037,0
2019/02,155,08/02/2019,5,Via Emilia tra San Lazzaro e Idice,15664,00,15176,488,12148,3516,15664,0
2019/02,155,09/02/2019,6,Via Emilia tra San Lazzaro e Idice,14211,20,13948,261,10559,3652,0,14211
2019/02,155,10/02/2019,7,Via Emilia tra San Lazzaro e Idice,10415,00,10350,65,7504,2911,0,10415
2019/02,155,11/02/2019,1,Via Emilia tra San Lazzaro e Idice,14014,10,13539,474,11146,2868,14014,0
2019/02,155,12/02/2019,2,Via Emilia tra San Lazzaro e Idice,14695,00,14201,494,11528,3167,14695,0
2019/02,155,13/02/2019,3,Via Emilia tra San Lazzaro e Idice,15188,00,14674,514,11984,3204,15188,0
2019/02,155,14/02/2019,4,Via Emilia tra San Lazzaro e Idice,15284,20,14744,538,11866,3418,15284,0
2019/02,156,01/02/2019,5,SP 253 tra la località Villanova e inizio variante Castenaso,21900,10,21285,614,17150,4750,21900,0
2019/02,156,02/02/2019,6,SP 253 tra la località Villanova e inizio variante Castenaso,19010,00,18856,154,14413,4597,0,19010
2019/02,156,03/02/2019,7,SP 253 tra la località Villanova e inizio variante Castenaso,14169,00,14132,37,10561,3608,0,14169
2019/02,156,04/02/2019,1,SP 253 tra la località Villanova e inizio variante Castenaso,20302,10,19623,678,16218,4084,20302,0
2019/02,156,05/02/2019,2,SP 253 tra la località Villanova e inizio variante Castenaso,21217,10,20574,642,16882,4335,21217,0
2019/02,156,06/02/2019,3,SP 253 tra la località Villanova e inizio variante Castenaso,21331,20,20598,731,16935,4396,21331,0
2019/02,156,07/02/2019,4,SP 253 tra la località Villanova e inizio variante Castenaso,21037,20,20329,706,16507,4530,21037,0
2019/02,156,08/02/2019,5,SP 253 tra la località Villanova e inizio variante Castenaso,22047,10,21314,732,17185,4862,22047,0
2019/02,156,09/02/2019,6,SP 253 tra la località Villanova e inizio variante Castenaso,19392,00,19226,166,14561,4831,0,19392
2019/02,156,10/02/2019,7,SP 253 tra la località Villanova e inizio variante Castenaso,13809,00,13778,31,10253,3556,0,13809
2019/02,156,11/02/2019,1,SP 253 tra la località Villanova e inizio variante Castenaso,20721,00,20031,690,16589,4132,20721,0
2019/02,156,12/02/2019,2,SP 253 tra la località Villanova e inizio variante Castenaso,21418,00,20684,734,16901,4517,21418,0
2019/02,156,13/02/2019,3,SP 253 tra la località Villanova e inizio variante Castenaso,21861,00,21134,727,17261,4600,21861,0
2019/02,156,14/02/2019,4,SP 253 tra la località Villanova e inizio variante Castenaso,22316,10,21616,699,17369,4947,22316,0
2019/02,157,01/02/2019,5,Via San Donato (ex SP 5) tra Granarolo dell'Emilia e Quarto Inferiore,11675,00,11412,263,9146,2529,11675,0
2019/02,157,02/02/2019,6,Via San Donato (ex SP 5) tra Granarolo dell'Emilia e Quarto Inferiore,10488,10,10367,120,7859,2629,0,10488
2019/02,157,03/02/2019,7,Via San Donato (ex SP 5) tra Granarolo dell'Emilia e Quarto Inferiore,7993,00,7953,40,5858,2135,0,7993
2019/02,157,04/02/2019,1,Via San Donato (ex SP 5) tra Granarolo dell'Emilia e Quarto Inferiore,11627,00,11320,307,9279,2348,11627,0
2019/02,157,05/02/2019,2,Via San Donato (ex SP 5) tra Granarolo dell'Emilia e Quarto Inferiore,11908,10,11639,268,9431,2477,11908,0
2019/02,157,06/02/2019,3,Via San Donato (ex SP 5) tra Granarolo dell'Emilia e Quarto Inferiore,11733,10,11453,279,9234,2499,11733,0
2019/02,157,07/02/2019,4,Via San Donato (ex SP 5) tra Granarolo dell'Emilia e Quarto Inferiore,11856,00,11566,290,9327,2529,11856,0
2019/02,157,08/02/2019,5,Via San Donato (ex SP 5) tra Granarolo dell'Emilia e Quarto Inferiore,12046,00,11768,278,9277,2769,12046,0
2019/02,157,09/02/2019,6,Via San Donato (ex SP 5) tra Granarolo dell'Emilia e Quarto Inferiore,11095,00,10955,140,8260,2835,0,11095
2019/02,157,10/02/2019,7,Via San Donato (ex SP 5) tra Granarolo dell'Emilia e Quarto Inferiore,9044,00,9002,42,6708,2336,0,9044
2019/02,157,11/02/2019,1,Via San Donato (ex SP 5) tra Granarolo dell'Emilia e Quarto Inferiore,11774,00,11483,291,9349,2425,11774,0
2019/02,157,12/02/2019,2,Via San Donato (ex SP 5) tra Granarolo dell'Emilia e Quarto Inferiore,11561,00,11276,285,9124,2437,11561,0
2019/02,157,13/02/2019,3,Via San Donato (ex SP 5) tra Granarolo dell'Emilia e Quarto Inferiore,12072,00,11786,286,9432,2640,12072,0
2019/02,157,14/02/2019,4,Via San Donato (ex SP 5) tra Granarolo dell'Emilia e Quarto Inferiore,12297,00,11996,301,9602,2695,12297,0
2019/02,158,01/02/2019,5,SS 64 tra Bologna e Lovoleto,11526,00,10854,672,8853,2673,11526,0
2019/02,158,02/02/2019,6,SS 64 tra Bologna e Lovoleto,8433,00,8261,172,6007,2426,0,8433
2019/02,158,03/02/2019,7,SS 64 tra Bologna e Lovoleto,6668,20,6606,60,4709,1959,0,6668
2019/02,158,04/02/2019,1,SS 64 tra Bologna e Lovoleto,11368,10,10688,679,8941,2427,11368,0
2019/02,158,05/02/2019,2,SS 64 tra Bologna e Lovoleto,11642,20,10902,738,9095,2547,11642,0
2019/02,158,06/02/2019,3,SS 64 tra Bologna e Lovoleto,11763,40,11063,696,9089,2674,11763,0
2019/02,158,07/02/2019,4,SS 64 tra Bologna e Lovoleto,11618,10,10916,701,8980,2638,11618,0
2019/02,158,08/02/2019,5,SS 64 tra Bologna e Lovoleto,12071,20,11364,705,9211,2860,12071,0
2019/02,158,09/02/2019,6,SS 64 tra Bologna e Lovoleto,9194,00,9003,191,6573,2621,0,9194
2019/02,158,10/02/2019,7,SS 64 tra Bologna e Lovoleto,7196,00,7137,59,5081,2115,0,7196
2019/02,158,11/02/2019,1,SS 64 tra Bologna e Lovoleto,11795,40,11080,711,9292,2503,11795,0
2019/02,158,12/02/2019,2,SS 64 tra Bologna e Lovoleto,11751,00,11044,707,9109,2642,11751,0
2019/02,158,13/02/2019,3,SS 64 tra Bologna e Lovoleto,12122,10,11423,698,9377,2745,12122,0
2019/02,158,14/02/2019,4,SS 64 tra Bologna e Lovoleto,12162,10,11475,686,9310,2852,12162,0
2019/02,160,01/02/2019,5,SP 18 tra Bargellino e Calderara di Reno (c/o Variante SP18),17885,20,16380,1503,14092,3793,17885,0
2019/02,160,02/02/2019,6,SP 18 tra Bargellino e Calderara di Reno (c/o Variante SP18),12440,00,12032,408,8986,3454,0,12440
2019/02,160,03/02/2019,7,SP 18 tra Bargellino e Calderara di Reno (c/o Variante SP18),9116,00,9036,80,6727,2389,0,9116
2019/02,160,04/02/2019,1,SP 18 tra Bargellino e Calderara di Reno (c/o Variante SP18),17575,30,16182,1390,14185,3390,17575,0
2019/02,160,05/02/2019,2,SP 18 tra Bargellino e Calderara di Reno (c/o Variante SP18),18235,00,16599,1636,14413,3822,18235,0
2019/02,160,06/02/2019,3,SP 18 tra Bargellino e Calderara di Reno (c/o Variante SP18),18239,10,16514,1724,14460,3779,18239,0
2019/02,160,07/02/2019,4,SP 18 tra Bargellino e Calderara di Reno (c/o Variante SP18),18288,10,16592,1695,14398,3890,18288,0
2019/02,160,08/02/2019,5,SP 18 tra Bargellino e Calderara di Reno (c/o Variante SP18),18752,10,17059,1692,14728,4024,18752,0
2019/02,160,09/02/2019,6,SP 18 tra Bargellino e Calderara di Reno (c/o Variante SP18),12770,00,12377,393,9304,3466,0,12770
2019/02,160,10/02/2019,7,SP 18 tra Bargellino e Calderara di Reno (c/o Variante SP18),9094,00,9026,68,6739,2355,0,9094
2019/02,160,11/02/2019,1,SP 18 tra Bargellino e Calderara di Reno (c/o Variante SP18),17860,20,16401,1457,14460,3400,17860,0
2019/02,160,12/02/2019,2,SP 18 tra Bargellino e Calderara di Reno (c/o Variante SP18),18545,10,16928,1616,14523,4022,18545,0
2019/02,160,13/02/2019,3,SP 18 tra Bargellino e Calderara di Reno (c/o Variante SP18),18588,10,16956,1631,14740,3848,18588,0
2019/02,160,14/02/2019,4,SP 18 tra Bargellino e Calderara di Reno (c/o Variante SP18),18891,00,17264,1627,14811,4080,18891,0
2019/02,161,01/02/2019,5,SP 568 da Tavernelle all'intersezione della SP3,18989,00,18024,965,14283,4706,18989,0
2019/02,161,02/02/2019,6,SP 568 da Tavernelle all'intersezione della SP3,16710,00,16490,220,11615,5095,0,16710
2019/02,161,03/02/2019,7,SP 568 da Tavernelle all'intersezione della SP3,14074,00,14013,61,9903,4171,0,14074
2019/02,161,04/02/2019,1,SP 568 da Tavernelle all'intersezione della SP3,18434,00,17451,983,14192,4242,18434,0
2019/02,161,05/02/2019,2,SP 568 da Tavernelle all'intersezione della SP3,18490,00,17429,1061,14281,4209,18490,0
2019/02,161,06/02/2019,3,SP 568 da Tavernelle all'intersezione della SP3,19068,00,18023,1045,14549,4519,19068,0
2019/02,161,07/02/2019,4,SP 568 da Tavernelle all'intersezione della SP3,19283,10,18167,1115,14708,4575,19283,0
2019/02,161,08/02/2019,5,SP 568 da Tavernelle all'intersezione della SP3,19966,00,18888,1078,14808,5158,19966,0
2019/02,161,09/02/2019,6,SP 568 da Tavernelle all'intersezione della SP3,16776,00,16553,223,11676,5100,0,16776
2019/02,161,10/02/2019,7,SP 568 da Tavernelle all'intersezione della SP3,14483,00,14437,46,10273,4210,0,14483
2019/02,161,11/02/2019,1,SP 568 da Tavernelle all'intersezione della SP3,18409,00,17376,1033,14182,4227,18409,0
2019/02,161,12/02/2019,2,SP 568 da Tavernelle all'intersezione della SP3,18936,00,17828,1108,14495,4441,18936,0
2019/02,161,13/02/2019,3,SP 568 da Tavernelle all'intersezione della SP3,19282,00,18203,1079,14795,4487,19282,0
2019/02,161,14/02/2019,4,SP 568 da Tavernelle all'intersezione della SP3,19993,00,18948,1045,14903,5090,19993,0
2019/02,162,01/02/2019,5,SS 9 località Cavazzona,17062,20,15568,1492,11817,5245,17062,0
2019/02,162,02/02/2019,6,SS 9 località Cavazzona,13174,00,12829,345,8723,4451,0,13174
2019/02,162,03/02/2019,7,SS 9 località Cavazzona,12171,00,12078,93,7816,4355,0,12171
2019/02,162,04/02/2019,1,SS 9 località Cavazzona,16454,00,14846,1608,11731,4723,16454,0
2019/02,162,05/02/2019,2,SS 9 località Cavazzona,16918,20,15131,1785,12155,4763,16918,0
2019/02,162,06/02/2019,3,SS 9 località Cavazzona,16811,20,15071,1738,11860,4951,16811,0
2019/02,162,07/02/2019,4,SS 9 località Cavazzona,17167,20,15481,1684,12105,5062,17167,0
2019/02,162,08/02/2019,5,SS 9 località Cavazzona,18281,00,16577,1704,12493,5788,18281,0
2019/02,162,09/02/2019,6,SS 9 località Cavazzona,15613,00,15232,381,10154,5459,0,15613
2019/02,162,10/02/2019,7,SS 9 località Cavazzona,12996,20,12886,108,8445,4551,0,12996
2019/02,162,11/02/2019,1,SS 9 località Cavazzona,16628,20,15078,1548,11747,4881,16628,0
2019/02,162,12/02/2019,2,SS 9 località Cavazzona,16951,10,15269,1681,12042,4909,16951,0
2019/02,162,13/02/2019,3,SS 9 località Cavazzona,17357,20,15678,1677,12121,5236,17357,0
2019/02,162,14/02/2019,4,SS 9 località Cavazzona,17356,00,15738,1618,12198,5158,17356,0
2019/02,170,01/02/2019,5,SS 67 tra Rovere e Forlì,9275,10,8856,418,7255,2020,9275,0
2019/02,170,02/02/2019,6,SS 67 tra Rovere e Forlì,7907,00,7726,181,5901,2006,0,7907
2019/02,170,03/02/2019,7,SS 67 tra Rovere e Forlì,6297,00,6257,40,4609,1688,0,6297
2019/02,170,04/02/2019,1,SS 67 tra Rovere e Forlì,7645,00,7306,339,5960,1685,7645,0
2019/02,170,05/02/2019,2,SS 67 tra Rovere e Forlì,9436,00,8961,475,7510,1926,9436,0
2019/02,170,06/02/2019,3,SS 67 tra Rovere e Forlì,9203,00,8804,399,7209,1994,9203,0
2019/02,170,07/02/2019,4,SS 67 tra Rovere e Forlì,9153,00,8785,368,7148,2005,9153,0
2019/02,170,08/02/2019,5,SS 67 tra Rovere e Forlì,9589,20,9152,435,7578,2011,9589,0
2019/02,170,09/02/2019,6,SS 67 tra Rovere e Forlì,8544,00,8379,165,6330,2214,0,8544
2019/02,170,10/02/2019,7,SS 67 tra Rovere e Forlì,6715,10,6679,35,5048,1667,0,6715
2019/02,170,11/02/2019,1,SS 67 tra Rovere e Forlì,9229,00,8785,444,7334,1895,9229,0
2019/02,170,12/02/2019,2,SS 67 tra Rovere e Forlì,9348,00,8897,451,7398,1950,9348,0
2019/02,170,13/02/2019,3,SS 67 tra Rovere e Forlì,9604,00,9112,492,7469,2135,9604,0
2019/02,170,14/02/2019,4,SS 67 tra Rovere e Forlì,10407,00,9899,508,7975,2432,10407,0
2019/02,171,01/02/2019,5,SP 56 tra Forlì e bivio SS67 (Castrocaro Terme),6892,00,6718,174,5357,1535,6892,0
2019/02,171,02/02/2019,6,SP 56 tra Forlì e bivio SS67 (Castrocaro Terme),5997,00,5945,52,4393,1604,0,5997
2019/02,171,03/02/2019,7,SP 56 tra Forlì e bivio SS67 (Castrocaro Terme),4599,00,4591,8,3334,1265,0,4599
2019/02,171,04/02/2019,1,SP 56 tra Forlì e bivio SS67 (Castrocaro Terme),5490,00,5339,151,4259,1231,5490,0
2019/02,171,05/02/2019,2,SP 56 tra Forlì e bivio SS67 (Castrocaro Terme),6861,00,6654,207,5532,1329,6861,0
2019/02,171,06/02/2019,3,SP 56 tra Forlì e bivio SS67 (Castrocaro Terme),6933,00,6721,212,5494,1439,6933,0
2019/02,171,07/02/2019,4,SP 56 tra Forlì e bivio SS67 (Castrocaro Terme),6773,00,6590,183,5313,1460,6773,0
2019/02,171,08/02/2019,5,SP 56 tra Forlì e bivio SS67 (Castrocaro Terme),7308,00,7092,216,5668,1640,7308,0
2019/02,171,09/02/2019,6,SP 56 tra Forlì e bivio SS67 (Castrocaro Terme),6745,00,6684,61,5014,1731,0,6745
2019/02,171,10/02/2019,7,SP 56 tra Forlì e bivio SS67 (Castrocaro Terme),4815,00,4804,11,3624,1191,0,4815
2019/02,171,11/02/2019,1,SP 56 tra Forlì e bivio SS67 (Castrocaro Terme),6794,00,6568,226,5493,1301,6794,0
2019/02,171,12/02/2019,2,SP 56 tra Forlì e bivio SS67 (Castrocaro Terme),7040,10,6854,185,5582,1458,7040,0
2019/02,171,13/02/2019,3,SP 56 tra Forlì e bivio SS67 (Castrocaro Terme),7012,30,6812,197,5541,1471,7012,0
2019/02,171,14/02/2019,4,SP 56 tra Forlì e bivio SS67 (Castrocaro Terme),6704,10,6564,139,5042,1662,6704,0
2019/02,173,01/02/2019,5,SP 4 tra Ronco (SS9) e bivio SP 72 (Para),8061,30,7621,437,6409,1652,8061,0
2019/02,173,02/02/2019,6,SP 4 tra Ronco (SS9) e bivio SP 72 (Para),5874,00,5688,186,4463,1411,0,5874
2019/02,173,03/02/2019,7,SP 4 tra Ronco (SS9) e bivio SP 72 (Para),4781,10,4744,36,3601,1180,0,4781
2019/02,173,04/02/2019,1,SP 4 tra Ronco (SS9) e bivio SP 72 (Para),6685,00,6315,370,5295,1390,6685,0
2019/02,173,05/02/2019,2,SP 4 tra Ronco (SS9) e bivio SP 72 (Para),8123,10,7661,461,6605,1518,8123,0
2019/02,173,06/02/2019,3,SP 4 tra Ronco (SS9) e bivio SP 72 (Para),8145,00,7694,451,6482,1663,8145,0
2019/02,173,07/02/2019,4,SP 4 tra Ronco (SS9) e bivio SP 72 (Para),8013,10,7567,445,6356,1657,8013,0
2019/02,173,08/02/2019,5,SP 4 tra Ronco (SS9) e bivio SP 72 (Para),8468,10,7990,477,6729,1739,8468,0
2019/02,173,09/02/2019,6,SP 4 tra Ronco (SS9) e bivio SP 72 (Para),6516,00,6361,155,4910,1606,0,6516
2019/02,173,10/02/2019,7,SP 4 tra Ronco (SS9) e bivio SP 72 (Para),5078,00,5046,32,3869,1209,0,5078
2019/02,173,11/02/2019,1,SP 4 tra Ronco (SS9) e bivio SP 72 (Para),7974,10,7530,443,6471,1503,7974,0
2019/02,173,12/02/2019,2,SP 4 tra Ronco (SS9) e bivio SP 72 (Para),8128,10,7643,484,6545,1583,8128,0
2019/02,173,13/02/2019,3,SP 4 tra Ronco (SS9) e bivio SP 72 (Para),8230,20,7782,446,6567,1663,8230,0
2019/02,173,14/02/2019,4,SP 4 tra Ronco (SS9) e bivio SP 72 (Para),8343,20,7900,441,6513,1830,8343,0
2019/02,174,01/02/2019,5,SS 9 tra Ronco e Forlimpopoli,,,,,,,,
2019/02,174,02/02/2019,6,SS 9 tra Ronco e Forlimpopoli,,,,,,,,
2019/02,174,03/02/2019,7,SS 9 tra Ronco e Forlimpopoli,,,,,,,,
2019/02,174,04/02/2019,1,SS 9 tra Ronco e Forlimpopoli,,,,,,,,
2019/02,174,05/02/2019,2,SS 9 tra Ronco e Forlimpopoli,,,,,,,,
2019/02,174,06/02/2019,3,SS 9 tra Ronco e Forlimpopoli,,,,,,,,
2019/02,174,07/02/2019,4,SS 9 tra Ronco e Forlimpopoli,,,,,,,,
2019/02,174,08/02/2019,5,SS 9 tra Ronco e Forlimpopoli,,,,,,,,
2019/02,174,09/02/2019,6,SS 9 tra Ronco e Forlimpopoli,,,,,,,,
2019/02,174,10/02/2019,7,SS 9 tra Ronco e Forlimpopoli,,,,,,,,
2019/02,174,11/02/2019,1,SS 9 tra Ronco e Forlimpopoli,,,,,,,,
2019/02,174,12/02/2019,2,SS 9 tra Ronco e Forlimpopoli,,,,,,,,
2019/02,174,13/02/2019,3,SS 9 tra Ronco e Forlimpopoli,,,,,,,,
2019/02,174,14/02/2019,4,SS 9 tra Ronco e Forlimpopoli,,,,,,,,
2019/02,176,01/02/2019,5,SP 2 in località La Caserma al Confine Provinciale,7761,00,7135,626,6036,1725,7761,0
2019/02,176,02/02/2019,6,SP 2 in località La Caserma al Confine Provinciale,6685,00,6568,117,4743,1942,0,6685
2019/02,176,03/02/2019,7,SP 2 in località La Caserma al Confine Provinciale,7244,00,7228,16,5623,1621,0,7244
2019/02,176,04/02/2019,1,SP 2 in località La Caserma al Confine Provinciale,6979,10,6456,522,5664,1315,6979,0
2019/02,176,05/02/2019,2,SP 2 in località La Caserma al Confine Provinciale,7389,00,6787,602,5982,1407,7389,0
2019/02,176,06/02/2019,3,SP 2 in località La Caserma al Confine Provinciale,7758,00,7172,586,6287,1471,7758,0
2019/02,176,07/02/2019,4,SP 2 in località La Caserma al Confine Provinciale,7812,00,7200,612,6296,1516,7812,0
2019/02,176,08/02/2019,5,SP 2 in località La Caserma al Confine Provinciale,8162,10,7590,571,6320,1842,8162,0
2019/02,176,09/02/2019,6,SP 2 in località La Caserma al Confine Provinciale,8248,00,8079,169,5972,2276,0,8248
2019/02,176,10/02/2019,7,SP 2 in località La Caserma al Confine Provinciale,8965,00,8931,34,6961,2004,0,8965
2019/02,176,11/02/2019,1,SP 2 in località La Caserma al Confine Provinciale,7555,10,6913,641,6102,1453,7555,0
2019/02,176,12/02/2019,2,SP 2 in località La Caserma al Confine Provinciale,7751,00,7156,595,6303,1448,7751,0
2019/02,176,13/02/2019,3,SP 2 in località La Caserma al Confine Provinciale,8121,00,7463,658,6511,1610,8121,0
2019/02,176,14/02/2019,4,SP 2 in località La Caserma al Confine Provinciale,8879,10,8311,567,6730,2149,8879,0
2019/02,177,01/02/2019,5,NSA 313 - Prosecuzione tangenziale di Bologna complanare sud alla A 14 nel tratto San Lazzaro/Idice,16307,10,15584,722,12327,3980,16307,0
2019/02,177,02/02/2019,6,NSA 313 - Prosecuzione tangenziale di Bologna complanare sud alla A 14 nel tratto San Lazzaro/Idice,12214,10,12059,154,8406,3808,0,12214
2019/02,177,03/02/2019,7,NSA 313 - Prosecuzione tangenziale di Bologna complanare sud alla A 14 nel tratto San Lazzaro/Idice,10857,00,10819,38,7217,3640,0,10857
2019/02,177,04/02/2019,1,NSA 313 - Prosecuzione tangenziale di Bologna complanare sud alla A 14 nel tratto San Lazzaro/Idice,16064,10,15299,764,12419,3645,16064,0
2019/02,177,05/02/2019,2,NSA 313 - Prosecuzione tangenziale di Bologna complanare sud alla A 14 nel tratto San Lazzaro/Idice,16612,10,15803,808,12743,3869,16612,0
2019/02,177,06/02/2019,3,NSA 313 - Prosecuzione tangenziale di Bologna complanare sud alla A 14 nel tratto San Lazzaro/Idice,16815,10,16049,765,12772,4043,16815,0
2019/02,177,07/02/2019,4,NSA 313 - Prosecuzione tangenziale di Bologna complanare sud alla A 14 nel tratto San Lazzaro/Idice,16719,10,15901,817,12608,4111,16719,0
2019/02,177,08/02/2019,5,NSA 313 - Prosecuzione tangenziale di Bologna complanare sud alla A 14 nel tratto San Lazzaro/Idice,17049,10,16197,851,12875,4174,17049,0
2019/02,177,09/02/2019,6,NSA 313 - Prosecuzione tangenziale di Bologna complanare sud alla A 14 nel tratto San Lazzaro/Idice,12851,00,12657,194,8860,3991,0,12851
2019/02,177,10/02/2019,7,NSA 313 - Prosecuzione tangenziale di Bologna complanare sud alla A 14 nel tratto San Lazzaro/Idice,10862,10,10808,53,7322,3540,0,10862
2019/02,177,11/02/2019,1,NSA 313 - Prosecuzione tangenziale di Bologna complanare sud alla A 14 nel tratto San Lazzaro/Idice,16298,00,15457,841,12598,3700,16298,0
2019/02,177,12/02/2019,2,NSA 313 - Prosecuzione tangenziale di Bologna complanare sud alla A 14 nel tratto San Lazzaro/Idice,16630,20,15814,814,12658,3972,16630,0
2019/02,177,13/02/2019,3,NSA 313 - Prosecuzione tangenziale di Bologna complanare sud alla A 14 nel tratto San Lazzaro/Idice,16742,20,15920,820,12724,4018,16742,0
2019/02,177,14/02/2019,4,NSA 313 - Prosecuzione tangenziale di Bologna complanare sud alla A 14 nel tratto San Lazzaro/Idice,17162,20,16308,852,13003,4159,17162,0
2019/02,182,01/02/2019,5,SP 258R tra Rimini e A 14,17136,20,16552,582,12982,4154,17136,0
2019/02,182,02/02/2019,6,SP 258R tra Rimini e A 14,15009,10,14792,216,10521,4488,0,15009
2019/02,182,03/02/2019,7,SP 258R tra Rimini e A 14,12350,00,12312,38,8624,3726,0,12350
2019/02,182,04/02/2019,1,SP 258R tra Rimini e A 14,16310,40,15651,655,12894,3416,16310,0
2019/02,182,05/02/2019,2,SP 258R tra Rimini e A 14,17379,00,16737,642,13729,3650,17379,0
2019/02,182,06/02/2019,3,SP 258R tra Rimini e A 14,16846,10,16206,639,13105,3741,16846,0
2019/02,182,07/02/2019,4,SP 258R tra Rimini e A 14,17143,00,16475,668,13303,3840,17143,0
2019/02,182,08/02/2019,5,SP 258R tra Rimini e A 14,17752,10,17082,669,13565,4187,17752,0
2019/02,182,09/02/2019,6,SP 258R tra Rimini e A 14,16044,10,15830,213,11556,4488,0,16044
2019/02,182,10/02/2019,7,SP 258R tra Rimini e A 14,12955,10,12896,58,9322,3633,0,12955
2019/02,182,11/02/2019,1,SP 258R tra Rimini e A 14,16704,10,15971,732,13195,3509,16704,0
2019/02,182,12/02/2019,2,SP 258R tra Rimini e A 14,17141,10,16342,798,13384,3757,17141,0
2019/02,182,13/02/2019,3,SP 258R tra Rimini e A 14,17269,00,16540,729,13303,3966,17269,0
2019/02,182,14/02/2019,4,SP 258R tra Rimini e A 14,17697,10,16974,722,13405,4292,17697,0
2019/02,186,01/02/2019,5,SS 16 tra Rimini e Igea Marina-Viserba,27443,30,26237,1203,21068,6375,27443,0
2019/02,186,02/02/2019,6,SS 16 tra Rimini e Igea Marina-Viserba,24746,10,24338,407,18028,6718,0,24746
2019/02,186,03/02/2019,7,SS 16 tra Rimini e Igea Marina-Viserba,22703,20,22568,133,16457,6246,0,22703
2019/02,186,04/02/2019,1,SS 16 tra Rimini e Igea Marina-Viserba,26120,20,25080,1038,20760,5360,26120,0
2019/02,186,05/02/2019,2,SS 16 tra Rimini e Igea Marina-Viserba,26554,20,25318,1234,20921,5633,26554,0
2019/02,186,06/02/2019,3,SS 16 tra Rimini e Igea Marina-Viserba,26560,00,25423,1137,20839,5721,26560,0
2019/02,186,07/02/2019,4,SS 16 tra Rimini e Igea Marina-Viserba,27298,10,26037,1260,21139,6159,27298,0
2019/02,186,08/02/2019,5,SS 16 tra Rimini e Igea Marina-Viserba,28258,00,26979,1279,21643,6615,28258,0
2019/02,186,09/02/2019,6,SS 16 tra Rimini e Igea Marina-Viserba,26780,00,26339,441,19518,7262,0,26780
2019/02,186,10/02/2019,7,SS 16 tra Rimini e Igea Marina-Viserba,24852,10,24673,178,18383,6469,0,24852
2019/02,186,11/02/2019,1,SS 16 tra Rimini e Igea Marina-Viserba,26739,00,25477,1262,21069,5670,26739,0
2019/02,186,12/02/2019,2,SS 16 tra Rimini e Igea Marina-Viserba,27092,30,25765,1324,21214,5878,27092,0
2019/02,186,13/02/2019,3,SS 16 tra Rimini e Igea Marina-Viserba,27657,00,26345,1312,21603,6054,27657,0
2019/02,186,14/02/2019,4,SS 16 tra Rimini e Igea Marina-Viserba,28808,40,27467,1337,21905,6903,28808,0
2019/02,215,01/02/2019,5,SP 3_1 tra accesso interporto Bologna e viadotto A 13,27792,50,21279,6508,20574,7218,27792,0
2019/02,215,02/02/2019,6,SP 3_1 tra accesso interporto Bologna e viadotto A 13,12861,00,11342,1519,9159,3702,0,12861
2019/02,215,03/02/2019,7,SP 3_1 tra accesso interporto Bologna e viadotto A 13,8502,00,8361,141,6224,2278,0,8502
2019/02,215,04/02/2019,1,SP 3_1 tra accesso interporto Bologna e viadotto A 13,25558,80,20032,5518,19833,5725,25558,0
2019/02,215,05/02/2019,2,SP 3_1 tra accesso interporto Bologna e viadotto A 13,28383,130,21507,6863,21166,7217,28383,0
2019/02,215,06/02/2019,3,SP 3_1 tra accesso interporto Bologna e viadotto A 13,28332,50,21339,6988,21023,7309,28332,0
2019/02,215,07/02/2019,4,SP 3_1 tra accesso interporto Bologna e viadotto A 13,28142,70,21219,6916,20839,7303,28142,0
2019/02,215,08/02/2019,5,SP 3_1 tra accesso interporto Bologna e viadotto A 13,28869,70,21996,6866,21278,7591,28869,0
2019/02,215,09/02/2019,6,SP 3_1 tra accesso interporto Bologna e viadotto A 13,14639,00,13047,1592,10053,4586,0,14639
2019/02,215,10/02/2019,7,SP 3_1 tra accesso interporto Bologna e viadotto A 13,11687,00,11546,141,8559,3128,0,11687
2019/02,215,11/02/2019,1,SP 3_1 tra accesso interporto Bologna e viadotto A 13,26707,40,20884,5819,20616,6091,26707,0
2019/02,215,12/02/2019,2,SP 3_1 tra accesso interporto Bologna e viadotto A 13,28389,50,21232,7152,21217,7172,28389,0
2019/02,215,13/02/2019,3,SP 3_1 tra accesso interporto Bologna e viadotto A 13,29125,110,21993,7121,21709,7416,29125,0
2019/02,215,14/02/2019,4,SP 3_1 tra accesso interporto Bologna e viadotto A 13,29067,60,21906,7155,21413,7654,29067,0
2019/02,218,01/02/2019,5,SP 10 tra Polesine e Roccabianca su variante Zibello,2068,00,1799,269,1599,469,2068,0
2019/02,218,02/02/2019,6,SP 10 tra Polesine e Roccabianca su variante Zibello,1679,10,1607,71,1223,456,0,1679
2019/02,218,03/02/2019,7,SP 10 tra Polesine e Roccabianca su variante Zibello,1360,00,1337,23,1024,336,0,1360
2019/02,218,04/02/2019,1,SP 10 tra Polesine e Roccabianca su variante Zibello,2258,00,1927,331,1841,417,2258,0
2019/02,218,05/02/2019,2,SP 10 tra Polesine e Roccabianca su variante Zibello,2435,00,2011,424,1925,510,2435,0
2019/02,218,06/02/2019,3,SP 10 tra Polesine e Roccabianca su variante Zibello,2422,00,2045,377,1934,488,2422,0
2019/02,218,07/02/2019,4,SP 10 tra Polesine e Roccabianca su variante Zibello,2431,00,2055,376,1921,510,2431,0
2019/02,218,08/02/2019,5,SP 10 tra Polesine e Roccabianca su variante Zibello,2524,00,2132,392,1965,559,2524,0
2019/02,218,09/02/2019,6,SP 10 tra Polesine e Roccabianca su variante Zibello,1863,00,1748,115,1387,476,0,1863
2019/02,218,10/02/2019,7,SP 10 tra Polesine e Roccabianca su variante Zibello,1366,00,1337,29,1034,332,0,1366
2019/02,218,11/02/2019,1,SP 10 tra Polesine e Roccabianca su variante Zibello,2249,00,1903,346,1771,478,2249,0
2019/02,218,12/02/2019,2,SP 10 tra Polesine e Roccabianca su variante Zibello,2368,00,2034,334,1859,509,2368,0
2019/02,218,13/02/2019,3,SP 10 tra Polesine e Roccabianca su variante Zibello,2425,00,2071,354,1915,510,2425,0
2019/02,218,14/02/2019,4,SP 10 tra Polesine e Roccabianca su variante Zibello,2546,00,2160,386,1939,607,2546,0
2019/02,219,01/02/2019,5,SS 9 tra Fiorenzuola d'Arda e Pontenure,14459,60,13317,1136,11332,3127,14459,0
2019/02,219,02/02/2019,6,SS 9 tra Fiorenzuola d'Arda e Pontenure,12964,130,12569,382,9780,3184,0,12964
2019/02,219,03/02/2019,7,SS 9 tra Fiorenzuola d'Arda e Pontenure,9725,00,9623,102,6957,2768,0,9725
2019/02,219,04/02/2019,1,SS 9 tra Fiorenzuola d'Arda e Pontenure,16493,100,15167,1316,13194,3299,16493,0
2019/02,219,05/02/2019,2,SS 9 tra Fiorenzuola d'Arda e Pontenure,16558,70,15141,1410,13315,3243,16558,0
2019/02,219,06/02/2019,3,SS 9 tra Fiorenzuola d'Arda e Pontenure,16718,110,15264,1443,13320,3398,16718,0
2019/02,219,07/02/2019,4,SS 9 tra Fiorenzuola d'Arda e Pontenure,16916,120,15533,1371,13605,3311,16916,0
2019/02,219,08/02/2019,5,SS 9 tra Fiorenzuola d'Arda e Pontenure,17100,160,15694,1390,13392,3708,17100,0
2019/02,219,09/02/2019,6,SS 9 tra Fiorenzuola d'Arda e Pontenure,13734,40,13345,385,10261,3473,0,13734
2019/02,219,10/02/2019,7,SS 9 tra Fiorenzuola d'Arda e Pontenure,10605,20,10522,81,7920,2685,0,10605
2019/02,219,11/02/2019,1,SS 9 tra Fiorenzuola d'Arda e Pontenure,16413,90,15126,1278,13301,3112,16413,0
2019/02,219,12/02/2019,2,SS 9 tra Fiorenzuola d'Arda e Pontenure,16817,110,15402,1404,13618,3199,16817,0
2019/02,219,13/02/2019,3,SS 9 tra Fiorenzuola d'Arda e Pontenure,16851,120,15429,1410,13413,3438,16851,0
2019/02,219,14/02/2019,4,SS 9 tra Fiorenzuola d'Arda e Pontenure,17104,140,15748,1342,13491,3613,17104,0
2019/02,220,01/02/2019,5,SS 9 tra Fiorenzuola d'Arda e Fidenza al confine provinciale,11867,00,10593,1274,9357,2510,11867,0
2019/02,220,02/02/2019,6,SS 9 tra Fiorenzuola d'Arda e Fidenza al confine provinciale,11841,00,11474,367,9172,2669,0,11841
2019/02,220,03/02/2019,7,SS 9 tra Fiorenzuola d'Arda e Fidenza al confine provinciale,10886,00,10811,75,8357,2529,0,10886
2019/02,220,04/02/2019,1,SS 9 tra Fiorenzuola d'Arda e Fidenza al confine provinciale,14384,1760,12473,1735,11485,2899,14384,0
2019/02,220,05/02/2019,2,SS 9 tra Fiorenzuola d'Arda e Fidenza al confine provinciale,14550,10,12630,1919,11539,3011,14550,0
2019/02,220,06/02/2019,3,SS 9 tra Fiorenzuola d'Arda e Fidenza al confine provinciale,16530,00,14377,2153,13367,3163,16530,0
2019/02,220,07/02/2019,4,SS 9 tra Fiorenzuola d'Arda e Fidenza al confine provinciale,15427,10,13439,1987,12191,3236,15427,0
2019/02,220,08/02/2019,5,SS 9 tra Fiorenzuola d'Arda e Fidenza al confine provinciale,14314,10,12542,1771,10968,3346,14314,0
2019/02,220,09/02/2019,6,SS 9 tra Fiorenzuola d'Arda e Fidenza al confine provinciale,12735,00,12322,413,9810,2925,0,12735
2019/02,220,10/02/2019,7,SS 9 tra Fiorenzuola d'Arda e Fidenza al confine provinciale,11343,00,11274,69,8811,2532,0,11343
2019/02,220,11/02/2019,1,SS 9 tra Fiorenzuola d'Arda e Fidenza al confine provinciale,13297,00,11730,1567,10601,2696,13297,0
2019/02,220,12/02/2019,2,SS 9 tra Fiorenzuola d'Arda e Fidenza al confine provinciale,13646,00,12018,1628,10833,2813,13646,0
2019/02,220,13/02/2019,3,SS 9 tra Fiorenzuola d'Arda e Fidenza al confine provinciale,14221,00,12499,1722,11326,2895,14221,0
2019/02,220,14/02/2019,4,SS 9 tra Fiorenzuola d'Arda e Fidenza al confine provinciale,14463,00,12816,1647,11146,3317,14463,0
2019/02,221,01/02/2019,5,SS 9 tra Fidenza e A 15,22080,00,19644,2436,16974,5106,22080,0
2019/02,221,02/02/2019,6,SS 9 tra Fidenza e A 15,18716,00,18045,671,13571,5145,0,18716
2019/02,221,03/02/2019,7,SS 9 tra Fidenza e A 15,15599,00,15478,121,11165,4434,0,15599
2019/02,221,04/02/2019,1,SS 9 tra Fidenza e A 15,25060,20,22051,3007,19672,5388,25060,0
2019/02,221,05/02/2019,2,SS 9 tra Fidenza e A 15,25791,20,22650,3139,20186,5605,25791,0
2019/02,221,06/02/2019,3,SS 9 tra Fidenza e A 15,24767,50,21682,3080,19101,5666,24767,0
2019/02,221,07/02/2019,4,SS 9 tra Fidenza e A 15,26181,10,23043,3137,20415,5766,26181,0
2019/02,221,08/02/2019,5,SS 9 tra Fidenza e A 15,25423,20,22505,2916,19306,6117,25423,0
2019/02,221,09/02/2019,6,SS 9 tra Fidenza e A 15,20556,10,19869,686,14757,5799,0,20556
2019/02,221,10/02/2019,7,SS 9 tra Fidenza e A 15,15752,00,15606,146,11359,4393,0,15752
2019/02,221,11/02/2019,1,SS 9 tra Fidenza e A 15,23331,20,20565,2764,18279,5052,23331,0
2019/02,221,12/02/2019,2,SS 9 tra Fidenza e A 15,24301,00,21452,2849,18930,5371,24301,0
2019/02,221,13/02/2019,3,SS 9 tra Fidenza e A 15,24564,20,21663,2899,19000,5564,24564,0
2019/02,221,14/02/2019,4,SS 9 tra Fidenza e A 15,25570,00,22692,2878,19430,6140,25570,0
2019/02,222,01/02/2019,5,SP 359R tra Fidenza e Salsomaggiore Terme,15394,60,15033,355,11612,3782,15394,0
2019/02,222,02/02/2019,6,SP 359R tra Fidenza e Salsomaggiore Terme,14241,30,14042,196,10222,4019,0,14241
2019/02,222,03/02/2019,7,SP 359R tra Fidenza e Salsomaggiore Terme,10929,10,10882,46,7606,3323,0,10929
2019/02,222,04/02/2019,1,SP 359R tra Fidenza e Salsomaggiore Terme,15559,70,15173,379,12096,3463,15559,0
2019/02,222,05/02/2019,2,SP 359R tra Fidenza e Salsomaggiore Terme,16048,60,15620,422,12405,3643,16048,0
2019/02,222,06/02/2019,3,SP 359R tra Fidenza e Salsomaggiore Terme,16327,60,15875,446,12586,3741,16327,0
2019/02,222,07/02/2019,4,SP 359R tra Fidenza e Salsomaggiore Terme,16355,60,15955,394,12607,3748,16355,0
2019/02,222,08/02/2019,5,SP 359R tra Fidenza e Salsomaggiore Terme,17113,70,16684,422,12951,4162,17113,0
2019/02,222,09/02/2019,6,SP 359R tra Fidenza e Salsomaggiore Terme,15369,40,15117,248,10932,4437,0,15369
2019/02,222,10/02/2019,7,SP 359R tra Fidenza e Salsomaggiore Terme,11039,00,10982,57,7756,3283,0,11039
2019/02,222,11/02/2019,1,SP 359R tra Fidenza e Salsomaggiore Terme,15821,80,15410,403,12432,3389,15821,0
2019/02,222,12/02/2019,2,SP 359R tra Fidenza e Salsomaggiore Terme,16345,50,15879,461,12718,3627,16345,0
2019/02,222,13/02/2019,3,SP 359R tra Fidenza e Salsomaggiore Terme,16251,80,15788,455,12529,3722,16251,0
2019/02,222,14/02/2019,4,SP 359R tra Fidenza e Salsomaggiore Terme,17127,50,16641,481,12641,4486,17127,0
2019/02,223,01/02/2019,5,SP 357R tra SS 9 e Noceto,10483,00,9398,1085,8171,2312,10483,0
2019/02,223,02/02/2019,6,SP 357R tra SS 9 e Noceto,8402,00,8098,304,6317,2085,0,8402
2019/02,223,03/02/2019,7,SP 357R tra SS 9 e Noceto,6221,00,6155,66,4419,1802,0,6221
2019/02,223,04/02/2019,1,SP 357R tra SS 9 e Noceto,10792,00,9509,1283,8610,2182,10792,0
2019/02,223,05/02/2019,2,SP 357R tra SS 9 e Noceto,10742,10,9464,1277,8483,2259,10742,0
2019/02,223,06/02/2019,3,SP 357R tra SS 9 e Noceto,11154,00,9837,1317,8784,2370,11154,0
2019/02,223,07/02/2019,4,SP 357R tra SS 9 e Noceto,10725,00,9450,1275,8516,2209,10725,0
2019/02,223,08/02/2019,5,SP 357R tra SS 9 e Noceto,11280,00,9833,1447,8822,2458,11280,0
2019/02,223,09/02/2019,6,SP 357R tra SS 9 e Noceto,9026,00,8701,325,6690,2336,0,9026
2019/02,223,10/02/2019,7,SP 357R tra SS 9 e Noceto,6338,00,6248,90,4612,1726,0,6338
2019/02,223,11/02/2019,1,SP 357R tra SS 9 e Noceto,9253,130,8099,1141,7152,2101,9253,0
2019/02,223,12/02/2019,2,SP 357R tra SS 9 e Noceto,8682,120,7511,1159,6624,2058,8682,0
2019/02,223,13/02/2019,3,SP 357R tra SS 9 e Noceto,8616,90,7397,1210,6582,2034,8616,0
2019/02,223,14/02/2019,4,SP 357R tra SS 9 e Noceto,9049,10,7806,1242,6783,2266,9049,0
2019/02,226,01/02/2019,5,SP 32 dal bivio SP 16 (per Langhirano) al bivio SP 665R,10515,10,9820,694,8282,2233,10515,0
2019/02,226,02/02/2019,6,SP 32 dal bivio SP 16 (per Langhirano) al bivio SP 665R,8327,00,8129,198,6209,2118,0,8327
2019/02,226,03/02/2019,7,SP 32 dal bivio SP 16 (per Langhirano) al bivio SP 665R,6667,10,6578,88,5021,1646,0,6667
2019/02,226,04/02/2019,1,SP 32 dal bivio SP 16 (per Langhirano) al bivio SP 665R,11039,00,10235,804,8927,2112,11039,0
2019/02,226,05/02/2019,2,SP 32 dal bivio SP 16 (per Langhirano) al bivio SP 665R,11387,00,10632,755,9144,2243,11387,0
2019/02,226,06/02/2019,3,SP 32 dal bivio SP 16 (per Langhirano) al bivio SP 665R,11726,20,10937,787,9401,2325,11726,0
2019/02,226,07/02/2019,4,SP 32 dal bivio SP 16 (per Langhirano) al bivio SP 665R,11642,10,10869,772,9249,2393,11642,0
2019/02,226,08/02/2019,5,SP 32 dal bivio SP 16 (per Langhirano) al bivio SP 665R,12029,00,11175,854,9422,2607,12029,0
2019/02,226,09/02/2019,6,SP 32 dal bivio SP 16 (per Langhirano) al bivio SP 665R,9116,00,8898,218,6745,2371,0,9116
2019/02,226,10/02/2019,7,SP 32 dal bivio SP 16 (per Langhirano) al bivio SP 665R,7231,00,7137,94,5503,1728,0,7231
2019/02,226,11/02/2019,1,SP 32 dal bivio SP 16 (per Langhirano) al bivio SP 665R,10996,00,10214,782,8970,2026,10996,0
2019/02,226,12/02/2019,2,SP 32 dal bivio SP 16 (per Langhirano) al bivio SP 665R,11517,10,10736,780,9393,2124,11517,0
2019/02,226,13/02/2019,3,SP 32 dal bivio SP 16 (per Langhirano) al bivio SP 665R,11568,20,10726,840,9306,2262,11568,0
2019/02,226,14/02/2019,4,SP 32 dal bivio SP 16 (per Langhirano) al bivio SP 665R,12014,00,11247,767,9463,2551,12014,0
2019/02,227,01/02/2019,5,SP 34 da Colorno al bivio SP 60 (al confine provinciale),5435,00,5248,187,4290,1145,5435,0
2019/02,227,02/02/2019,6,SP 34 da Colorno al bivio SP 60 (al confine provinciale),4570,00,4496,74,3587,983,0,4570
2019/02,227,03/02/2019,7,SP 34 da Colorno al bivio SP 60 (al confine provinciale),3261,00,3249,12,2457,804,0,3261
2019/02,227,04/02/2019,1,SP 34 da Colorno al bivio SP 60 (al confine provinciale),5617,00,5426,191,4570,1047,5617,0
2019/02,227,05/02/2019,2,SP 34 da Colorno al bivio SP 60 (al confine provinciale),5755,00,5553,202,4640,1115,5755,0
2019/02,227,06/02/2019,3,SP 34 da Colorno al bivio SP 60 (al confine provinciale),5815,00,5603,212,4629,1186,5815,0
2019/02,227,07/02/2019,4,SP 34 da Colorno al bivio SP 60 (al confine provinciale),6058,00,5859,199,4875,1183,6058,0
2019/02,227,08/02/2019,5,SP 34 da Colorno al bivio SP 60 (al confine provinciale),5857,10,5648,208,4617,1240,5857,0
2019/02,227,09/02/2019,6,SP 34 da Colorno al bivio SP 60 (al confine provinciale),4904,00,4809,95,3775,1129,0,4904
2019/02,227,10/02/2019,7,SP 34 da Colorno al bivio SP 60 (al confine provinciale),3503,00,3482,21,2685,818,0,3503
2019/02,227,11/02/2019,1,SP 34 da Colorno al bivio SP 60 (al confine provinciale),5593,00,5380,213,4517,1076,5593,0
2019/02,227,12/02/2019,2,SP 34 da Colorno al bivio SP 60 (al confine provinciale),5698,10,5491,206,4558,1140,5698,0
2019/02,227,13/02/2019,3,SP 34 da Colorno al bivio SP 60 (al confine provinciale),5699,00,5490,209,4504,1195,5699,0
2019/02,227,14/02/2019,4,SP 34 da Colorno al bivio SP 60 (al confine provinciale),5979,00,5780,199,4695,1284,5979,0
2019/02,228,01/02/2019,5,SP 62R tra Brescello (bivio SP 41) e Sorbolo (bivio SP 20),10518,20,8856,1660,8226,2292,10518,0
2019/02,228,02/02/2019,6,SP 62R tra Brescello (bivio SP 41) e Sorbolo (bivio SP 20),9023,00,8646,377,6578,2445,0,9023
2019/02,228,03/02/2019,7,SP 62R tra Brescello (bivio SP 41) e Sorbolo (bivio SP 20),7878,10,7778,99,5750,2128,0,7878
2019/02,228,04/02/2019,1,SP 62R tra Brescello (bivio SP 41) e Sorbolo (bivio SP 20),10666,20,8878,1786,8573,2093,10666,0
2019/02,228,05/02/2019,2,SP 62R tra Brescello (bivio SP 41) e Sorbolo (bivio SP 20),10854,50,8973,1876,8714,2140,10854,0
2019/02,228,06/02/2019,3,SP 62R tra Brescello (bivio SP 41) e Sorbolo (bivio SP 20),11383,50,9349,2029,9046,2337,11383,0
2019/02,228,07/02/2019,4,SP 62R tra Brescello (bivio SP 41) e Sorbolo (bivio SP 20),11225,10,9117,2107,8891,2334,11225,0
2019/02,228,08/02/2019,5,SP 62R tra Brescello (bivio SP 41) e Sorbolo (bivio SP 20),11641,10,9785,1855,9078,2563,11641,0
2019/02,228,09/02/2019,6,SP 62R tra Brescello (bivio SP 41) e Sorbolo (bivio SP 20),9695,20,9320,373,7055,2640,0,9695
2019/02,228,10/02/2019,7,SP 62R tra Brescello (bivio SP 41) e Sorbolo (bivio SP 20),8640,00,8542,98,6205,2435,0,8640
2019/02,228,11/02/2019,1,SP 62R tra Brescello (bivio SP 41) e Sorbolo (bivio SP 20),10717,20,8812,1903,8577,2140,10717,0
2019/02,228,12/02/2019,2,SP 62R tra Brescello (bivio SP 41) e Sorbolo (bivio SP 20),10861,30,8869,1989,8742,2119,10861,0
2019/02,228,13/02/2019,3,SP 62R tra Brescello (bivio SP 41) e Sorbolo (bivio SP 20),11103,30,9116,1984,8875,2228,11103,0
2019/02,228,14/02/2019,4,SP 62R tra Brescello (bivio SP 41) e Sorbolo (bivio SP 20),12091,10,10073,2017,9528,2563,12091,0
2019/02,229,01/02/2019,5,SP 111 tra bivio SP 1 (a nord di Poviglio) e Boretto (innesto variante),,,,,,,,
2019/02,229,02/02/2019,6,SP 111 tra bivio SP 1 (a nord di Poviglio) e Boretto (innesto variante),,,,,,,,
2019/02,229,03/02/2019,7,SP 111 tra bivio SP 1 (a nord di Poviglio) e Boretto (innesto variante),,,,,,,,
2019/02,229,04/02/2019,1,SP 111 tra bivio SP 1 (a nord di Poviglio) e Boretto (innesto variante),,,,,,,,
2019/02,229,05/02/2019,2,SP 111 tra bivio SP 1 (a nord di Poviglio) e Boretto (innesto variante),,,,,,,,
2019/02,229,06/02/2019,3,SP 111 tra bivio SP 1 (a nord di Poviglio) e Boretto (innesto variante),,,,,,,,
2019/02,229,07/02/2019,4,SP 111 tra bivio SP 1 (a nord di Poviglio) e Boretto (innesto variante),,,,,,,,
2019/02,229,08/02/2019,5,SP 111 tra bivio SP 1 (a nord di Poviglio) e Boretto (innesto variante),,,,,,,,
2019/02,229,09/02/2019,6,SP 111 tra bivio SP 1 (a nord di Poviglio) e Boretto (innesto variante),,,,,,,,
2019/02,229,10/02/2019,7,SP 111 tra bivio SP 1 (a nord di Poviglio) e Boretto (innesto variante),,,,,,,,
2019/02,229,11/02/2019,1,SP 111 tra bivio SP 1 (a nord di Poviglio) e Boretto (innesto variante),,,,,,,,
2019/02,229,12/02/2019,2,SP 111 tra bivio SP 1 (a nord di Poviglio) e Boretto (innesto variante),,,,,,,,
2019/02,229,13/02/2019,3,SP 111 tra bivio SP 1 (a nord di Poviglio) e Boretto (innesto variante),,,,,,,,
2019/02,229,14/02/2019,4,SP 111 tra bivio SP 1 (a nord di Poviglio) e Boretto (innesto variante),,,,,,,,
2019/02,230,01/02/2019,5,SP 62RVar Cispadana da Boretto (bivio Variante SP 358R) a Gualtieri (bivio SP 63R),10730,00,8431,2299,8381,2349,10730,0
2019/02,230,02/02/2019,6,SP 62RVar Cispadana da Boretto (bivio Variante SP 358R) a Gualtieri (bivio SP 63R),7802,00,7377,425,5712,2090,0,7802
2019/02,230,03/02/2019,7,SP 62RVar Cispadana da Boretto (bivio Variante SP 358R) a Gualtieri (bivio SP 63R),7316,00,7191,125,5244,2072,0,7316
2019/02,230,04/02/2019,1,SP 62RVar Cispadana da Boretto (bivio Variante SP 358R) a Gualtieri (bivio SP 63R),10678,10,8262,2415,8637,2041,10678,0
2019/02,230,05/02/2019,2,SP 62RVar Cispadana da Boretto (bivio Variante SP 358R) a Gualtieri (bivio SP 63R),11148,00,8518,2630,8964,2184,11148,0
2019/02,230,06/02/2019,3,SP 62RVar Cispadana da Boretto (bivio Variante SP 358R) a Gualtieri (bivio SP 63R),11360,00,8655,2705,9075,2285,11360,0
2019/02,230,07/02/2019,4,SP 62RVar Cispadana da Boretto (bivio Variante SP 358R) a Gualtieri (bivio SP 63R),11426,00,8681,2745,9140,2286,11426,0
2019/02,230,08/02/2019,5,SP 62RVar Cispadana da Boretto (bivio Variante SP 358R) a Gualtieri (bivio SP 63R),11702,00,9138,2564,9117,2585,11702,0
2019/02,230,09/02/2019,6,SP 62RVar Cispadana da Boretto (bivio Variante SP 358R) a Gualtieri (bivio SP 63R),8453,00,8017,436,6149,2304,0,8453
2019/02,230,10/02/2019,7,SP 62RVar Cispadana da Boretto (bivio Variante SP 358R) a Gualtieri (bivio SP 63R),7867,00,7727,140,5671,2196,0,7867
2019/02,230,11/02/2019,1,SP 62RVar Cispadana da Boretto (bivio Variante SP 358R) a Gualtieri (bivio SP 63R),11154,10,8492,2661,8984,2170,11154,0
2019/02,230,12/02/2019,2,SP 62RVar Cispadana da Boretto (bivio Variante SP 358R) a Gualtieri (bivio SP 63R),11255,10,8616,2638,9043,2212,11255,0
2019/02,230,13/02/2019,3,SP 62RVar Cispadana da Boretto (bivio Variante SP 358R) a Gualtieri (bivio SP 63R),11518,00,8770,2748,9203,2315,11518,0
2019/02,230,14/02/2019,4,SP 62RVar Cispadana da Boretto (bivio Variante SP 358R) a Gualtieri (bivio SP 63R),11955,00,9316,2639,9430,2525,11955,0
2019/02,231,01/02/2019,5,SP 63R tra la località Santa Vittoria (c/o bivio SP 81) e la Cispadana,6739,10,6312,426,5416,1323,6739,0
2019/02,231,02/02/2019,6,SP 63R tra la località Santa Vittoria (c/o bivio SP 81) e la Cispadana,5944,00,5835,109,4584,1360,0,5944
2019/02,231,03/02/2019,7,SP 63R tra la località Santa Vittoria (c/o bivio SP 81) e la Cispadana,4503,00,4487,16,3316,1187,0,4503
2019/02,231,04/02/2019,1,SP 63R tra la località Santa Vittoria (c/o bivio SP 81) e la Cispadana,6602,00,6151,451,5440,1162,6602,0
2019/02,231,05/02/2019,2,SP 63R tra la località Santa Vittoria (c/o bivio SP 81) e la Cispadana,6818,00,6351,467,5612,1206,6818,0
2019/02,231,06/02/2019,3,SP 63R tra la località Santa Vittoria (c/o bivio SP 81) e la Cispadana,6867,00,6414,453,5577,1290,6867,0
2019/02,231,07/02/2019,4,SP 63R tra la località Santa Vittoria (c/o bivio SP 81) e la Cispadana,6984,00,6518,466,5714,1270,6984,0
2019/02,231,08/02/2019,5,SP 63R tra la località Santa Vittoria (c/o bivio SP 81) e la Cispadana,7134,10,6638,495,5668,1466,7134,0
2019/02,231,09/02/2019,6,SP 63R tra la località Santa Vittoria (c/o bivio SP 81) e la Cispadana,6305,00,6199,106,4791,1514,0,6305
2019/02,231,10/02/2019,7,SP 63R tra la località Santa Vittoria (c/o bivio SP 81) e la Cispadana,4843,00,4826,17,3516,1327,0,4843
2019/02,231,11/02/2019,1,SP 63R tra la località Santa Vittoria (c/o bivio SP 81) e la Cispadana,6730,00,6271,459,5599,1131,6730,0
2019/02,231,12/02/2019,2,SP 63R tra la località Santa Vittoria (c/o bivio SP 81) e la Cispadana,7053,10,6622,430,5791,1262,7053,0
2019/02,231,13/02/2019,3,SP 63R tra la località Santa Vittoria (c/o bivio SP 81) e la Cispadana,7101,00,6633,468,5788,1313,7101,0
2019/02,231,14/02/2019,4,SP 63R tra la località Santa Vittoria (c/o bivio SP 81) e la Cispadana,7167,10,6728,438,5763,1404,7167,0
2019/02,236,01/02/2019,5,SP 468 tra Casumaro e Reno Centese,5501,00,4951,550,4347,1154,5501,0
2019/02,236,02/02/2019,6,SP 468 tra Casumaro e Reno Centese,4832,10,4562,269,3702,1130,0,4832
2019/02,236,03/02/2019,7,SP 468 tra Casumaro e Reno Centese,3707,00,3696,11,2770,937,0,3707
2019/02,236,04/02/2019,1,SP 468 tra Casumaro e Reno Centese,5303,00,4815,488,4270,1033,5303,0
2019/02,236,05/02/2019,2,SP 468 tra Casumaro e Reno Centese,5338,00,4764,574,4362,976,5338,0
2019/02,236,06/02/2019,3,SP 468 tra Casumaro e Reno Centese,5590,00,4988,602,4499,1091,5590,0
2019/02,236,07/02/2019,4,SP 468 tra Casumaro e Reno Centese,5481,10,4870,610,4413,1068,5481,0
2019/02,236,08/02/2019,5,SP 468 tra Casumaro e Reno Centese,5643,00,5113,530,4401,1242,5643,0
2019/02,236,09/02/2019,6,SP 468 tra Casumaro e Reno Centese,4925,00,4781,144,3704,1221,0,4925
2019/02,236,10/02/2019,7,SP 468 tra Casumaro e Reno Centese,3708,00,3683,25,2742,966,0,3708
2019/02,236,11/02/2019,1,SP 468 tra Casumaro e Reno Centese,5322,00,4753,569,4320,1002,5322,0
2019/02,236,12/02/2019,2,SP 468 tra Casumaro e Reno Centese,5378,00,4784,594,4374,1004,5378,0
2019/02,236,13/02/2019,3,SP 468 tra Casumaro e Reno Centese,5702,00,5082,620,4587,1115,5702,0
2019/02,236,14/02/2019,4,SP 468 tra Casumaro e Reno Centese,5826,00,5198,628,4608,1218,5826,0
2019/02,237,01/02/2019,5,SP 23 tra Quattro Castella e la Variante di Montecavolo (c/o bivio SP 21),14169,00,13513,656,11003,3166,14169,0
2019/02,237,02/02/2019,6,SP 23 tra Quattro Castella e la Variante di Montecavolo (c/o bivio SP 21),12273,00,12097,176,9071,3202,0,12273
2019/02,237,03/02/2019,7,SP 23 tra Quattro Castella e la Variante di Montecavolo (c/o bivio SP 21),9624,10,9591,32,7119,2505,0,9624
2019/02,237,04/02/2019,1,SP 23 tra Quattro Castella e la Variante di Montecavolo (c/o bivio SP 21),14123,00,13436,687,11385,2738,14123,0
2019/02,237,05/02/2019,2,SP 23 tra Quattro Castella e la Variante di Montecavolo (c/o bivio SP 21),14704,00,13971,733,11826,2878,14704,0
2019/02,237,06/02/2019,3,SP 23 tra Quattro Castella e la Variante di Montecavolo (c/o bivio SP 21),15067,00,14350,717,11951,3116,15067,0
2019/02,237,07/02/2019,4,SP 23 tra Quattro Castella e la Variante di Montecavolo (c/o bivio SP 21),15031,10,14280,750,11905,3126,15031,0
2019/02,237,08/02/2019,5,SP 23 tra Quattro Castella e la Variante di Montecavolo (c/o bivio SP 21),15406,00,14607,799,11970,3436,15406,0
2019/02,237,09/02/2019,6,SP 23 tra Quattro Castella e la Variante di Montecavolo (c/o bivio SP 21),13304,10,13117,186,9769,3535,0,13304
2019/02,237,10/02/2019,7,SP 23 tra Quattro Castella e la Variante di Montecavolo (c/o bivio SP 21),9854,00,9809,45,7288,2566,0,9854
2019/02,237,11/02/2019,1,SP 23 tra Quattro Castella e la Variante di Montecavolo (c/o bivio SP 21),14253,00,13551,702,11431,2822,14253,0
2019/02,237,12/02/2019,2,SP 23 tra Quattro Castella e la Variante di Montecavolo (c/o bivio SP 21),14979,00,14260,719,11952,3027,14979,0
2019/02,237,13/02/2019,3,SP 23 tra Quattro Castella e la Variante di Montecavolo (c/o bivio SP 21),15525,00,14725,800,12222,3303,15525,0
2019/02,237,14/02/2019,4,SP 23 tra Quattro Castella e la Variante di Montecavolo (c/o bivio SP 21),15348,00,14542,806,11881,3467,15348,0
2019/02,238,01/02/2019,5,SP 37 fra Albinea e Scandiano (bivio SP 7),10589,10,10073,515,8160,2429,10589,0
2019/02,238,02/02/2019,6,SP 37 fra Albinea e Scandiano (bivio SP 7),8661,00,8515,146,6193,2468,0,8661
2019/02,238,03/02/2019,7,SP 37 fra Albinea e Scandiano (bivio SP 7),6696,10,6662,33,4743,1953,0,6696
2019/02,238,04/02/2019,1,SP 37 fra Albinea e Scandiano (bivio SP 7),10873,00,10266,607,8711,2162,10873,0
2019/02,238,05/02/2019,2,SP 37 fra Albinea e Scandiano (bivio SP 7),11107,00,10480,627,8836,2271,11107,0
2019/02,238,06/02/2019,3,SP 37 fra Albinea e Scandiano (bivio SP 7),11327,00,10701,626,8990,2337,11327,0
2019/02,238,07/02/2019,4,SP 37 fra Albinea e Scandiano (bivio SP 7),11333,00,10735,598,8880,2453,11333,0
2019/02,238,08/02/2019,5,SP 37 fra Albinea e Scandiano (bivio SP 7),11981,00,11325,656,9159,2822,11981,0
2019/02,238,09/02/2019,6,SP 37 fra Albinea e Scandiano (bivio SP 7),9392,00,9246,146,6754,2638,0,9392
2019/02,238,10/02/2019,7,SP 37 fra Albinea e Scandiano (bivio SP 7),6993,00,6955,38,5055,1938,0,6993
2019/02,238,11/02/2019,1,SP 37 fra Albinea e Scandiano (bivio SP 7),11174,00,10617,557,8981,2193,11174,0
2019/02,238,12/02/2019,2,SP 37 fra Albinea e Scandiano (bivio SP 7),11129,00,10510,619,8727,2402,11129,0
2019/02,238,13/02/2019,3,SP 37 fra Albinea e Scandiano (bivio SP 7),11907,10,11259,647,9262,2645,11907,0
2019/02,238,14/02/2019,4,SP 37 fra Albinea e Scandiano (bivio SP 7),11693,00,11063,630,9119,2574,11693,0
2019/02,239,01/02/2019,5,SP 486R fra Sassuolo e Castellarano,24918,00,21968,2950,19622,5296,24918,0
2019/02,239,02/02/2019,6,SP 486R fra Sassuolo e Castellarano,19358,00,18970,388,14312,5046,0,19358
2019/02,239,03/02/2019,7,SP 486R fra Sassuolo e Castellarano,14775,00,14647,128,10599,4176,0,14775
2019/02,239,04/02/2019,1,SP 486R fra Sassuolo e Castellarano,26069,10,22979,3089,20908,5161,26069,0
2019/02,239,05/02/2019,2,SP 486R fra Sassuolo e Castellarano,26931,10,23474,3456,21558,5373,26931,0
2019/02,239,06/02/2019,3,SP 486R fra Sassuolo e Castellarano,27253,10,23502,3750,21807,5446,27253,0
2019/02,239,07/02/2019,4,SP 486R fra Sassuolo e Castellarano,27453,20,23546,3905,21921,5532,27453,0
2019/02,239,08/02/2019,5,SP 486R fra Sassuolo e Castellarano,27906,10,24392,3513,21806,6100,27906,0
2019/02,239,09/02/2019,6,SP 486R fra Sassuolo e Castellarano,21094,00,20625,469,15501,5593,0,21094
2019/02,239,10/02/2019,7,SP 486R fra Sassuolo e Castellarano,16877,00,16762,115,12343,4534,0,16877
2019/02,239,11/02/2019,1,SP 486R fra Sassuolo e Castellarano,26527,10,23313,3213,21365,5162,26527,0
2019/02,239,12/02/2019,2,SP 486R fra Sassuolo e Castellarano,27052,10,23400,3651,21754,5298,27052,0
2019/02,239,13/02/2019,3,SP 486R fra Sassuolo e Castellarano,27708,00,23865,3843,22094,5614,27708,0
2019/02,239,14/02/2019,4,SP 486R fra Sassuolo e Castellarano,28467,20,24447,4018,22462,6005,28467,0
2019/02,242,01/02/2019,5,SS 12 tra Maranello e Pavullo nel Frignano,13604,10,12445,1158,10399,3205,13604,0
2019/02,242,02/02/2019,6,SS 12 tra Maranello e Pavullo nel Frignano,12548,00,12311,237,9215,3333,0,12548
2019/02,242,03/02/2019,7,SS 12 tra Maranello e Pavullo nel Frignano,12143,00,12093,50,9253,2890,0,12143
2019/02,242,04/02/2019,1,SS 12 tra Maranello e Pavullo nel Frignano,14356,00,13185,1171,11234,3122,14356,0
2019/02,242,05/02/2019,2,SS 12 tra Maranello e Pavullo nel Frignano,14914,00,13698,1216,11769,3145,14914,0
2019/02,242,06/02/2019,3,SS 12 tra Maranello e Pavullo nel Frignano,15322,20,14056,1264,11930,3392,15322,0
2019/02,242,07/02/2019,4,SS 12 tra Maranello e Pavullo nel Frignano,15349,10,14058,1290,11812,3537,15349,0
2019/02,242,08/02/2019,5,SS 12 tra Maranello e Pavullo nel Frignano,16112,00,14799,1313,12256,3856,16112,0
2019/02,242,09/02/2019,6,SS 12 tra Maranello e Pavullo nel Frignano,14677,00,14398,279,10886,3791,0,14677
2019/02,242,10/02/2019,7,SS 12 tra Maranello e Pavullo nel Frignano,12856,00,12815,41,9811,3045,0,12856
2019/02,242,11/02/2019,1,SS 12 tra Maranello e Pavullo nel Frignano,14460,00,13270,1190,11283,3177,14460,0
2019/02,242,12/02/2019,2,SS 12 tra Maranello e Pavullo nel Frignano,14974,00,13593,1381,11638,3336,14974,0
2019/02,242,13/02/2019,3,SS 12 tra Maranello e Pavullo nel Frignano,15328,00,14054,1274,11764,3564,15328,0
2019/02,242,14/02/2019,4,SS 12 tra Maranello e Pavullo nel Frignano,16204,00,14723,1481,12250,3954,16204,0
2019/02,243,01/02/2019,5,SP 27 tra Ponte Samoggia e Muffa,10660,10,9971,688,8417,2243,10660,0
2019/02,243,02/02/2019,6,SP 27 tra Ponte Samoggia e Muffa,7772,00,7612,160,5986,1786,0,7772
2019/02,243,03/02/2019,7,SP 27 tra Ponte Samoggia e Muffa,5575,00,5531,44,4132,1443,0,5575
2019/02,243,04/02/2019,1,SP 27 tra Ponte Samoggia e Muffa,10714,00,9967,747,8606,2108,10714,0
2019/02,243,05/02/2019,2,SP 27 tra Ponte Samoggia e Muffa,10919,00,10066,853,8808,2111,10919,0
2019/02,243,06/02/2019,3,SP 27 tra Ponte Samoggia e Muffa,11762,00,10926,836,9373,2389,11762,0
2019/02,243,07/02/2019,4,SP 27 tra Ponte Samoggia e Muffa,11149,00,10320,829,8908,2241,11149,0
2019/02,243,08/02/2019,5,SP 27 tra Ponte Samoggia e Muffa,11401,00,10537,864,8994,2407,11401,0
2019/02,243,09/02/2019,6,SP 27 tra Ponte Samoggia e Muffa,8404,00,8245,159,6325,2079,0,8404
2019/02,243,10/02/2019,7,SP 27 tra Ponte Samoggia e Muffa,6137,00,6093,44,4601,1536,0,6137
2019/02,243,11/02/2019,1,SP 27 tra Ponte Samoggia e Muffa,10849,00,10025,824,8808,2041,10849,0
2019/02,243,12/02/2019,2,SP 27 tra Ponte Samoggia e Muffa,11124,10,10190,933,8921,2203,11124,0
2019/02,243,13/02/2019,3,SP 27 tra Ponte Samoggia e Muffa,11199,10,10460,738,8857,2342,11199,0
2019/02,243,14/02/2019,4,SP 27 tra Ponte Samoggia e Muffa,11482,00,10698,784,8981,2501,11482,0
2019/02,244,01/02/2019,5,SP 569 tra Pragatto e innesto variante Ponte Ronca,27542,00,25890,1652,21137,6405,27542,0
2019/02,244,02/02/2019,6,SP 569 tra Pragatto e innesto variante Ponte Ronca,25177,00,24833,344,18852,6325,0,25177
2019/02,244,03/02/2019,7,SP 569 tra Pragatto e innesto variante Ponte Ronca,20684,00,20596,88,15452,5232,0,20684
2019/02,244,04/02/2019,1,SP 569 tra Pragatto e innesto variante Ponte Ronca,26612,00,25015,1597,20874,5738,26612,0
2019/02,244,05/02/2019,2,SP 569 tra Pragatto e innesto variante Ponte Ronca,27327,00,25563,1764,21494,5833,27327,0
2019/02,244,06/02/2019,3,SP 569 tra Pragatto e innesto variante Ponte Ronca,26595,00,24841,1754,20426,6169,26595,0
2019/02,244,07/02/2019,4,SP 569 tra Pragatto e innesto variante Ponte Ronca,27700,00,25990,1710,21623,6077,27700,0
2019/02,244,08/02/2019,5,SP 569 tra Pragatto e innesto variante Ponte Ronca,28890,10,27133,1756,21962,6928,28890,0
2019/02,244,09/02/2019,6,SP 569 tra Pragatto e innesto variante Ponte Ronca,26981,00,26641,340,20316,6665,0,26981
2019/02,244,10/02/2019,7,SP 569 tra Pragatto e innesto variante Ponte Ronca,21931,20,21860,69,16681,5250,0,21931
2019/02,244,11/02/2019,1,SP 569 tra Pragatto e innesto variante Ponte Ronca,26840,20,25146,1692,21078,5762,26840,0
2019/02,244,12/02/2019,2,SP 569 tra Pragatto e innesto variante Ponte Ronca,27630,10,25838,1791,21467,6163,27630,0
2019/02,244,13/02/2019,3,SP 569 tra Pragatto e innesto variante Ponte Ronca,27995,30,26212,1780,21803,6192,27995,0
2019/02,244,14/02/2019,4,SP 569 tra Pragatto e innesto variante Ponte Ronca,28739,20,27025,1712,21967,6772,28739,0
2019/02,245,01/02/2019,5,SP 569 da intersezione Pedemontana a Savignano sul Panaro,7114,10,6748,365,5370,1744,7114,0
2019/02,245,02/02/2019,6,SP 569 da intersezione Pedemontana a Savignano sul Panaro,7375,00,7237,138,5453,1922,0,7375
2019/02,245,03/02/2019,7,SP 569 da intersezione Pedemontana a Savignano sul Panaro,6240,00,6180,60,4728,1512,0,6240
2019/02,245,04/02/2019,1,SP 569 da intersezione Pedemontana a Savignano sul Panaro,6681,00,6345,336,5221,1460,6681,0
2019/02,245,05/02/2019,2,SP 569 da intersezione Pedemontana a Savignano sul Panaro,7038,00,6658,380,5486,1552,7038,0
2019/02,245,06/02/2019,3,SP 569 da intersezione Pedemontana a Savignano sul Panaro,7375,10,7000,374,5750,1625,7375,0
2019/02,245,07/02/2019,4,SP 569 da intersezione Pedemontana a Savignano sul Panaro,7458,00,7040,418,5868,1590,7458,0
2019/02,245,08/02/2019,5,SP 569 da intersezione Pedemontana a Savignano sul Panaro,8077,00,7664,413,6143,1934,8077,0
2019/02,245,09/02/2019,6,SP 569 da intersezione Pedemontana a Savignano sul Panaro,8419,00,8271,148,6273,2146,0,8419
2019/02,245,10/02/2019,7,SP 569 da intersezione Pedemontana a Savignano sul Panaro,6826,00,6777,49,5217,1609,0,6826
2019/02,245,11/02/2019,1,SP 569 da intersezione Pedemontana a Savignano sul Panaro,6677,10,6300,376,5241,1436,6677,0
2019/02,245,12/02/2019,2,SP 569 da intersezione Pedemontana a Savignano sul Panaro,7169,00,6721,448,5526,1643,7169,0
2019/02,245,13/02/2019,3,SP 569 da intersezione Pedemontana a Savignano sul Panaro,7509,00,7097,412,5868,1641,7509,0
2019/02,245,14/02/2019,4,SP 569 da intersezione Pedemontana a Savignano sul Panaro,7538,00,7147,391,5703,1835,7538,0
2019/02,246,01/02/2019,5,SP 255 da Decima a San Giovanni in Persiceto,14357,00,13406,951,11084,3273,14357,0
2019/02,246,02/02/2019,6,SP 255 da Decima a San Giovanni in Persiceto,10843,00,10703,140,7731,3112,0,10843
2019/02,246,03/02/2019,7,SP 255 da Decima a San Giovanni in Persiceto,8204,00,8172,32,5584,2620,0,8204
2019/02,246,04/02/2019,1,SP 255 da Decima a San Giovanni in Persiceto,14148,00,13088,1060,11076,3072,14148,0
2019/02,246,05/02/2019,2,SP 255 da Decima a San Giovanni in Persiceto,14119,10,13015,1103,11167,2952,14119,0
2019/02,246,06/02/2019,3,SP 255 da Decima a San Giovanni in Persiceto,15133,00,13978,1155,11903,3230,15133,0
2019/02,246,07/02/2019,4,SP 255 da Decima a San Giovanni in Persiceto,15077,00,13927,1150,11731,3346,15077,0
2019/02,246,08/02/2019,5,SP 255 da Decima a San Giovanni in Persiceto,15039,10,14001,1037,11529,3510,15039,0
2019/02,246,09/02/2019,6,SP 255 da Decima a San Giovanni in Persiceto,11695,00,11500,195,8378,3317,0,11695
2019/02,246,10/02/2019,7,SP 255 da Decima a San Giovanni in Persiceto,9107,10,9046,60,6574,2533,0,9107
2019/02,246,11/02/2019,1,SP 255 da Decima a San Giovanni in Persiceto,14264,00,13177,1087,11212,3052,14264,0
2019/02,246,12/02/2019,2,SP 255 da Decima a San Giovanni in Persiceto,14648,10,13492,1155,11560,3088,14648,0
2019/02,246,13/02/2019,3,SP 255 da Decima a San Giovanni in Persiceto,15108,10,13943,1164,11713,3395,15108,0
2019/02,246,14/02/2019,4,SP 255 da Decima a San Giovanni in Persiceto,15519,00,14365,1154,11801,3718,15519,0
2019/02,247,01/02/2019,5,SP 255 fra Nonantola e Sant'Agata Bolognese,9848,00,8472,1376,7580,2268,9848,0
2019/02,247,02/02/2019,6,SP 255 fra Nonantola e Sant'Agata Bolognese,6470,00,6270,200,4490,1980,0,6470
2019/02,247,03/02/2019,7,SP 255 fra Nonantola e Sant'Agata Bolognese,5334,00,5308,26,3614,1720,0,5334
2019/02,247,04/02/2019,1,SP 255 fra Nonantola e Sant'Agata Bolognese,8792,10,7477,1314,6831,1961,8792,0
2019/02,247,05/02/2019,2,SP 255 fra Nonantola e Sant'Agata Bolognese,8989,10,7581,1407,6933,2056,8989,0
2019/02,247,06/02/2019,3,SP 255 fra Nonantola e Sant'Agata Bolognese,10533,00,9014,1519,8215,2318,10533,0
2019/02,247,07/02/2019,4,SP 255 fra Nonantola e Sant'Agata Bolognese,10456,00,8929,1527,8102,2354,10456,0
2019/02,247,08/02/2019,5,SP 255 fra Nonantola e Sant'Agata Bolognese,10996,00,9477,1519,8339,2657,10996,0
2019/02,247,09/02/2019,6,SP 255 fra Nonantola e Sant'Agata Bolognese,7817,00,7577,240,5311,2506,0,7817
2019/02,247,10/02/2019,7,SP 255 fra Nonantola e Sant'Agata Bolognese,6269,00,6203,66,4366,1903,0,6269
2019/02,247,11/02/2019,1,SP 255 fra Nonantola e Sant'Agata Bolognese,10025,00,8637,1388,7864,2161,10025,0
2019/02,247,12/02/2019,2,SP 255 fra Nonantola e Sant'Agata Bolognese,10446,00,8915,1531,8159,2287,10446,0
2019/02,247,13/02/2019,3,SP 255 fra Nonantola e Sant'Agata Bolognese,10433,10,8912,1520,8093,2340,10433,0
2019/02,247,14/02/2019,4,SP 255 fra Nonantola e Sant'Agata Bolognese,10768,10,9260,1507,8194,2574,10768,0
2019/02,251,01/02/2019,5,SP 610 tra Imola e Casalfiumanese in località Ca' Miseria,12695,00,12076,619,9718,2977,12695,0
2019/02,251,02/02/2019,6,SP 610 tra Imola e Casalfiumanese in località Ca' Miseria,11627,00,11457,170,8664,2963,0,11627
2019/02,251,03/02/2019,7,SP 610 tra Imola e Casalfiumanese in località Ca' Miseria,9007,10,8977,29,6800,2207,0,9007
2019/02,251,04/02/2019,1,SP 610 tra Imola e Casalfiumanese in località Ca' Miseria,12110,10,11424,685,9545,2565,12110,0
2019/02,251,05/02/2019,2,SP 610 tra Imola e Casalfiumanese in località Ca' Miseria,12678,00,11969,709,9856,2822,12678,0
2019/02,251,06/02/2019,3,SP 610 tra Imola e Casalfiumanese in località Ca' Miseria,12956,00,12303,653,9878,3078,12956,0
2019/02,251,07/02/2019,4,SP 610 tra Imola e Casalfiumanese in località Ca' Miseria,13168,20,12467,699,10237,2931,13168,0
2019/02,251,08/02/2019,5,SP 610 tra Imola e Casalfiumanese in località Ca' Miseria,13404,00,12720,684,10255,3149,13404,0
2019/02,251,09/02/2019,6,SP 610 tra Imola e Casalfiumanese in località Ca' Miseria,12359,00,12179,180,9311,3048,0,12359
2019/02,251,10/02/2019,7,SP 610 tra Imola e Casalfiumanese in località Ca' Miseria,9327,10,9269,57,7150,2177,0,9327
2019/02,251,11/02/2019,1,SP 610 tra Imola e Casalfiumanese in località Ca' Miseria,12290,10,11640,649,9700,2590,12290,0
2019/02,251,12/02/2019,2,SP 610 tra Imola e Casalfiumanese in località Ca' Miseria,12649,10,11885,763,9771,2878,12649,0
2019/02,251,13/02/2019,3,SP 610 tra Imola e Casalfiumanese in località Ca' Miseria,13141,00,12409,732,10084,3057,13141,0
2019/02,251,14/02/2019,4,SP 610 tra Imola e Casalfiumanese in località Ca' Miseria,13620,00,12853,767,10417,3203,13620,0
2019/02,252,01/02/2019,5,SP 3_2 tra Budrio e bivio SP 29 per Medicina,8970,00,8278,692,7123,1847,8970,0
2019/02,252,02/02/2019,6,SP 3_2 tra Budrio e bivio SP 29 per Medicina,6071,00,5963,108,4631,1440,0,6071
2019/02,252,03/02/2019,7,SP 3_2 tra Budrio e bivio SP 29 per Medicina,5770,00,5751,19,4466,1304,0,5770
2019/02,252,04/02/2019,1,SP 3_2 tra Budrio e bivio SP 29 per Medicina,8589,10,7912,676,6979,1610,8589,0
2019/02,252,05/02/2019,2,SP 3_2 tra Budrio e bivio SP 29 per Medicina,9177,00,8417,760,7391,1786,9177,0
2019/02,252,06/02/2019,3,SP 3_2 tra Budrio e bivio SP 29 per Medicina,8951,00,8117,834,7136,1815,8951,0
2019/02,252,07/02/2019,4,SP 3_2 tra Budrio e bivio SP 29 per Medicina,9171,10,8361,809,7361,1810,9171,0
2019/02,252,08/02/2019,5,SP 3_2 tra Budrio e bivio SP 29 per Medicina,9475,00,8667,808,7502,1973,9475,0
2019/02,252,09/02/2019,6,SP 3_2 tra Budrio e bivio SP 29 per Medicina,6811,00,6673,138,5009,1802,0,6811
2019/02,252,10/02/2019,7,SP 3_2 tra Budrio e bivio SP 29 per Medicina,5958,00,5924,34,4549,1409,0,5958
2019/02,252,11/02/2019,1,SP 3_2 tra Budrio e bivio SP 29 per Medicina,8962,10,8198,763,7248,1714,8962,0
2019/02,252,12/02/2019,2,SP 3_2 tra Budrio e bivio SP 29 per Medicina,9126,30,8371,752,7379,1747,9126,0
2019/02,252,13/02/2019,3,SP 3_2 tra Budrio e bivio SP 29 per Medicina,9359,10,8571,787,7460,1899,9359,0
2019/02,252,14/02/2019,4,SP 3_2 tra Budrio e bivio SP 29 per Medicina,9476,10,8669,806,7558,1918,9476,0
2019/02,255,01/02/2019,5,SS 9 tra Castel San Pietro e Imola,19530,30,18890,637,15330,4200,19530,0
2019/02,255,02/02/2019,6,SS 9 tra Castel San Pietro e Imola,16564,20,16352,210,12216,4348,0,16564
2019/02,255,03/02/2019,7,SS 9 tra Castel San Pietro e Imola,13289,10,13227,61,9606,3683,0,13289
2019/02,255,04/02/2019,1,SS 9 tra Castel San Pietro e Imola,18951,40,18229,718,14791,4160,18951,0
2019/02,255,05/02/2019,2,SS 9 tra Castel San Pietro e Imola,19172,30,18424,745,15054,4118,19172,0
2019/02,255,06/02/2019,3,SS 9 tra Castel San Pietro e Imola,19916,30,19165,748,15699,4217,19916,0
2019/02,255,07/02/2019,4,SS 9 tra Castel San Pietro e Imola,19479,60,18712,761,15373,4106,19479,0
2019/02,255,08/02/2019,5,SS 9 tra Castel San Pietro e Imola,20707,30,19868,836,15949,4758,20707,0
2019/02,255,09/02/2019,6,SS 9 tra Castel San Pietro e Imola,17952,40,17698,250,13252,4700,0,17952
2019/02,255,10/02/2019,7,SS 9 tra Castel San Pietro e Imola,13798,10,13724,73,10157,3641,0,13798
2019/02,255,11/02/2019,1,SS 9 tra Castel San Pietro e Imola,19411,00,18625,786,15388,4023,19411,0
2019/02,255,12/02/2019,2,SS 9 tra Castel San Pietro e Imola,19543,30,18747,793,15420,4123,19543,0
2019/02,255,13/02/2019,3,SS 9 tra Castel San Pietro e Imola,19792,40,19054,734,15463,4329,19792,0
2019/02,255,14/02/2019,4,SS 9 tra Castel San Pietro e Imola,20239,40,19409,826,15709,4530,20239,0
2019/02,256,01/02/2019,5,SP 302R tra Faenza (bivio SP 66) e Brisighella,7797,00,7600,197,6027,1770,7797,0
2019/02,256,02/02/2019,6,SP 302R tra Faenza (bivio SP 66) e Brisighella,7043,00,6966,77,5294,1749,0,7043
2019/02,256,03/02/2019,7,SP 302R tra Faenza (bivio SP 66) e Brisighella,6369,10,6353,15,4978,1391,0,6369
2019/02,256,04/02/2019,1,SP 302R tra Faenza (bivio SP 66) e Brisighella,7542,00,7372,170,5997,1545,7542,0
2019/02,256,05/02/2019,2,SP 302R tra Faenza (bivio SP 66) e Brisighella,7786,00,7580,206,6215,1571,7786,0
2019/02,256,06/02/2019,3,SP 302R tra Faenza (bivio SP 66) e Brisighella,8117,00,7844,273,6443,1674,8117,0
2019/02,256,07/02/2019,4,SP 302R tra Faenza (bivio SP 66) e Brisighella,7949,00,7689,260,6286,1663,7949,0
2019/02,256,08/02/2019,5,SP 302R tra Faenza (bivio SP 66) e Brisighella,8303,00,8057,246,6430,1873,8303,0
2019/02,256,09/02/2019,6,SP 302R tra Faenza (bivio SP 66) e Brisighella,8128,00,8036,92,6167,1961,0,8128
2019/02,256,10/02/2019,7,SP 302R tra Faenza (bivio SP 66) e Brisighella,6816,00,6796,20,5401,1415,0,6816
2019/02,256,11/02/2019,1,SP 302R tra Faenza (bivio SP 66) e Brisighella,7777,00,7543,234,6135,1642,7777,0
2019/02,256,12/02/2019,2,SP 302R tra Faenza (bivio SP 66) e Brisighella,7881,20,7621,258,6230,1651,7881,0
2019/02,256,13/02/2019,3,SP 302R tra Faenza (bivio SP 66) e Brisighella,8155,00,7932,223,6359,1796,8155,0
2019/02,256,14/02/2019,4,SP 302R tra Faenza (bivio SP 66) e Brisighella,8566,00,8314,252,6482,2084,8566,0
2019/02,257,01/02/2019,5,SP 302R tra Faenza e il bivio SP 4 (a sud di Russi),6258,00,6084,174,4844,1414,6258,0
2019/02,257,02/02/2019,6,SP 302R tra Faenza e il bivio SP 4 (a sud di Russi),5434,00,5366,68,3909,1525,0,5434
2019/02,257,03/02/2019,7,SP 302R tra Faenza e il bivio SP 4 (a sud di Russi),4427,00,4409,18,3204,1223,0,4427
2019/02,257,04/02/2019,1,SP 302R tra Faenza e il bivio SP 4 (a sud di Russi),6018,00,5823,195,4770,1248,6018,0
2019/02,257,05/02/2019,2,SP 302R tra Faenza e il bivio SP 4 (a sud di Russi),6163,00,5965,198,4833,1330,6163,0
2019/02,257,06/02/2019,3,SP 302R tra Faenza e il bivio SP 4 (a sud di Russi),6513,00,6327,186,5039,1474,6513,0
2019/02,257,07/02/2019,4,SP 302R tra Faenza e il bivio SP 4 (a sud di Russi),6243,00,6059,184,4847,1396,6243,0
2019/02,257,08/02/2019,5,SP 302R tra Faenza e il bivio SP 4 (a sud di Russi),6434,00,6227,207,4943,1491,6434,0
2019/02,257,09/02/2019,6,SP 302R tra Faenza e il bivio SP 4 (a sud di Russi),5543,10,5467,75,4081,1462,0,5543
2019/02,257,10/02/2019,7,SP 302R tra Faenza e il bivio SP 4 (a sud di Russi),4648,00,4624,24,3508,1140,0,4648
2019/02,257,11/02/2019,1,SP 302R tra Faenza e il bivio SP 4 (a sud di Russi),6056,00,5864,192,4765,1291,6056,0
2019/02,257,12/02/2019,2,SP 302R tra Faenza e il bivio SP 4 (a sud di Russi),6361,00,6154,207,4956,1405,6361,0
2019/02,257,13/02/2019,3,SP 302R tra Faenza e il bivio SP 4 (a sud di Russi),6442,00,6245,197,4965,1477,6442,0
2019/02,257,14/02/2019,4,SP 302R tra Faenza e il bivio SP 4 (a sud di Russi),6469,00,6263,206,4962,1507,6469,0
2019/02,258,01/02/2019,5,SS 9 tra Forlimpopoli e Cesena,24715,60,22680,2029,18885,5830,24715,0
2019/02,258,02/02/2019,6,SS 9 tra Forlimpopoli e Cesena,19611,00,18921,690,13729,5882,0,19611
2019/02,258,03/02/2019,7,SS 9 tra Forlimpopoli e Cesena,15520,10,15348,171,11048,4472,0,15520
2019/02,258,04/02/2019,1,SS 9 tra Forlimpopoli e Cesena,22880,00,20985,1895,18071,4809,22880,0
2019/02,258,05/02/2019,2,SS 9 tra Forlimpopoli e Cesena,23939,30,21905,2031,18801,5138,23939,0
2019/02,258,06/02/2019,3,SS 9 tra Forlimpopoli e Cesena,24403,30,22430,1970,18842,5561,24403,0
2019/02,258,07/02/2019,4,SS 9 tra Forlimpopoli e Cesena,24383,40,22369,2010,18895,5488,24383,0
2019/02,258,08/02/2019,5,SS 9 tra Forlimpopoli e Cesena,24852,10,22908,1943,18905,5947,24852,0
2019/02,258,09/02/2019,6,SS 9 tra Forlimpopoli e Cesena,21134,10,20397,736,15259,5875,0,21134
2019/02,258,10/02/2019,7,SS 9 tra Forlimpopoli e Cesena,16198,00,15985,213,11593,4605,0,16198
2019/02,258,11/02/2019,1,SS 9 tra Forlimpopoli e Cesena,24009,50,21901,2103,18814,5195,24009,0
2019/02,258,12/02/2019,2,SS 9 tra Forlimpopoli e Cesena,24505,20,22477,2026,19043,5462,24505,0
2019/02,258,13/02/2019,3,SS 9 tra Forlimpopoli e Cesena,25779,30,23747,2029,19278,6501,25779,0
2019/02,258,14/02/2019,4,SS 9 tra Forlimpopoli e Cesena,25372,70,23257,2108,19381,5991,25372,0
2019/02,259,01/02/2019,5,SP 7 in località Calabrina al Confine Provinciale,7578,00,7161,417,5623,1955,7578,0
2019/02,259,02/02/2019,6,SP 7 in località Calabrina al Confine Provinciale,6427,00,6222,205,4272,2155,0,6427
2019/02,259,03/02/2019,7,SP 7 in località Calabrina al Confine Provinciale,5897,00,5877,20,4141,1756,0,5897
2019/02,259,04/02/2019,1,SP 7 in località Calabrina al Confine Provinciale,7299,00,6850,449,5749,1550,7299,0
2019/02,259,05/02/2019,2,SP 7 in località Calabrina al Confine Provinciale,7742,00,7309,433,6184,1558,7742,0
2019/02,259,06/02/2019,3,SP 7 in località Calabrina al Confine Provinciale,7743,00,7298,445,6150,1593,7743,0
2019/02,259,07/02/2019,4,SP 7 in località Calabrina al Confine Provinciale,7987,00,7535,452,6235,1752,7987,0
2019/02,259,08/02/2019,5,SP 7 in località Calabrina al Confine Provinciale,8423,00,7911,512,6363,2060,8423,0
2019/02,259,09/02/2019,6,SP 7 in località Calabrina al Confine Provinciale,8703,00,8511,192,6272,2431,0,8703
2019/02,259,10/02/2019,7,SP 7 in località Calabrina al Confine Provinciale,7757,00,7714,43,5519,2238,0,7757
2019/02,259,11/02/2019,1,SP 7 in località Calabrina al Confine Provinciale,7334,00,6853,481,5803,1531,7334,0
2019/02,259,12/02/2019,2,SP 7 in località Calabrina al Confine Provinciale,8001,00,7575,426,6337,1664,8001,0
2019/02,259,13/02/2019,3,SP 7 in località Calabrina al Confine Provinciale,8244,00,7740,504,6473,1771,8244,0
2019/02,259,14/02/2019,4,SP 7 in località Calabrina al Confine Provinciale,9205,00,8708,497,6808,2397,9205,0
2019/02,260,01/02/2019,5,SP 8 tra Cesena e A 14,11552,10,11220,331,9026,2526,11552,0
2019/02,260,02/02/2019,6,SP 8 tra Cesena e A 14,9892,00,9805,87,7162,2730,0,9892
2019/02,260,03/02/2019,7,SP 8 tra Cesena e A 14,8089,10,8070,18,5962,2127,0,8089
2019/02,260,04/02/2019,1,SP 8 tra Cesena e A 14,10797,20,10511,284,8851,1946,10797,0
2019/02,260,05/02/2019,2,SP 8 tra Cesena e A 14,11271,00,10976,295,9153,2118,11271,0
2019/02,260,06/02/2019,3,SP 8 tra Cesena e A 14,11168,00,10855,313,8911,2257,11168,0
2019/02,260,07/02/2019,4,SP 8 tra Cesena e A 14,11211,00,10875,336,8975,2236,11211,0
2019/02,260,08/02/2019,5,SP 8 tra Cesena e A 14,11736,00,11379,357,9112,2624,11736,0
2019/02,260,09/02/2019,6,SP 8 tra Cesena e A 14,11103,00,10975,128,8273,2830,0,11103
2019/02,260,10/02/2019,7,SP 8 tra Cesena e A 14,8466,00,8449,17,6279,2187,0,8466
2019/02,260,11/02/2019,1,SP 8 tra Cesena e A 14,10834,00,10512,322,8920,1914,10834,0
2019/02,260,12/02/2019,2,SP 8 tra Cesena e A 14,11217,00,10910,307,9017,2200,11217,0
2019/02,260,13/02/2019,3,SP 8 tra Cesena e A 14,11414,10,11078,335,9062,2352,11414,0
2019/02,260,14/02/2019,4,SP 8 tra Cesena e A 14,11694,00,11399,295,9074,2620,11694,0
2019/02,261,01/02/2019,5,SS 9 tra Cesena e Savignano sul Rubicone,28666,00,26535,2131,22145,6521,28666,0
2019/02,261,02/02/2019,6,SS 9 tra Cesena e Savignano sul Rubicone,21678,00,20937,741,15430,6248,0,21678
2019/02,261,03/02/2019,7,SS 9 tra Cesena e Savignano sul Rubicone,15975,00,15829,146,11153,4822,0,15975
2019/02,261,04/02/2019,1,SS 9 tra Cesena e Savignano sul Rubicone,27541,00,25396,2145,22196,5345,27541,0
2019/02,261,05/02/2019,2,SS 9 tra Cesena e Savignano sul Rubicone,28002,10,25817,2184,22319,5683,28002,0
2019/02,261,06/02/2019,3,SS 9 tra Cesena e Savignano sul Rubicone,28397,00,26235,2162,22306,6091,28397,0
2019/02,261,07/02/2019,4,SS 9 tra Cesena e Savignano sul Rubicone,28415,10,26211,2203,22225,6190,28415,0
2019/02,261,08/02/2019,5,SS 9 tra Cesena e Savignano sul Rubicone,29018,00,26894,2124,22355,6663,29018,0
2019/02,261,09/02/2019,6,SS 9 tra Cesena e Savignano sul Rubicone,23051,10,22222,828,16750,6301,0,23051
2019/02,261,10/02/2019,7,SS 9 tra Cesena e Savignano sul Rubicone,16058,00,15925,133,11080,4978,0,16058
2019/02,261,11/02/2019,1,SS 9 tra Cesena e Savignano sul Rubicone,28259,00,26169,2090,22412,5847,28259,0
2019/02,261,13/02/2019,3,SS 9 tra Cesena e Savignano sul Rubicone,28667,00,26501,2166,22467,6200,28667,0
2019/02,261,14/02/2019,4,SS 9 tra Cesena e Savignano sul Rubicone,29230,10,26948,2281,22581,6649,29230,0
2019/02,262,01/02/2019,5,SS 9 tra Savignano sul Rubicone e Santarcangelo di Romagna,,,,,,,,
2019/02,262,02/02/2019,6,SS 9 tra Savignano sul Rubicone e Santarcangelo di Romagna,,,,,,,,
2019/02,262,03/02/2019,7,SS 9 tra Savignano sul Rubicone e Santarcangelo di Romagna,,,,,,,,
2019/02,262,04/02/2019,1,SS 9 tra Savignano sul Rubicone e Santarcangelo di Romagna,,,,,,,,
2019/02,262,05/02/2019,2,SS 9 tra Savignano sul Rubicone e Santarcangelo di Romagna,,,,,,,,
2019/02,262,06/02/2019,3,SS 9 tra Savignano sul Rubicone e Santarcangelo di Romagna,,,,,,,,
2019/02,262,07/02/2019,4,SS 9 tra Savignano sul Rubicone e Santarcangelo di Romagna,,,,,,,,
2019/02,262,08/02/2019,5,SS 9 tra Savignano sul Rubicone e Santarcangelo di Romagna,,,,,,,,
2019/02,262,09/02/2019,6,SS 9 tra Savignano sul Rubicone e Santarcangelo di Romagna,,,,,,,,
2019/02,262,10/02/2019,7,SS 9 tra Savignano sul Rubicone e Santarcangelo di Romagna,,,,,,,,
2019/02,262,11/02/2019,1,SS 9 tra Savignano sul Rubicone e Santarcangelo di Romagna,,,,,,,,
2019/02,262,12/02/2019,2,SS 9 tra Savignano sul Rubicone e Santarcangelo di Romagna,,,,,,,,
2019/02,262,13/02/2019,3,SS 9 tra Savignano sul Rubicone e Santarcangelo di Romagna,,,,,,,,
2019/02,262,14/02/2019,4,SS 9 tra Savignano sul Rubicone e Santarcangelo di Romagna,,,,,,,,
2019/02,263,01/02/2019,5,Via Adriatica (ex SS 16) tra Riccione e Misano Adriatico,17055,20,16685,368,12815,4240,17055,0
2019/02,263,02/02/2019,6,Via Adriatica (ex SS 16) tra Riccione e Misano Adriatico,16073,10,15923,149,10950,5123,0,16073
2019/02,263,03/02/2019,7,Via Adriatica (ex SS 16) tra Riccione e Misano Adriatico,13836,20,13796,38,8978,4858,0,13836
2019/02,263,04/02/2019,1,Via Adriatica (ex SS 16) tra Riccione e Misano Adriatico,15874,00,15493,381,12579,3295,15874,0
2019/02,263,05/02/2019,2,Via Adriatica (ex SS 16) tra Riccione e Misano Adriatico,16581,00,16178,403,13123,3458,16581,0
2019/02,263,06/02/2019,3,Via Adriatica (ex SS 16) tra Riccione e Misano Adriatico,16383,00,15947,436,12730,3653,16383,0
2019/02,263,07/02/2019,4,Via Adriatica (ex SS 16) tra Riccione e Misano Adriatico,16423,10,16020,402,12663,3760,16423,0
2019/02,263,08/02/2019,5,Via Adriatica (ex SS 16) tra Riccione e Misano Adriatico,17353,20,16893,458,13087,4266,17353,0
2019/02,263,09/02/2019,6,Via Adriatica (ex SS 16) tra Riccione e Misano Adriatico,16484,00,16330,154,11252,5232,0,16484
2019/02,263,10/02/2019,7,Via Adriatica (ex SS 16) tra Riccione e Misano Adriatico,13989,00,13951,38,9369,4620,0,13989
2019/02,263,11/02/2019,1,Via Adriatica (ex SS 16) tra Riccione e Misano Adriatico,16196,00,15815,381,12851,3345,16196,0
2019/02,263,12/02/2019,2,Via Adriatica (ex SS 16) tra Riccione e Misano Adriatico,16527,10,16090,436,12987,3540,16527,0
2019/02,263,13/02/2019,3,Via Adriatica (ex SS 16) tra Riccione e Misano Adriatico,16326,00,15918,408,12656,3670,16326,0
2019/02,263,14/02/2019,4,Via Adriatica (ex SS 16) tra Riccione e Misano Adriatico,17246,20,16766,478,13000,4246,17246,0
2019/02,269,01/02/2019,5,SS 12 a Medolla,19084,00,17402,1682,15023,4061,19084,0
2019/02,269,02/02/2019,6,SS 12 a Medolla,14466,60,13738,722,10375,4091,0,14466
2019/02,269,03/02/2019,7,SS 12 a Medolla,11622,00,11521,101,8216,3406,0,11622
2019/02,269,04/02/2019,1,SS 12 a Medolla,19157,20,17325,1830,15489,3668,19157,0
2019/02,269,05/02/2019,2,SS 12 a Medolla,19484,00,17566,1918,15833,3651,19484,0
2019/02,269,06/02/2019,3,SS 12 a Medolla,19807,00,17883,1924,15909,3898,19807,0
2019/02,269,07/02/2019,4,SS 12 a Medolla,20000,00,18031,1969,16085,3915,20000,0
2019/02,269,08/02/2019,5,SS 12 a Medolla,19997,20,18091,1904,15529,4468,19997,0
2019/02,269,09/02/2019,6,SS 12 a Medolla,14935,00,14573,362,10585,4350,0,14935
2019/02,269,10/02/2019,7,SS 12 a Medolla,12637,00,12579,58,9014,3623,0,12637
2019/02,269,11/02/2019,1,SS 12 a Medolla,19310,00,17380,1930,15665,3645,19310,0
2019/02,269,12/02/2019,2,SS 12 a Medolla,19945,10,17911,2033,16079,3866,19945,0
2019/02,269,13/02/2019,3,SS 12 a Medolla,20313,20,18335,1976,16252,4061,20313,0
2019/02,269,14/02/2019,4,SS 12 a Medolla,20591,00,18582,2009,16278,4313,20591,0
2019/02,275,01/02/2019,5,SP 5 dall'intersezione SP 3 a intersezione per Ca' de Fabbri,10932,00,10540,392,8683,2249,10932,0
2019/02,275,02/02/2019,6,SP 5 dall'intersezione SP 3 a intersezione per Ca' de Fabbri,7772,00,7666,106,5713,2059,0,7772
2019/02,275,03/02/2019,7,SP 5 dall'intersezione SP 3 a intersezione per Ca' de Fabbri,6039,00,5997,42,4289,1750,0,6039
2019/02,275,04/02/2019,1,SP 5 dall'intersezione SP 3 a intersezione per Ca' de Fabbri,10561,00,10129,432,8501,2060,10561,0
2019/02,275,05/02/2019,2,SP 5 dall'intersezione SP 3 a intersezione per Ca' de Fabbri,10744,00,10299,445,8565,2179,10744,0
2019/02,275,06/02/2019,3,SP 5 dall'intersezione SP 3 a intersezione per Ca' de Fabbri,11109,20,10617,490,8795,2314,11109,0
2019/02,275,07/02/2019,4,SP 5 dall'intersezione SP 3 a intersezione per Ca' de Fabbri,10999,00,10528,471,8735,2264,10999,0
2019/02,275,08/02/2019,5,SP 5 dall'intersezione SP 3 a intersezione per Ca' de Fabbri,11242,00,10744,498,8837,2405,11242,0
2019/02,275,09/02/2019,6,SP 5 dall'intersezione SP 3 a intersezione per Ca' de Fabbri,8749,00,8595,154,6436,2313,0,8749
2019/02,275,10/02/2019,7,SP 5 dall'intersezione SP 3 a intersezione per Ca' de Fabbri,6627,00,6591,36,4789,1838,0,6627
2019/02,275,11/02/2019,1,SP 5 dall'intersezione SP 3 a intersezione per Ca' de Fabbri,10790,10,10280,509,8634,2156,10790,0
2019/02,275,12/02/2019,2,SP 5 dall'intersezione SP 3 a intersezione per Ca' de Fabbri,11130,00,10611,519,8882,2248,11130,0
2019/02,275,13/02/2019,3,SP 5 dall'intersezione SP 3 a intersezione per Ca' de Fabbri,11145,00,10575,570,8824,2321,11145,0
2019/02,275,14/02/2019,4,SP 5 dall'intersezione SP 3 a intersezione per Ca' de Fabbri,11416,00,10908,508,8857,2559,11416,0
2019/02,276,01/02/2019,5,SP 3_2 tra intersezione SP 5 e ponte torrente Idice,12001,00,11041,960,9686,2315,12001,0
2019/02,276,02/02/2019,6,SP 3_2 tra intersezione SP 5 e ponte torrente Idice,6574,00,6408,166,4962,1612,0,6574
2019/02,276,03/02/2019,7,SP 3_2 tra intersezione SP 5 e ponte torrente Idice,5911,00,5866,45,4416,1495,0,5911
2019/02,276,04/02/2019,1,SP 3_2 tra intersezione SP 5 e ponte torrente Idice,11641,00,10688,953,9511,2130,11641,0
2019/02,276,05/02/2019,2,SP 3_2 tra intersezione SP 5 e ponte torrente Idice,12305,00,11261,1044,9930,2375,12305,0
2019/02,276,06/02/2019,3,SP 3_2 tra intersezione SP 5 e ponte torrente Idice,12535,00,11397,1138,10117,2418,12535,0
2019/02,276,07/02/2019,4,SP 3_2 tra intersezione SP 5 e ponte torrente Idice,12130,00,11022,1108,9700,2430,12130,0
2019/02,276,08/02/2019,5,SP 3_2 tra intersezione SP 5 e ponte torrente Idice,12174,00,11080,1094,9553,2621,12174,0
2019/02,276,09/02/2019,6,SP 3_2 tra intersezione SP 5 e ponte torrente Idice,7592,00,7396,196,5562,2030,0,7592
2019/02,276,10/02/2019,7,SP 3_2 tra intersezione SP 5 e ponte torrente Idice,7523,00,7462,61,5722,1801,0,7523
2019/02,276,11/02/2019,1,SP 3_2 tra intersezione SP 5 e ponte torrente Idice,12281,00,11201,1080,10007,2274,12281,0
2019/02,276,12/02/2019,2,SP 3_2 tra intersezione SP 5 e ponte torrente Idice,12376,00,11266,1110,9952,2424,12376,0
2019/02,276,13/02/2019,3,SP 3_2 tra intersezione SP 5 e ponte torrente Idice,12983,00,11748,1235,10360,2623,12983,0
2019/02,276,14/02/2019,4,SP 3_2 tra intersezione SP 5 e ponte torrente Idice,13022,00,11889,1133,10326,2696,13022,0
2019/02,277,01/02/2019,5,SP 6 tra Budrio e San Martino in Argine,7576,00,7155,421,5864,1712,7576,0
2019/02,277,02/02/2019,6,SP 6 tra Budrio e San Martino in Argine,5637,00,5518,119,4166,1471,0,5637
2019/02,277,03/02/2019,7,SP 6 tra Budrio e San Martino in Argine,4382,00,4354,28,3178,1204,0,4382
2019/02,277,04/02/2019,1,SP 6 tra Budrio e San Martino in Argine,7629,00,7168,461,6039,1590,7629,0
2019/02,277,05/02/2019,2,SP 6 tra Budrio e San Martino in Argine,7820,00,7349,471,6138,1682,7820,0
2019/02,277,06/02/2019,3,SP 6 tra Budrio e San Martino in Argine,7873,00,7361,512,6229,1644,7873,0
2019/02,277,07/02/2019,4,SP 6 tra Budrio e San Martino in Argine,7766,00,7295,471,6062,1704,7766,0
2019/02,277,08/02/2019,5,SP 6 tra Budrio e San Martino in Argine,8023,00,7577,446,6107,1916,8023,0
2019/02,277,09/02/2019,6,SP 6 tra Budrio e San Martino in Argine,6138,00,6008,130,4535,1603,0,6138
2019/02,277,10/02/2019,7,SP 6 tra Budrio e San Martino in Argine,4510,00,4486,24,3246,1264,0,4510
2019/02,277,11/02/2019,1,SP 6 tra Budrio e San Martino in Argine,7555,00,7090,465,6009,1546,7555,0
2019/02,277,12/02/2019,2,SP 6 tra Budrio e San Martino in Argine,7846,10,7376,469,6163,1683,7846,0
2019/02,277,13/02/2019,3,SP 6 tra Budrio e San Martino in Argine,7920,00,7422,498,6253,1667,7920,0
2019/02,277,14/02/2019,4,SP 6 tra Budrio e San Martino in Argine,8155,00,7658,497,6294,1861,8155,0
2019/02,278,01/02/2019,5,SP 6 tra Budrio e bivio SP 253,14149,00,13466,683,11140,3009,14149,0
2019/02,278,02/02/2019,6,SP 6 tra Budrio e bivio SP 253,10755,00,10598,157,8055,2700,0,10755
2019/02,278,03/02/2019,7,SP 6 tra Budrio e bivio SP 253,8159,00,8110,49,5918,2241,0,8159
2019/02,278,04/02/2019,1,SP 6 tra Budrio e bivio SP 253,13510,00,12857,653,10816,2694,13510,0
2019/02,278,05/02/2019,2,SP 6 tra Budrio e bivio SP 253,14125,10,13403,721,11310,2815,14125,0
2019/02,278,06/02/2019,3,SP 6 tra Budrio e bivio SP 253,14022,00,13289,733,11157,2865,14022,0
2019/02,278,07/02/2019,4,SP 6 tra Budrio e bivio SP 253,13877,00,13186,691,10932,2945,13877,0
2019/02,278,08/02/2019,5,SP 6 tra Budrio e bivio SP 253,14329,00,13665,664,11147,3182,14329,0
2019/02,278,09/02/2019,6,SP 6 tra Budrio e bivio SP 253,11245,10,11082,162,8219,3026,0,11245
2019/02,278,10/02/2019,7,SP 6 tra Budrio e bivio SP 253,8022,00,7982,40,5769,2253,0,8022
2019/02,278,11/02/2019,1,SP 6 tra Budrio e bivio SP 253,13590,00,12862,728,10876,2714,13590,0
2019/02,278,12/02/2019,2,SP 6 tra Budrio e bivio SP 253,14195,00,13450,745,11340,2855,14195,0
2019/02,278,13/02/2019,3,SP 6 tra Budrio e bivio SP 253,14249,00,13500,749,11282,2967,14249,0
2019/02,278,14/02/2019,4,SP 6 tra Budrio e bivio SP 253,14369,00,13625,744,11135,3234,14369,0
2019/02,279,01/02/2019,5,SP 31 dal bivio SP 28 per Castenaso a Ponte Rizzoli,13524,00,12699,825,11214,2310,13524,0
2019/02,279,02/02/2019,6,SP 31 dal bivio SP 28 per Castenaso a Ponte Rizzoli,8942,00,8819,123,6930,2012,0,8942
2019/02,279,03/02/2019,7,SP 31 dal bivio SP 28 per Castenaso a Ponte Rizzoli,7423,00,7372,51,5759,1664,0,7423
2019/02,279,04/02/2019,1,SP 31 dal bivio SP 28 per Castenaso a Ponte Rizzoli,13456,00,12543,913,11307,2149,13456,0
2019/02,279,05/02/2019,2,SP 31 dal bivio SP 28 per Castenaso a Ponte Rizzoli,13890,00,12987,903,11609,2281,13890,0
2019/02,279,06/02/2019,3,SP 31 dal bivio SP 28 per Castenaso a Ponte Rizzoli,13901,00,12997,904,11642,2259,13901,0
2019/02,279,07/02/2019,4,SP 31 dal bivio SP 28 per Castenaso a Ponte Rizzoli,13923,00,13011,912,11601,2322,13923,0
2019/02,279,08/02/2019,5,SP 31 dal bivio SP 28 per Castenaso a Ponte Rizzoli,14499,00,13554,945,11941,2558,14499,0
2019/02,279,09/02/2019,6,SP 31 dal bivio SP 28 per Castenaso a Ponte Rizzoli,9748,00,9589,159,7600,2148,0,9748
2019/02,279,10/02/2019,7,SP 31 dal bivio SP 28 per Castenaso a Ponte Rizzoli,7515,00,7462,53,5874,1641,0,7515
2019/02,279,11/02/2019,1,SP 31 dal bivio SP 28 per Castenaso a Ponte Rizzoli,13935,20,12919,1014,11782,2153,13935,0
2019/02,279,12/02/2019,2,SP 31 dal bivio SP 28 per Castenaso a Ponte Rizzoli,13891,00,12912,979,11648,2243,13891,0
2019/02,279,13/02/2019,3,SP 31 dal bivio SP 28 per Castenaso a Ponte Rizzoli,14150,10,13187,962,11823,2327,14150,0
2019/02,279,14/02/2019,4,SP 31 dal bivio SP 28 per Castenaso a Ponte Rizzoli,14360,00,13402,958,11918,2442,14360,0
2019/02,280,01/02/2019,5,SP 26 tra Gesso e Ponte Rivabella,20440,00,20042,398,15668,4772,20440,0
2019/02,280,02/02/2019,6,SP 26 tra Gesso e Ponte Rivabella,17319,00,17175,144,12867,4452,0,17319
2019/02,280,03/02/2019,7,SP 26 tra Gesso e Ponte Rivabella,13585,00,13555,30,10090,3495,0,13585
2019/02,280,04/02/2019,1,SP 26 tra Gesso e Ponte Rivabella,20108,10,19653,454,15736,4372,20108,0
2019/02,280,05/02/2019,2,SP 26 tra Gesso e Ponte Rivabella,20647,00,20191,456,16046,4601,20647,0
2019/02,280,06/02/2019,3,SP 26 tra Gesso e Ponte Rivabella,21112,00,20619,493,16242,4870,21112,0
2019/02,280,07/02/2019,4,SP 26 tra Gesso e Ponte Rivabella,20854,10,20355,498,16135,4719,20854,0
2019/02,280,08/02/2019,5,SP 26 tra Gesso e Ponte Rivabella,21600,00,21125,475,16464,5136,21600,0
2019/02,280,09/02/2019,6,SP 26 tra Gesso e Ponte Rivabella,18879,00,18711,168,13982,4897,0,18879
2019/02,280,10/02/2019,7,SP 26 tra Gesso e Ponte Rivabella,14782,00,14744,38,11095,3687,0,14782
2019/02,280,11/02/2019,1,SP 26 tra Gesso e Ponte Rivabella,20734,00,20212,522,16254,4480,20734,0
2019/02,280,12/02/2019,2,SP 26 tra Gesso e Ponte Rivabella,20844,00,20354,490,16165,4679,20844,0
2019/02,280,13/02/2019,3,SP 26 tra Gesso e Ponte Rivabella,21363,00,20840,523,16384,4979,21363,0
2019/02,280,14/02/2019,4,SP 26 tra Gesso e Ponte Rivabella,21905,10,21373,531,16414,5491,21905,0
2019/02,281,01/02/2019,5,SP 78_1 tra Bazzano e Intersezione SP 27 a Monteveglio,6444,10,6250,193,4995,1449,6444,0
2019/02,281,02/02/2019,6,SP 78_1 tra Bazzano e Intersezione SP 27 a Monteveglio,6082,20,6012,68,4655,1427,0,6082
2019/02,281,03/02/2019,7,SP 78_1 tra Bazzano e Intersezione SP 27 a Monteveglio,4118,00,4084,34,3002,1116,0,4118
2019/02,281,04/02/2019,1,SP 78_1 tra Bazzano e Intersezione SP 27 a Monteveglio,6509,30,6302,204,5238,1271,6509,0
2019/02,281,05/02/2019,2,SP 78_1 tra Bazzano e Intersezione SP 27 a Monteveglio,6659,10,6442,216,5323,1336,6659,0
2019/02,281,06/02/2019,3,SP 78_1 tra Bazzano e Intersezione SP 27 a Monteveglio,6732,30,6517,212,5325,1407,6732,0
2019/02,281,07/02/2019,4,SP 78_1 tra Bazzano e Intersezione SP 27 a Monteveglio,6751,10,6520,230,5315,1436,6751,0
2019/02,281,08/02/2019,5,SP 78_1 tra Bazzano e Intersezione SP 27 a Monteveglio,6804,20,6590,212,5287,1517,6804,0
2019/02,281,09/02/2019,6,SP 78_1 tra Bazzano e Intersezione SP 27 a Monteveglio,6749,00,6664,85,5120,1629,0,6749
2019/02,281,10/02/2019,7,SP 78_1 tra Bazzano e Intersezione SP 27 a Monteveglio,4516,00,4481,35,3393,1123,0,4516
2019/02,281,11/02/2019,1,SP 78_1 tra Bazzano e Intersezione SP 27 a Monteveglio,6583,00,6351,232,5353,1230,6583,0
2019/02,281,12/02/2019,2,SP 78_1 tra Bazzano e Intersezione SP 27 a Monteveglio,6729,10,6507,221,5345,1384,6729,0
2019/02,281,13/02/2019,3,SP 78_1 tra Bazzano e Intersezione SP 27 a Monteveglio,6708,20,6487,219,5283,1425,6708,0
2019/02,281,14/02/2019,4,SP 78_1 tra Bazzano e Intersezione SP 27 a Monteveglio,6978,10,6775,202,5406,1572,6978,0
2019/02,282,01/02/2019,5,SS 9 tra Anzola dell'Emilia e Bologna,23620,00,21485,2135,17818,5802,23620,0
2019/02,282,02/02/2019,6,SS 9 tra Anzola dell'Emilia e Bologna,15650,00,15148,502,11043,4607,0,15650
2019/02,282,03/02/2019,7,SS 9 tra Anzola dell'Emilia e Bologna,13298,00,13182,116,9096,4202,0,13298
2019/02,282,04/02/2019,1,SS 9 tra Anzola dell'Emilia e Bologna,22796,00,20674,2122,17276,5520,22796,0
2019/02,282,05/02/2019,2,SS 9 tra Anzola dell'Emilia e Bologna,23674,00,21282,2392,17995,5679,23674,0
2019/02,282,06/02/2019,3,SS 9 tra Anzola dell'Emilia e Bologna,24190,00,21840,2350,18254,5936,24190,0
2019/02,282,07/02/2019,4,SS 9 tra Anzola dell'Emilia e Bologna,24144,00,21885,2259,18358,5786,24144,0
2019/02,282,08/02/2019,5,SS 9 tra Anzola dell'Emilia e Bologna,24549,00,22177,2372,18367,6182,24549,0
2019/02,282,09/02/2019,6,SS 9 tra Anzola dell'Emilia e Bologna,17738,00,17228,510,12525,5213,0,17738
2019/02,282,10/02/2019,7,SS 9 tra Anzola dell'Emilia e Bologna,14165,00,14041,124,10025,4140,0,14165
2019/02,282,11/02/2019,1,SS 9 tra Anzola dell'Emilia e Bologna,23525,00,21287,2238,17923,5602,23525,0
2019/02,282,12/02/2019,2,SS 9 tra Anzola dell'Emilia e Bologna,23760,00,21426,2334,18028,5732,23760,0
2019/02,282,13/02/2019,3,SS 9 tra Anzola dell'Emilia e Bologna,24058,00,21765,2293,18070,5988,24058,0
2019/02,282,14/02/2019,4,SS 9 tra Anzola dell'Emilia e Bologna,24485,10,22179,2305,18408,6077,24485,0
2019/02,285,01/02/2019,5,SP 1 fra Crevalcore e Decima,6158,00,5812,346,4693,1465,6158,0
2019/02,285,02/02/2019,6,SP 1 fra Crevalcore e Decima,4869,00,4779,90,3403,1466,0,4869
2019/02,285,03/02/2019,7,SP 1 fra Crevalcore e Decima,3738,00,3724,14,2631,1107,0,3738
2019/02,285,04/02/2019,1,SP 1 fra Crevalcore e Decima,5931,00,5509,422,4717,1214,5931,0
2019/02,285,05/02/2019,2,SP 1 fra Crevalcore e Decima,6220,00,5812,408,4923,1297,6220,0
2019/02,285,06/02/2019,3,SP 1 fra Crevalcore e Decima,6183,00,5731,452,4836,1347,6183,0
2019/02,285,07/02/2019,4,SP 1 fra Crevalcore e Decima,6315,00,5875,440,4911,1404,6315,0
2019/02,285,08/02/2019,5,SP 1 fra Crevalcore e Decima,6547,00,6150,397,5038,1509,6547,0
2019/02,285,09/02/2019,6,SP 1 fra Crevalcore e Decima,5096,00,4999,97,3563,1533,0,5096
2019/02,285,10/02/2019,7,SP 1 fra Crevalcore e Decima,3721,00,3697,24,2627,1094,0,3721
2019/02,285,11/02/2019,1,SP 1 fra Crevalcore e Decima,5916,10,5517,398,4683,1233,5916,0
2019/02,285,12/02/2019,2,SP 1 fra Crevalcore e Decima,6316,00,5893,423,5008,1308,6316,0
2019/02,285,13/02/2019,3,SP 1 fra Crevalcore e Decima,6214,00,5801,413,4871,1343,6214,0
2019/02,285,14/02/2019,4,SP 1 fra Crevalcore e Decima,6498,10,6076,421,5025,1473,6498,0
2019/02,287,04/02/2019,1,SP 6 fra Cento e Pilastrello,6290,00,5918,372,5040,1250,6290,0
2019/02,287,05/02/2019,2,SP 6 fra Cento e Pilastrello,7751,00,7270,481,6255,1496,7751,0
2019/02,287,06/02/2019,3,SP 6 fra Cento e Pilastrello,7735,10,7227,507,6170,1565,7735,0
2019/02,287,07/02/2019,4,SP 6 fra Cento e Pilastrello,7678,00,7195,483,6194,1484,7678,0
2019/02,287,08/02/2019,5,SP 6 fra Cento e Pilastrello,8071,10,7578,492,6301,1770,8071,0
2019/02,287,09/02/2019,6,SP 6 fra Cento e Pilastrello,7090,00,6985,105,4994,2096,0,7090
2019/02,287,10/02/2019,7,SP 6 fra Cento e Pilastrello,5594,00,5580,14,4063,1531,0,5594
2019/02,287,11/02/2019,1,SP 6 fra Cento e Pilastrello,6341,00,5941,400,5270,1071,6341,0
2019/02,287,12/02/2019,2,SP 6 fra Cento e Pilastrello,8066,10,7568,497,6471,1595,8066,0
2019/02,287,13/02/2019,3,SP 6 fra Cento e Pilastrello,8013,10,7511,501,6346,1667,8013,0
2019/02,287,14/02/2019,4,SP 6 fra Cento e Pilastrello,8404,20,7839,563,6617,1787,8404,0
2019/02,288,01/02/2019,5,SP 42 fra Pieve di Cento e Castello d'Argile,18865,00,18010,855,14479,4386,18865,0
2019/02,288,02/02/2019,6,SP 42 fra Pieve di Cento e Castello d'Argile,12782,00,12569,213,9505,3277,0,12782
2019/02,288,03/02/2019,7,SP 42 fra Pieve di Cento e Castello d'Argile,10446,00,10362,84,7626,2820,0,10446
2019/02,288,04/02/2019,1,SP 42 fra Pieve di Cento e Castello d'Argile,18054,00,17222,832,14280,3774,18054,0
2019/02,288,05/02/2019,2,SP 42 fra Pieve di Cento e Castello d'Argile,18663,00,17779,884,14599,4064,18663,0
2019/02,288,06/02/2019,3,SP 42 fra Pieve di Cento e Castello d'Argile,19000,00,18103,897,14811,4189,19000,0
2019/02,288,07/02/2019,4,SP 42 fra Pieve di Cento e Castello d'Argile,18760,10,17842,917,14611,4149,18760,0
2019/02,288,08/02/2019,5,SP 42 fra Pieve di Cento e Castello d'Argile,19061,20,18119,940,14464,4597,19061,0
2019/02,288,09/02/2019,6,SP 42 fra Pieve di Cento e Castello d'Argile,14344,10,14100,243,10359,3985,0,14344
2019/02,288,10/02/2019,7,SP 42 fra Pieve di Cento e Castello d'Argile,11983,00,11907,76,8728,3255,0,11983
2019/02,288,11/02/2019,1,SP 42 fra Pieve di Cento e Castello d'Argile,18348,00,17470,878,14510,3838,18348,0
2019/02,288,12/02/2019,2,SP 42 fra Pieve di Cento e Castello d'Argile,18665,00,17805,860,14587,4078,18665,0
2019/02,288,13/02/2019,3,SP 42 fra Pieve di Cento e Castello d'Argile,19081,00,18228,853,14727,4354,19081,0
2019/02,288,14/02/2019,4,SP 42 fra Pieve di Cento e Castello d'Argile,19672,20,18782,888,15099,4573,19672,0
2019/02,289,01/02/2019,5,SP 66 fra Cento e Sant'Agostino,14257,00,13534,723,11274,2983,14257,0
2019/02,289,02/02/2019,6,SP 66 fra Cento e Sant'Agostino,12460,00,12276,184,9378,3082,0,12460
2019/02,289,03/02/2019,7,SP 66 fra Cento e Sant'Agostino,9562,00,9521,41,7045,2517,0,9562
2019/02,289,04/02/2019,1,SP 66 fra Cento e Sant'Agostino,14080,00,13285,795,11460,2620,14080,0
2019/02,289,05/02/2019,2,SP 66 fra Cento e Sant'Agostino,14331,00,13515,816,11530,2801,14331,0
2019/02,289,06/02/2019,3,SP 66 fra Cento e Sant'Agostino,14566,00,13775,791,11654,2912,14566,0
2019/02,289,07/02/2019,4,SP 66 fra Cento e Sant'Agostino,14531,20,13730,799,11686,2845,14531,0
2019/02,289,08/02/2019,5,SP 66 fra Cento e Sant'Agostino,14555,00,13753,802,11393,3162,14555,0
2019/02,290,01/02/2019,5,SP 11 fra Pieve di Cento e San Pietro in Casale,6313,00,5995,318,4856,1457,6313,0
2019/02,290,02/02/2019,6,SP 11 fra Pieve di Cento e San Pietro in Casale,6203,00,6083,120,3817,2386,0,6203
2019/02,290,03/02/2019,7,SP 11 fra Pieve di Cento e San Pietro in Casale,5572,00,5526,46,3691,1881,0,5572
2019/02,290,04/02/2019,1,SP 11 fra Pieve di Cento e San Pietro in Casale,6285,00,5931,354,5083,1202,6285,0
2019/02,290,05/02/2019,2,SP 11 fra Pieve di Cento e San Pietro in Casale,6240,00,5892,348,5007,1233,6240,0
2019/02,290,06/02/2019,3,SP 11 fra Pieve di Cento e San Pietro in Casale,6253,10,5909,343,4945,1308,6253,0
2019/02,290,07/02/2019,4,SP 11 fra Pieve di Cento e San Pietro in Casale,6385,00,5986,399,5101,1284,6385,0
2019/02,290,08/02/2019,5,SP 11 fra Pieve di Cento e San Pietro in Casale,6580,00,6245,335,4964,1616,6580,0
2019/02,290,09/02/2019,6,SP 11 fra Pieve di Cento e San Pietro in Casale,5897,00,5789,108,3991,1906,0,5897
2019/02,290,10/02/2019,7,SP 11 fra Pieve di Cento e San Pietro in Casale,4398,00,4375,23,3045,1353,0,4398
2019/02,290,11/02/2019,1,SP 11 fra Pieve di Cento e San Pietro in Casale,6114,00,5775,339,4917,1197,6114,0
2019/02,290,12/02/2019,2,SP 11 fra Pieve di Cento e San Pietro in Casale,6256,00,5905,351,4970,1286,6256,0
2019/02,290,13/02/2019,3,SP 11 fra Pieve di Cento e San Pietro in Casale,6422,00,6060,362,5057,1365,6422,0
2019/02,290,14/02/2019,4,SP 11 fra Pieve di Cento e San Pietro in Casale,6722,00,6374,348,5204,1518,6722,0
2019/02,291,01/02/2019,5,SP 4 tra San Pietro in Casale e San Vincenzo/San Venanzio,10464,00,10084,380,7985,2479,10464,0
2019/02,291,02/02/2019,6,SP 4 tra San Pietro in Casale e San Vincenzo/San Venanzio,8492,00,8394,98,6295,2197,0,8492
2019/02,291,03/02/2019,7,SP 4 tra San Pietro in Casale e San Vincenzo/San Venanzio,6159,00,6144,15,4564,1595,0,6159
2019/02,291,04/02/2019,1,SP 4 tra San Pietro in Casale e San Vincenzo/San Venanzio,9987,00,9599,388,7844,2143,9987,0
2019/02,291,05/02/2019,2,SP 4 tra San Pietro in Casale e San Vincenzo/San Venanzio,10375,00,10019,356,8080,2295,10375,0
2019/02,291,06/02/2019,3,SP 4 tra San Pietro in Casale e San Vincenzo/San Venanzio,10315,00,9912,403,7968,2347,10315,0
2019/02,291,07/02/2019,4,SP 4 tra San Pietro in Casale e San Vincenzo/San Venanzio,10333,10,9896,436,7972,2361,10333,0
2019/02,291,08/02/2019,5,SP 4 tra San Pietro in Casale e San Vincenzo/San Venanzio,10760,00,10348,412,8114,2646,10760,0
2019/02,291,09/02/2019,6,SP 4 tra San Pietro in Casale e San Vincenzo/San Venanzio,8506,00,8383,123,6289,2217,0,8506
2019/02,291,10/02/2019,7,SP 4 tra San Pietro in Casale e San Vincenzo/San Venanzio,6443,00,6419,24,4811,1632,0,6443
2019/02,291,11/02/2019,1,SP 4 tra San Pietro in Casale e San Vincenzo/San Venanzio,10220,00,9796,424,7989,2231,10220,0
2019/02,291,12/02/2019,2,SP 4 tra San Pietro in Casale e San Vincenzo/San Venanzio,10560,00,10117,443,8236,2324,10560,0
2019/02,291,13/02/2019,3,SP 4 tra San Pietro in Casale e San Vincenzo/San Venanzio,10603,00,10134,469,8096,2507,10603,0
2019/02,291,14/02/2019,4,SP 4 tra San Pietro in Casale e San Vincenzo/San Venanzio,10982,00,10539,443,8380,2602,10982,0
2019/02,292,01/02/2019,5,SP 4 tra San Giorgio di Piano e Intersezione SP 11 c/o San Pietro in Casale,17575,00,16995,580,13260,4315,17575,0
2019/02,292,02/02/2019,6,SP 4 tra San Giorgio di Piano e Intersezione SP 11 c/o San Pietro in Casale,15280,00,15089,191,10209,5071,0,15280
2019/02,292,03/02/2019,7,SP 4 tra San Giorgio di Piano e Intersezione SP 11 c/o San Pietro in Casale,10578,00,10527,51,7351,3227,0,10578
2019/02,292,04/02/2019,1,SP 4 tra San Giorgio di Piano e Intersezione SP 11 c/o San Pietro in Casale,17087,10,16504,582,13234,3853,17087,0
2019/02,292,05/02/2019,2,SP 4 tra San Giorgio di Piano e Intersezione SP 11 c/o San Pietro in Casale,17793,00,17236,557,13753,4040,17793,0
2019/02,292,06/02/2019,3,SP 4 tra San Giorgio di Piano e Intersezione SP 11 c/o San Pietro in Casale,17571,00,16955,616,13514,4057,17571,0
2019/02,292,07/02/2019,4,SP 4 tra San Giorgio di Piano e Intersezione SP 11 c/o San Pietro in Casale,17605,00,16984,621,13449,4156,17605,0
2019/02,292,08/02/2019,5,SP 4 tra San Giorgio di Piano e Intersezione SP 11 c/o San Pietro in Casale,18244,00,17622,622,13599,4645,18244,0
2019/02,292,09/02/2019,6,SP 4 tra San Giorgio di Piano e Intersezione SP 11 c/o San Pietro in Casale,14258,00,14079,179,10210,4048,0,14258
2019/02,292,10/02/2019,7,SP 4 tra San Giorgio di Piano e Intersezione SP 11 c/o San Pietro in Casale,10284,00,10246,38,7379,2905,0,10284
2019/02,292,11/02/2019,1,SP 4 tra San Giorgio di Piano e Intersezione SP 11 c/o San Pietro in Casale,17783,30,17140,640,13848,3935,17783,0
2019/02,292,12/02/2019,2,SP 4 tra San Giorgio di Piano e Intersezione SP 11 c/o San Pietro in Casale,17950,00,17273,677,13770,4180,17950,0
2019/02,292,13/02/2019,3,SP 4 tra San Giorgio di Piano e Intersezione SP 11 c/o San Pietro in Casale,17884,00,17233,651,13568,4316,17884,0
2019/02,292,14/02/2019,4,SP 4 tra San Giorgio di Piano e Intersezione SP 11 c/o San Pietro in Casale,18445,10,17798,646,13740,4705,18445,0
2019/02,295,01/02/2019,5,SP 9 fra Colorno e Torrile centro abitato di Bezze,3368,00,3063,305,2705,663,3368,0
2019/02,295,02/02/2019,6,SP 9 fra Colorno e Torrile centro abitato di Bezze,2631,00,2530,101,1993,638,0,2631
2019/02,295,03/02/2019,7,SP 9 fra Colorno e Torrile centro abitato di Bezze,1967,00,1909,58,1472,495,0,1967
2019/02,295,04/02/2019,1,SP 9 fra Colorno e Torrile centro abitato di Bezze,3538,10,3154,383,2852,686,3538,0
2019/02,295,05/02/2019,2,SP 9 fra Colorno e Torrile centro abitato di Bezze,3705,20,3297,406,3001,704,3705,0
2019/02,295,06/02/2019,3,SP 9 fra Colorno e Torrile centro abitato di Bezze,3665,00,3249,416,2963,702,3665,0
2019/02,295,07/02/2019,4,SP 9 fra Colorno e Torrile centro abitato di Bezze,3572,10,3199,372,2871,701,3572,0
2019/02,295,08/02/2019,5,SP 9 fra Colorno e Torrile centro abitato di Bezze,3691,10,3338,352,2921,770,3691,0
2019/02,295,09/02/2019,6,SP 9 fra Colorno e Torrile centro abitato di Bezze,2788,10,2645,142,2117,671,0,2788
2019/02,295,10/02/2019,7,SP 9 fra Colorno e Torrile centro abitato di Bezze,1906,00,1856,50,1396,510,0,1906
2019/02,295,11/02/2019,1,SP 9 fra Colorno e Torrile centro abitato di Bezze,3637,00,3242,395,2991,646,3637,0
2019/02,295,12/02/2019,2,SP 9 fra Colorno e Torrile centro abitato di Bezze,3720,00,3290,430,2978,742,3720,0
2019/02,295,13/02/2019,3,SP 9 fra Colorno e Torrile centro abitato di Bezze,3693,00,3263,430,2950,743,3693,0
2019/02,295,14/02/2019,4,SP 9 fra Colorno e Torrile centro abitato di Bezze,4017,00,3585,432,3228,789,4017,0
2019/02,298,01/02/2019,5,SP 588R da Castione Marchesi (A 1) a Busseto,2717,00,2564,153,2158,559,2717,0
2019/02,298,02/02/2019,6,SP 588R da Castione Marchesi (A 1) a Busseto,2304,00,2216,88,1639,665,0,2304
2019/02,298,03/02/2019,7,SP 588R da Castione Marchesi (A 1) a Busseto,1642,00,1614,28,1186,456,0,1642
2019/02,298,04/02/2019,1,SP 588R da Castione Marchesi (A 1) a Busseto,2817,10,2635,181,2338,479,2817,0
2019/02,298,05/02/2019,2,SP 588R da Castione Marchesi (A 1) a Busseto,2874,00,2704,170,2365,509,2874,0
2019/02,298,06/02/2019,3,SP 588R da Castione Marchesi (A 1) a Busseto,3037,10,2844,192,2484,553,3037,0
2019/02,298,07/02/2019,4,SP 588R da Castione Marchesi (A 1) a Busseto,2938,00,2759,179,2364,574,2938,0
2019/02,298,08/02/2019,5,SP 588R da Castione Marchesi (A 1) a Busseto,3032,10,2826,205,2371,661,3032,0
2019/02,298,09/02/2019,6,SP 588R da Castione Marchesi (A 1) a Busseto,2364,00,2308,56,1788,576,0,2364
2019/02,298,10/02/2019,7,SP 588R da Castione Marchesi (A 1) a Busseto,1753,00,1732,21,1278,475,0,1753
2019/02,298,11/02/2019,1,SP 588R da Castione Marchesi (A 1) a Busseto,2692,20,2525,165,2202,490,2692,0
2019/02,298,12/02/2019,2,SP 588R da Castione Marchesi (A 1) a Busseto,2966,00,2764,202,2387,579,2966,0
2019/02,298,13/02/2019,3,SP 588R da Castione Marchesi (A 1) a Busseto,2985,00,2774,211,2409,576,2985,0
2019/02,298,14/02/2019,4,SP 588R da Castione Marchesi (A 1) a Busseto,3064,00,2878,186,2382,682,3064,0
2019/02,300,01/02/2019,5,SP 462R fra Fiorenzuola d'Arda e Cortemaggiore,7394,00,6478,916,5884,1510,7394,0
2019/02,300,02/02/2019,6,SP 462R fra Fiorenzuola d'Arda e Cortemaggiore,5810,10,5528,281,4473,1337,0,5810
2019/02,300,03/02/2019,7,SP 462R fra Fiorenzuola d'Arda e Cortemaggiore,5714,00,5630,84,4462,1252,0,5714
2019/02,300,04/02/2019,1,SP 462R fra Fiorenzuola d'Arda e Cortemaggiore,8208,30,7167,1038,6748,1460,8208,0
2019/02,300,05/02/2019,2,SP 462R fra Fiorenzuola d'Arda e Cortemaggiore,8337,10,7259,1077,6795,1542,8337,0
2019/02,300,06/02/2019,3,SP 462R fra Fiorenzuola d'Arda e Cortemaggiore,8662,30,7529,1130,7043,1619,8662,0
2019/02,300,07/02/2019,4,SP 462R fra Fiorenzuola d'Arda e Cortemaggiore,8557,20,7455,1100,6953,1604,8557,0
2019/02,300,08/02/2019,5,SP 462R fra Fiorenzuola d'Arda e Cortemaggiore,8518,20,7441,1075,6737,1781,8518,0
2019/02,300,09/02/2019,6,SP 462R fra Fiorenzuola d'Arda e Cortemaggiore,6696,20,6359,335,5022,1674,0,6696
2019/02,300,10/02/2019,7,SP 462R fra Fiorenzuola d'Arda e Cortemaggiore,4854,00,4804,50,3694,1160,0,4854
2019/02,300,11/02/2019,1,SP 462R fra Fiorenzuola d'Arda e Cortemaggiore,7975,10,6964,1010,6471,1504,7975,0
2019/02,300,12/02/2019,2,SP 462R fra Fiorenzuola d'Arda e Cortemaggiore,8574,20,7455,1117,6951,1623,8574,0
2019/02,300,13/02/2019,3,SP 462R fra Fiorenzuola d'Arda e Cortemaggiore,8471,00,7342,1129,6781,1690,8471,0
2019/02,300,14/02/2019,4,SP 462R fra Fiorenzuola d'Arda e Cortemaggiore,8632,30,7562,1067,6915,1717,8632,0
2019/02,301,01/02/2019,5,SP 4 tra Fiorenzuola d'Arda (Tg Sud) e Castell'Arquato,7190,00,6713,477,5673,1517,7190,0
2019/02,301,02/02/2019,6,SP 4 tra Fiorenzuola d'Arda (Tg Sud) e Castell'Arquato,6665,00,6564,101,5111,1554,0,6665
2019/02,301,03/02/2019,7,SP 4 tra Fiorenzuola d'Arda (Tg Sud) e Castell'Arquato,4890,00,4868,22,3630,1260,0,4890
2019/02,301,04/02/2019,1,SP 4 tra Fiorenzuola d'Arda (Tg Sud) e Castell'Arquato,7824,00,7213,611,6281,1543,7824,0
2019/02,301,05/02/2019,2,SP 4 tra Fiorenzuola d'Arda (Tg Sud) e Castell'Arquato,8181,00,7542,639,6565,1616,8181,0
2019/02,301,06/02/2019,3,SP 4 tra Fiorenzuola d'Arda (Tg Sud) e Castell'Arquato,8353,00,7698,655,6706,1647,8353,0
2019/02,301,07/02/2019,4,SP 4 tra Fiorenzuola d'Arda (Tg Sud) e Castell'Arquato,8318,30,7700,615,6593,1725,8318,0
2019/02,301,08/02/2019,5,SP 4 tra Fiorenzuola d'Arda (Tg Sud) e Castell'Arquato,8570,00,7944,626,6693,1877,8570,0
2019/02,301,09/02/2019,6,SP 4 tra Fiorenzuola d'Arda (Tg Sud) e Castell'Arquato,7252,00,7153,99,5581,1671,0,7252
2019/02,301,10/02/2019,7,SP 4 tra Fiorenzuola d'Arda (Tg Sud) e Castell'Arquato,5311,10,5300,10,3901,1410,0,5311
2019/02,301,11/02/2019,1,SP 4 tra Fiorenzuola d'Arda (Tg Sud) e Castell'Arquato,7837,10,7192,644,6382,1455,7837,0
2019/02,301,12/02/2019,2,SP 4 tra Fiorenzuola d'Arda (Tg Sud) e Castell'Arquato,8131,00,7455,676,6488,1643,8131,0
2019/02,301,13/02/2019,3,SP 4 tra Fiorenzuola d'Arda (Tg Sud) e Castell'Arquato,8066,00,7439,627,6436,1630,8066,0
2019/02,301,14/02/2019,4,SP 4 tra Fiorenzuola d'Arda (Tg Sud) e Castell'Arquato,8803,00,8096,707,6847,1956,8803,0
2019/02,302,01/02/2019,5,SP 12 da Fidenza (Casello A 1) a Soragna,7188,10,6364,823,5692,1496,7188,0
2019/02,302,02/02/2019,6,SP 12 da Fidenza (Casello A 1) a Soragna,6375,00,6171,204,4834,1541,0,6375
2019/02,302,03/02/2019,7,SP 12 da Fidenza (Casello A 1) a Soragna,5734,00,5688,46,4307,1427,0,5734
2019/02,302,04/02/2019,1,SP 12 da Fidenza (Casello A 1) a Soragna,7051,10,6234,816,5773,1278,7051,0
2019/02,302,05/02/2019,2,SP 12 da Fidenza (Casello A 1) a Soragna,7139,10,6375,763,5822,1317,7139,0
2019/02,302,06/02/2019,3,SP 12 da Fidenza (Casello A 1) a Soragna,7496,10,6683,812,6207,1289,7496,0
2019/02,302,07/02/2019,4,SP 12 da Fidenza (Casello A 1) a Soragna,7173,10,6277,895,5865,1308,7173,0
2019/02,302,08/02/2019,5,SP 12 da Fidenza (Casello A 1) a Soragna,7634,00,6672,962,6091,1543,7634,0
2019/02,302,09/02/2019,6,SP 12 da Fidenza (Casello A 1) a Soragna,7097,10,6874,222,5287,1810,0,7097
2019/02,302,10/02/2019,7,SP 12 da Fidenza (Casello A 1) a Soragna,6126,00,6074,52,4541,1585,0,6126
2019/02,302,11/02/2019,1,SP 12 da Fidenza (Casello A 1) a Soragna,7360,00,6439,921,6030,1330,7360,0
2019/02,302,12/02/2019,2,SP 12 da Fidenza (Casello A 1) a Soragna,7721,00,6749,972,6362,1359,7721,0
2019/02,302,13/02/2019,3,SP 12 da Fidenza (Casello A 1) a Soragna,7883,10,6872,1010,6417,1466,7883,0
2019/02,302,14/02/2019,4,SP 12 da Fidenza (Casello A 1) a Soragna,8202,00,7225,977,6620,1582,8202,0
2019/02,303,01/02/2019,5,SP 11 fra Borgonovo e Gragnano,6623,10,6369,253,5104,1519,6623,0
2019/02,303,02/02/2019,6,SP 11 fra Borgonovo e Gragnano,7468,00,7346,122,5636,1832,0,7468
2019/02,303,03/02/2019,7,SP 11 fra Borgonovo e Gragnano,5823,00,5792,31,4254,1569,0,5823
2019/02,303,04/02/2019,1,SP 11 fra Borgonovo e Gragnano,9075,00,8659,416,7335,1740,9075,0
2019/02,303,05/02/2019,2,SP 11 fra Borgonovo e Gragnano,9079,00,8666,413,7253,1826,9079,0
2019/02,303,06/02/2019,3,SP 11 fra Borgonovo e Gragnano,9182,00,8675,507,7359,1823,9182,0
2019/02,303,07/02/2019,4,SP 11 fra Borgonovo e Gragnano,9463,10,8905,557,7553,1910,9463,0
2019/02,303,08/02/2019,5,SP 11 fra Borgonovo e Gragnano,9591,00,9074,517,7470,2121,9591,0
2019/02,303,09/02/2019,6,SP 11 fra Borgonovo e Gragnano,8362,00,8223,139,6304,2058,0,8362
2019/02,303,10/02/2019,7,SP 11 fra Borgonovo e Gragnano,5662,00,5630,32,4528,1134,0,5662
2019/02,303,11/02/2019,1,SP 11 fra Borgonovo e Gragnano,8971,00,8471,500,7243,1728,8971,0
2019/02,303,12/02/2019,2,SP 11 fra Borgonovo e Gragnano,9314,10,8794,519,7510,1804,9314,0
2019/02,303,13/02/2019,3,SP 11 fra Borgonovo e Gragnano,9379,00,8831,548,7514,1865,9379,0
2019/02,303,14/02/2019,4,SP 11 fra Borgonovo e Gragnano,9717,00,9198,519,7626,2091,9717,0
2019/02,304,01/02/2019,5,SP 42 fra Podenzano e bivio SP 6/ponte fiume Nure in località San Giorgio Piacentino,5416,00,5153,263,4123,1293,5416,0
2019/02,304,02/02/2019,6,SP 42 fra Podenzano e bivio SP 6/ponte fiume Nure in località San Giorgio Piacentino,4807,00,4751,56,3500,1307,0,4807
2019/02,304,03/02/2019,7,SP 42 fra Podenzano e bivio SP 6/ponte fiume Nure in località San Giorgio Piacentino,3930,00,3918,12,2905,1025,0,3930
2019/02,304,04/02/2019,1,SP 42 fra Podenzano e bivio SP 6/ponte fiume Nure in località San Giorgio Piacentino,6385,00,6070,315,5102,1283,6385,0
2019/02,304,05/02/2019,2,SP 42 fra Podenzano e bivio SP 6/ponte fiume Nure in località San Giorgio Piacentino,6691,00,6333,358,5387,1304,6691,0
2019/02,304,06/02/2019,3,SP 42 fra Podenzano e bivio SP 6/ponte fiume Nure in località San Giorgio Piacentino,6698,00,6282,416,5323,1375,6698,0
2019/02,304,07/02/2019,4,SP 42 fra Podenzano e bivio SP 6/ponte fiume Nure in località San Giorgio Piacentino,6932,10,6510,421,5551,1381,6932,0
2019/02,304,08/02/2019,5,SP 42 fra Podenzano e bivio SP 6/ponte fiume Nure in località San Giorgio Piacentino,6891,00,6467,424,5313,1578,6891,0
2019/02,304,09/02/2019,6,SP 42 fra Podenzano e bivio SP 6/ponte fiume Nure in località San Giorgio Piacentino,5478,00,5397,81,4090,1388,0,5478
2019/02,304,10/02/2019,7,SP 42 fra Podenzano e bivio SP 6/ponte fiume Nure in località San Giorgio Piacentino,4331,00,4315,16,3298,1033,0,4331
2019/02,304,11/02/2019,1,SP 42 fra Podenzano e bivio SP 6/ponte fiume Nure in località San Giorgio Piacentino,6622,00,6187,435,5341,1281,6622,0
2019/02,304,12/02/2019,2,SP 42 fra Podenzano e bivio SP 6/ponte fiume Nure in località San Giorgio Piacentino,6880,00,6365,515,5553,1327,6880,0
2019/02,304,13/02/2019,3,SP 42 fra Podenzano e bivio SP 6/ponte fiume Nure in località San Giorgio Piacentino,7071,00,6588,483,5652,1419,7071,0
2019/02,304,14/02/2019,4,SP 42 fra Podenzano e bivio SP 6/ponte fiume Nure in località San Giorgio Piacentino,7355,10,6861,493,5793,1562,7355,0
2019/02,305,01/02/2019,5,SP 6Bis fra Carpaneto e Castell'Arquato,3318,00,3063,255,2554,764,3318,0
2019/02,305,02/02/2019,6,SP 6Bis fra Carpaneto e Castell'Arquato,3393,00,3308,85,2430,963,0,3393
2019/02,305,03/02/2019,7,SP 6Bis fra Carpaneto e Castell'Arquato,3185,00,3150,35,2343,842,0,3185
2019/02,305,04/02/2019,1,SP 6Bis fra Carpaneto e Castell'Arquato,3909,00,3503,406,3148,761,3909,0
2019/02,305,05/02/2019,2,SP 6Bis fra Carpaneto e Castell'Arquato,4092,20,3692,398,3314,778,4092,0
2019/02,305,06/02/2019,3,SP 6Bis fra Carpaneto e Castell'Arquato,4182,20,3764,416,3314,868,4182,0
2019/02,305,07/02/2019,4,SP 6Bis fra Carpaneto e Castell'Arquato,4273,00,3862,411,3292,981,4273,0
2019/02,305,08/02/2019,5,SP 6Bis fra Carpaneto e Castell'Arquato,4522,00,4116,406,3419,1103,4522,0
2019/02,305,09/02/2019,6,SP 6Bis fra Carpaneto e Castell'Arquato,4224,00,4114,110,3096,1128,0,4224
2019/02,305,10/02/2019,7,SP 6Bis fra Carpaneto e Castell'Arquato,3642,20,3611,29,2872,770,0,3642
2019/02,305,11/02/2019,1,SP 6Bis fra Carpaneto e Castell'Arquato,4034,00,3614,420,3236,798,4034,0
2019/02,305,12/02/2019,2,SP 6Bis fra Carpaneto e Castell'Arquato,4276,00,3794,482,3409,867,4276,0
2019/02,305,13/02/2019,3,SP 6Bis fra Carpaneto e Castell'Arquato,4448,00,3966,482,3567,881,4448,0
2019/02,305,14/02/2019,4,SP 6Bis fra Carpaneto e Castell'Arquato,4492,00,4074,418,3458,1034,4492,0
2019/02,306,01/02/2019,5,SP 654R fra Ponte dell'Olio e Bettola,2933,00,2848,85,2254,679,2933,0
2019/02,306,02/02/2019,6,SP 654R fra Ponte dell'Olio e Bettola,3476,00,3414,62,2715,761,0,3476
2019/02,306,03/02/2019,7,SP 654R fra Ponte dell'Olio e Bettola,3271,00,3249,22,2574,697,0,3271
2019/02,306,04/02/2019,1,SP 654R fra Ponte dell'Olio e Bettola,4479,00,4345,134,3710,769,4479,0
2019/02,306,05/02/2019,2,SP 654R fra Ponte dell'Olio e Bettola,4163,30,4023,137,3346,817,4163,0
2019/02,306,06/02/2019,3,SP 654R fra Ponte dell'Olio e Bettola,4098,00,3960,138,3233,865,4098,0
2019/02,306,07/02/2019,4,SP 654R fra Ponte dell'Olio e Bettola,4078,30,3921,154,3276,802,4078,0
2019/02,306,08/02/2019,5,SP 654R fra Ponte dell'Olio e Bettola,4570,00,4390,180,3560,1010,4570,0
2019/02,306,09/02/2019,6,SP 654R fra Ponte dell'Olio e Bettola,4419,00,4334,85,3447,972,0,4419
2019/02,306,10/02/2019,7,SP 654R fra Ponte dell'Olio e Bettola,3715,00,3697,18,2949,766,0,3715
2019/02,306,11/02/2019,1,SP 654R fra Ponte dell'Olio e Bettola,4531,20,4378,151,3705,826,4531,0
2019/02,306,12/02/2019,2,SP 654R fra Ponte dell'Olio e Bettola,4157,00,3986,171,3318,839,4157,0
2019/02,306,13/02/2019,3,SP 654R fra Ponte dell'Olio e Bettola,4191,10,4028,162,3352,839,4191,0
2019/02,306,14/02/2019,4,SP 654R fra Ponte dell'Olio e Bettola,4312,30,4124,185,3405,907,4312,0
2019/02,307,01/02/2019,5,SS 45 tra Rivergaro e Perino,2566,00,2447,119,1933,633,2566,0
2019/02,307,02/02/2019,6,SS 45 tra Rivergaro e Perino,3476,00,3382,94,2781,695,0,3476
2019/02,307,03/02/2019,7,SS 45 tra Rivergaro e Perino,3861,00,3829,32,3107,754,0,3861
2019/02,307,04/02/2019,1,SS 45 tra Rivergaro e Perino,3677,00,3523,154,2911,766,3677,0
2019/02,307,05/02/2019,2,SS 45 tra Rivergaro e Perino,3740,00,3543,197,3017,723,3740,0
2019/02,307,06/02/2019,3,SS 45 tra Rivergaro e Perino,3932,00,3750,182,3094,838,3932,0
2019/02,307,07/02/2019,4,SS 45 tra Rivergaro e Perino,3934,00,3741,193,3138,796,3934,0
2019/02,307,08/02/2019,5,SS 45 tra Rivergaro e Perino,4283,00,4086,197,3294,989,4283,0
2019/02,307,09/02/2019,6,SS 45 tra Rivergaro e Perino,5096,00,5001,95,4172,924,0,5096
2019/02,307,10/02/2019,7,SS 45 tra Rivergaro e Perino,4169,00,4153,16,3341,828,0,4169
2019/02,307,11/02/2019,1,SS 45 tra Rivergaro e Perino,3786,10,3647,138,3022,764,3786,0
2019/02,307,12/02/2019,2,SS 45 tra Rivergaro e Perino,3893,00,3707,186,3149,744,3893,0
2019/02,307,13/02/2019,3,SS 45 tra Rivergaro e Perino,4085,00,3913,172,3272,813,4085,0
2019/02,307,14/02/2019,4,SS 45 tra Rivergaro e Perino,4263,10,4108,154,3329,934,4263,0
2019/02,308,01/02/2019,5,SP 412R fra Pianello Val Tidone e Borgonovo Val Tidone,4638,00,4455,183,3588,1050,4638,0
2019/02,308,02/02/2019,6,SP 412R fra Pianello Val Tidone e Borgonovo Val Tidone,5440,00,5345,95,4216,1224,0,5440
2019/02,308,03/02/2019,7,SP 412R fra Pianello Val Tidone e Borgonovo Val Tidone,4733,00,4703,30,3565,1168,0,4733
2019/02,308,04/02/2019,1,SP 412R fra Pianello Val Tidone e Borgonovo Val Tidone,6258,00,5966,292,5158,1100,6258,0
2019/02,308,05/02/2019,2,SP 412R fra Pianello Val Tidone e Borgonovo Val Tidone,6507,20,6187,318,5252,1255,6507,0
2019/02,308,06/02/2019,3,SP 412R fra Pianello Val Tidone e Borgonovo Val Tidone,6721,00,6426,295,5468,1253,6721,0
2019/02,308,07/02/2019,4,SP 412R fra Pianello Val Tidone e Borgonovo Val Tidone,6387,00,6052,335,5132,1255,6387,0
2019/02,308,08/02/2019,5,SP 412R fra Pianello Val Tidone e Borgonovo Val Tidone,6868,00,6567,301,5423,1445,6868,0
2019/02,308,09/02/2019,6,SP 412R fra Pianello Val Tidone e Borgonovo Val Tidone,6463,00,6346,117,5042,1421,0,6463
2019/02,308,10/02/2019,7,SP 412R fra Pianello Val Tidone e Borgonovo Val Tidone,5081,00,5058,23,3953,1128,0,5081
2019/02,308,11/02/2019,1,SP 412R fra Pianello Val Tidone e Borgonovo Val Tidone,6251,00,5965,286,5065,1186,6251,0
2019/02,308,12/02/2019,2,SP 412R fra Pianello Val Tidone e Borgonovo Val Tidone,6346,10,6060,285,5126,1220,6346,0
2019/02,308,13/02/2019,3,SP 412R fra Pianello Val Tidone e Borgonovo Val Tidone,6944,00,6610,334,5632,1312,6944,0
2019/02,308,14/02/2019,4,SP 412R fra Pianello Val Tidone e Borgonovo Val Tidone,6636,00,6338,298,5316,1320,6636,0
2019/02,309,01/02/2019,5,SP 10R fra Castelvetro Piacentino e Monticelli d'Ongina,9962,00,9556,406,7706,2256,9962,0
2019/02,309,02/02/2019,6,SP 10R fra Castelvetro Piacentino e Monticelli d'Ongina,10143,00,9965,178,7610,2533,0,10143
2019/02,309,03/02/2019,7,SP 10R fra Castelvetro Piacentino e Monticelli d'Ongina,8551,00,8499,52,6475,2076,0,8551
2019/02,309,04/02/2019,1,SP 10R fra Castelvetro Piacentino e Monticelli d'Ongina,10693,10,10186,506,8584,2109,10693,0
2019/02,309,05/02/2019,2,SP 10R fra Castelvetro Piacentino e Monticelli d'Ongina,10778,10,10283,494,8619,2159,10778,0
2019/02,309,06/02/2019,3,SP 10R fra Castelvetro Piacentino e Monticelli d'Ongina,10970,10,10466,503,8790,2180,10970,0
2019/02,309,07/02/2019,4,SP 10R fra Castelvetro Piacentino e Monticelli d'Ongina,10921,40,10381,536,8731,2190,10921,0
2019/02,309,08/02/2019,5,SP 10R fra Castelvetro Piacentino e Monticelli d'Ongina,11713,00,11193,520,9132,2581,11713,0
2019/02,309,09/02/2019,6,SP 10R fra Castelvetro Piacentino e Monticelli d'Ongina,10403,00,10223,180,7821,2582,0,10403
2019/02,309,10/02/2019,7,SP 10R fra Castelvetro Piacentino e Monticelli d'Ongina,8681,00,8633,48,6610,2071,0,8681
2019/02,309,11/02/2019,1,SP 10R fra Castelvetro Piacentino e Monticelli d'Ongina,10950,10,10431,518,8770,2180,10950,0
2019/02,309,12/02/2019,2,SP 10R fra Castelvetro Piacentino e Monticelli d'Ongina,11002,10,10482,519,8765,2237,11002,0
2019/02,309,13/02/2019,3,SP 10R fra Castelvetro Piacentino e Monticelli d'Ongina,11168,00,10675,493,8913,2255,11168,0
2019/02,309,14/02/2019,4,SP 10R fra Castelvetro Piacentino e Monticelli d'Ongina,11454,10,10912,541,9005,2449,11454,0
2019/02,310,01/02/2019,5,SP 358R fra Cadelbosco di Sopra e Castelnovo di Sotto,15095,00,14277,818,11674,3421,15095,0
2019/02,310,02/02/2019,6,SP 358R fra Cadelbosco di Sopra e Castelnovo di Sotto,12301,10,12073,227,8787,3514,0,12301
2019/02,310,03/02/2019,7,SP 358R fra Cadelbosco di Sopra e Castelnovo di Sotto,9216,00,9165,51,6392,2824,0,9216
2019/02,310,04/02/2019,1,SP 358R fra Cadelbosco di Sopra e Castelnovo di Sotto,15148,10,14305,842,11985,3163,15148,0
2019/02,310,05/02/2019,2,SP 358R fra Cadelbosco di Sopra e Castelnovo di Sotto,15561,10,14698,862,12304,3257,15561,0
2019/02,310,06/02/2019,3,SP 358R fra Cadelbosco di Sopra e Castelnovo di Sotto,15588,00,14721,867,12157,3431,15588,0
2019/02,310,07/02/2019,4,SP 358R fra Cadelbosco di Sopra e Castelnovo di Sotto,15607,00,14690,917,12054,3553,15607,0
2019/02,310,08/02/2019,5,SP 358R fra Cadelbosco di Sopra e Castelnovo di Sotto,16236,00,15313,923,12474,3762,16236,0
2019/02,310,09/02/2019,6,SP 358R fra Cadelbosco di Sopra e Castelnovo di Sotto,13306,00,13073,233,9431,3875,0,13306
2019/02,310,10/02/2019,7,SP 358R fra Cadelbosco di Sopra e Castelnovo di Sotto,9867,00,9797,70,6820,3047,0,9867
2019/02,310,11/02/2019,1,SP 358R fra Cadelbosco di Sopra e Castelnovo di Sotto,15614,00,14744,870,12393,3221,15614,0
2019/02,310,12/02/2019,2,SP 358R fra Cadelbosco di Sopra e Castelnovo di Sotto,15727,10,14871,855,12438,3289,15727,0
2019/02,310,13/02/2019,3,SP 358R fra Cadelbosco di Sopra e Castelnovo di Sotto,15723,20,14832,889,12293,3430,15723,0
2019/02,310,14/02/2019,4,SP 358R fra Cadelbosco di Sopra e Castelnovo di Sotto,16648,00,15750,898,12872,3776,16648,0
2019/02,311,01/02/2019,5,SP 62RVar tra la località San Giacomo (bivio SP 42) ed SP 2 (c/o Tagliata),10612,00,8338,2274,8395,2217,10612,0
2019/02,311,02/02/2019,6,SP 62RVar tra la località San Giacomo (bivio SP 42) ed SP 2 (c/o Tagliata),7507,00,7074,433,5494,2013,0,7507
2019/02,311,03/02/2019,7,SP 62RVar tra la località San Giacomo (bivio SP 42) ed SP 2 (c/o Tagliata),6805,00,6699,106,4891,1914,0,6805
2019/02,311,04/02/2019,1,SP 62RVar tra la località San Giacomo (bivio SP 42) ed SP 2 (c/o Tagliata),10796,00,8320,2476,8778,2018,10796,0
2019/02,311,05/02/2019,2,SP 62RVar tra la località San Giacomo (bivio SP 42) ed SP 2 (c/o Tagliata),11260,00,8507,2753,9121,2139,11260,0
2019/02,311,06/02/2019,3,SP 62RVar tra la località San Giacomo (bivio SP 42) ed SP 2 (c/o Tagliata),11419,20,8581,2836,9021,2398,11419,0
2019/02,311,07/02/2019,4,SP 62RVar tra la località San Giacomo (bivio SP 42) ed SP 2 (c/o Tagliata),11390,10,8570,2819,9124,2266,11390,0
2019/02,311,08/02/2019,5,SP 62RVar tra la località San Giacomo (bivio SP 42) ed SP 2 (c/o Tagliata),11816,10,9163,2652,9328,2488,11816,0
2019/02,311,09/02/2019,6,SP 62RVar tra la località San Giacomo (bivio SP 42) ed SP 2 (c/o Tagliata),8230,00,7811,419,5982,2248,0,8230
2019/02,311,10/02/2019,7,SP 62RVar tra la località San Giacomo (bivio SP 42) ed SP 2 (c/o Tagliata),7807,00,7675,132,5564,2243,0,7807
2019/02,311,11/02/2019,1,SP 62RVar tra la località San Giacomo (bivio SP 42) ed SP 2 (c/o Tagliata),11324,10,8608,2715,9193,2131,11324,0
2019/02,311,12/02/2019,2,SP 62RVar tra la località San Giacomo (bivio SP 42) ed SP 2 (c/o Tagliata),11291,00,8523,2768,9169,2122,11291,0
2019/02,311,13/02/2019,3,SP 62RVar tra la località San Giacomo (bivio SP 42) ed SP 2 (c/o Tagliata),11560,00,8777,2783,9219,2341,11560,0
2019/02,311,14/02/2019,4,SP 62RVar tra la località San Giacomo (bivio SP 42) ed SP 2 (c/o Tagliata),11806,00,9076,2730,9351,2455,11806,0
2019/02,312,01/02/2019,5,SP 42 fra Novellara e San Giacomo (SP 62R),13731,00,12526,1205,10655,3076,13731,0
2019/02,312,02/02/2019,6,SP 42 fra Novellara e San Giacomo (SP 62R),10713,00,10509,204,7557,3156,0,10713
2019/02,312,03/02/2019,7,SP 42 fra Novellara e San Giacomo (SP 62R),8814,00,8737,77,6267,2547,0,8814
2019/02,312,04/02/2019,1,SP 42 fra Novellara e San Giacomo (SP 62R),13335,00,12084,1251,10769,2566,13335,0
2019/02,312,05/02/2019,2,SP 42 fra Novellara e San Giacomo (SP 62R),14060,20,12745,1313,11314,2746,14060,0
2019/02,312,06/02/2019,3,SP 42 fra Novellara e San Giacomo (SP 62R),14173,00,12759,1414,11223,2950,14173,0
2019/02,312,07/02/2019,4,SP 42 fra Novellara e San Giacomo (SP 62R),13989,00,12694,1295,11238,2751,13989,0
2019/02,312,08/02/2019,5,SP 42 fra Novellara e San Giacomo (SP 62R),14393,00,13058,1335,11155,3238,14393,0
2019/02,312,09/02/2019,6,SP 42 fra Novellara e San Giacomo (SP 62R),11380,00,11132,248,8067,3313,0,11380
2019/02,312,10/02/2019,7,SP 42 fra Novellara e San Giacomo (SP 62R),8817,00,8740,77,6180,2637,0,8817
2019/02,312,11/02/2019,1,SP 42 fra Novellara e San Giacomo (SP 62R),13619,00,12246,1373,11002,2617,13619,0
2019/02,312,12/02/2019,2,SP 42 fra Novellara e San Giacomo (SP 62R),14099,00,12783,1316,11303,2796,14099,0
2019/02,312,13/02/2019,3,SP 42 fra Novellara e San Giacomo (SP 62R),14516,00,13118,1398,11582,2934,14516,0
2019/02,312,14/02/2019,4,SP 42 fra Novellara e San Giacomo (SP 62R),14963,00,13596,1367,11723,3240,14963,0
2019/02,314,01/02/2019,5,SP 2 fra Reggiolo (bivio SP 2) e località Villarotta (SP 84),8526,00,8173,353,6561,1965,8526,0
2019/02,314,02/02/2019,6,SP 2 fra Reggiolo (bivio SP 2) e località Villarotta (SP 84),6794,00,6664,130,4865,1929,0,6794
2019/02,314,03/02/2019,7,SP 2 fra Reggiolo (bivio SP 2) e località Villarotta (SP 84),5104,00,5062,42,3499,1605,0,5104
2019/02,314,04/02/2019,1,SP 2 fra Reggiolo (bivio SP 2) e località Villarotta (SP 84),8525,00,8160,365,6799,1726,8525,0
2019/02,314,05/02/2019,2,SP 2 fra Reggiolo (bivio SP 2) e località Villarotta (SP 84),8695,00,8328,367,6918,1777,8695,0
2019/02,314,06/02/2019,3,SP 2 fra Reggiolo (bivio SP 2) e località Villarotta (SP 84),8964,00,8561,403,7117,1847,8964,0
2019/02,314,07/02/2019,4,SP 2 fra Reggiolo (bivio SP 2) e località Villarotta (SP 84),8426,00,8034,392,6717,1709,8426,0
2019/02,314,08/02/2019,5,SP 2 fra Reggiolo (bivio SP 2) e località Villarotta (SP 84),8992,00,8580,412,7010,1982,8992,0
2019/02,314,09/02/2019,6,SP 2 fra Reggiolo (bivio SP 2) e località Villarotta (SP 84),7250,00,7096,154,5158,2092,0,7250
2019/02,314,10/02/2019,7,SP 2 fra Reggiolo (bivio SP 2) e località Villarotta (SP 84),6184,00,6122,62,4390,1794,0,6184
2019/02,314,11/02/2019,1,SP 2 fra Reggiolo (bivio SP 2) e località Villarotta (SP 84),8543,10,8149,393,6800,1743,8543,0
2019/02,314,12/02/2019,2,SP 2 fra Reggiolo (bivio SP 2) e località Villarotta (SP 84),8988,00,8615,373,7190,1798,8988,0
2019/02,314,13/02/2019,3,SP 2 fra Reggiolo (bivio SP 2) e località Villarotta (SP 84),9146,00,8740,406,7241,1905,9146,0
2019/02,314,14/02/2019,4,SP 2 fra Reggiolo (bivio SP 2) e località Villarotta (SP 84),9184,00,8734,450,7162,2022,9184,0
2019/02,318,01/02/2019,5,SP 51 fra Sassuolo (bivio SP 467R) e Rubiera,10578,20,8173,2403,8288,2290,10578,0
2019/02,318,02/02/2019,6,SP 51 fra Sassuolo (bivio SP 467R) e Rubiera,7922,00,7730,192,5389,2533,0,7922
2019/02,318,03/02/2019,7,SP 51 fra Sassuolo (bivio SP 467R) e Rubiera,6527,00,6471,56,4581,1946,0,6527
2019/02,318,04/02/2019,1,SP 51 fra Sassuolo (bivio SP 467R) e Rubiera,10488,40,8107,2377,8488,2000,10488,0
2019/02,318,05/02/2019,2,SP 51 fra Sassuolo (bivio SP 467R) e Rubiera,11024,40,8281,2739,9016,2008,11024,0
2019/02,318,06/02/2019,3,SP 51 fra Sassuolo (bivio SP 467R) e Rubiera,11293,10,8295,2997,9203,2090,11293,0
2019/02,318,07/02/2019,4,SP 51 fra Sassuolo (bivio SP 467R) e Rubiera,11407,30,8414,2990,9238,2169,11407,0
2019/02,318,08/02/2019,5,SP 51 fra Sassuolo (bivio SP 467R) e Rubiera,11657,20,8805,2850,9189,2468,11657,0
2019/02,318,09/02/2019,6,SP 51 fra Sassuolo (bivio SP 467R) e Rubiera,7883,00,7632,251,5412,2471,0,7883
2019/02,318,10/02/2019,7,SP 51 fra Sassuolo (bivio SP 467R) e Rubiera,7726,00,7667,59,5388,2338,0,7726
2019/02,318,11/02/2019,1,SP 51 fra Sassuolo (bivio SP 467R) e Rubiera,10939,00,8300,2639,8959,1980,10939,0
2019/02,318,12/02/2019,2,SP 51 fra Sassuolo (bivio SP 467R) e Rubiera,11359,30,8511,2845,9276,2083,11359,0
2019/02,318,13/02/2019,3,SP 51 fra Sassuolo (bivio SP 467R) e Rubiera,11393,00,8465,2928,9243,2150,11393,0
2019/02,318,14/02/2019,4,SP 51 fra Sassuolo (bivio SP 467R) e Rubiera,11828,10,8876,2951,9303,2525,11828,0
2019/02,319,01/02/2019,5,SP 15 tra Sassuolo e Magreta,,,,,,,,
2019/02,319,02/02/2019,6,SP 15 tra Sassuolo e Magreta,,,,,,,,
2019/02,319,03/02/2019,7,SP 15 tra Sassuolo e Magreta,,,,,,,,
2019/02,319,04/02/2019,1,SP 15 tra Sassuolo e Magreta,,,,,,,,
2019/02,319,05/02/2019,2,SP 15 tra Sassuolo e Magreta,,,,,,,,
2019/02,319,06/02/2019,3,SP 15 tra Sassuolo e Magreta,,,,,,,,
2019/02,319,07/02/2019,4,SP 15 tra Sassuolo e Magreta,,,,,,,,
2019/02,319,08/02/2019,5,SP 15 tra Sassuolo e Magreta,,,,,,,,
2019/02,319,09/02/2019,6,SP 15 tra Sassuolo e Magreta,,,,,,,,
2019/02,319,10/02/2019,7,SP 15 tra Sassuolo e Magreta,,,,,,,,
2019/02,319,11/02/2019,1,SP 15 tra Sassuolo e Magreta,,,,,,,,
2019/02,319,12/02/2019,2,SP 15 tra Sassuolo e Magreta,,,,,,,,
2019/02,319,13/02/2019,3,SP 15 tra Sassuolo e Magreta,,,,,,,,
2019/02,319,14/02/2019,4,SP 15 tra Sassuolo e Magreta,,,,,,,,
2019/02,321,01/02/2019,5,SP 467 tra SP 486 e confine provinciale,,,,,,,,
2019/02,321,02/02/2019,6,SP 467 tra SP 486 e confine provinciale,,,,,,,,
2019/02,321,03/02/2019,7,SP 467 tra SP 486 e confine provinciale,,,,,,,,
2019/02,321,04/02/2019,1,SP 467 tra SP 486 e confine provinciale,,,,,,,,
2019/02,321,05/02/2019,2,SP 467 tra SP 486 e confine provinciale,,,,,,,,
2019/02,321,06/02/2019,3,SP 467 tra SP 486 e confine provinciale,,,,,,,,
2019/02,321,07/02/2019,4,SP 467 tra SP 486 e confine provinciale,,,,,,,,
2019/02,321,08/02/2019,5,SP 467 tra SP 486 e confine provinciale,,,,,,,,
2019/02,321,09/02/2019,6,SP 467 tra SP 486 e confine provinciale,,,,,,,,
2019/02,321,10/02/2019,7,SP 467 tra SP 486 e confine provinciale,,,,,,,,
2019/02,321,11/02/2019,1,SP 467 tra SP 486 e confine provinciale,,,,,,,,
2019/02,321,12/02/2019,2,SP 467 tra SP 486 e confine provinciale,,,,,,,,
2019/02,321,13/02/2019,3,SP 467 tra SP 486 e confine provinciale,,,,,,,,
2019/02,321,14/02/2019,4,SP 467 tra SP 486 e confine provinciale,,,,,,,,
2019/02,323,01/02/2019,5,SP 467 fra SP 3 e SS 12,24141,10,20828,3312,18928,5213,24141,0
2019/02,323,02/02/2019,6,SP 467 fra SP 3 e SS 12,16310,00,15854,456,11855,4455,0,16310
2019/02,323,03/02/2019,7,SP 467 fra SP 3 e SS 12,12235,00,12136,99,8742,3493,0,12235
2019/02,323,04/02/2019,1,SP 467 fra SP 3 e SS 12,25727,20,22380,3345,20332,5395,25727,0
2019/02,323,05/02/2019,2,SP 467 fra SP 3 e SS 12,26345,00,22691,3654,20689,5656,26345,0
2019/02,323,06/02/2019,3,SP 467 fra SP 3 e SS 12,26608,30,22960,3645,20819,5789,26608,0
2019/02,323,07/02/2019,4,SP 467 fra SP 3 e SS 12,26797,10,22941,3855,21114,5683,26797,0
2019/02,323,08/02/2019,5,SP 467 fra SP 3 e SS 12,27575,20,23779,3794,21412,6163,27575,0
2019/02,323,09/02/2019,6,SP 467 fra SP 3 e SS 12,18173,10,17582,590,13200,4973,0,18173
2019/02,323,10/02/2019,7,SP 467 fra SP 3 e SS 12,13542,00,13454,88,9920,3622,0,13542
2019/02,323,11/02/2019,1,SP 467 fra SP 3 e SS 12,26136,00,22644,3492,20718,5418,26136,0
2019/02,323,12/02/2019,2,SP 467 fra SP 3 e SS 12,26865,00,22965,3900,21135,5730,26865,0
2019/02,323,13/02/2019,3,SP 467 fra SP 3 e SS 12,26807,00,22806,4001,20953,5854,26807,0
2019/02,323,14/02/2019,4,SP 467 fra SP 3 e SS 12,27595,10,23406,4188,21526,6069,27595,0
2019/02,328,01/02/2019,5,SP 486 tra Modena e Baggiovara,22947,20,22449,496,17700,5247,22947,0
2019/02,328,02/02/2019,6,SP 486 tra Modena e Baggiovara,20038,10,19812,225,14632,5406,0,20038
2019/02,328,03/02/2019,7,SP 486 tra Modena e Baggiovara,14946,00,14847,99,10561,4385,0,14946
2019/02,328,04/02/2019,1,SP 486 tra Modena e Baggiovara,24604,30,23996,605,19455,5149,24604,0
2019/02,328,05/02/2019,2,SP 486 tra Modena e Baggiovara,24399,40,23811,584,19095,5304,24399,0
2019/02,328,06/02/2019,3,SP 486 tra Modena e Baggiovara,24718,20,24125,591,19198,5520,24718,0
2019/02,328,07/02/2019,4,SP 486 tra Modena e Baggiovara,25227,10,24597,629,19518,5709,25227,0
2019/02,328,08/02/2019,5,SP 486 tra Modena e Baggiovara,25697,20,25050,645,19655,6042,25697,0
2019/02,328,09/02/2019,6,SP 486 tra Modena e Baggiovara,22393,10,22140,252,16021,6372,0,22393
2019/02,328,10/02/2019,7,SP 486 tra Modena e Baggiovara,15423,00,15314,109,10773,4650,0,15423
2019/02,328,11/02/2019,1,SP 486 tra Modena e Baggiovara,24325,10,23782,542,19250,5075,24325,0
2019/02,328,12/02/2019,2,SP 486 tra Modena e Baggiovara,24926,20,24348,576,19331,5595,24926,0
2019/02,328,13/02/2019,3,SP 486 tra Modena e Baggiovara,25001,20,24438,561,19255,5746,25001,0
2019/02,328,14/02/2019,4,SP 486 tra Modena e Baggiovara,25616,00,24975,641,19744,5872,25616,0
2019/02,332,01/02/2019,5,SP 306R fra Castel Bolognese e Riolo Terme,8324,00,7835,489,6450,1874,8324,0
2019/02,332,02/02/2019,6,SP 306R fra Castel Bolognese e Riolo Terme,7135,00,6983,152,5279,1856,0,7135
2019/02,332,03/02/2019,7,SP 306R fra Castel Bolognese e Riolo Terme,5833,00,5815,18,4434,1399,0,5833
2019/02,332,04/02/2019,1,SP 306R fra Castel Bolognese e Riolo Terme,7931,00,7469,462,6227,1704,7931,0
2019/02,332,05/02/2019,2,SP 306R fra Castel Bolognese e Riolo Terme,8319,00,7790,529,6621,1698,8319,0
2019/02,332,06/02/2019,3,SP 306R fra Castel Bolognese e Riolo Terme,8395,00,7898,497,6640,1755,8395,0
2019/02,332,07/02/2019,4,SP 306R fra Castel Bolognese e Riolo Terme,8358,00,7898,460,6515,1843,8358,0
2019/02,332,08/02/2019,5,SP 306R fra Castel Bolognese e Riolo Terme,8627,10,8096,530,6604,2023,8627,0
2019/02,332,09/02/2019,6,SP 306R fra Castel Bolognese e Riolo Terme,7523,00,7389,134,5508,2015,0,7523
2019/02,332,10/02/2019,7,SP 306R fra Castel Bolognese e Riolo Terme,6256,20,6221,33,4689,1567,0,6256
2019/02,332,11/02/2019,1,SP 306R fra Castel Bolognese e Riolo Terme,8310,00,7782,528,6634,1676,8310,0
2019/02,332,12/02/2019,2,SP 306R fra Castel Bolognese e Riolo Terme,8339,00,7793,546,6614,1725,8339,0
2019/02,332,13/02/2019,3,SP 306R fra Castel Bolognese e Riolo Terme,8225,10,7717,507,6450,1775,8225,0
2019/02,332,14/02/2019,4,SP 306R fra Castel Bolognese e Riolo Terme,8766,00,8273,493,6660,2106,8766,0
2019/02,333,01/02/2019,5,SS 9 tra Castel Bolognese e Faenza,22709,00,21918,791,16762,5947,22709,0
2019/02,333,02/02/2019,6,SS 9 tra Castel Bolognese e Faenza,20210,00,19972,238,13592,6618,0,20210
2019/02,333,03/02/2019,7,SS 9 tra Castel Bolognese e Faenza,15273,20,15222,49,10200,5073,0,15273
2019/02,333,04/02/2019,1,SS 9 tra Castel Bolognese e Faenza,21304,00,20542,762,16483,4821,21304,0
2019/02,333,05/02/2019,2,SS 9 tra Castel Bolognese e Faenza,22284,00,21493,791,17090,5194,22284,0
2019/02,333,06/02/2019,3,SS 9 tra Castel Bolognese e Faenza,22176,00,21389,787,16795,5381,22176,0
2019/02,333,07/02/2019,4,SS 9 tra Castel Bolognese e Faenza,22091,00,21378,713,16765,5326,22091,0
2019/02,333,08/02/2019,5,SS 9 tra Castel Bolognese e Faenza,23153,00,22363,790,16954,6199,23153,0
2019/02,333,09/02/2019,6,SS 9 tra Castel Bolognese e Faenza,20554,20,20306,246,13820,6734,0,20554
2019/02,333,10/02/2019,7,SS 9 tra Castel Bolognese e Faenza,16319,10,16237,81,11114,5205,0,16319
2019/02,333,11/02/2019,1,SS 9 tra Castel Bolognese e Faenza,21953,10,21100,852,17085,4868,21953,0
2019/02,333,12/02/2019,2,SS 9 tra Castel Bolognese e Faenza,22224,00,21413,811,16968,5256,22224,0
2019/02,333,13/02/2019,3,SS 9 tra Castel Bolognese e Faenza,22507,00,21756,751,16938,5569,22507,0
2019/02,333,14/02/2019,4,SS 9 tra Castel Bolognese e Faenza,23652,20,22851,799,17484,6168,23652,0
2019/02,334,01/02/2019,5,SP 8 dal Casello A 1 (Faenza) a Cotignola,14623,00,13831,792,11345,3278,14623,0
2019/02,334,02/02/2019,6,SP 8 dal Casello A 1 (Faenza) a Cotignola,13081,00,12894,187,9413,3668,0,13081
2019/02,334,03/02/2019,7,SP 8 dal Casello A 1 (Faenza) a Cotignola,11421,00,11390,31,8372,3049,0,11421
2019/02,334,04/02/2019,1,SP 8 dal Casello A 1 (Faenza) a Cotignola,14059,00,13215,844,11255,2804,14059,0
2019/02,334,05/02/2019,2,SP 8 dal Casello A 1 (Faenza) a Cotignola,14045,00,12906,1139,10942,3103,14045,0
2019/02,334,06/02/2019,3,SP 8 dal Casello A 1 (Faenza) a Cotignola,13969,00,12875,1094,10875,3094,13969,0
2019/02,334,07/02/2019,4,SP 8 dal Casello A 1 (Faenza) a Cotignola,14284,00,13263,1021,11247,3037,14284,0
2019/02,334,08/02/2019,5,SP 8 dal Casello A 1 (Faenza) a Cotignola,14746,00,13730,1016,11152,3594,14746,0
2019/02,334,09/02/2019,6,SP 8 dal Casello A 1 (Faenza) a Cotignola,13059,00,12817,242,9226,3833,0,13059
2019/02,334,10/02/2019,7,SP 8 dal Casello A 1 (Faenza) a Cotignola,12052,00,12025,27,8993,3059,0,12052
2019/02,334,11/02/2019,1,SP 8 dal Casello A 1 (Faenza) a Cotignola,14086,00,12981,1105,11318,2768,14086,0
2019/02,334,12/02/2019,2,SP 8 dal Casello A 1 (Faenza) a Cotignola,14103,00,13003,1100,11126,2977,14103,0
2019/02,334,13/02/2019,3,SP 8 dal Casello A 1 (Faenza) a Cotignola,14046,00,13056,990,10735,3311,14046,0
2019/02,334,14/02/2019,4,SP 8 dal Casello A 1 (Faenza) a Cotignola,14754,00,13807,947,11228,3526,14754,0
2019/02,335,01/02/2019,5,SP 7 tra l'A 14 (bivio SP 29) e l'A 14dir (Barbiano),7301,10,6825,475,5665,1636,7301,0
2019/02,335,02/02/2019,6,SP 7 tra l'A 14 (bivio SP 29) e l'A 14dir (Barbiano),5612,00,5498,114,3994,1618,0,5612
2019/02,335,03/02/2019,7,SP 7 tra l'A 14 (bivio SP 29) e l'A 14dir (Barbiano),4444,00,4419,25,3147,1297,0,4444
2019/02,335,04/02/2019,1,SP 7 tra l'A 14 (bivio SP 29) e l'A 14dir (Barbiano),7138,10,6585,552,5739,1399,7138,0
2019/02,335,05/02/2019,2,SP 7 tra l'A 14 (bivio SP 29) e l'A 14dir (Barbiano),7358,00,6786,572,5920,1438,7358,0
2019/02,335,06/02/2019,3,SP 7 tra l'A 14 (bivio SP 29) e l'A 14dir (Barbiano),7654,00,7059,595,6162,1492,7654,0
2019/02,335,07/02/2019,4,SP 7 tra l'A 14 (bivio SP 29) e l'A 14dir (Barbiano),7592,20,6996,594,6057,1535,7592,0
2019/02,335,08/02/2019,5,SP 7 tra l'A 14 (bivio SP 29) e l'A 14dir (Barbiano),7780,00,7173,607,6071,1709,7780,0
2019/02,335,09/02/2019,6,SP 7 tra l'A 14 (bivio SP 29) e l'A 14dir (Barbiano),5937,00,5807,130,4145,1792,0,5937
2019/02,335,10/02/2019,7,SP 7 tra l'A 14 (bivio SP 29) e l'A 14dir (Barbiano),4898,00,4885,13,3466,1432,0,4898
2019/02,335,11/02/2019,1,SP 7 tra l'A 14 (bivio SP 29) e l'A 14dir (Barbiano),7591,00,6873,718,6155,1436,7591,0
2019/02,335,12/02/2019,2,SP 7 tra l'A 14 (bivio SP 29) e l'A 14dir (Barbiano),7567,00,6892,675,6054,1513,7567,0
2019/02,335,13/02/2019,3,SP 7 tra l'A 14 (bivio SP 29) e l'A 14dir (Barbiano),7701,00,7087,614,6184,1517,7701,0
2019/02,335,14/02/2019,4,SP 7 tra l'A 14 (bivio SP 29) e l'A 14dir (Barbiano),7789,00,7160,629,6088,1701,7789,0
2019/02,336,01/02/2019,5,SP 253R tra Lugo (ponte fiume Senio) e Bagnacavallo,11523,00,10892,631,9109,2414,11523,0
2019/02,336,02/02/2019,6,SP 253R tra Lugo (ponte fiume Senio) e Bagnacavallo,9310,00,9171,139,6971,2339,0,9310
2019/02,336,03/02/2019,7,SP 253R tra Lugo (ponte fiume Senio) e Bagnacavallo,6315,00,6291,24,4606,1709,0,6315
2019/02,336,04/02/2019,1,SP 253R tra Lugo (ponte fiume Senio) e Bagnacavallo,11193,00,10520,673,9107,2086,11193,0
2019/02,336,05/02/2019,2,SP 253R tra Lugo (ponte fiume Senio) e Bagnacavallo,11403,00,10614,789,9220,2183,11403,0
2019/02,336,06/02/2019,3,SP 253R tra Lugo (ponte fiume Senio) e Bagnacavallo,11588,00,10809,779,9284,2304,11588,0
2019/02,336,07/02/2019,4,SP 253R tra Lugo (ponte fiume Senio) e Bagnacavallo,11652,00,10871,781,9372,2280,11652,0
2019/02,336,08/02/2019,5,SP 253R tra Lugo (ponte fiume Senio) e Bagnacavallo,11895,10,11160,734,9406,2489,11895,0
2019/02,336,09/02/2019,6,SP 253R tra Lugo (ponte fiume Senio) e Bagnacavallo,9716,00,9483,233,7331,2385,0,9716
2019/02,336,10/02/2019,7,SP 253R tra Lugo (ponte fiume Senio) e Bagnacavallo,6594,00,6559,35,4841,1753,0,6594
2019/02,336,11/02/2019,1,SP 253R tra Lugo (ponte fiume Senio) e Bagnacavallo,11258,00,10627,631,9139,2119,11258,0
2019/02,336,12/02/2019,2,SP 253R tra Lugo (ponte fiume Senio) e Bagnacavallo,11567,00,10891,676,9284,2283,11567,0
2019/02,336,13/02/2019,3,SP 253R tra Lugo (ponte fiume Senio) e Bagnacavallo,11669,00,10975,694,9356,2313,11669,0
2019/02,336,14/02/2019,4,SP 253R tra Lugo (ponte fiume Senio) e Bagnacavallo,11860,20,11108,750,9456,2404,11860,0
2019/02,337,01/02/2019,5,SP 14 fra Lugo (bivio SSPP 41/46) e Fusignano,11999,20,11441,556,9531,2468,11999,0
2019/02,337,02/02/2019,6,SP 14 fra Lugo (bivio SSPP 41/46) e Fusignano,9394,00,9259,135,7188,2206,0,9394
2019/02,337,03/02/2019,7,SP 14 fra Lugo (bivio SSPP 41/46) e Fusignano,6311,00,6296,15,4503,1808,0,6311
2019/02,337,04/02/2019,1,SP 14 fra Lugo (bivio SSPP 41/46) e Fusignano,11507,10,10927,579,9366,2141,11507,0
2019/02,337,05/02/2019,2,SP 14 fra Lugo (bivio SSPP 41/46) e Fusignano,11790,00,11218,572,9520,2270,11790,0
2019/02,337,06/02/2019,3,SP 14 fra Lugo (bivio SSPP 41/46) e Fusignano,11750,10,11167,582,9559,2191,11750,0
2019/02,337,07/02/2019,4,SP 14 fra Lugo (bivio SSPP 41/46) e Fusignano,11932,00,11369,563,9650,2282,11932,0
2019/02,337,08/02/2019,5,SP 14 fra Lugo (bivio SSPP 41/46) e Fusignano,12069,00,11507,562,9638,2431,12069,0
2019/02,337,09/02/2019,6,SP 14 fra Lugo (bivio SSPP 41/46) e Fusignano,9901,00,9689,212,7590,2311,0,9901
2019/02,337,10/02/2019,7,SP 14 fra Lugo (bivio SSPP 41/46) e Fusignano,6954,00,6929,25,5142,1812,0,6954
2019/02,337,11/02/2019,1,SP 14 fra Lugo (bivio SSPP 41/46) e Fusignano,11711,00,11083,628,9591,2120,11711,0
2019/02,337,12/02/2019,2,SP 14 fra Lugo (bivio SSPP 41/46) e Fusignano,11842,10,11207,634,9524,2318,11842,0
2019/02,337,13/02/2019,3,SP 14 fra Lugo (bivio SSPP 41/46) e Fusignano,12180,20,11588,590,9824,2356,12180,0
2019/02,337,14/02/2019,4,SP 14 fra Lugo (bivio SSPP 41/46) e Fusignano,12470,00,11827,643,9856,2614,12470,0
2019/02,339,01/02/2019,5,SP 3 tra San Lorenzo in Noceto e Predappio,7523,00,7156,367,5937,1586,7523,0
2019/02,339,02/02/2019,6,SP 3 tra San Lorenzo in Noceto e Predappio,6303,00,6212,91,4647,1656,0,6303
2019/02,339,03/02/2019,7,SP 3 tra San Lorenzo in Noceto e Predappio,5260,10,5246,13,3948,1312,0,5260
2019/02,339,04/02/2019,1,SP 3 tra San Lorenzo in Noceto e Predappio,6322,00,6016,306,5052,1270,6322,0
2019/02,339,05/02/2019,2,SP 3 tra San Lorenzo in Noceto e Predappio,7449,00,7110,339,6017,1432,7449,0
2019/02,339,06/02/2019,3,SP 3 tra San Lorenzo in Noceto e Predappio,7697,00,7341,356,6105,1592,7697,0
2019/02,339,07/02/2019,4,SP 3 tra San Lorenzo in Noceto e Predappio,7560,00,7200,360,6001,1559,7560,0
2019/02,339,08/02/2019,5,SP 3 tra San Lorenzo in Noceto e Predappio,7700,00,7314,386,6103,1597,7700,0
2019/02,339,09/02/2019,6,SP 3 tra San Lorenzo in Noceto e Predappio,6810,10,6705,104,5045,1765,0,6810
2019/02,339,10/02/2019,7,SP 3 tra San Lorenzo in Noceto e Predappio,5484,00,5462,22,4156,1328,0,5484
2019/02,339,11/02/2019,1,SP 3 tra San Lorenzo in Noceto e Predappio,7487,00,7106,381,6008,1479,7487,0
2019/02,339,12/02/2019,2,SP 3 tra San Lorenzo in Noceto e Predappio,7675,00,7267,408,6142,1533,7675,0
2019/02,339,13/02/2019,3,SP 3 tra San Lorenzo in Noceto e Predappio,7942,00,7554,388,6304,1638,7942,0
2019/02,339,14/02/2019,4,SP 3 tra San Lorenzo in Noceto e Predappio,8121,00,7701,420,6221,1900,8121,0
2019/02,340,01/02/2019,5,SP 72 tra San Martino in Strada e bivio ex SS 310R (Meldola),9922,00,9500,422,7822,2100,9922,0
2019/02,340,02/02/2019,6,SP 72 tra San Martino in Strada e bivio ex SS 310R (Meldola),7594,00,7460,134,5634,1960,0,7594
2019/02,340,03/02/2019,7,SP 72 tra San Martino in Strada e bivio ex SS 310R (Meldola),6686,00,6674,12,4825,1861,0,6686
2019/02,340,04/02/2019,1,SP 72 tra San Martino in Strada e bivio ex SS 310R (Meldola),8574,10,8262,311,6738,1836,8574,0
2019/02,340,05/02/2019,2,SP 72 tra San Martino in Strada e bivio ex SS 310R (Meldola),10051,10,9599,451,8140,1911,10051,0
2019/02,340,06/02/2019,3,SP 72 tra San Martino in Strada e bivio ex SS 310R (Meldola),10230,00,9856,374,8137,2093,10230,0
2019/02,340,07/02/2019,4,SP 72 tra San Martino in Strada e bivio ex SS 310R (Meldola),9937,10,9552,384,7866,2071,9937,0
2019/02,340,08/02/2019,5,SP 72 tra San Martino in Strada e bivio ex SS 310R (Meldola),10260,00,9780,480,8015,2245,10260,0
2019/02,340,09/02/2019,6,SP 72 tra San Martino in Strada e bivio ex SS 310R (Meldola),8599,00,8456,143,6354,2245,0,8599
2019/02,340,10/02/2019,7,SP 72 tra San Martino in Strada e bivio ex SS 310R (Meldola),6807,00,6793,14,5067,1740,0,6807
2019/02,340,11/02/2019,1,SP 72 tra San Martino in Strada e bivio ex SS 310R (Meldola),9903,00,9470,433,7999,1904,9903,0
2019/02,340,12/02/2019,2,SP 72 tra San Martino in Strada e bivio ex SS 310R (Meldola),10181,00,9727,454,8110,2071,10181,0
2019/02,340,13/02/2019,3,SP 72 tra San Martino in Strada e bivio ex SS 310R (Meldola),10328,20,9844,482,8164,2164,10328,0
2019/02,340,14/02/2019,4,SP 72 tra San Martino in Strada e bivio ex SS 310R (Meldola),10642,00,10197,445,8237,2405,10642,0
2019/02,342,01/02/2019,5,SP 33 in località Gatteo,17428,00,15928,1500,13447,3981,17428,0
2019/02,342,02/02/2019,6,SP 33 in località Gatteo,14105,00,13642,463,10334,3771,0,14105
2019/02,342,03/02/2019,7,SP 33 in località Gatteo,11120,00,11019,101,8117,3003,0,11120
2019/02,342,04/02/2019,1,SP 33 in località Gatteo,16839,00,15269,1570,13646,3193,16839,0
2019/02,342,05/02/2019,2,SP 33 in località Gatteo,17618,10,15976,1641,14207,3411,17618,0
2019/02,342,06/02/2019,3,SP 33 in località Gatteo,17501,10,15874,1626,14011,3490,17501,0
2019/02,342,07/02/2019,4,SP 33 in località Gatteo,17720,10,16048,1671,14062,3658,17720,0
2019/02,342,08/02/2019,5,SP 33 in località Gatteo,18463,00,16798,1665,14432,4031,18463,0
2019/02,342,09/02/2019,6,SP 33 in località Gatteo,14998,10,14495,502,11048,3950,0,14998
2019/02,342,10/02/2019,7,SP 33 in località Gatteo,11267,10,11168,98,8159,3108,0,11267
2019/02,342,11/02/2019,1,SP 33 in località Gatteo,17169,10,15599,1569,13834,3335,17169,0
2019/02,342,12/02/2019,2,SP 33 in località Gatteo,17843,00,16171,1672,14363,3480,17843,0
2019/02,342,13/02/2019,3,SP 33 in località Gatteo,18121,10,16416,1704,14403,3718,18121,0
2019/02,342,14/02/2019,4,SP 33 in località Gatteo,18319,00,16666,1653,14256,4063,18319,0
2019/02,343,01/02/2019,5,SP 4 tra Galeata e Santa Sofia,5180,00,4890,290,3913,1267,5180,0
2019/02,343,02/02/2019,6,SP 4 tra Galeata e Santa Sofia,5022,00,4863,159,3633,1389,0,5022
2019/02,343,03/02/2019,7,SP 4 tra Galeata e Santa Sofia,4692,00,4669,23,3729,963,0,4692
2019/02,343,04/02/2019,1,SP 4 tra Galeata e Santa Sofia,5431,00,5100,331,4374,1057,5431,0
2019/02,343,05/02/2019,2,SP 4 tra Galeata e Santa Sofia,5316,00,4979,337,4180,1136,5316,0
2019/02,343,06/02/2019,3,SP 4 tra Galeata e Santa Sofia,5570,00,5264,306,4374,1196,5570,0
2019/02,343,07/02/2019,4,SP 4 tra Galeata e Santa Sofia,5507,00,5170,337,4282,1225,5507,0
2019/02,343,08/02/2019,5,SP 4 tra Galeata e Santa Sofia,5634,00,5326,308,4385,1249,5634,0
2019/02,343,09/02/2019,6,SP 4 tra Galeata e Santa Sofia,5755,00,5581,174,4308,1447,0,5755
2019/02,343,10/02/2019,7,SP 4 tra Galeata e Santa Sofia,4855,00,4828,27,3931,924,0,4855
2019/02,343,11/02/2019,1,SP 4 tra Galeata e Santa Sofia,5471,00,5147,324,4388,1083,5471,0
2019/02,343,12/02/2019,2,SP 4 tra Galeata e Santa Sofia,5447,10,5133,313,4271,1176,5447,0
2019/02,343,13/02/2019,3,SP 4 tra Galeata e Santa Sofia,5521,00,5209,312,4282,1239,5521,0
2019/02,343,14/02/2019,4,SP 4 tra Galeata e Santa Sofia,5618,00,5291,327,4367,1251,5618,0
2019/02,344,01/02/2019,5,SS 3Bis/E 45 tra Borello e Mercato Saraceno,11939,20,10972,965,9336,2603,11939,0
2019/02,344,02/02/2019,6,SS 3Bis/E 45 tra Borello e Mercato Saraceno,10356,10,10098,257,7717,2639,0,10356
2019/02,344,03/02/2019,7,SS 3Bis/E 45 tra Borello e Mercato Saraceno,9530,00,9429,101,7382,2148,0,9530
2019/02,344,04/02/2019,1,SS 3Bis/E 45 tra Borello e Mercato Saraceno,11620,10,10594,1025,9298,2322,11620,0
2019/02,344,05/02/2019,2,SS 3Bis/E 45 tra Borello e Mercato Saraceno,12000,20,11029,969,9601,2399,12000,0
2019/02,344,06/02/2019,3,SS 3Bis/E 45 tra Borello e Mercato Saraceno,12373,30,11324,1046,9901,2472,12373,0
2019/02,344,07/02/2019,4,SS 3Bis/E 45 tra Borello e Mercato Saraceno,12336,10,11256,1079,9754,2582,12336,0
2019/02,344,08/02/2019,5,SS 3Bis/E 45 tra Borello e Mercato Saraceno,13022,20,11980,1040,10053,2969,13022,0
2019/02,344,09/02/2019,6,SS 3Bis/E 45 tra Borello e Mercato Saraceno,11577,10,11239,337,8636,2941,0,11577
2019/02,344,10/02/2019,7,SS 3Bis/E 45 tra Borello e Mercato Saraceno,10240,00,10156,84,8027,2213,0,10240
2019/02,344,11/02/2019,1,SS 3Bis/E 45 tra Borello e Mercato Saraceno,11868,10,10911,956,9428,2440,11868,0
2019/02,344,12/02/2019,2,SS 3Bis/E 45 tra Borello e Mercato Saraceno,12356,00,11366,990,9814,2542,12356,0
2019/02,344,13/02/2019,3,SS 3Bis/E 45 tra Borello e Mercato Saraceno,12672,00,11595,1077,9963,2709,12672,0
2019/02,344,14/02/2019,4,SS 3Bis/E 45 tra Borello e Mercato Saraceno,14363,10,13197,1165,11128,3235,14363,0
2019/02,348,01/02/2019,5,SP 10 dal bivio con SP 89 (San Mauro Pascoli) c/o A 14  al bivio SS 16 (San Mauro Mare),,,,,,,,
2019/02,348,02/02/2019,6,SP 10 dal bivio con SP 89 (San Mauro Pascoli) c/o A 14  al bivio SS 16 (San Mauro Mare),,,,,,,,
2019/02,348,03/02/2019,7,SP 10 dal bivio con SP 89 (San Mauro Pascoli) c/o A 14  al bivio SS 16 (San Mauro Mare),,,,,,,,
2019/02,348,04/02/2019,1,SP 10 dal bivio con SP 89 (San Mauro Pascoli) c/o A 14  al bivio SS 16 (San Mauro Mare),,,,,,,,
2019/02,348,05/02/2019,2,SP 10 dal bivio con SP 89 (San Mauro Pascoli) c/o A 14  al bivio SS 16 (San Mauro Mare),,,,,,,,
2019/02,348,06/02/2019,3,SP 10 dal bivio con SP 89 (San Mauro Pascoli) c/o A 14  al bivio SS 16 (San Mauro Mare),,,,,,,,
2019/02,348,07/02/2019,4,SP 10 dal bivio con SP 89 (San Mauro Pascoli) c/o A 14  al bivio SS 16 (San Mauro Mare),,,,,,,,
2019/02,348,08/02/2019,5,SP 10 dal bivio con SP 89 (San Mauro Pascoli) c/o A 14  al bivio SS 16 (San Mauro Mare),,,,,,,,
2019/02,348,09/02/2019,6,SP 10 dal bivio con SP 89 (San Mauro Pascoli) c/o A 14  al bivio SS 16 (San Mauro Mare),,,,,,,,
2019/02,348,10/02/2019,7,SP 10 dal bivio con SP 89 (San Mauro Pascoli) c/o A 14  al bivio SS 16 (San Mauro Mare),,,,,,,,
2019/02,348,11/02/2019,1,SP 10 dal bivio con SP 89 (San Mauro Pascoli) c/o A 14  al bivio SS 16 (San Mauro Mare),,,,,,,,
2019/02,348,12/02/2019,2,SP 10 dal bivio con SP 89 (San Mauro Pascoli) c/o A 14  al bivio SS 16 (San Mauro Mare),,,,,,,,
2019/02,348,13/02/2019,3,SP 10 dal bivio con SP 89 (San Mauro Pascoli) c/o A 14  al bivio SS 16 (San Mauro Mare),,,,,,,,
2019/02,348,14/02/2019,4,SP 10 dal bivio con SP 89 (San Mauro Pascoli) c/o A 14  al bivio SS 16 (San Mauro Mare),,,,,,,,
2019/02,349,01/02/2019,5,SS 16 tra Cervia e Cesenatico,20380,00,18368,2012,15223,5157,20380,0
2019/02,349,02/02/2019,6,SS 16 tra Cervia e Cesenatico,18825,20,18396,427,13114,5711,0,18825
2019/02,349,03/02/2019,7,SS 16 tra Cervia e Cesenatico,18704,10,18563,140,13709,4995,0,18704
2019/02,349,04/02/2019,1,SS 16 tra Cervia e Cesenatico,18961,20,17018,1941,14998,3963,18961,0
2019/02,349,05/02/2019,2,SS 16 tra Cervia e Cesenatico,19276,00,16944,2332,15124,4152,19276,0
2019/02,349,06/02/2019,3,SS 16 tra Cervia e Cesenatico,19622,00,17350,2272,15405,4217,19622,0
2019/02,349,07/02/2019,4,SS 16 tra Cervia e Cesenatico,20442,00,18110,2332,15865,4577,20442,0
2019/02,349,08/02/2019,5,SS 16 tra Cervia e Cesenatico,20941,20,18697,2242,15493,5448,20941,0
2019/02,349,09/02/2019,6,SS 16 tra Cervia e Cesenatico,21585,20,20981,602,14891,6694,0,21585
2019/02,349,10/02/2019,7,SS 16 tra Cervia e Cesenatico,22010,00,21813,197,16035,5975,0,22010
2019/02,349,11/02/2019,1,SS 16 tra Cervia e Cesenatico,19339,20,16995,2342,15289,4050,19339,0
2019/02,349,12/02/2019,2,SS 16 tra Cervia e Cesenatico,19976,20,17457,2517,15729,4247,19976,0
2019/02,349,13/02/2019,3,SS 16 tra Cervia e Cesenatico,20466,20,17953,2511,15985,4481,20466,0
2019/02,349,14/02/2019,4,SS 16 tra Cervia e Cesenatico,23339,10,20820,2518,17545,5794,23339,0
2019/02,351,01/02/2019,5,SS 72 tra Rimini e  San Marino,,,,,,,,
2019/02,351,02/02/2019,6,SS 72 tra Rimini e  San Marino,,,,,,,,
2019/02,351,03/02/2019,7,SS 72 tra Rimini e  San Marino,,,,,,,,
2019/02,351,04/02/2019,1,SS 72 tra Rimini e  San Marino,,,,,,,,
2019/02,351,05/02/2019,2,SS 72 tra Rimini e  San Marino,,,,,,,,
2019/02,351,06/02/2019,3,SS 72 tra Rimini e  San Marino,,,,,,,,
2019/02,351,07/02/2019,4,SS 72 tra Rimini e  San Marino,,,,,,,,
2019/02,351,08/02/2019,5,SS 72 tra Rimini e  San Marino,,,,,,,,
2019/02,351,09/02/2019,6,SS 72 tra Rimini e  San Marino,,,,,,,,
2019/02,351,10/02/2019,7,SS 72 tra Rimini e  San Marino,,,,,,,,
2019/02,351,11/02/2019,1,SS 72 tra Rimini e  San Marino,,,,,,,,
2019/02,351,12/02/2019,2,SS 72 tra Rimini e  San Marino,,,,,,,,
2019/02,351,13/02/2019,3,SS 72 tra Rimini e  San Marino,,,,,,,,
2019/02,351,14/02/2019,4,SS 72 tra Rimini e  San Marino,,,,,,,,
2019/02,354,01/02/2019,5,SP 31 tra Viadotto A 14 e Coriano,12538,10,12216,321,9772,2766,12538,0
2019/02,354,02/02/2019,6,SP 31 tra Viadotto A 14 e Coriano,11283,00,11146,137,8262,3021,0,11283
2019/02,354,03/02/2019,7,SP 31 tra Viadotto A 14 e Coriano,9034,00,8998,36,6384,2650,0,9034
2019/02,354,04/02/2019,1,SP 31 tra Viadotto A 14 e Coriano,12411,00,12075,336,10059,2352,12411,0
2019/02,354,05/02/2019,2,SP 31 tra Viadotto A 14 e Coriano,12398,10,12029,368,9884,2514,12398,0
2019/02,354,06/02/2019,3,SP 31 tra Viadotto A 14 e Coriano,12413,00,12096,317,9868,2545,12413,0
2019/02,354,07/02/2019,4,SP 31 tra Viadotto A 14 e Coriano,12269,10,11931,337,9755,2514,12269,0
2019/02,354,08/02/2019,5,SP 31 tra Viadotto A 14 e Coriano,12739,10,12431,307,10021,2718,12739,0
2019/02,354,09/02/2019,6,SP 31 tra Viadotto A 14 e Coriano,11591,10,11472,118,8351,3240,0,11591
2019/02,354,10/02/2019,7,SP 31 tra Viadotto A 14 e Coriano,9367,00,9336,31,6643,2724,0,9367
2019/02,354,11/02/2019,1,SP 31 tra Viadotto A 14 e Coriano,12293,10,11971,321,9936,2357,12293,0
2019/02,354,12/02/2019,2,SP 31 tra Viadotto A 14 e Coriano,12432,20,12110,320,9919,2513,12432,0
2019/02,354,13/02/2019,3,SP 31 tra Viadotto A 14 e Coriano,12647,20,12279,366,10029,2618,12647,0
2019/02,354,14/02/2019,4,SP 31 tra Viadotto A 14 e Coriano,13145,00,12795,350,10237,2908,13145,0
2019/02,355,01/02/2019,5,SP 17V tra San Giovanni in Marignano e Morciano di Romagna (variante),15474,00,14816,658,12218,3256,15474,0
2019/02,355,02/02/2019,6,SP 17V tra San Giovanni in Marignano e Morciano di Romagna (variante),12446,00,12319,127,9597,2849,0,12446
2019/02,355,03/02/2019,7,SP 17V tra San Giovanni in Marignano e Morciano di Romagna (variante),9519,00,9496,23,6973,2546,0,9519
2019/02,355,04/02/2019,1,SP 17V tra San Giovanni in Marignano e Morciano di Romagna (variante),14882,00,14220,662,12101,2781,14882,0
2019/02,355,05/02/2019,2,SP 17V tra San Giovanni in Marignano e Morciano di Romagna (variante),15641,00,14915,726,12717,2924,15641,0
2019/02,355,06/02/2019,3,SP 17V tra San Giovanni in Marignano e Morciano di Romagna (variante),15429,00,14734,695,12461,2968,15429,0
2019/02,355,07/02/2019,4,SP 17V tra San Giovanni in Marignano e Morciano di Romagna (variante),16032,00,15254,778,12880,3152,16032,0
2019/02,355,08/02/2019,5,SP 17V tra San Giovanni in Marignano e Morciano di Romagna (variante),15954,00,15293,661,12673,3281,15954,0
2019/02,355,09/02/2019,6,SP 17V tra San Giovanni in Marignano e Morciano di Romagna (variante),13595,00,13434,161,10451,3144,0,13595
2019/02,355,10/02/2019,7,SP 17V tra San Giovanni in Marignano e Morciano di Romagna (variante),10172,00,10147,25,7470,2702,0,10172
2019/02,355,11/02/2019,1,SP 17V tra San Giovanni in Marignano e Morciano di Romagna (variante),15462,00,14801,661,12649,2813,15462,0
2019/02,355,12/02/2019,2,SP 17V tra San Giovanni in Marignano e Morciano di Romagna (variante),15761,00,15094,667,12598,3163,15761,0
2019/02,355,13/02/2019,3,SP 17V tra San Giovanni in Marignano e Morciano di Romagna (variante),16544,00,15776,768,13337,3207,16544,0
2019/02,355,14/02/2019,4,SP 17V tra San Giovanni in Marignano e Morciano di Romagna (variante),17302,00,16564,738,13688,3614,17302,0
2019/02,356,01/02/2019,5,SP 2 fra Reggiolo c/o bivio variante nord e confine regionale,7554,00,6686,868,5884,1670,7554,0
2019/02,356,02/02/2019,6,SP 2 fra Reggiolo c/o bivio variante nord e confine regionale,6408,00,5993,415,4479,1929,0,6408
2019/02,356,03/02/2019,7,SP 2 fra Reggiolo c/o bivio variante nord e confine regionale,4312,00,4259,53,2901,1411,0,4312
2019/02,356,04/02/2019,1,SP 2 fra Reggiolo c/o bivio variante nord e confine regionale,7180,00,6315,865,5750,1430,7180,0
2019/02,356,05/02/2019,2,SP 2 fra Reggiolo c/o bivio variante nord e confine regionale,7196,00,6316,880,5676,1520,7196,0
2019/02,356,06/02/2019,3,SP 2 fra Reggiolo c/o bivio variante nord e confine regionale,7323,00,6471,852,5787,1536,7323,0
2019/02,356,07/02/2019,4,SP 2 fra Reggiolo c/o bivio variante nord e confine regionale,7270,00,6446,824,5749,1521,7270,0
2019/02,356,08/02/2019,5,SP 2 fra Reggiolo c/o bivio variante nord e confine regionale,7825,00,6874,951,6019,1806,7825,0
2019/02,356,09/02/2019,6,SP 2 fra Reggiolo c/o bivio variante nord e confine regionale,6347,00,6178,169,4510,1837,0,6347
2019/02,356,10/02/2019,7,SP 2 fra Reggiolo c/o bivio variante nord e confine regionale,4475,00,4405,70,3143,1332,0,4475
2019/02,356,11/02/2019,1,SP 2 fra Reggiolo c/o bivio variante nord e confine regionale,7166,00,6258,908,5698,1468,7166,0
2019/02,356,12/02/2019,2,SP 2 fra Reggiolo c/o bivio variante nord e confine regionale,7693,00,6765,928,6125,1568,7693,0
2019/02,356,13/02/2019,3,SP 2 fra Reggiolo c/o bivio variante nord e confine regionale,7693,00,6747,946,6071,1622,7693,0
2019/02,356,14/02/2019,4,SP 2 fra Reggiolo c/o bivio variante nord e confine regionale,7904,10,7005,898,6155,1749,7904,0
2019/02,357,01/02/2019,5,SP 306R fra Casola Valsenio e bivio SP 65 c/o località Isola,3215,00,2886,329,2591,624,3215,0
2019/02,357,02/02/2019,6,SP 306R fra Casola Valsenio e bivio SP 65 c/o località Isola,2639,00,2564,75,2031,608,0,2639
2019/02,357,03/02/2019,7,SP 306R fra Casola Valsenio e bivio SP 65 c/o località Isola,2572,00,2565,7,2078,494,0,2572
2019/02,357,04/02/2019,1,SP 306R fra Casola Valsenio e bivio SP 65 c/o località Isola,2996,00,2688,308,2423,573,2996,0
2019/02,357,05/02/2019,2,SP 306R fra Casola Valsenio e bivio SP 65 c/o località Isola,3407,10,3050,356,2812,595,3407,0
2019/02,357,06/02/2019,3,SP 306R fra Casola Valsenio e bivio SP 65 c/o località Isola,3215,10,2906,308,2639,576,3215,0
2019/02,357,07/02/2019,4,SP 306R fra Casola Valsenio e bivio SP 65 c/o località Isola,3259,00,2936,323,2617,642,3259,0
2019/02,357,08/02/2019,5,SP 306R fra Casola Valsenio e bivio SP 65 c/o località Isola,3365,00,3031,334,2679,686,3365,0
2019/02,357,09/02/2019,6,SP 306R fra Casola Valsenio e bivio SP 65 c/o località Isola,2891,00,2797,94,2217,674,0,2891
2019/02,357,10/02/2019,7,SP 306R fra Casola Valsenio e bivio SP 65 c/o località Isola,2581,00,2553,28,2037,544,0,2581
2019/02,357,11/02/2019,1,SP 306R fra Casola Valsenio e bivio SP 65 c/o località Isola,3187,00,2863,324,2650,537,3187,0
2019/02,357,12/02/2019,2,SP 306R fra Casola Valsenio e bivio SP 65 c/o località Isola,3549,00,3169,380,2886,663,3549,0
2019/02,357,13/02/2019,3,SP 306R fra Casola Valsenio e bivio SP 65 c/o località Isola,3372,10,2973,398,2750,622,3372,0
2019/02,357,14/02/2019,4,SP 306R fra Casola Valsenio e bivio SP 65 c/o località Isola,3472,10,3153,318,2689,783,3472,0
2019/02,376,01/02/2019,5,SP 68 tra Portomaggiore e la Superstrada Ferrara-Mare,3208,00,3047,161,2566,642,3208,0
2019/02,376,02/02/2019,6,SP 68 tra Portomaggiore e la Superstrada Ferrara-Mare,2423,00,2371,52,1826,597,0,2423
2019/02,376,03/02/2019,7,SP 68 tra Portomaggiore e la Superstrada Ferrara-Mare,2002,00,1996,6,1507,495,0,2002
2019/02,376,04/02/2019,1,SP 68 tra Portomaggiore e la Superstrada Ferrara-Mare,2974,00,2793,181,2416,558,2974,0
2019/02,376,05/02/2019,2,SP 68 tra Portomaggiore e la Superstrada Ferrara-Mare,3249,00,3061,188,2666,583,3249,0
2019/02,376,06/02/2019,3,SP 68 tra Portomaggiore e la Superstrada Ferrara-Mare,3032,00,2845,187,2454,578,3032,0
2019/02,376,07/02/2019,4,SP 68 tra Portomaggiore e la Superstrada Ferrara-Mare,3300,10,3095,204,2670,630,3300,0
2019/02,376,08/02/2019,5,SP 68 tra Portomaggiore e la Superstrada Ferrara-Mare,3329,00,3142,187,2625,704,3329,0
2019/02,376,09/02/2019,6,SP 68 tra Portomaggiore e la Superstrada Ferrara-Mare,2639,00,2546,93,1993,646,0,2639
2019/02,376,10/02/2019,7,SP 68 tra Portomaggiore e la Superstrada Ferrara-Mare,2091,00,2076,15,1610,481,0,2091
2019/02,376,11/02/2019,1,SP 68 tra Portomaggiore e la Superstrada Ferrara-Mare,3158,00,2976,182,2486,672,3158,0
2019/02,376,12/02/2019,2,SP 68 tra Portomaggiore e la Superstrada Ferrara-Mare,3250,00,3039,211,2604,646,3250,0
2019/02,376,13/02/2019,3,SP 68 tra Portomaggiore e la Superstrada Ferrara-Mare,3146,00,2944,202,2553,593,3146,0
2019/02,376,14/02/2019,4,SP 68 tra Portomaggiore e la Superstrada Ferrara-Mare,3424,00,3223,201,2665,759,3424,0
2019/02,377,01/02/2019,5,SP 18 tra Bondeno e il confine regionale (Lombardia),4984,00,4664,320,3888,1096,4984,0
2019/02,377,02/02/2019,6,SP 18 tra Bondeno e il confine regionale (Lombardia),3671,00,3602,69,2712,959,0,3671
2019/02,377,03/02/2019,7,SP 18 tra Bondeno e il confine regionale (Lombardia),3258,00,3236,22,2326,932,0,3258
2019/02,377,04/02/2019,1,SP 18 tra Bondeno e il confine regionale (Lombardia),4791,00,4405,386,3882,909,4791,0
2019/02,377,05/02/2019,2,SP 18 tra Bondeno e il confine regionale (Lombardia),4929,10,4532,396,4063,866,4929,0
2019/02,377,06/02/2019,3,SP 18 tra Bondeno e il confine regionale (Lombardia),4873,00,4476,397,3897,976,4873,0
2019/02,377,07/02/2019,4,SP 18 tra Bondeno e il confine regionale (Lombardia),5006,00,4622,384,4035,971,5006,0
2019/02,377,08/02/2019,5,SP 18 tra Bondeno e il confine regionale (Lombardia),5191,00,4763,428,4023,1168,5191,0
2019/02,377,09/02/2019,6,SP 18 tra Bondeno e il confine regionale (Lombardia),4086,00,4006,80,2994,1092,0,4086
2019/02,377,10/02/2019,7,SP 18 tra Bondeno e il confine regionale (Lombardia),4751,00,4739,12,3781,970,0,4751
2019/02,377,11/02/2019,1,SP 18 tra Bondeno e il confine regionale (Lombardia),4779,00,4388,391,3802,977,4779,0
2019/02,377,12/02/2019,2,SP 18 tra Bondeno e il confine regionale (Lombardia),4989,00,4555,434,4056,933,4989,0
2019/02,377,13/02/2019,3,SP 18 tra Bondeno e il confine regionale (Lombardia),5051,10,4588,462,4017,1034,5051,0
2019/02,377,14/02/2019,4,SP 18 tra Bondeno e il confine regionale (Lombardia),5311,00,4860,451,4138,1173,5311,0
2019/02,381,01/02/2019,5,SS 724 Tangenziale nord di Modena,,,,,,,,
2019/02,381,02/02/2019,6,SS 724 Tangenziale nord di Modena,,,,,,,,
2019/02,381,03/02/2019,7,SS 724 Tangenziale nord di Modena,,,,,,,,
2019/02,381,04/02/2019,1,SS 724 Tangenziale nord di Modena,,,,,,,,
2019/02,381,05/02/2019,2,SS 724 Tangenziale nord di Modena,,,,,,,,
2019/02,381,06/02/2019,3,SS 724 Tangenziale nord di Modena,,,,,,,,
2019/02,381,07/02/2019,4,SS 724 Tangenziale nord di Modena,,,,,,,,
2019/02,381,08/02/2019,5,SS 724 Tangenziale nord di Modena,,,,,,,,
2019/02,381,09/02/2019,6,SS 724 Tangenziale nord di Modena,,,,,,,,
2019/02,381,10/02/2019,7,SS 724 Tangenziale nord di Modena,,,,,,,,
2019/02,381,11/02/2019,1,SS 724 Tangenziale nord di Modena,,,,,,,,
2019/02,381,12/02/2019,2,SS 724 Tangenziale nord di Modena,,,,,,,,
2019/02,381,13/02/2019,3,SS 724 Tangenziale nord di Modena,,,,,,,,
2019/02,381,14/02/2019,4,SS 724 Tangenziale nord di Modena,,,,,,,,
2019/02,383,01/02/2019,5,SS 722 Tangenziale nord di Reggio Emilia,31714,70,28147,3560,24954,6760,31714,0
2019/02,383,02/02/2019,6,SS 722 Tangenziale nord di Reggio Emilia,23661,60,22957,698,17085,6576,0,23661
2019/02,383,03/02/2019,7,SS 722 Tangenziale nord di Reggio Emilia,18611,10,18439,171,12931,5680,0,18611
2019/02,383,04/02/2019,1,SS 722 Tangenziale nord di Reggio Emilia,31917,20,28134,3781,25570,6347,31917,0
2019/02,383,05/02/2019,2,SS 722 Tangenziale nord di Reggio Emilia,32696,60,28676,4014,26312,6384,32696,0
2019/02,383,06/02/2019,3,SS 722 Tangenziale nord di Reggio Emilia,33049,40,28915,4130,26341,6708,33049,0
2019/02,383,07/02/2019,4,SS 722 Tangenziale nord di Reggio Emilia,33661,70,29350,4304,27061,6600,33661,0
2019/02,383,08/02/2019,5,SS 722 Tangenziale nord di Reggio Emilia,34101,70,29960,4134,26655,7446,34101,0
2019/02,383,09/02/2019,6,SS 722 Tangenziale nord di Reggio Emilia,24272,10,23504,767,17328,6944,0,24272
2019/02,383,10/02/2019,7,SS 722 Tangenziale nord di Reggio Emilia,21416,20,21214,200,14254,7162,0,21416
2019/02,383,11/02/2019,1,SS 722 Tangenziale nord di Reggio Emilia,32260,110,28458,3791,25920,6340,32260,0
2019/02,383,12/02/2019,2,SS 722 Tangenziale nord di Reggio Emilia,33255,70,29273,3975,26837,6418,33255,0
2019/02,383,13/02/2019,3,SS 722 Tangenziale nord di Reggio Emilia,33627,60,29493,4128,26834,6793,33627,0
2019/02,383,14/02/2019,4,SS 722 Tangenziale nord di Reggio Emilia,34336,70,30366,3963,26973,7363,34336,0
2019/02,385,01/02/2019,5,SP 10R fra Castel San Giovanni e Confine regionale (Lombardia),9594,00,8727,867,7201,2393,9594,0
2019/02,385,02/02/2019,6,SP 10R fra Castel San Giovanni e Confine regionale (Lombardia),9895,00,9664,231,7388,2507,0,9895
2019/02,385,03/02/2019,7,SP 10R fra Castel San Giovanni e Confine regionale (Lombardia),7499,10,7398,100,5403,2096,0,7499
2019/02,385,04/02/2019,1,SP 10R fra Castel San Giovanni e Confine regionale (Lombardia),12344,10,11014,1329,9721,2623,12344,0
2019/02,385,05/02/2019,2,SP 10R fra Castel San Giovanni e Confine regionale (Lombardia),12454,00,11131,1323,9696,2758,12454,0
2019/02,385,06/02/2019,3,SP 10R fra Castel San Giovanni e Confine regionale (Lombardia),12726,00,11372,1354,9871,2855,12726,0
2019/02,385,07/02/2019,4,SP 10R fra Castel San Giovanni e Confine regionale (Lombardia),12388,10,11012,1375,9685,2703,12388,0
2019/02,385,08/02/2019,5,SP 10R fra Castel San Giovanni e Confine regionale (Lombardia),13135,00,11765,1370,10098,3037,13135,0
2019/02,385,09/02/2019,6,SP 10R fra Castel San Giovanni e Confine regionale (Lombardia),10700,10,10473,226,7856,2844,0,10700
2019/02,385,10/02/2019,7,SP 10R fra Castel San Giovanni e Confine regionale (Lombardia),7921,00,7826,95,5839,2082,0,7921
2019/02,385,11/02/2019,1,SP 10R fra Castel San Giovanni e Confine regionale (Lombardia),11964,10,10567,1396,9278,2686,11964,0
2019/02,385,12/02/2019,2,SP 10R fra Castel San Giovanni e Confine regionale (Lombardia),12457,10,11019,1437,9672,2785,12457,0
2019/02,385,13/02/2019,3,SP 10R fra Castel San Giovanni e Confine regionale (Lombardia),12553,10,11226,1326,9694,2859,12553,0
2019/02,385,14/02/2019,4,SP 10R fra Castel San Giovanni e Confine regionale (Lombardia),13069,10,11698,1370,10046,3023,13069,0
2019/02,388,01/02/2019,5,SP 31 fra bivio SP 12 in località Castelnuovo Fogliani e il confine provinciale,3804,00,3719,85,3003,801,3804,0
2019/02,388,02/02/2019,6,SP 31 fra bivio SP 12 in località Castelnuovo Fogliani e il confine provinciale,3986,00,3930,56,3077,909,0,3986
2019/02,388,03/02/2019,7,SP 31 fra bivio SP 12 in località Castelnuovo Fogliani e il confine provinciale,3521,00,3505,16,2728,793,0,3521
2019/02,388,04/02/2019,1,SP 31 fra bivio SP 12 in località Castelnuovo Fogliani e il confine provinciale,4449,00,4356,93,3646,803,4449,0
2019/02,388,05/02/2019,2,SP 31 fra bivio SP 12 in località Castelnuovo Fogliani e il confine provinciale,4467,00,4329,138,3648,819,4467,0
2019/02,388,06/02/2019,3,SP 31 fra bivio SP 12 in località Castelnuovo Fogliani e il confine provinciale,4386,00,4262,124,3485,901,4386,0
2019/02,388,07/02/2019,4,SP 31 fra bivio SP 12 in località Castelnuovo Fogliani e il confine provinciale,4490,00,4372,118,3603,887,4490,0
2019/02,388,08/02/2019,5,SP 31 fra bivio SP 12 in località Castelnuovo Fogliani e il confine provinciale,4709,00,4565,144,3650,1059,4709,0
2019/02,388,09/02/2019,6,SP 31 fra bivio SP 12 in località Castelnuovo Fogliani e il confine provinciale,4763,00,4680,83,3675,1088,0,4763
2019/02,388,10/02/2019,7,SP 31 fra bivio SP 12 in località Castelnuovo Fogliani e il confine provinciale,3798,00,3778,20,2891,907,0,3798
2019/02,388,11/02/2019,1,SP 31 fra bivio SP 12 in località Castelnuovo Fogliani e il confine provinciale,4206,00,4073,133,3412,794,4206,0
2019/02,388,12/02/2019,2,SP 31 fra bivio SP 12 in località Castelnuovo Fogliani e il confine provinciale,4335,00,4173,162,3561,774,4335,0
2019/02,388,13/02/2019,3,SP 31 fra bivio SP 12 in località Castelnuovo Fogliani e il confine provinciale,4477,10,4318,158,3584,893,4477,0
2019/02,388,14/02/2019,4,SP 31 fra bivio SP 12 in località Castelnuovo Fogliani e il confine provinciale,4798,00,4654,144,3762,1036,4798,0
2019/02,389,01/02/2019,5,SP 588R fra Villanova d’Arda e confine provinciale,3545,00,3277,268,2788,757,3545,0
2019/02,389,02/02/2019,6,SP 588R fra Villanova d’Arda e confine provinciale,3402,00,3307,95,2501,901,0,3402
2019/02,389,03/02/2019,7,SP 588R fra Villanova d’Arda e confine provinciale,2752,00,2715,37,2045,707,0,2752
2019/02,389,04/02/2019,1,SP 588R fra Villanova d’Arda e confine provinciale,3748,00,3394,354,3036,712,3748,0
2019/02,389,05/02/2019,2,SP 588R fra Villanova d’Arda e confine provinciale,3961,00,3599,362,3258,703,3961,0
2019/02,389,06/02/2019,3,SP 588R fra Villanova d’Arda e confine provinciale,4140,10,3741,398,3315,825,4140,0
2019/02,389,07/02/2019,4,SP 588R fra Villanova d’Arda e confine provinciale,3916,10,3526,389,3119,797,3916,0
2019/02,389,08/02/2019,5,SP 588R fra Villanova d’Arda e confine provinciale,4128,00,3771,357,3228,900,4128,0
2019/02,389,09/02/2019,6,SP 588R fra Villanova d’Arda e confine provinciale,3557,00,3463,94,2623,934,0,3557
2019/02,389,10/02/2019,7,SP 588R fra Villanova d’Arda e confine provinciale,2823,00,2788,35,2138,685,0,2823
2019/02,389,11/02/2019,1,SP 588R fra Villanova d’Arda e confine provinciale,3716,10,3355,360,3028,688,3716,0
2019/02,389,12/02/2019,2,SP 588R fra Villanova d’Arda e confine provinciale,3788,20,3450,336,3079,709,3788,0
2019/02,389,13/02/2019,3,SP 588R fra Villanova d’Arda e confine provinciale,4023,00,3660,363,3171,852,4023,0
2019/02,389,14/02/2019,4,SP 588R fra Villanova d’Arda e confine provinciale,4024,10,3614,409,3186,838,4024,0
2019/02,390,01/02/2019,5,SP 462R dal bivio SP 10R in località Monticelli a Cortemaggiore,2536,00,2428,108,1961,575,2536,0
2019/02,390,02/02/2019,6,SP 462R dal bivio SP 10R in località Monticelli a Cortemaggiore,2513,00,2463,50,1916,597,0,2513
2019/02,390,03/02/2019,7,SP 462R dal bivio SP 10R in località Monticelli a Cortemaggiore,2349,00,2329,20,1797,552,0,2349
2019/02,390,05/02/2019,2,SP 462R dal bivio SP 10R in località Monticelli a Cortemaggiore,2861,20,2712,147,2308,553,2861,0
2019/02,390,06/02/2019,3,SP 462R dal bivio SP 10R in località Monticelli a Cortemaggiore,2955,00,2804,151,2384,571,2955,0
2019/02,390,07/02/2019,4,SP 462R dal bivio SP 10R in località Monticelli a Cortemaggiore,2798,00,2644,154,2232,566,2798,0
2019/02,390,08/02/2019,5,SP 462R dal bivio SP 10R in località Monticelli a Cortemaggiore,3080,00,2927,153,2391,689,3080,0
2019/02,390,09/02/2019,6,SP 462R dal bivio SP 10R in località Monticelli a Cortemaggiore,2770,00,2719,51,2069,701,0,2770
2019/02,390,10/02/2019,7,SP 462R dal bivio SP 10R in località Monticelli a Cortemaggiore,2243,00,2226,17,1726,517,0,2243
2019/02,390,11/02/2019,1,SP 462R dal bivio SP 10R in località Monticelli a Cortemaggiore,2673,00,2555,118,2149,524,2673,0
2019/02,390,12/02/2019,2,SP 462R dal bivio SP 10R in località Monticelli a Cortemaggiore,3007,00,2854,153,2476,531,3007,0
2019/02,390,13/02/2019,3,SP 462R dal bivio SP 10R in località Monticelli a Cortemaggiore,2931,00,2785,146,2369,562,2931,0
2019/02,390,14/02/2019,4,SP 462R dal bivio SP 10R in località Monticelli a Cortemaggiore,3118,10,2950,167,2413,705,3118,0
2019/02,391,01/02/2019,5,SP 10R fra Castelvetro Piacentino e confine regionale (Lombardia),18654,00,18223,431,14047,4607,18654,0
2019/02,391,02/02/2019,6,SP 10R fra Castelvetro Piacentino e confine regionale (Lombardia),19330,00,19092,238,13886,5444,0,19330
2019/02,391,03/02/2019,7,SP 10R fra Castelvetro Piacentino e confine regionale (Lombardia),17071,00,16998,73,12479,4592,0,17071
2019/02,391,04/02/2019,1,SP 10R fra Castelvetro Piacentino e confine regionale (Lombardia),19147,00,18682,465,15084,4063,19147,0
2019/02,391,05/02/2019,2,SP 10R fra Castelvetro Piacentino e confine regionale (Lombardia),19622,00,19095,527,15525,4097,19622,0
2019/02,391,06/02/2019,3,SP 10R fra Castelvetro Piacentino e confine regionale (Lombardia),20105,00,19581,524,15810,4295,20105,0
2019/02,391,07/02/2019,4,SP 10R fra Castelvetro Piacentino e confine regionale (Lombardia),19707,00,19170,537,15500,4207,19707,0
2019/02,391,08/02/2019,5,SP 10R fra Castelvetro Piacentino e confine regionale (Lombardia),21564,00,21016,548,16304,5260,21564,0
2019/02,391,09/02/2019,6,SP 10R fra Castelvetro Piacentino e confine regionale (Lombardia),20425,00,20187,238,14726,5699,0,20425
2019/02,391,10/02/2019,7,SP 10R fra Castelvetro Piacentino e confine regionale (Lombardia),15423,30,15342,78,10974,4449,0,15423
2019/02,391,11/02/2019,1,SP 10R fra Castelvetro Piacentino e confine regionale (Lombardia),19525,00,19029,496,15374,4151,19525,0
2019/02,391,12/02/2019,2,SP 10R fra Castelvetro Piacentino e confine regionale (Lombardia),19668,00,19129,539,15572,4096,19668,0
2019/02,391,13/02/2019,3,SP 10R fra Castelvetro Piacentino e confine regionale (Lombardia),20607,00,20081,526,16122,4485,20607,0
2019/02,391,14/02/2019,4,SP 10R fra Castelvetro Piacentino e confine regionale (Lombardia),21039,00,20517,522,16103,4936,21039,0
2019/02,393,01/02/2019,5,SP 10R fra Caorso e Roncaglia,9937,10,8670,1266,7500,2437,9937,0
2019/02,393,02/02/2019,6,SP 10R fra Caorso e Roncaglia,7894,10,7608,285,5710,2184,0,7894
2019/02,393,03/02/2019,7,SP 10R fra Caorso e Roncaglia,6185,00,6126,59,4437,1748,0,6185
2019/02,393,04/02/2019,1,SP 10R fra Caorso e Roncaglia,11156,00,9634,1522,8897,2259,11156,0
2019/02,393,05/02/2019,2,SP 10R fra Caorso e Roncaglia,11049,10,9521,1527,8682,2367,11049,0
2019/02,393,06/02/2019,3,SP 10R fra Caorso e Roncaglia,11303,00,9760,1543,8871,2432,11303,0
2019/02,393,07/02/2019,4,SP 10R fra Caorso e Roncaglia,11225,10,9686,1538,8783,2442,11225,0
2019/02,393,08/02/2019,5,SP 10R fra Caorso e Roncaglia,11612,10,10228,1383,8778,2834,11612,0
2019/02,393,09/02/2019,6,SP 10R fra Caorso e Roncaglia,8798,10,8517,280,6262,2536,0,8798
2019/02,393,10/02/2019,7,SP 10R fra Caorso e Roncaglia,6602,10,6540,61,4675,1927,0,6602
2019/02,393,11/02/2019,1,SP 10R fra Caorso e Roncaglia,11021,00,9519,1502,8688,2333,11021,0
2019/02,393,12/02/2019,2,SP 10R fra Caorso e Roncaglia,11308,00,9697,1611,8876,2432,11308,0
2019/02,393,13/02/2019,3,SP 10R fra Caorso e Roncaglia,11486,20,9947,1537,8975,2511,11486,0
2019/02,393,14/02/2019,4,SP 10R fra Caorso e Roncaglia,11622,00,10031,1591,8937,2685,11622,0
2019/02,394,01/02/2019,5,SP 523R da Roccamurata (bivio SP 308R) a Borgo Val di Taro,3435,00,3152,283,2683,752,3435,0
2019/02,394,02/02/2019,6,SP 523R da Roccamurata (bivio SP 308R) a Borgo Val di Taro,3031,00,2940,91,2412,619,0,3031
2019/02,394,03/02/2019,7,SP 523R da Roccamurata (bivio SP 308R) a Borgo Val di Taro,2695,00,2673,22,1998,697,0,2695
2019/02,394,04/02/2019,1,SP 523R da Roccamurata (bivio SP 308R) a Borgo Val di Taro,4491,10,4135,355,3570,921,4491,0
2019/02,394,05/02/2019,2,SP 523R da Roccamurata (bivio SP 308R) a Borgo Val di Taro,4435,00,4056,379,3566,869,4435,0
2019/02,394,06/02/2019,3,SP 523R da Roccamurata (bivio SP 308R) a Borgo Val di Taro,4677,00,4259,418,3760,917,4677,0
2019/02,394,07/02/2019,4,SP 523R da Roccamurata (bivio SP 308R) a Borgo Val di Taro,4315,00,3954,361,3422,893,4315,0
2019/02,394,08/02/2019,5,SP 523R da Roccamurata (bivio SP 308R) a Borgo Val di Taro,4705,00,4318,387,3727,978,4705,0
2019/02,394,09/02/2019,6,SP 523R da Roccamurata (bivio SP 308R) a Borgo Val di Taro,3731,00,3606,125,2906,825,0,3731
2019/02,394,10/02/2019,7,SP 523R da Roccamurata (bivio SP 308R) a Borgo Val di Taro,3193,00,3162,31,2397,796,0,3193
2019/02,394,11/02/2019,1,SP 523R da Roccamurata (bivio SP 308R) a Borgo Val di Taro,4729,00,4381,348,3791,938,4729,0
2019/02,394,12/02/2019,2,SP 523R da Roccamurata (bivio SP 308R) a Borgo Val di Taro,4550,00,4164,386,3620,930,4550,0
2019/02,394,13/02/2019,3,SP 523R da Roccamurata (bivio SP 308R) a Borgo Val di Taro,4676,00,4293,383,3737,939,4676,0
2019/02,394,14/02/2019,4,SP 523R da Roccamurata (bivio SP 308R) a Borgo Val di Taro,4691,00,4316,375,3709,982,4691,0
2019/02,395,01/02/2019,5,SP 308R da Fornovo di Taro (bivio SS 62) a Solignano,3305,00,3190,115,2594,711,3305,0
2019/02,395,02/02/2019,6,SP 308R da Fornovo di Taro (bivio SS 62) a Solignano,2927,00,2883,44,2283,644,0,2927
2019/02,395,03/02/2019,7,SP 308R da Fornovo di Taro (bivio SS 62) a Solignano,2607,00,2596,11,1956,651,0,2607
2019/02,395,04/02/2019,1,SP 308R da Fornovo di Taro (bivio SS 62) a Solignano,4191,10,4002,188,3310,881,4191,0
2019/02,395,05/02/2019,2,SP 308R da Fornovo di Taro (bivio SS 62) a Solignano,4217,00,4038,179,3374,843,4217,0
2019/02,395,06/02/2019,3,SP 308R da Fornovo di Taro (bivio SS 62) a Solignano,4444,00,4218,226,3441,1003,4444,0
2019/02,395,07/02/2019,4,SP 308R da Fornovo di Taro (bivio SS 62) a Solignano,4230,00,4015,215,3269,961,4230,0
2019/02,395,08/02/2019,5,SP 308R da Fornovo di Taro (bivio SS 62) a Solignano,4506,00,4288,218,3494,1012,4506,0
2019/02,395,09/02/2019,6,SP 308R da Fornovo di Taro (bivio SS 62) a Solignano,3527,00,3449,78,2766,761,0,3527
2019/02,395,10/02/2019,7,SP 308R da Fornovo di Taro (bivio SS 62) a Solignano,3000,00,2980,20,2291,709,0,3000
2019/02,395,11/02/2019,1,SP 308R da Fornovo di Taro (bivio SS 62) a Solignano,4179,10,3974,204,3299,880,4179,0
2019/02,395,12/02/2019,2,SP 308R da Fornovo di Taro (bivio SS 62) a Solignano,4417,00,4170,247,3551,866,4417,0
2019/02,395,13/02/2019,3,SP 308R da Fornovo di Taro (bivio SS 62) a Solignano,4359,00,4107,252,3472,887,4359,0
2019/02,395,14/02/2019,4,SP 308R da Fornovo di Taro (bivio SS 62) a Solignano,4420,00,4181,239,3446,974,4420,0
2019/02,396,01/02/2019,5,SP 28 fra Fornovo di Taro e Varano de Melegari centro abitato Viazzano,6439,00,6221,218,5135,1304,6439,0
2019/02,396,02/02/2019,6,SP 28 fra Fornovo di Taro e Varano de Melegari centro abitato Viazzano,5468,00,5398,70,4334,1134,0,5468
2019/02,396,03/02/2019,7,SP 28 fra Fornovo di Taro e Varano de Melegari centro abitato Viazzano,4215,00,4189,26,3201,1014,0,4215
2019/02,396,04/02/2019,1,SP 28 fra Fornovo di Taro e Varano de Melegari centro abitato Viazzano,7089,00,6826,263,5781,1308,7089,0
2019/02,396,05/02/2019,2,SP 28 fra Fornovo di Taro e Varano de Melegari centro abitato Viazzano,7630,10,7364,265,6185,1445,7630,0
2019/02,396,06/02/2019,3,SP 28 fra Fornovo di Taro e Varano de Melegari centro abitato Viazzano,7561,00,7234,327,6126,1435,7561,0
2019/02,396,07/02/2019,4,SP 28 fra Fornovo di Taro e Varano de Melegari centro abitato Viazzano,7422,00,7115,307,5989,1433,7422,0
2019/02,396,08/02/2019,5,SP 28 fra Fornovo di Taro e Varano de Melegari centro abitato Viazzano,7668,10,7354,313,6116,1552,7668,0
2019/02,396,09/02/2019,6,SP 28 fra Fornovo di Taro e Varano de Melegari centro abitato Viazzano,6349,00,6225,124,4987,1362,0,6349
2019/02,396,10/02/2019,7,SP 28 fra Fornovo di Taro e Varano de Melegari centro abitato Viazzano,4692,00,4665,27,3592,1100,0,4692
2019/02,396,11/02/2019,1,SP 28 fra Fornovo di Taro e Varano de Melegari centro abitato Viazzano,7301,00,7023,278,5959,1342,7301,0
2019/02,396,12/02/2019,2,SP 28 fra Fornovo di Taro e Varano de Melegari centro abitato Viazzano,7979,00,7641,338,6472,1507,7979,0
2019/02,396,13/02/2019,3,SP 28 fra Fornovo di Taro e Varano de Melegari centro abitato Viazzano,7774,00,7478,296,6226,1548,7774,0
2019/02,396,14/02/2019,4,SP 28 fra Fornovo di Taro e Varano de Melegari centro abitato Viazzano,7946,00,7609,337,6325,1621,7946,0
2019/02,397,01/02/2019,5,SP 12 fra casello A 1 e Fidenza,,,,,,,,
2019/02,397,02/02/2019,6,SP 12 fra casello A 1 e Fidenza,,,,,,,,
2019/02,397,03/02/2019,7,SP 12 fra casello A 1 e Fidenza,,,,,,,,
2019/02,397,04/02/2019,1,SP 12 fra casello A 1 e Fidenza,,,,,,,,
2019/02,397,05/02/2019,2,SP 12 fra casello A 1 e Fidenza,,,,,,,,
2019/02,397,06/02/2019,3,SP 12 fra casello A 1 e Fidenza,,,,,,,,
2019/02,397,07/02/2019,4,SP 12 fra casello A 1 e Fidenza,,,,,,,,
2019/02,397,08/02/2019,5,SP 12 fra casello A 1 e Fidenza,,,,,,,,
2019/02,397,09/02/2019,6,SP 12 fra casello A 1 e Fidenza,,,,,,,,
2019/02,397,10/02/2019,7,SP 12 fra casello A 1 e Fidenza,,,,,,,,
2019/02,397,11/02/2019,1,SP 12 fra casello A 1 e Fidenza,,,,,,,,
2019/02,397,12/02/2019,2,SP 12 fra casello A 1 e Fidenza,,,,,,,,
2019/02,397,13/02/2019,3,SP 12 fra casello A 1 e Fidenza,,,,,,,,
2019/02,397,14/02/2019,4,SP 12 fra casello A 1 e Fidenza,,,,,,,,
2019/02,398,01/02/2019,5,SP 11 tra Fontevivo e Cispadana (tangenziale),,,,,,,,
2019/02,398,02/02/2019,6,SP 11 tra Fontevivo e Cispadana (tangenziale),,,,,,,,
2019/02,398,03/02/2019,7,SP 11 tra Fontevivo e Cispadana (tangenziale),,,,,,,,
2019/02,398,04/02/2019,1,SP 11 tra Fontevivo e Cispadana (tangenziale),,,,,,,,
2019/02,398,05/02/2019,2,SP 11 tra Fontevivo e Cispadana (tangenziale),,,,,,,,
2019/02,398,06/02/2019,3,SP 11 tra Fontevivo e Cispadana (tangenziale),,,,,,,,
2019/02,398,07/02/2019,4,SP 11 tra Fontevivo e Cispadana (tangenziale),,,,,,,,
2019/02,398,08/02/2019,5,SP 11 tra Fontevivo e Cispadana (tangenziale),,,,,,,,
2019/02,398,09/02/2019,6,SP 11 tra Fontevivo e Cispadana (tangenziale),,,,,,,,
2019/02,398,10/02/2019,7,SP 11 tra Fontevivo e Cispadana (tangenziale),,,,,,,,
2019/02,398,11/02/2019,1,SP 11 tra Fontevivo e Cispadana (tangenziale),,,,,,,,
2019/02,398,12/02/2019,2,SP 11 tra Fontevivo e Cispadana (tangenziale),,,,,,,,
2019/02,398,13/02/2019,3,SP 11 tra Fontevivo e Cispadana (tangenziale),,,,,,,,
2019/02,398,14/02/2019,4,SP 11 tra Fontevivo e Cispadana (tangenziale),,,,,,,,
2019/02,401,01/02/2019,5,SP 513R fra Traversetolo e confine provinciale,6449,00,5995,454,5115,1334,6449,0
2019/02,401,02/02/2019,6,SP 513R fra Traversetolo e confine provinciale,5619,00,5469,150,4296,1323,0,5619
2019/02,401,03/02/2019,7,SP 513R fra Traversetolo e confine provinciale,5788,20,5754,32,4711,1077,0,5788
2019/02,401,04/02/2019,1,SP 513R fra Traversetolo e confine provinciale,6734,00,6050,684,5496,1238,6734,0
2019/02,401,05/02/2019,2,SP 513R fra Traversetolo e confine provinciale,6779,10,6190,588,5533,1246,6779,0
2019/02,401,06/02/2019,3,SP 513R fra Traversetolo e confine provinciale,7073,20,6465,606,5781,1292,7073,0
2019/02,401,07/02/2019,4,SP 513R fra Traversetolo e confine provinciale,7049,00,6431,618,5768,1281,7049,0
2019/02,401,08/02/2019,5,SP 513R fra Traversetolo e confine provinciale,7528,00,6873,655,5986,1542,7528,0
2019/02,401,09/02/2019,6,SP 513R fra Traversetolo e confine provinciale,6029,00,5904,125,4663,1366,0,6029
2019/02,401,10/02/2019,7,SP 513R fra Traversetolo e confine provinciale,5861,10,5812,48,4776,1085,0,5861
2019/02,401,11/02/2019,1,SP 513R fra Traversetolo e confine provinciale,6822,00,6166,656,5631,1191,6822,0
2019/02,401,12/02/2019,2,SP 513R fra Traversetolo e confine provinciale,7016,10,6391,624,5791,1225,7016,0
2019/02,401,13/02/2019,3,SP 513R fra Traversetolo e confine provinciale,7381,20,6711,668,6008,1373,7381,0
2019/02,401,14/02/2019,4,SP 513R fra Traversetolo e confine provinciale,7374,20,6746,626,5941,1433,7374,0
2019/02,402,01/02/2019,5,SP 18 da Pilastrello (bivio SP 513R) al bivio per la Pedemontana,13145,00,12893,252,10420,2725,13145,0
2019/02,402,02/02/2019,6,SP 18 da Pilastrello (bivio SP 513R) al bivio per la Pedemontana,11336,00,11241,95,8682,2654,0,11336
2019/02,402,03/02/2019,7,SP 18 da Pilastrello (bivio SP 513R) al bivio per la Pedemontana,8343,00,8325,18,6117,2226,0,8343
2019/02,402,04/02/2019,1,SP 18 da Pilastrello (bivio SP 513R) al bivio per la Pedemontana,13190,00,12887,303,10608,2582,13190,0
2019/02,402,05/02/2019,2,SP 18 da Pilastrello (bivio SP 513R) al bivio per la Pedemontana,13631,00,13310,321,10995,2636,13631,0
2019/02,402,06/02/2019,3,SP 18 da Pilastrello (bivio SP 513R) al bivio per la Pedemontana,13898,00,13554,344,11081,2817,13898,0
2019/02,402,07/02/2019,4,SP 18 da Pilastrello (bivio SP 513R) al bivio per la Pedemontana,13719,00,13393,326,10950,2769,13719,0
2019/02,402,08/02/2019,5,SP 18 da Pilastrello (bivio SP 513R) al bivio per la Pedemontana,13971,00,13631,340,10942,3029,13971,0
2019/02,402,09/02/2019,6,SP 18 da Pilastrello (bivio SP 513R) al bivio per la Pedemontana,11940,10,11822,117,8871,3069,0,11940
2019/02,402,10/02/2019,7,SP 18 da Pilastrello (bivio SP 513R) al bivio per la Pedemontana,8452,00,8423,29,6185,2267,0,8452
2019/02,402,11/02/2019,1,SP 18 da Pilastrello (bivio SP 513R) al bivio per la Pedemontana,13228,00,12949,279,10793,2435,13228,0
2019/02,402,12/02/2019,2,SP 18 da Pilastrello (bivio SP 513R) al bivio per la Pedemontana,14449,00,14100,349,11710,2739,14449,0
2019/02,402,13/02/2019,3,SP 18 da Pilastrello (bivio SP 513R) al bivio per la Pedemontana,14062,00,13719,343,11189,2873,14062,0
2019/02,402,14/02/2019,4,SP 18 da Pilastrello (bivio SP 513R) al bivio per la Pedemontana,14513,00,14202,311,11561,2952,14513,0
2019/02,403,01/02/2019,5,SP 72 tra Parma e Mezzani,7752,10,7188,563,6296,1456,7752,0
2019/02,403,02/02/2019,6,SP 72 tra Parma e Mezzani,5430,00,5349,81,4073,1357,0,5430
2019/02,403,03/02/2019,7,SP 72 tra Parma e Mezzani,4034,00,4013,21,2941,1093,0,4034
2019/02,403,04/02/2019,1,SP 72 tra Parma e Mezzani,7911,00,7262,649,6589,1322,7911,0
2019/02,403,05/02/2019,2,SP 72 tra Parma e Mezzani,8030,20,7372,656,6587,1443,8030,0
2019/02,403,06/02/2019,3,SP 72 tra Parma e Mezzani,7933,00,7245,688,6463,1470,7933,0
2019/02,403,07/02/2019,4,SP 72 tra Parma e Mezzani,8054,00,7409,645,6595,1459,8054,0
2019/02,403,08/02/2019,5,SP 72 tra Parma e Mezzani,8206,10,7532,673,6632,1574,8206,0
2019/02,403,09/02/2019,6,SP 72 tra Parma e Mezzani,5778,00,5685,93,4294,1484,0,5778
2019/02,403,10/02/2019,7,SP 72 tra Parma e Mezzani,4082,00,4054,28,3052,1030,0,4082
2019/02,403,11/02/2019,1,SP 72 tra Parma e Mezzani,7944,00,7265,679,6641,1303,7944,0
2019/02,403,12/02/2019,2,SP 72 tra Parma e Mezzani,8103,00,7393,710,6772,1331,8103,0
2019/02,403,13/02/2019,3,SP 72 tra Parma e Mezzani,8046,00,7363,683,6652,1394,8046,0
2019/02,403,14/02/2019,4,SP 72 tra Parma e Mezzani,8249,00,7605,644,6717,1532,8249,0
2019/02,404,01/02/2019,5,exSP 32 (via Dante Alighieri) da Felino a Pilastro,6884,10,6710,173,5384,1500,6884,0
2019/02,404,02/02/2019,6,exSP 32 (via Dante Alighieri) da Felino a Pilastro,5938,20,5869,67,4484,1454,0,5938
2019/02,404,03/02/2019,7,exSP 32 (via Dante Alighieri) da Felino a Pilastro,4350,20,4322,26,3251,1099,0,4350
2019/02,404,04/02/2019,1,exSP 32 (via Dante Alighieri) da Felino a Pilastro,7022,10,6861,160,5673,1349,7022,0
2019/02,404,05/02/2019,2,exSP 32 (via Dante Alighieri) da Felino a Pilastro,7075,30,6882,190,5718,1357,7075,0
2019/02,404,06/02/2019,3,exSP 32 (via Dante Alighieri) da Felino a Pilastro,7187,10,6972,214,5726,1461,7187,0
2019/02,404,07/02/2019,4,exSP 32 (via Dante Alighieri) da Felino a Pilastro,7199,10,7040,158,5717,1482,7199,0
2019/02,404,08/02/2019,5,exSP 32 (via Dante Alighieri) da Felino a Pilastro,7354,10,7180,173,5709,1645,7354,0
2019/02,404,09/02/2019,6,exSP 32 (via Dante Alighieri) da Felino a Pilastro,6295,30,6224,68,4674,1621,0,6295
2019/02,404,10/02/2019,7,exSP 32 (via Dante Alighieri) da Felino a Pilastro,4764,40,4740,20,3488,1276,0,4764
2019/02,404,11/02/2019,1,exSP 32 (via Dante Alighieri) da Felino a Pilastro,6893,40,6716,173,5565,1328,6893,0
2019/02,404,12/02/2019,2,exSP 32 (via Dante Alighieri) da Felino a Pilastro,7125,10,6932,192,5720,1405,7125,0
2019/02,404,13/02/2019,3,exSP 32 (via Dante Alighieri) da Felino a Pilastro,7140,10,6956,183,5734,1406,7140,0
2019/02,404,14/02/2019,4,exSP 32 (via Dante Alighieri) da Felino a Pilastro,7572,20,7409,161,5901,1671,7572,0
2019/02,405,01/02/2019,5,SP 15 fra SS62 e Sala Baganza,10065,00,9352,713,7974,2091,10065,0
2019/02,405,02/02/2019,6,SP 15 fra SS62 e Sala Baganza,7269,00,7131,138,5351,1918,0,7269
2019/02,405,03/02/2019,7,SP 15 fra SS62 e Sala Baganza,5582,00,5562,20,3939,1643,0,5582
2019/02,405,04/02/2019,1,SP 15 fra SS62 e Sala Baganza,10421,00,9623,798,8461,1960,10421,0
2019/02,405,05/02/2019,2,SP 15 fra SS62 e Sala Baganza,10502,00,9722,780,8559,1943,10502,0
2019/02,405,06/02/2019,3,SP 15 fra SS62 e Sala Baganza,10786,00,9973,813,8618,2168,10786,0
2019/02,405,07/02/2019,4,SP 15 fra SS62 e Sala Baganza,10886,00,10052,834,8680,2206,10886,0
2019/02,405,08/02/2019,5,SP 15 fra SS62 e Sala Baganza,10883,00,10051,832,8683,2200,10883,0
2019/02,405,09/02/2019,6,SP 15 fra SS62 e Sala Baganza,8734,00,8563,171,6423,2311,0,8734
2019/02,405,10/02/2019,7,SP 15 fra SS62 e Sala Baganza,5830,00,5805,25,4080,1750,0,5830
2019/02,405,11/02/2019,1,SP 15 fra SS62 e Sala Baganza,10140,00,9380,760,8263,1877,10140,0
2019/02,405,12/02/2019,2,SP 15 fra SS62 e Sala Baganza,10922,00,10108,814,8835,2087,10922,0
2019/02,405,13/02/2019,3,SP 15 fra SS62 e Sala Baganza,11161,00,10329,832,8933,2228,11161,0
2019/02,405,14/02/2019,4,SP 15 fra SS62 e Sala Baganza,11298,00,10486,812,8978,2320,11298,0
2019/02,410,01/02/2019,5,SP 54 fra Pomposa e Codigoro,4385,00,4137,248,3489,896,4385,0
2019/02,410,02/02/2019,6,SP 54 fra Pomposa e Codigoro,3843,00,3760,83,2772,1071,0,3843
2019/02,410,03/02/2019,7,SP 54 fra Pomposa e Codigoro,3025,00,3018,7,2132,893,0,3025
2019/02,410,04/02/2019,1,SP 54 fra Pomposa e Codigoro,4288,00,4016,272,3554,734,4288,0
2019/02,410,05/02/2019,2,SP 54 fra Pomposa e Codigoro,4275,10,3992,282,3585,690,4275,0
2019/02,410,06/02/2019,3,SP 54 fra Pomposa e Codigoro,4401,00,4116,285,3640,761,4401,0
2019/02,410,07/02/2019,4,SP 54 fra Pomposa e Codigoro,4497,00,4225,272,3669,828,4497,0
2019/02,410,08/02/2019,5,SP 54 fra Pomposa e Codigoro,4706,00,4374,332,3742,964,4706,0
2019/02,410,09/02/2019,6,SP 54 fra Pomposa e Codigoro,4158,00,4014,144,3063,1095,0,4158
2019/02,410,10/02/2019,7,SP 54 fra Pomposa e Codigoro,3151,00,3143,8,2253,898,0,3151
2019/02,410,11/02/2019,1,SP 54 fra Pomposa e Codigoro,4273,00,4004,269,3546,727,4273,0
2019/02,410,12/02/2019,2,SP 54 fra Pomposa e Codigoro,4413,00,4168,245,3630,783,4413,0
2019/02,410,13/02/2019,3,SP 54 fra Pomposa e Codigoro,4541,00,4232,309,3682,859,4541,0
2019/02,410,14/02/2019,4,SP 54 fra Pomposa e Codigoro,4735,10,4450,284,3721,1014,4735,0
2019/02,411,01/02/2019,5,SP 53 fra Codigoro e Marozzo,5277,00,5188,89,4229,1048,5277,0
2019/02,411,02/02/2019,6,SP 53 fra Codigoro e Marozzo,3933,00,3891,42,2921,1012,0,3933
2019/02,411,03/02/2019,7,SP 53 fra Codigoro e Marozzo,3034,00,3029,5,2162,872,0,3034
2019/02,411,04/02/2019,1,SP 53 fra Codigoro e Marozzo,5353,10,5263,89,4344,1009,5353,0
2019/02,411,05/02/2019,2,SP 53 fra Codigoro e Marozzo,5444,00,5322,122,4508,936,5444,0
2019/02,411,06/02/2019,3,SP 53 fra Codigoro e Marozzo,5339,00,5237,102,4356,983,5339,0
2019/02,411,07/02/2019,4,SP 53 fra Codigoro e Marozzo,5191,00,5088,103,4207,984,5191,0
2019/02,411,08/02/2019,5,SP 53 fra Codigoro e Marozzo,5400,00,5276,124,4302,1098,5400,0
2019/02,411,09/02/2019,6,SP 53 fra Codigoro e Marozzo,4004,00,3938,66,2989,1015,0,4004
2019/02,411,10/02/2019,7,SP 53 fra Codigoro e Marozzo,3213,00,3208,5,2312,901,0,3213
2019/02,411,11/02/2019,1,SP 53 fra Codigoro e Marozzo,5169,10,5071,97,4216,953,5169,0
2019/02,411,12/02/2019,2,SP 53 fra Codigoro e Marozzo,5425,00,5315,110,4413,1012,5425,0
2019/02,411,13/02/2019,3,SP 53 fra Codigoro e Marozzo,5374,10,5243,130,4385,989,5374,0
2019/02,411,14/02/2019,4,SP 53 fra Codigoro e Marozzo,5417,00,5305,112,4361,1056,5417,0
2019/02,426,01/02/2019,5,SS 63 tra Casina e Vezzano sul Crostolo,13348,10,13005,342,10168,3180,13348,0
2019/02,426,02/02/2019,6,SS 63 tra Casina e Vezzano sul Crostolo,12417,00,12235,182,9250,3167,0,12417
2019/02,426,03/02/2019,7,SS 63 tra Casina e Vezzano sul Crostolo,10209,00,10156,53,7605,2604,0,10209
2019/02,426,04/02/2019,1,SS 63 tra Casina e Vezzano sul Crostolo,13650,00,13221,429,10720,2930,13650,0
2019/02,426,05/02/2019,2,SS 63 tra Casina e Vezzano sul Crostolo,13834,00,13391,443,10834,3000,13834,0
2019/02,426,06/02/2019,3,SS 63 tra Casina e Vezzano sul Crostolo,14604,00,14120,484,11391,3213,14604,0
2019/02,426,07/02/2019,4,SS 63 tra Casina e Vezzano sul Crostolo,14355,00,13867,488,11142,3213,14355,0
2019/02,426,08/02/2019,5,SS 63 tra Casina e Vezzano sul Crostolo,14888,00,14418,470,11253,3635,14888,0
2019/02,426,09/02/2019,6,SS 63 tra Casina e Vezzano sul Crostolo,13899,00,13694,205,10394,3505,0,13899
2019/02,426,10/02/2019,7,SS 63 tra Casina e Vezzano sul Crostolo,11036,00,10971,65,8249,2787,0,11036
2019/02,426,11/02/2019,1,SS 63 tra Casina e Vezzano sul Crostolo,13839,00,13371,468,10857,2982,13839,0
2019/02,426,12/02/2019,2,SS 63 tra Casina e Vezzano sul Crostolo,14225,00,13786,439,11033,3192,14225,0
2019/02,426,13/02/2019,3,SS 63 tra Casina e Vezzano sul Crostolo,14783,00,14264,519,11473,3310,14783,0
2019/02,426,14/02/2019,4,SS 63 tra Casina e Vezzano sul Crostolo,15087,00,14549,538,11315,3772,15087,0
2019/02,427,01/02/2019,5,SP 7 fra Viano e Scandiano (bivio SP 37),10016,10,9384,631,7804,2212,10016,0
2019/02,427,02/02/2019,6,SP 7 fra Viano e Scandiano (bivio SP 37),8812,00,8672,140,6425,2387,0,8812
2019/02,427,03/02/2019,7,SP 7 fra Viano e Scandiano (bivio SP 37),6693,00,6623,70,4795,1898,0,6693
2019/02,427,04/02/2019,1,SP 7 fra Viano e Scandiano (bivio SP 37),10333,10,9630,702,8356,1977,10333,0
2019/02,427,05/02/2019,2,SP 7 fra Viano e Scandiano (bivio SP 37),10310,00,9668,642,8158,2152,10310,0
2019/02,427,06/02/2019,3,SP 7 fra Viano e Scandiano (bivio SP 37),10537,20,9819,716,8314,2223,10537,0
2019/02,427,07/02/2019,4,SP 7 fra Viano e Scandiano (bivio SP 37),10405,10,9638,766,8203,2202,10405,0
2019/02,427,08/02/2019,5,SP 7 fra Viano e Scandiano (bivio SP 37),10601,20,9922,677,8187,2414,10601,0
2019/02,427,09/02/2019,6,SP 7 fra Viano e Scandiano (bivio SP 37),9142,10,8996,145,6602,2540,0,9142
2019/02,427,10/02/2019,7,SP 7 fra Viano e Scandiano (bivio SP 37),7023,00,6957,66,5195,1828,0,7023
2019/02,427,11/02/2019,1,SP 7 fra Viano e Scandiano (bivio SP 37),10349,00,9587,762,8368,1981,10349,0
2019/02,427,12/02/2019,2,SP 7 fra Viano e Scandiano (bivio SP 37),,,,,,,,
2019/02,427,13/02/2019,3,SP 7 fra Viano e Scandiano (bivio SP 37),,,,,,,,
2019/02,427,14/02/2019,4,SP 7 fra Viano e Scandiano (bivio SP 37),,,,,,,,
2019/02,428,01/02/2019,5,SP 19 fra Colombaia (bivio SP 76) e il Bivio SP 486R al confine provinciale,3203,00,2880,323,2433,770,3203,0
2019/02,428,02/02/2019,6,SP 19 fra Colombaia (bivio SP 76) e il Bivio SP 486R al confine provinciale,2294,00,2257,37,1645,649,0,2294
2019/02,428,03/02/2019,7,SP 19 fra Colombaia (bivio SP 76) e il Bivio SP 486R al confine provinciale,2367,00,2343,24,1804,563,0,2367
2019/02,428,04/02/2019,1,SP 19 fra Colombaia (bivio SP 76) e il Bivio SP 486R al confine provinciale,3585,00,3169,416,2786,799,3585,0
2019/02,428,05/02/2019,2,SP 19 fra Colombaia (bivio SP 76) e il Bivio SP 486R al confine provinciale,3517,00,3117,400,2768,749,3517,0
2019/02,428,06/02/2019,3,SP 19 fra Colombaia (bivio SP 76) e il Bivio SP 486R al confine provinciale,3758,00,3295,463,2963,795,3758,0
2019/02,428,07/02/2019,4,SP 19 fra Colombaia (bivio SP 76) e il Bivio SP 486R al confine provinciale,3732,00,3285,447,2910,822,3732,0
2019/02,428,08/02/2019,5,SP 19 fra Colombaia (bivio SP 76) e il Bivio SP 486R al confine provinciale,3725,00,3338,387,2759,966,3725,0
2019/02,428,09/02/2019,6,SP 19 fra Colombaia (bivio SP 76) e il Bivio SP 486R al confine provinciale,3179,00,3126,53,2463,716,0,3179
2019/02,428,11/02/2019,1,SP 19 fra Colombaia (bivio SP 76) e il Bivio SP 486R al confine provinciale,3641,00,3180,461,2848,793,3641,0
2019/02,428,12/02/2019,2,SP 19 fra Colombaia (bivio SP 76) e il Bivio SP 486R al confine provinciale,3640,00,3201,439,2854,786,3640,0
2019/02,428,13/02/2019,3,SP 19 fra Colombaia (bivio SP 76) e il Bivio SP 486R al confine provinciale,3827,00,3373,454,2979,848,3827,0
2019/02,428,14/02/2019,4,SP 19 fra Colombaia (bivio SP 76) e il Bivio SP 486R al confine provinciale,3850,00,3367,483,3029,821,3850,0
2019/02,429,01/02/2019,5,SP 12 fra San Polo d'Enza e Montecchio Emilia (variante a sud abitato),7067,00,6462,605,5616,1451,7067,0
2019/02,429,02/02/2019,6,SP 12 fra San Polo d'Enza e Montecchio Emilia (variante a sud abitato),6066,00,5914,152,4579,1487,0,6066
2019/02,429,03/02/2019,7,SP 12 fra San Polo d'Enza e Montecchio Emilia (variante a sud abitato),4849,00,4765,84,3640,1209,0,4849
2019/02,429,04/02/2019,1,SP 12 fra San Polo d'Enza e Montecchio Emilia (variante a sud abitato),7726,20,6996,728,6344,1382,7726,0
2019/02,429,05/02/2019,2,SP 12 fra San Polo d'Enza e Montecchio Emilia (variante a sud abitato),7635,00,6904,731,6218,1417,7635,0
2019/02,429,06/02/2019,3,SP 12 fra San Polo d'Enza e Montecchio Emilia (variante a sud abitato),7762,00,7028,734,6281,1481,7762,0
2019/02,429,07/02/2019,4,SP 12 fra San Polo d'Enza e Montecchio Emilia (variante a sud abitato),8002,10,7118,883,6550,1452,8002,0
2019/02,429,08/02/2019,5,SP 12 fra San Polo d'Enza e Montecchio Emilia (variante a sud abitato),8070,10,7260,809,6467,1603,8070,0
2019/02,429,09/02/2019,6,SP 12 fra San Polo d'Enza e Montecchio Emilia (variante a sud abitato),6521,00,6345,176,5003,1518,0,6521
2019/02,429,10/02/2019,7,SP 12 fra San Polo d'Enza e Montecchio Emilia (variante a sud abitato),4744,00,4664,80,3502,1242,0,4744
2019/02,429,11/02/2019,1,SP 12 fra San Polo d'Enza e Montecchio Emilia (variante a sud abitato),7759,10,6963,795,6381,1378,7759,0
2019/02,429,12/02/2019,2,SP 12 fra San Polo d'Enza e Montecchio Emilia (variante a sud abitato),7776,00,6914,862,6422,1354,7776,0
2019/02,429,13/02/2019,3,SP 12 fra San Polo d'Enza e Montecchio Emilia (variante a sud abitato),8063,10,7151,911,6478,1585,8063,0
2019/02,429,14/02/2019,4,SP 12 fra San Polo d'Enza e Montecchio Emilia (variante a sud abitato),8421,00,7473,948,6773,1648,8421,0
2019/02,430,01/02/2019,5,SP 28 tra Montecchio Emilia e bivio circonvallazione,10313,00,9762,551,8294,2019,10313,0
2019/02,430,02/02/2019,6,SP 28 tra Montecchio Emilia e bivio circonvallazione,7928,00,7819,109,5961,1967,0,7928
2019/02,430,03/02/2019,7,SP 28 tra Montecchio Emilia e bivio circonvallazione,5219,00,5177,42,3667,1552,0,5219
2019/02,430,04/02/2019,1,SP 28 tra Montecchio Emilia e bivio circonvallazione,10557,00,10019,538,8728,1829,10557,0
2019/02,430,05/02/2019,2,SP 28 tra Montecchio Emilia e bivio circonvallazione,10740,00,10063,677,8824,1916,10740,0
2019/02,430,06/02/2019,3,SP 28 tra Montecchio Emilia e bivio circonvallazione,10903,00,10213,690,8955,1948,10903,0
2019/02,430,07/02/2019,4,SP 28 tra Montecchio Emilia e bivio circonvallazione,10820,00,10134,686,8827,1993,10820,0
2019/02,430,08/02/2019,5,SP 28 tra Montecchio Emilia e bivio circonvallazione,11291,00,10615,676,8896,2395,11291,0
2019/02,430,09/02/2019,6,SP 28 tra Montecchio Emilia e bivio circonvallazione,8380,00,8249,131,6168,2212,0,8380
2019/02,430,10/02/2019,7,SP 28 tra Montecchio Emilia e bivio circonvallazione,5569,00,5522,47,3886,1683,0,5569
2019/02,430,11/02/2019,1,SP 28 tra Montecchio Emilia e bivio circonvallazione,10521,00,9870,651,8790,1731,10521,0
2019/02,430,12/02/2019,2,SP 28 tra Montecchio Emilia e bivio circonvallazione,10938,00,10249,689,9021,1917,10938,0
2019/02,430,13/02/2019,3,SP 28 tra Montecchio Emilia e bivio circonvallazione,10651,00,9996,655,8619,2032,10651,0
2019/02,430,14/02/2019,4,SP 28 tra Montecchio Emilia e bivio circonvallazione,11161,00,10486,675,8954,2207,11161,0
2019/02,431,01/02/2019,5,SP 12 fra Sant'Ilario d'Enza (variante a sud) e Montecchio Emilia,6231,00,6062,169,5051,1180,6231,0
2019/02,431,02/02/2019,6,SP 12 fra Sant'Ilario d'Enza (variante a sud) e Montecchio Emilia,5601,00,5536,65,4351,1250,0,5601
2019/02,431,03/02/2019,7,SP 12 fra Sant'Ilario d'Enza (variante a sud) e Montecchio Emilia,3960,00,3943,17,2874,1086,0,3960
2019/02,431,04/02/2019,1,SP 12 fra Sant'Ilario d'Enza (variante a sud) e Montecchio Emilia,6430,00,6246,184,5265,1165,6430,0
2019/02,431,05/02/2019,2,SP 12 fra Sant'Ilario d'Enza (variante a sud) e Montecchio Emilia,6605,10,6383,221,5387,1218,6605,0
2019/02,431,06/02/2019,3,SP 12 fra Sant'Ilario d'Enza (variante a sud) e Montecchio Emilia,6511,00,6316,195,5244,1267,6511,0
2019/02,431,07/02/2019,4,SP 12 fra Sant'Ilario d'Enza (variante a sud) e Montecchio Emilia,6650,00,6411,239,5297,1353,6650,0
2019/02,431,08/02/2019,5,SP 12 fra Sant'Ilario d'Enza (variante a sud) e Montecchio Emilia,6518,00,6289,229,5188,1330,6518,0
2019/02,431,09/02/2019,6,SP 12 fra Sant'Ilario d'Enza (variante a sud) e Montecchio Emilia,5988,00,5904,84,4613,1375,0,5988
2019/02,431,10/02/2019,7,SP 12 fra Sant'Ilario d'Enza (variante a sud) e Montecchio Emilia,4249,10,4224,24,3099,1150,0,4249
2019/02,431,12/02/2019,2,SP 12 fra Sant'Ilario d'Enza (variante a sud) e Montecchio Emilia,6912,00,6650,262,5641,1271,6912,0
2019/02,431,13/02/2019,3,SP 12 fra Sant'Ilario d'Enza (variante a sud) e Montecchio Emilia,6764,00,6453,311,5526,1238,6764,0
2019/02,431,14/02/2019,4,SP 12 fra Sant'Ilario d'Enza (variante a sud) e Montecchio Emilia,6756,00,6500,256,5333,1423,6756,0
2019/02,432,01/02/2019,5,SP 67 fra Calerno e Montecchio Emilia,9791,00,8572,1219,7833,1958,9791,0
2019/02,432,02/02/2019,6,SP 67 fra Calerno e Montecchio Emilia,6685,00,6456,229,4959,1726,0,6685
2019/02,432,03/02/2019,7,SP 67 fra Calerno e Montecchio Emilia,5608,00,5512,96,4019,1589,0,5608
2019/02,432,04/02/2019,1,SP 67 fra Calerno e Montecchio Emilia,10120,00,8949,1171,8247,1873,10120,0
2019/02,432,05/02/2019,2,SP 67 fra Calerno e Montecchio Emilia,10222,00,8959,1263,8301,1921,10222,0
2019/02,432,06/02/2019,3,SP 67 fra Calerno e Montecchio Emilia,10504,10,9261,1242,8491,2013,10504,0
2019/02,432,07/02/2019,4,SP 67 fra Calerno e Montecchio Emilia,10570,00,9211,1359,8582,1988,10570,0
2019/02,432,08/02/2019,5,SP 67 fra Calerno e Montecchio Emilia,10835,00,9568,1267,8667,2168,10835,0
2019/02,432,09/02/2019,6,SP 67 fra Calerno e Montecchio Emilia,7462,10,7240,221,5547,1915,0,7462
2019/02,432,10/02/2019,7,SP 67 fra Calerno e Montecchio Emilia,5757,00,5650,107,4117,1640,0,5757
2019/02,432,11/02/2019,1,SP 67 fra Calerno e Montecchio Emilia,10077,00,8865,1212,8232,1845,10077,0
2019/02,432,12/02/2019,2,SP 67 fra Calerno e Montecchio Emilia,10513,00,9209,1304,8593,1920,10513,0
2019/02,432,13/02/2019,3,SP 67 fra Calerno e Montecchio Emilia,10739,10,9407,1331,8694,2045,10739,0
2019/02,432,14/02/2019,4,SP 67 fra Calerno e Montecchio Emilia,10837,20,9446,1389,8704,2133,10837,0
2019/02,434,01/02/2019,5,Via San Nicola (ex SP 39) tra bivio per Taneto a Caprara,3229,00,3163,66,2546,683,3229,0
2019/02,434,02/02/2019,6,Via San Nicola (ex SP 39) tra bivio per Taneto a Caprara,2681,00,2652,29,2084,597,0,2681
2019/02,434,03/02/2019,7,Via San Nicola (ex SP 39) tra bivio per Taneto a Caprara,2024,00,2012,12,1466,558,0,2024
2019/02,434,04/02/2019,1,Via San Nicola (ex SP 39) tra bivio per Taneto a Caprara,3322,00,3243,79,2657,665,3322,0
2019/02,434,05/02/2019,2,Via San Nicola (ex SP 39) tra bivio per Taneto a Caprara,3344,00,3271,73,2695,649,3344,0
2019/02,434,06/02/2019,3,Via San Nicola (ex SP 39) tra bivio per Taneto a Caprara,3307,00,3234,73,2591,716,3307,0
2019/02,434,07/02/2019,4,Via San Nicola (ex SP 39) tra bivio per Taneto a Caprara,3328,10,3247,80,2627,701,3328,0
2019/02,434,08/02/2019,5,Via San Nicola (ex SP 39) tra bivio per Taneto a Caprara,3409,00,3327,82,2601,808,3409,0
2019/02,434,09/02/2019,6,Via San Nicola (ex SP 39) tra bivio per Taneto a Caprara,2843,00,2812,31,2146,697,0,2843
2019/02,434,10/02/2019,7,Via San Nicola (ex SP 39) tra bivio per Taneto a Caprara,2012,00,2002,10,1439,573,0,2012
2019/02,434,11/02/2019,1,Via San Nicola (ex SP 39) tra bivio per Taneto a Caprara,3156,00,3090,66,2524,632,3156,0
2019/02,434,12/02/2019,2,Via San Nicola (ex SP 39) tra bivio per Taneto a Caprara,3311,10,3222,88,2639,672,3311,0
2019/02,434,13/02/2019,3,Via San Nicola (ex SP 39) tra bivio per Taneto a Caprara,3564,00,3475,89,2820,744,3564,0
2019/02,434,14/02/2019,4,Via San Nicola (ex SP 39) tra bivio per Taneto a Caprara,3582,00,3497,85,2823,759,3582,0
2019/02,436,01/02/2019,5,SP 26 da Santa Sofia a San Piero in Bagno,777,00,749,28,615,162,777,0
2019/02,436,02/02/2019,6,SP 26 da Santa Sofia a San Piero in Bagno,704,00,689,15,500,204,0,704
2019/02,436,03/02/2019,7,SP 26 da Santa Sofia a San Piero in Bagno,710,00,710,0,525,185,0,710
2019/02,436,04/02/2019,1,SP 26 da Santa Sofia a San Piero in Bagno,782,00,750,32,620,162,782,0
2019/02,436,05/02/2019,2,SP 26 da Santa Sofia a San Piero in Bagno,787,10,747,39,646,141,787,0
2019/02,436,06/02/2019,3,SP 26 da Santa Sofia a San Piero in Bagno,893,00,846,47,739,154,893,0
2019/02,436,07/02/2019,4,SP 26 da Santa Sofia a San Piero in Bagno,802,00,770,32,628,174,802,0
2019/02,436,08/02/2019,5,SP 26 da Santa Sofia a San Piero in Bagno,841,10,804,36,648,193,841,0
2019/02,436,09/02/2019,6,SP 26 da Santa Sofia a San Piero in Bagno,836,10,801,34,615,221,0,836
2019/02,436,10/02/2019,7,SP 26 da Santa Sofia a San Piero in Bagno,892,00,890,2,685,207,0,892
2019/02,436,11/02/2019,1,SP 26 da Santa Sofia a San Piero in Bagno,811,00,780,31,628,183,811,0
2019/02,436,12/02/2019,2,SP 26 da Santa Sofia a San Piero in Bagno,782,00,722,60,630,152,782,0
2019/02,436,13/02/2019,3,SP 26 da Santa Sofia a San Piero in Bagno,917,10,854,62,722,195,917,0
2019/02,436,14/02/2019,4,SP 26 da Santa Sofia a San Piero in Bagno,908,00,868,40,678,230,908,0
2019/02,437,01/02/2019,5,SP 13 tra SS 9 (Santarcangelo di Romagna) e SP 92 (località Camerano),6807,00,5859,948,5395,1412,6807,0
2019/02,437,02/02/2019,6,SP 13 tra SS 9 (Santarcangelo di Romagna) e SP 92 (località Camerano),5557,00,5365,192,4164,1393,0,5557
2019/02,437,03/02/2019,7,SP 13 tra SS 9 (Santarcangelo di Romagna) e SP 92 (località Camerano),4339,00,4309,30,3203,1136,0,4339
2019/02,437,04/02/2019,1,SP 13 tra SS 9 (Santarcangelo di Romagna) e SP 92 (località Camerano),6827,00,5802,1025,5592,1235,6827,0
2019/02,437,05/02/2019,2,SP 13 tra SS 9 (Santarcangelo di Romagna) e SP 92 (località Camerano),6982,00,6007,975,5771,1211,6982,0
2019/02,437,06/02/2019,3,SP 13 tra SS 9 (Santarcangelo di Romagna) e SP 92 (località Camerano),6814,10,5856,957,5467,1347,6814,0
2019/02,437,07/02/2019,4,SP 13 tra SS 9 (Santarcangelo di Romagna) e SP 92 (località Camerano),6915,10,5901,1013,5561,1354,6915,0
2019/02,437,08/02/2019,5,SP 13 tra SS 9 (Santarcangelo di Romagna) e SP 92 (località Camerano),7111,00,6101,1010,5651,1460,7111,0
2019/02,437,09/02/2019,6,SP 13 tra SS 9 (Santarcangelo di Romagna) e SP 92 (località Camerano),5800,00,5615,185,4315,1485,0,5800
2019/02,437,10/02/2019,7,SP 13 tra SS 9 (Santarcangelo di Romagna) e SP 92 (località Camerano),4594,00,4555,39,3453,1141,0,4594
2019/02,437,11/02/2019,1,SP 13 tra SS 9 (Santarcangelo di Romagna) e SP 92 (località Camerano),7003,10,5993,1009,5750,1253,7003,0
2019/02,437,12/02/2019,2,SP 13 tra SS 9 (Santarcangelo di Romagna) e SP 92 (località Camerano),6961,20,5978,981,5662,1299,6961,0
2019/02,437,13/02/2019,3,SP 13 tra SS 9 (Santarcangelo di Romagna) e SP 92 (località Camerano),6912,10,5941,970,5534,1378,6912,0
2019/02,437,14/02/2019,4,SP 13 tra SS 9 (Santarcangelo di Romagna) e SP 92 (località Camerano),7173,00,6208,965,5672,1501,7173,0
2019/02,438,01/02/2019,5,SP 14 tra Colombare (bivio SP 14Ter) e bivio SP 258R,8065,00,7519,546,6433,1632,8065,0
2019/02,438,02/02/2019,6,SP 14 tra Colombare (bivio SP 14Ter) e bivio SP 258R,6312,10,6206,105,4695,1617,0,6312
2019/02,438,03/02/2019,7,SP 14 tra Colombare (bivio SP 14Ter) e bivio SP 258R,5711,20,5681,28,4378,1333,0,5711
2019/02,438,04/02/2019,1,SP 14 tra Colombare (bivio SP 14Ter) e bivio SP 258R,7650,10,7091,558,6299,1351,7650,0
2019/02,438,05/02/2019,2,SP 14 tra Colombare (bivio SP 14Ter) e bivio SP 258R,7539,10,7079,459,6150,1389,7539,0
2019/02,438,06/02/2019,3,SP 14 tra Colombare (bivio SP 14Ter) e bivio SP 258R,8048,00,7401,647,6506,1542,8048,0
2019/02,438,07/02/2019,4,SP 14 tra Colombare (bivio SP 14Ter) e bivio SP 258R,8053,20,7372,679,6474,1579,8053,0
2019/02,438,08/02/2019,5,SP 14 tra Colombare (bivio SP 14Ter) e bivio SP 258R,8574,00,7918,656,6798,1776,8574,0
2019/02,438,09/02/2019,6,SP 14 tra Colombare (bivio SP 14Ter) e bivio SP 258R,6796,10,6642,153,5049,1747,0,6796
2019/02,438,10/02/2019,7,SP 14 tra Colombare (bivio SP 14Ter) e bivio SP 258R,5759,00,5729,30,4377,1382,0,5759
2019/02,438,11/02/2019,1,SP 14 tra Colombare (bivio SP 14Ter) e bivio SP 258R,7744,10,7140,603,6388,1356,7744,0
2019/02,438,12/02/2019,2,SP 14 tra Colombare (bivio SP 14Ter) e bivio SP 258R,8140,10,7464,675,6630,1510,8140,0
2019/02,438,13/02/2019,3,SP 14 tra Colombare (bivio SP 14Ter) e bivio SP 258R,8419,00,7725,694,6811,1608,8419,0
2019/02,438,14/02/2019,4,SP 14 tra Colombare (bivio SP 14Ter) e bivio SP 258R,8426,00,7861,565,6652,1774,8426,0
2019/02,439,01/02/2019,5,SP 49 da Santarcangelo di Romagna alla località Posta (bivio SP 258R),12846,40,11992,850,10152,2694,12846,0
2019/02,439,02/02/2019,6,SP 49 da Santarcangelo di Romagna alla località Posta (bivio SP 258R),10871,00,10696,175,7975,2896,0,10871
2019/02,439,03/02/2019,7,SP 49 da Santarcangelo di Romagna alla località Posta (bivio SP 258R),8916,00,8900,16,6483,2433,0,8916
2019/02,439,04/02/2019,1,SP 49 da Santarcangelo di Romagna alla località Posta (bivio SP 258R),11660,00,10860,800,9402,2258,11660,0
2019/02,439,05/02/2019,2,SP 49 da Santarcangelo di Romagna alla località Posta (bivio SP 258R),12682,00,11878,804,10290,2392,12682,0
2019/02,439,06/02/2019,3,SP 49 da Santarcangelo di Romagna alla località Posta (bivio SP 258R),12272,10,11354,917,9836,2436,12272,0
2019/02,439,07/02/2019,4,SP 49 da Santarcangelo di Romagna alla località Posta (bivio SP 258R),12563,10,11629,933,9968,2595,12563,0
2019/02,439,08/02/2019,5,SP 49 da Santarcangelo di Romagna alla località Posta (bivio SP 258R),13330,00,12448,882,10377,2953,13330,0
2019/02,439,09/02/2019,6,SP 49 da Santarcangelo di Romagna alla località Posta (bivio SP 258R),11429,20,11233,194,8410,3019,0,11429
2019/02,439,10/02/2019,7,SP 49 da Santarcangelo di Romagna alla località Posta (bivio SP 258R),8978,00,8959,19,6577,2401,0,8978
2019/02,439,11/02/2019,1,SP 49 da Santarcangelo di Romagna alla località Posta (bivio SP 258R),11989,00,11070,919,9781,2208,11989,0
2019/02,439,12/02/2019,2,SP 49 da Santarcangelo di Romagna alla località Posta (bivio SP 258R),12346,10,11464,881,9826,2520,12346,0
2019/02,439,13/02/2019,3,SP 49 da Santarcangelo di Romagna alla località Posta (bivio SP 258R),12604,10,11681,922,9985,2619,12604,0
2019/02,439,14/02/2019,4,SP 49 da Santarcangelo di Romagna alla località Posta (bivio SP 258R),13094,00,12145,949,10198,2896,13094,0
2019/02,440,01/02/2019,5,SP 35 tra bivio SP 50 (località Cella) e Sant'Andrea in Casale,12366,00,12010,356,9527,2839,12366,0
2019/02,440,02/02/2019,6,SP 35 tra bivio SP 50 (località Cella) e Sant'Andrea in Casale,11123,00,10977,146,8028,3095,0,11123
2019/02,440,03/02/2019,7,SP 35 tra bivio SP 50 (località Cella) e Sant'Andrea in Casale,8528,20,8508,18,5941,2587,0,8528
2019/02,440,04/02/2019,1,SP 35 tra bivio SP 50 (località Cella) e Sant'Andrea in Casale,11748,00,11473,275,9462,2286,11748,0
2019/02,440,05/02/2019,2,SP 35 tra bivio SP 50 (località Cella) e Sant'Andrea in Casale,12038,00,11731,307,9706,2332,12038,0
2019/02,440,06/02/2019,3,SP 35 tra bivio SP 50 (località Cella) e Sant'Andrea in Casale,11899,00,11607,292,9393,2506,11899,0
2019/02,440,07/02/2019,4,SP 35 tra bivio SP 50 (località Cella) e Sant'Andrea in Casale,12222,00,11876,346,9724,2498,12222,0
2019/02,440,08/02/2019,5,SP 35 tra bivio SP 50 (località Cella) e Sant'Andrea in Casale,12493,00,12192,301,9702,2791,12493,0
2019/02,440,09/02/2019,6,SP 35 tra bivio SP 50 (località Cella) e Sant'Andrea in Casale,11553,00,11397,156,8408,3145,0,11553
2019/02,440,10/02/2019,7,SP 35 tra bivio SP 50 (località Cella) e Sant'Andrea in Casale,8817,00,8800,17,6291,2526,0,8817
2019/02,440,11/02/2019,1,SP 35 tra bivio SP 50 (località Cella) e Sant'Andrea in Casale,11760,00,11475,285,9427,2333,11760,0
2019/02,440,12/02/2019,2,SP 35 tra bivio SP 50 (località Cella) e Sant'Andrea in Casale,12106,00,11750,356,9720,2386,12106,0
2019/02,440,13/02/2019,3,SP 35 tra bivio SP 50 (località Cella) e Sant'Andrea in Casale,12277,00,11950,327,9684,2593,12277,0
2019/02,440,14/02/2019,4,SP 35 tra bivio SP 50 (località Cella) e Sant'Andrea in Casale,12769,10,12416,352,9870,2899,12769,0
2019/02,441,01/02/2019,5,SP 58 tra San Giovanni in Marignano e il confine regionale (Marche),8850,00,8438,412,6961,1889,8850,0
2019/02,441,02/02/2019,6,SP 58 tra San Giovanni in Marignano e il confine regionale (Marche),7315,00,7222,93,5224,2091,0,7315
2019/02,441,03/02/2019,7,SP 58 tra San Giovanni in Marignano e il confine regionale (Marche),6052,00,6040,12,4108,1944,0,6052
2019/02,441,04/02/2019,1,SP 58 tra San Giovanni in Marignano e il confine regionale (Marche),8497,00,8091,406,6855,1642,8497,0
2019/02,441,05/02/2019,2,SP 58 tra San Giovanni in Marignano e il confine regionale (Marche),8626,00,8178,448,7039,1587,8626,0
2019/02,441,06/02/2019,3,SP 58 tra San Giovanni in Marignano e il confine regionale (Marche),8700,00,8245,455,6950,1750,8700,0
2019/02,441,07/02/2019,4,SP 58 tra San Giovanni in Marignano e il confine regionale (Marche),8912,00,8475,437,7107,1805,8912,0
2019/02,441,08/02/2019,5,SP 58 tra San Giovanni in Marignano e il confine regionale (Marche),9048,00,8623,425,7053,1995,9048,0
2019/02,441,09/02/2019,6,SP 58 tra San Giovanni in Marignano e il confine regionale (Marche),7757,00,7650,107,5608,2149,0,7757
2019/02,441,10/02/2019,7,SP 58 tra San Giovanni in Marignano e il confine regionale (Marche),6280,00,6255,25,4311,1969,0,6280
2019/02,441,11/02/2019,1,SP 58 tra San Giovanni in Marignano e il confine regionale (Marche),8680,00,8281,399,7039,1641,8680,0
2019/02,441,12/02/2019,2,SP 58 tra San Giovanni in Marignano e il confine regionale (Marche),8718,10,8305,412,7054,1664,8718,0
2019/02,441,13/02/2019,3,SP 58 tra San Giovanni in Marignano e il confine regionale (Marche),8774,00,8336,438,7028,1746,8774,0
2019/02,441,14/02/2019,4,SP 58 tra San Giovanni in Marignano e il confine regionale (Marche),9424,00,8952,472,7427,1997,9424,0
2019/02,442,01/02/2019,5,SP 118 tra Casemurate (bivio SP 254R) e il confine provinciale,3649,00,3355,294,2819,830,3649,0
2019/02,442,02/02/2019,6,SP 118 tra Casemurate (bivio SP 254R) e il confine provinciale,2999,00,2900,99,2267,732,0,2999
2019/02,442,03/02/2019,7,SP 118 tra Casemurate (bivio SP 254R) e il confine provinciale,2629,00,2592,37,1944,685,0,2629
2019/02,442,04/02/2019,1,SP 118 tra Casemurate (bivio SP 254R) e il confine provinciale,4037,00,3567,470,3047,990,4037,0
2019/02,442,05/02/2019,2,SP 118 tra Casemurate (bivio SP 254R) e il confine provinciale,5132,20,4469,661,4114,1018,5132,0
2019/02,442,06/02/2019,3,SP 118 tra Casemurate (bivio SP 254R) e il confine provinciale,5039,10,4432,606,3997,1042,5039,0
2019/02,442,07/02/2019,4,SP 118 tra Casemurate (bivio SP 254R) e il confine provinciale,5010,30,4401,606,4005,1005,5010,0
2019/02,442,08/02/2019,5,SP 118 tra Casemurate (bivio SP 254R) e il confine provinciale,5380,10,4688,691,4156,1224,5380,0
2019/02,442,09/02/2019,6,SP 118 tra Casemurate (bivio SP 254R) e il confine provinciale,4559,30,4281,275,3460,1099,0,4559
2019/02,442,10/02/2019,7,SP 118 tra Casemurate (bivio SP 254R) e il confine provinciale,3708,00,3644,64,2666,1042,0,3708
2019/02,442,11/02/2019,1,SP 118 tra Casemurate (bivio SP 254R) e il confine provinciale,4997,10,4376,620,3960,1037,4997,0
2019/02,442,12/02/2019,2,SP 118 tra Casemurate (bivio SP 254R) e il confine provinciale,5000,00,4368,632,4036,964,5000,0
2019/02,442,13/02/2019,3,SP 118 tra Casemurate (bivio SP 254R) e il confine provinciale,4969,00,4361,608,3983,986,4969,0
2019/02,442,14/02/2019,4,SP 118 tra Casemurate (bivio SP 254R) e il confine provinciale,5023,10,4454,568,3869,1154,5023,0
2019/02,443,01/02/2019,5,SP 16 tra Faenza e il confine provinciale,5418,00,5168,250,4249,1169,5418,0
2019/02,443,02/02/2019,6,SP 16 tra Faenza e il confine provinciale,4724,00,4668,56,3537,1187,0,4724
2019/02,443,03/02/2019,7,SP 16 tra Faenza e il confine provinciale,4063,00,4040,23,3145,918,0,4063
2019/02,443,04/02/2019,1,SP 16 tra Faenza e il confine provinciale,5104,00,4852,252,4071,1033,5104,0
2019/02,443,05/02/2019,2,SP 16 tra Faenza e il confine provinciale,5449,00,5199,250,4376,1073,5449,0
2019/02,443,06/02/2019,3,SP 16 tra Faenza e il confine provinciale,5420,00,5144,276,4310,1110,5420,0
2019/02,443,07/02/2019,4,SP 16 tra Faenza e il confine provinciale,5498,00,5223,275,4360,1138,5498,0
2019/02,443,08/02/2019,5,SP 16 tra Faenza e il confine provinciale,5733,00,5471,262,4474,1259,5733,0
2019/02,443,09/02/2019,6,SP 16 tra Faenza e il confine provinciale,5251,00,5156,95,4016,1235,0,5251
2019/02,443,10/02/2019,7,SP 16 tra Faenza e il confine provinciale,4611,00,4591,20,3587,1024,0,4611
2019/02,443,11/02/2019,1,SP 16 tra Faenza e il confine provinciale,5356,00,5104,252,4237,1119,5356,0
2019/02,443,12/02/2019,2,SP 16 tra Faenza e il confine provinciale,5504,00,5234,270,4390,1114,5504,0
2019/02,443,13/02/2019,3,SP 16 tra Faenza e il confine provinciale,5458,00,5200,258,4301,1157,5458,0
2019/02,443,14/02/2019,4,SP 16 tra Faenza e il confine provinciale,5748,00,5448,300,4565,1183,5748,0
2019/02,444,01/02/2019,5,SP 5 fra Russi e San Pancrazio,5801,00,5546,255,4669,1132,5801,0
2019/02,444,02/02/2019,6,SP 5 fra Russi e San Pancrazio,4750,00,4690,60,3637,1113,0,4750
2019/02,444,03/02/2019,7,SP 5 fra Russi e San Pancrazio,3486,00,3474,12,2564,922,0,3486
2019/02,444,04/02/2019,1,SP 5 fra Russi e San Pancrazio,5618,00,5376,242,4603,1015,5618,0
2019/02,444,05/02/2019,2,SP 5 fra Russi e San Pancrazio,5914,20,5628,284,4821,1093,5914,0
2019/02,444,06/02/2019,3,SP 5 fra Russi e San Pancrazio,5575,00,5295,280,4485,1090,5575,0
2019/02,444,07/02/2019,4,SP 5 fra Russi e San Pancrazio,5655,00,5380,275,4569,1086,5655,0
2019/02,444,08/02/2019,5,SP 5 fra Russi e San Pancrazio,5940,10,5657,282,4705,1235,5940,0
2019/02,444,09/02/2019,6,SP 5 fra Russi e San Pancrazio,,,,,,,,
2019/02,444,10/02/2019,7,SP 5 fra Russi e San Pancrazio,,,,,,,,
2019/02,444,11/02/2019,1,SP 5 fra Russi e San Pancrazio,,,,,,,,
2019/02,444,12/02/2019,2,SP 5 fra Russi e San Pancrazio,,,,,,,,
2019/02,444,13/02/2019,3,SP 5 fra Russi e San Pancrazio,,,,,,,,
2019/02,444,14/02/2019,4,SP 5 fra Russi e San Pancrazio,,,,,,,,
2019/02,445,01/02/2019,5,SP 610R fra SP 253R e Conselice,5699,00,4968,731,4436,1263,5699,0
2019/02,445,02/02/2019,6,SP 610R fra SP 253R e Conselice,4199,00,4052,147,3045,1154,0,4199
2019/02,445,03/02/2019,7,SP 610R fra SP 253R e Conselice,3598,00,3559,39,2674,924,0,3598
2019/02,445,04/02/2019,1,SP 610R fra SP 253R e Conselice,5530,10,4688,841,4407,1123,5530,0
2019/02,445,05/02/2019,2,SP 610R fra SP 253R e Conselice,5680,00,4830,850,4476,1204,5680,0
2019/02,445,06/02/2019,3,SP 610R fra SP 253R e Conselice,5617,10,4757,859,4420,1197,5617,0
2019/02,445,07/02/2019,4,SP 610R fra SP 253R e Conselice,5800,10,4924,875,4590,1210,5800,0
2019/02,445,08/02/2019,5,SP 610R fra SP 253R e Conselice,5998,00,5196,802,4700,1298,5998,0
2019/02,445,09/02/2019,6,SP 610R fra SP 253R e Conselice,4639,00,4406,233,3387,1252,0,4639
2019/02,445,10/02/2019,7,SP 610R fra SP 253R e Conselice,4266,00,4217,49,3278,988,0,4266
2019/02,445,11/02/2019,1,SP 610R fra SP 253R e Conselice,5535,00,4730,805,4336,1199,5535,0
2019/02,445,12/02/2019,2,SP 610R fra SP 253R e Conselice,5943,00,5096,847,4667,1276,5943,0
2019/02,445,13/02/2019,3,SP 610R fra SP 253R e Conselice,5624,00,4805,819,4394,1230,5624,0
2019/02,445,14/02/2019,4,SP 610R fra SP 253R e Conselice,6026,10,5158,867,4693,1333,6026,0
2019/02,446,01/02/2019,5,SP 13 in località Santa Maria di Fabriago,8823,10,8323,499,7000,1823,8823,0
2019/02,446,02/02/2019,6,SP 13 in località Santa Maria di Fabriago,6979,00,6835,144,5129,1850,0,6979
2019/02,446,03/02/2019,7,SP 13 in località Santa Maria di Fabriago,5361,00,5340,21,3839,1522,0,5361
2019/02,446,04/02/2019,1,SP 13 in località Santa Maria di Fabriago,8667,00,7970,697,7030,1637,8667,0
2019/02,446,05/02/2019,2,SP 13 in località Santa Maria di Fabriago,9019,00,8149,870,7344,1675,9019,0
2019/02,446,06/02/2019,3,SP 13 in località Santa Maria di Fabriago,9282,00,8488,794,7471,1811,9282,0
2019/02,446,07/02/2019,4,SP 13 in località Santa Maria di Fabriago,9262,00,8381,881,7438,1824,9262,0
2019/02,446,08/02/2019,5,SP 13 in località Santa Maria di Fabriago,9348,00,8593,755,7449,1899,9348,0
2019/02,446,09/02/2019,6,SP 13 in località Santa Maria di Fabriago,7330,00,7032,298,5422,1908,0,7330
2019/02,446,10/02/2019,7,SP 13 in località Santa Maria di Fabriago,5238,00,5213,25,3806,1432,0,5238
2019/02,446,11/02/2019,1,SP 13 in località Santa Maria di Fabriago,8923,00,8234,689,7176,1747,8923,0
2019/02,446,12/02/2019,2,SP 13 in località Santa Maria di Fabriago,8935,00,8306,629,7138,1797,8935,0
2019/02,446,13/02/2019,3,SP 13 in località Santa Maria di Fabriago,9341,00,8679,662,7478,1863,9341,0
2019/02,446,14/02/2019,4,SP 13 in località Santa Maria di Fabriago,9337,10,8711,625,7306,2031,9337,0
2019/02,447,01/02/2019,5,SP 28 in località Molinazzo (Comune di Gossolengo),3569,00,3475,94,2735,834,3569,0
2019/02,447,02/02/2019,6,SP 28 in località Molinazzo (Comune di Gossolengo),4007,00,3948,59,2953,1054,0,4007
2019/02,447,03/02/2019,7,SP 28 in località Molinazzo (Comune di Gossolengo),3313,00,3300,13,2537,776,0,3313
2019/02,447,04/02/2019,1,SP 28 in località Molinazzo (Comune di Gossolengo),4796,00,4625,171,3858,938,4796,0
2019/02,447,05/02/2019,2,SP 28 in località Molinazzo (Comune di Gossolengo),4742,00,4587,155,3904,838,4742,0
2019/02,447,06/02/2019,3,SP 28 in località Molinazzo (Comune di Gossolengo),5223,00,4960,263,4287,936,5223,0
2019/02,447,07/02/2019,4,SP 28 in località Molinazzo (Comune di Gossolengo),4963,00,4759,204,4000,963,4963,0
2019/02,447,08/02/2019,5,SP 28 in località Molinazzo (Comune di Gossolengo),5363,00,5145,218,4238,1125,5363,0
2019/02,447,09/02/2019,6,SP 28 in località Molinazzo (Comune di Gossolengo),4757,10,4700,56,3591,1166,0,4757
2019/02,447,10/02/2019,7,SP 28 in località Molinazzo (Comune di Gossolengo),3716,00,3697,19,2844,872,0,3716
2019/02,447,11/02/2019,1,SP 28 in località Molinazzo (Comune di Gossolengo),4894,00,4710,184,3985,909,4894,0
2019/02,447,12/02/2019,2,SP 28 in località Molinazzo (Comune di Gossolengo),5010,00,4830,180,4080,930,5010,0
2019/02,447,13/02/2019,3,SP 28 in località Molinazzo (Comune di Gossolengo),5311,00,5116,195,4312,999,5311,0
2019/02,447,14/02/2019,4,SP 28 in località Molinazzo (Comune di Gossolengo),5413,00,5214,199,4241,1172,5413,0
2019/02,448,01/02/2019,5,SP 5 fra Reggiolo e intersezione SP 45 per Fabbrico,7410,10,6643,766,5789,1621,7410,0
2019/02,448,02/02/2019,6,SP 5 fra Reggiolo e intersezione SP 45 per Fabbrico,5767,00,5602,165,4006,1761,0,5767
2019/02,448,03/02/2019,7,SP 5 fra Reggiolo e intersezione SP 45 per Fabbrico,4931,00,4909,22,3478,1453,0,4931
2019/02,448,04/02/2019,1,SP 5 fra Reggiolo e intersezione SP 45 per Fabbrico,7127,10,6406,720,5741,1386,7127,0
2019/02,448,05/02/2019,2,SP 5 fra Reggiolo e intersezione SP 45 per Fabbrico,7374,00,6651,723,5921,1453,7374,0
2019/02,448,06/02/2019,3,SP 5 fra Reggiolo e intersezione SP 45 per Fabbrico,7355,10,6567,787,5796,1559,7355,0
2019/02,448,07/02/2019,4,SP 5 fra Reggiolo e intersezione SP 45 per Fabbrico,7408,00,6611,797,5830,1578,7408,0
2019/02,448,08/02/2019,5,SP 5 fra Reggiolo e intersezione SP 45 per Fabbrico,7547,10,6790,756,5795,1752,7547,0
2019/02,448,09/02/2019,6,SP 5 fra Reggiolo e intersezione SP 45 per Fabbrico,6288,00,6099,189,4400,1888,0,6288
2019/02,448,10/02/2019,7,SP 5 fra Reggiolo e intersezione SP 45 per Fabbrico,5461,00,5429,32,3937,1524,0,5461
2019/02,448,11/02/2019,1,SP 5 fra Reggiolo e intersezione SP 45 per Fabbrico,7158,10,6383,774,5774,1384,7158,0
2019/02,448,12/02/2019,2,SP 5 fra Reggiolo e intersezione SP 45 per Fabbrico,7307,00,6489,818,5887,1420,7307,0
2019/02,448,13/02/2019,3,SP 5 fra Reggiolo e intersezione SP 45 per Fabbrico,7614,00,6799,815,6030,1584,7614,0
2019/02,448,14/02/2019,4,SP 5 fra Reggiolo e intersezione SP 45 per Fabbrico,7813,00,7018,795,6111,1702,7813,0
2019/02,449,01/02/2019,5,SP 111 fra via Emilia e la variante Asse Val d'Enza,11354,10,9437,1916,9064,2290,11354,0
2019/02,449,02/02/2019,6,SP 111 fra via Emilia e la variante Asse Val d'Enza,7108,00,6757,351,5211,1897,0,7108
2019/02,449,03/02/2019,7,SP 111 fra via Emilia e la variante Asse Val d'Enza,6367,00,6236,131,4559,1808,0,6367
2019/02,449,04/02/2019,1,SP 111 fra via Emilia e la variante Asse Val d'Enza,11305,00,9407,1898,9148,2157,11305,0
2019/02,449,05/02/2019,2,SP 111 fra via Emilia e la variante Asse Val d'Enza,11914,10,9810,2103,9652,2262,11914,0
2019/02,449,06/02/2019,3,SP 111 fra via Emilia e la variante Asse Val d'Enza,12040,30,9977,2060,9705,2335,12040,0
2019/02,449,07/02/2019,4,SP 111 fra via Emilia e la variante Asse Val d'Enza,12264,00,10106,2158,9873,2391,12264,0
2019/02,449,08/02/2019,5,SP 111 fra via Emilia e la variante Asse Val d'Enza,12498,00,10363,2135,9997,2501,12498,0
2019/02,449,09/02/2019,6,SP 111 fra via Emilia e la variante Asse Val d'Enza,7946,00,7549,397,5794,2152,0,7946
2019/02,449,10/02/2019,7,SP 111 fra via Emilia e la variante Asse Val d'Enza,6755,00,6608,147,4864,1891,0,6755
2019/02,449,11/02/2019,1,SP 111 fra via Emilia e la variante Asse Val d'Enza,11657,00,9670,1987,9446,2211,11657,0
2019/02,449,12/02/2019,2,SP 111 fra via Emilia e la variante Asse Val d'Enza,12125,00,10014,2111,9900,2225,12125,0
2019/02,449,13/02/2019,3,SP 111 fra via Emilia e la variante Asse Val d'Enza,12595,00,10337,2258,10222,2373,12595,0
2019/02,449,14/02/2019,4,SP 111 fra via Emilia e la variante Asse Val d'Enza,12834,10,10506,2327,10257,2577,12834,0
2019/02,450,01/02/2019,5,SP 35 sul Ponte Po,8349,10,7460,888,6513,1836,8349,0
2019/02,450,02/02/2019,6,SP 35 sul Ponte Po,6705,00,6592,113,4846,1859,0,6705
2019/02,450,03/02/2019,7,SP 35 sul Ponte Po,4973,00,4950,23,3400,1573,0,4973
2019/02,450,04/02/2019,1,SP 35 sul Ponte Po,8028,50,7094,929,6512,1516,8028,0
2019/02,450,05/02/2019,2,SP 35 sul Ponte Po,8358,40,7381,973,6784,1574,8358,0
2019/02,450,06/02/2019,3,SP 35 sul Ponte Po,8407,40,7372,1031,6740,1667,8407,0
2019/02,450,07/02/2019,4,SP 35 sul Ponte Po,8283,20,7282,999,6721,1562,8283,0
2019/02,450,08/02/2019,5,SP 35 sul Ponte Po,8830,50,7805,1020,6802,2028,8830,0
2019/02,450,09/02/2019,6,SP 35 sul Ponte Po,7122,10,6955,166,5166,1956,0,7122
2019/02,450,10/02/2019,7,SP 35 sul Ponte Po,5000,00,4966,34,3485,1515,0,5000
2019/02,450,11/02/2019,1,SP 35 sul Ponte Po,8090,70,7083,1000,6564,1526,8090,0
2019/02,450,12/02/2019,2,SP 35 sul Ponte Po,8436,10,7410,1025,6758,1678,8436,0
2019/02,450,13/02/2019,3,SP 35 sul Ponte Po,8512,10,7472,1039,6803,1709,8512,0
2019/02,450,14/02/2019,4,SP 35 sul Ponte Po,8727,10,7700,1026,6793,1934,8727,0
2019/02,451,01/02/2019,5,SP 62RVar sulla variante di Luzzara (c/o Codisotto),11952,20,9243,2707,9344,2608,11952,0
2019/02,451,02/02/2019,6,SP 62RVar sulla variante di Luzzara (c/o Codisotto),8600,00,8150,450,6239,2361,0,8600
2019/02,451,03/02/2019,7,SP 62RVar sulla variante di Luzzara (c/o Codisotto),7045,00,6921,124,4831,2214,0,7045
2019/02,451,04/02/2019,1,SP 62RVar sulla variante di Luzzara (c/o Codisotto),11525,00,8692,2833,9256,2269,11525,0
2019/02,451,05/02/2019,2,SP 62RVar sulla variante di Luzzara (c/o Codisotto),11968,10,8885,3082,9558,2410,11968,0
2019/02,451,06/02/2019,3,SP 62RVar sulla variante di Luzzara (c/o Codisotto),12364,00,9152,3212,9784,2580,12364,0
2019/02,451,07/02/2019,4,SP 62RVar sulla variante di Luzzara (c/o Codisotto),12256,10,9105,3150,9702,2554,12256,0
2019/02,451,08/02/2019,5,SP 62RVar sulla variante di Luzzara (c/o Codisotto),12954,00,9920,3034,10073,2881,12954,0
2019/02,451,09/02/2019,6,SP 62RVar sulla variante di Luzzara (c/o Codisotto),9245,10,8821,423,6775,2470,0,9245
2019/02,451,10/02/2019,7,SP 62RVar sulla variante di Luzzara (c/o Codisotto),7656,00,7528,128,5308,2348,0,7656
2019/02,451,11/02/2019,1,SP 62RVar sulla variante di Luzzara (c/o Codisotto),11951,00,8905,3046,9484,2467,11951,0
2019/02,451,12/02/2019,2,SP 62RVar sulla variante di Luzzara (c/o Codisotto),12078,10,8938,3139,9660,2418,12078,0
2019/02,451,13/02/2019,3,SP 62RVar sulla variante di Luzzara (c/o Codisotto),12237,00,9062,3175,9671,2566,12237,0
2019/02,451,14/02/2019,4,SP 62RVar sulla variante di Luzzara (c/o Codisotto),12807,00,9729,3078,10034,2773,12807,0
2019/02,452,01/02/2019,5,SP 3 sulla variante tra Bagnolo in Piano e il casello A 1 di Reggio Emilia,12069,00,10857,1212,9483,2586,12069,0
2019/02,452,02/02/2019,6,SP 3 sulla variante tra Bagnolo in Piano e il casello A 1 di Reggio Emilia,8548,00,8312,236,5996,2552,0,8548
2019/02,452,03/02/2019,7,SP 3 sulla variante tra Bagnolo in Piano e il casello A 1 di Reggio Emilia,7299,00,7246,53,5023,2276,0,7299
2019/02,452,04/02/2019,1,SP 3 sulla variante tra Bagnolo in Piano e il casello A 1 di Reggio Emilia,11957,00,10619,1338,9615,2342,11957,0
2019/02,452,05/02/2019,2,SP 3 sulla variante tra Bagnolo in Piano e il casello A 1 di Reggio Emilia,12146,00,10830,1316,9793,2353,12146,0
2019/02,452,06/02/2019,3,SP 3 sulla variante tra Bagnolo in Piano e il casello A 1 di Reggio Emilia,12351,00,10970,1381,9825,2526,12351,0
2019/02,452,07/02/2019,4,SP 3 sulla variante tra Bagnolo in Piano e il casello A 1 di Reggio Emilia,12349,10,10982,1366,9743,2606,12349,0
2019/02,452,08/02/2019,5,SP 3 sulla variante tra Bagnolo in Piano e il casello A 1 di Reggio Emilia,12730,10,11437,1292,9916,2814,12730,0
2019/02,452,09/02/2019,6,SP 3 sulla variante tra Bagnolo in Piano e il casello A 1 di Reggio Emilia,9380,00,9170,210,6551,2829,0,9380
2019/02,452,10/02/2019,7,SP 3 sulla variante tra Bagnolo in Piano e il casello A 1 di Reggio Emilia,8197,00,8134,63,5705,2492,0,8197
2019/02,452,11/02/2019,1,SP 3 sulla variante tra Bagnolo in Piano e il casello A 1 di Reggio Emilia,11965,00,10744,1221,9622,2343,11965,0
2019/02,452,12/02/2019,2,SP 3 sulla variante tra Bagnolo in Piano e il casello A 1 di Reggio Emilia,12454,00,11175,1279,10061,2393,12454,0
2019/02,452,13/02/2019,3,SP 3 sulla variante tra Bagnolo in Piano e il casello A 1 di Reggio Emilia,12549,00,11230,1319,9985,2564,12549,0
2019/02,452,14/02/2019,4,SP 3 sulla variante tra Bagnolo in Piano e il casello A 1 di Reggio Emilia,12853,00,11527,1326,10023,2830,12853,0
2019/02,453,01/02/2019,5,Asse viario Modena-Sassuolo tra Modena e Baggiovara,48622,50,43416,5201,37950,10672,48622,0
2019/02,453,02/02/2019,6,Asse viario Modena-Sassuolo tra Modena e Baggiovara,36639,00,35755,884,25982,10657,0,36639
2019/02,453,03/02/2019,7,Asse viario Modena-Sassuolo tra Modena e Baggiovara,30325,00,30150,175,20609,9716,0,30325
2019/02,453,04/02/2019,1,Asse viario Modena-Sassuolo tra Modena e Baggiovara,52297,20,46934,5361,41751,10546,52297,0
2019/02,453,05/02/2019,2,Asse viario Modena-Sassuolo tra Modena e Baggiovara,54335,10,48321,6013,43115,11220,54335,0
2019/02,453,06/02/2019,3,Asse viario Modena-Sassuolo tra Modena e Baggiovara,54864,20,48816,6046,43192,11672,54864,0
2019/02,453,07/02/2019,4,Asse viario Modena-Sassuolo tra Modena e Baggiovara,55126,60,48864,6256,43433,11693,55126,0
2019/02,453,08/02/2019,5,Asse viario Modena-Sassuolo tra Modena e Baggiovara,56194,40,50162,6028,43562,12632,56194,0
2019/02,453,09/02/2019,6,Asse viario Modena-Sassuolo tra Modena e Baggiovara,41866,10,40952,913,29599,12267,0,41866
2019/02,453,10/02/2019,7,Asse viario Modena-Sassuolo tra Modena e Baggiovara,33367,00,33156,211,23250,10117,0,33367
2019/02,453,11/02/2019,1,Asse viario Modena-Sassuolo tra Modena e Baggiovara,53250,10,47796,5453,42692,10558,53250,0
2019/02,453,12/02/2019,2,Asse viario Modena-Sassuolo tra Modena e Baggiovara,54337,30,48331,6003,43326,11011,54337,0
2019/02,453,13/02/2019,3,Asse viario Modena-Sassuolo tra Modena e Baggiovara,55521,90,49403,6109,43897,11624,55521,0
2019/02,453,14/02/2019,4,Asse viario Modena-Sassuolo tra Modena e Baggiovara,56962,50,50402,6555,44552,12410,56962,0
2019/02,502,01/02/2019,5,SP 26 tra località Pioppa e viadotto A 1 (c/o Zola Predosa),13300,10,12398,901,10977,2323,13300,0
2019/02,502,02/02/2019,6,SP 26 tra località Pioppa e viadotto A 1 (c/o Zola Predosa),8422,00,8322,100,6493,1929,0,8422
2019/02,502,03/02/2019,7,SP 26 tra località Pioppa e viadotto A 1 (c/o Zola Predosa),6689,00,6656,33,5085,1604,0,6689
2019/02,502,04/02/2019,1,SP 26 tra località Pioppa e viadotto A 1 (c/o Zola Predosa),13126,00,12226,900,11032,2094,13126,0
2019/02,502,05/02/2019,2,SP 26 tra località Pioppa e viadotto A 1 (c/o Zola Predosa),13587,00,12598,989,11283,2304,13587,0
2019/02,502,06/02/2019,3,SP 26 tra località Pioppa e viadotto A 1 (c/o Zola Predosa),13796,00,12823,973,11277,2519,13796,0
2019/02,502,07/02/2019,4,SP 26 tra località Pioppa e viadotto A 1 (c/o Zola Predosa),13783,00,12849,934,11430,2353,13783,0
2019/02,502,08/02/2019,5,SP 26 tra località Pioppa e viadotto A 1 (c/o Zola Predosa),13840,00,12871,969,11303,2537,13840,0
2019/02,502,09/02/2019,6,SP 26 tra località Pioppa e viadotto A 1 (c/o Zola Predosa),9383,10,9261,121,7027,2356,0,9383
2019/02,502,10/02/2019,7,SP 26 tra località Pioppa e viadotto A 1 (c/o Zola Predosa),6982,00,6936,46,5252,1730,0,6982
2019/02,502,11/02/2019,1,SP 26 tra località Pioppa e viadotto A 1 (c/o Zola Predosa),13551,10,12611,939,11243,2308,13551,0
2019/02,502,12/02/2019,2,SP 26 tra località Pioppa e viadotto A 1 (c/o Zola Predosa),13655,10,12725,929,11257,2398,13655,0
2019/02,502,13/02/2019,3,SP 26 tra località Pioppa e viadotto A 1 (c/o Zola Predosa),14425,10,13377,1047,11803,2622,14425,0
2019/02,502,14/02/2019,4,SP 26 tra località Pioppa e viadotto A 1 (c/o Zola Predosa),13895,00,12998,897,11460,2435,13895,0
2019/02,504,01/02/2019,5,SP 7 dalla località Ca de' Mandorli al bivio per Castel de Britti,10927,00,10680,247,8379,2548,10927,0
2019/02,504,02/02/2019,6,SP 7 dalla località Ca de' Mandorli al bivio per Castel de Britti,9196,00,9067,129,6858,2338,0,9196
2019/02,504,03/02/2019,7,SP 7 dalla località Ca de' Mandorli al bivio per Castel de Britti,7400,00,7372,28,5503,1897,0,7400
2019/02,504,04/02/2019,1,SP 7 dalla località Ca de' Mandorli al bivio per Castel de Britti,10455,10,10177,277,8214,2241,10455,0
2019/02,504,05/02/2019,2,SP 7 dalla località Ca de' Mandorli al bivio per Castel de Britti,10997,00,10687,310,8608,2389,10997,0
2019/02,504,06/02/2019,3,SP 7 dalla località Ca de' Mandorli al bivio per Castel de Britti,11194,00,10896,298,8662,2532,11194,0
2019/02,504,07/02/2019,4,SP 7 dalla località Ca de' Mandorli al bivio per Castel de Britti,11127,00,10810,317,8638,2489,11127,0
2019/02,504,08/02/2019,5,SP 7 dalla località Ca de' Mandorli al bivio per Castel de Britti,11779,00,11447,332,9046,2733,11779,0
2019/02,504,09/02/2019,6,SP 7 dalla località Ca de' Mandorli al bivio per Castel de Britti,10060,00,9936,124,7545,2515,0,10060
2019/02,504,10/02/2019,7,SP 7 dalla località Ca de' Mandorli al bivio per Castel de Britti,7782,00,7741,41,5899,1883,0,7782
2019/02,504,11/02/2019,1,SP 7 dalla località Ca de' Mandorli al bivio per Castel de Britti,10627,10,10298,328,8297,2330,10627,0
2019/02,504,12/02/2019,2,SP 7 dalla località Ca de' Mandorli al bivio per Castel de Britti,11114,20,10748,364,8659,2455,11114,0
2019/02,504,13/02/2019,3,SP 7 dalla località Ca de' Mandorli al bivio per Castel de Britti,11236,10,10883,352,8678,2558,11236,0
2019/02,504,14/02/2019,4,SP 7 dalla località Ca de' Mandorli al bivio per Castel de Britti,11531,00,11207,324,8756,2775,11531,0
2019/02,505,01/02/2019,5,SP 610 tra casello A 1 (Imola) e bivio SP 51 per Castel Guelfo di Bologna,13319,20,11208,2109,10293,3026,13319,0
2019/02,505,02/02/2019,6,SP 610 tra casello A 1 (Imola) e bivio SP 51 per Castel Guelfo di Bologna,9630,00,9278,352,6779,2851,0,9630
2019/02,505,03/02/2019,7,SP 610 tra casello A 1 (Imola) e bivio SP 51 per Castel Guelfo di Bologna,7924,10,7783,140,5467,2457,0,7924
2019/02,505,04/02/2019,1,SP 610 tra casello A 1 (Imola) e bivio SP 51 per Castel Guelfo di Bologna,12922,00,10683,2239,10184,2738,12922,0
2019/02,505,05/02/2019,2,SP 610 tra casello A 1 (Imola) e bivio SP 51 per Castel Guelfo di Bologna,13239,30,10978,2258,10381,2858,13239,0
2019/02,505,06/02/2019,3,SP 610 tra casello A 1 (Imola) e bivio SP 51 per Castel Guelfo di Bologna,13452,10,11023,2428,10400,3052,13452,0
2019/02,505,07/02/2019,4,SP 610 tra casello A 1 (Imola) e bivio SP 51 per Castel Guelfo di Bologna,13417,00,11120,2297,10404,3013,13417,0
2019/02,505,08/02/2019,5,SP 610 tra casello A 1 (Imola) e bivio SP 51 per Castel Guelfo di Bologna,13660,20,11486,2172,10450,3210,13660,0
2019/02,505,09/02/2019,6,SP 610 tra casello A 1 (Imola) e bivio SP 51 per Castel Guelfo di Bologna,10377,10,9985,391,7213,3164,0,10377
2019/02,505,10/02/2019,7,SP 610 tra casello A 1 (Imola) e bivio SP 51 per Castel Guelfo di Bologna,8935,10,8787,147,6248,2687,0,8935
2019/02,505,11/02/2019,1,SP 610 tra casello A 1 (Imola) e bivio SP 51 per Castel Guelfo di Bologna,13266,50,11038,2223,10415,2851,13266,0
2019/02,505,12/02/2019,2,SP 610 tra casello A 1 (Imola) e bivio SP 51 per Castel Guelfo di Bologna,13456,00,11131,2325,10500,2956,13456,0
2019/02,505,13/02/2019,3,SP 610 tra casello A 1 (Imola) e bivio SP 51 per Castel Guelfo di Bologna,13452,20,11143,2307,10538,2914,13452,0
2019/02,505,14/02/2019,4,SP 610 tra casello A 1 (Imola) e bivio SP 51 per Castel Guelfo di Bologna,14095,20,11803,2290,10864,3231,14095,0
2019/02,600,01/02/2019,5,SP 19 tra SP31 e Medicina,7248,00,6522,726,5876,1372,7248,0
2019/02,600,02/02/2019,6,SP 19 tra SP31 e Medicina,5489,10,5351,137,4233,1256,0,5489
2019/02,600,03/02/2019,7,SP 19 tra SP31 e Medicina,5396,00,5367,29,4224,1172,0,5396
2019/02,600,04/02/2019,1,SP 19 tra SP31 e Medicina,7147,00,6355,792,5892,1255,7147,0
2019/02,600,05/02/2019,2,SP 19 tra SP31 e Medicina,7560,10,6751,808,6212,1348,7560,0
2019/02,600,06/02/2019,3,SP 19 tra SP31 e Medicina,7496,00,6658,838,6173,1323,7496,0
2019/02,600,07/02/2019,4,SP 19 tra SP31 e Medicina,7360,00,6514,846,6033,1327,7360,0
2019/02,600,08/02/2019,5,SP 19 tra SP31 e Medicina,7700,00,6860,840,6239,1461,7700,0
2019/02,600,09/02/2019,6,SP 19 tra SP31 e Medicina,6012,10,5844,167,4597,1415,0,6012
2019/02,600,10/02/2019,7,SP 19 tra SP31 e Medicina,5320,00,5282,38,4158,1162,0,5320
2019/02,600,11/02/2019,1,SP 19 tra SP31 e Medicina,7393,00,6545,848,6062,1331,7393,0
2019/02,600,12/02/2019,2,SP 19 tra SP31 e Medicina,7525,00,6725,800,6161,1364,7525,0
2019/02,600,13/02/2019,3,SP 19 tra SP31 e Medicina,7639,00,6800,839,6234,1405,7639,0
2019/02,600,14/02/2019,4,SP 19 tra SP31 e Medicina,7687,00,6864,823,6172,1515,7687,0
2019/02,601,01/02/2019,5,SP 21 da Castel San Pietro al bivio SP 35 (c/o Sassoleone),3053,00,2989,64,2319,734,3053,0
2019/02,601,02/02/2019,6,SP 21 da Castel San Pietro al bivio SP 35 (c/o Sassoleone),3060,00,3035,25,2280,780,0,3060
2019/02,601,03/02/2019,7,SP 21 da Castel San Pietro al bivio SP 35 (c/o Sassoleone),2714,00,2703,11,2098,616,0,2714
2019/02,601,04/02/2019,1,SP 21 da Castel San Pietro al bivio SP 35 (c/o Sassoleone),3104,00,3036,68,2479,625,3104,0
2019/02,601,05/02/2019,2,SP 21 da Castel San Pietro al bivio SP 35 (c/o Sassoleone),3049,20,2977,70,2406,643,3049,0
2019/02,601,06/02/2019,3,SP 21 da Castel San Pietro al bivio SP 35 (c/o Sassoleone),3104,00,3026,78,2435,669,3104,0
2019/02,601,07/02/2019,4,SP 21 da Castel San Pietro al bivio SP 35 (c/o Sassoleone),3095,00,3013,82,2400,695,3095,0
2019/02,601,08/02/2019,5,SP 21 da Castel San Pietro al bivio SP 35 (c/o Sassoleone),3266,00,3173,93,2520,746,3266,0
2019/02,601,09/02/2019,6,SP 21 da Castel San Pietro al bivio SP 35 (c/o Sassoleone),3555,10,3506,48,2747,808,0,3555
2019/02,601,10/02/2019,7,SP 21 da Castel San Pietro al bivio SP 35 (c/o Sassoleone),3044,00,3031,13,2349,695,0,3044
2019/02,601,11/02/2019,1,SP 21 da Castel San Pietro al bivio SP 35 (c/o Sassoleone),3108,00,3026,82,2450,658,3108,0
2019/02,601,12/02/2019,2,SP 21 da Castel San Pietro al bivio SP 35 (c/o Sassoleone),3171,00,3076,95,2520,651,3171,0
2019/02,601,13/02/2019,3,SP 21 da Castel San Pietro al bivio SP 35 (c/o Sassoleone),3207,10,3152,54,2493,714,3207,0
2019/02,601,14/02/2019,4,SP 21 da Castel San Pietro al bivio SP 35 (c/o Sassoleone),3350,00,3263,87,2556,794,3350,0
2019/02,602,01/02/2019,5,SP 9_1 da Crevalcore alla località Caselle,1591,00,1529,62,1223,368,1591,0
2019/02,602,02/02/2019,6,SP 9_1 da Crevalcore alla località Caselle,1308,00,1286,22,1014,294,0,1308
2019/02,602,03/02/2019,7,SP 9_1 da Crevalcore alla località Caselle,1053,00,1050,3,819,234,0,1053
2019/02,602,04/02/2019,1,SP 9_1 da Crevalcore alla località Caselle,1553,00,1476,77,1242,311,1553,0
2019/02,602,05/02/2019,2,SP 9_1 da Crevalcore alla località Caselle,1727,00,1658,69,1395,332,1727,0
2019/02,602,06/02/2019,3,SP 9_1 da Crevalcore alla località Caselle,1611,00,1540,71,1307,304,1611,0
2019/02,602,07/02/2019,4,SP 9_1 da Crevalcore alla località Caselle,1624,00,1561,63,1298,326,1624,0
2019/02,602,08/02/2019,5,SP 9_1 da Crevalcore alla località Caselle,1799,00,1734,65,1387,412,1799,0
2019/02,602,09/02/2019,6,SP 9_1 da Crevalcore alla località Caselle,1456,00,1432,24,1147,309,0,1456
2019/02,602,10/02/2019,7,SP 9_1 da Crevalcore alla località Caselle,1376,00,1373,3,1131,245,0,1376
2019/02,602,11/02/2019,1,SP 9_1 da Crevalcore alla località Caselle,1640,00,1563,77,1323,317,1640,0
2019/02,602,12/02/2019,2,SP 9_1 da Crevalcore alla località Caselle,1724,00,1628,96,1340,384,1724,0
2019/02,602,13/02/2019,3,SP 9_1 da Crevalcore alla località Caselle,1705,10,1627,77,1369,336,1705,0
2019/02,602,14/02/2019,4,SP 9_1 da Crevalcore alla località Caselle,1582,00,1505,77,1288,294,1582,0
2019/02,603,01/02/2019,5,SP 10 dalla località Decima ai confini provinciali di Bologna e Ferrara,3937,00,3806,131,2931,1006,3937,0
2019/02,603,02/02/2019,6,SP 10 dalla località Decima ai confini provinciali di Bologna e Ferrara,3071,10,3025,45,2143,928,0,3071
2019/02,603,03/02/2019,7,SP 10 dalla località Decima ai confini provinciali di Bologna e Ferrara,2366,00,2362,4,1603,763,0,2366
2019/02,603,04/02/2019,1,SP 10 dalla località Decima ai confini provinciali di Bologna e Ferrara,3774,00,3644,130,2874,900,3774,0
2019/02,603,05/02/2019,2,SP 10 dalla località Decima ai confini provinciali di Bologna e Ferrara,3870,00,3723,147,2979,891,3870,0
2019/02,603,06/02/2019,3,SP 10 dalla località Decima ai confini provinciali di Bologna e Ferrara,4141,00,3974,167,3175,966,4141,0
2019/02,603,07/02/2019,4,SP 10 dalla località Decima ai confini provinciali di Bologna e Ferrara,4074,00,3913,161,3077,997,4074,0
2019/02,603,08/02/2019,5,SP 10 dalla località Decima ai confini provinciali di Bologna e Ferrara,4187,00,4038,149,3086,1101,4187,0
2019/02,603,09/02/2019,6,SP 10 dalla località Decima ai confini provinciali di Bologna e Ferrara,3248,10,3184,63,2256,992,0,3248
2019/02,603,10/02/2019,7,SP 10 dalla località Decima ai confini provinciali di Bologna e Ferrara,2671,00,2661,10,1885,786,0,2671
2019/02,603,11/02/2019,1,SP 10 dalla località Decima ai confini provinciali di Bologna e Ferrara,3738,00,3593,145,2882,856,3738,0
2019/02,603,12/02/2019,2,SP 10 dalla località Decima ai confini provinciali di Bologna e Ferrara,3972,10,3803,168,3071,901,3972,0
2019/02,603,13/02/2019,3,SP 10 dalla località Decima ai confini provinciali di Bologna e Ferrara,3953,00,3762,191,3015,938,3953,0
2019/02,603,14/02/2019,4,SP 10 dalla località Decima ai confini provinciali di Bologna e Ferrara,4321,00,4152,169,3199,1122,4321,0
2019/02,604,01/02/2019,5,SP 37 da Sasso Marconi alla intersezione SP 58,4535,00,4376,159,3763,772,4535,0
2019/02,604,02/02/2019,6,SP 37 da Sasso Marconi alla intersezione SP 58,3158,00,3136,22,2479,679,0,3158
2019/02,604,03/02/2019,7,SP 37 da Sasso Marconi alla intersezione SP 58,2609,00,2602,7,2068,541,0,2609
2019/02,604,04/02/2019,1,SP 37 da Sasso Marconi alla intersezione SP 58,4498,00,4298,200,3809,689,4498,0
2019/02,604,05/02/2019,2,SP 37 da Sasso Marconi alla intersezione SP 58,4981,20,4760,219,4212,769,4981,0
2019/02,604,06/02/2019,3,SP 37 da Sasso Marconi alla intersezione SP 58,5000,00,4768,232,4219,781,5000,0
2019/02,604,07/02/2019,4,SP 37 da Sasso Marconi alla intersezione SP 58,5033,00,4809,224,4228,805,5033,0
2019/02,604,08/02/2019,5,SP 37 da Sasso Marconi alla intersezione SP 58,5336,00,5088,248,4451,885,5336,0
2019/02,604,09/02/2019,6,SP 37 da Sasso Marconi alla intersezione SP 58,3786,00,3749,37,3060,726,0,3786
2019/02,604,10/02/2019,7,SP 37 da Sasso Marconi alla intersezione SP 58,3233,00,3220,13,2562,671,0,3233
2019/02,604,11/02/2019,1,SP 37 da Sasso Marconi alla intersezione SP 58,4877,00,4696,181,4126,751,4877,0
2019/02,604,12/02/2019,2,SP 37 da Sasso Marconi alla intersezione SP 58,5081,00,4853,228,4249,832,5081,0
2019/02,604,13/02/2019,3,SP 37 da Sasso Marconi alla intersezione SP 58,5244,00,5046,198,4394,850,5244,0
2019/02,604,14/02/2019,4,SP 37 da Sasso Marconi alla intersezione SP 58,5241,00,5004,237,4338,903,5241,0
2019/02,605,01/02/2019,5,SP 324 da Silla alla intersezione SP 623,7178,00,6874,304,5724,1454,7178,0
2019/02,605,02/02/2019,6,SP 324 da Silla alla intersezione SP 623,6001,00,5925,76,4457,1544,0,6001
2019/02,605,03/02/2019,7,SP 324 da Silla alla intersezione SP 623,4889,00,4857,32,3733,1156,0,4889
2019/02,605,04/02/2019,1,SP 324 da Silla alla intersezione SP 623,6978,00,6707,271,5751,1227,6978,0
2019/02,605,05/02/2019,2,SP 324 da Silla alla intersezione SP 623,7356,00,7073,283,6108,1248,7356,0
2019/02,605,06/02/2019,3,SP 324 da Silla alla intersezione SP 623,7468,00,7172,296,6121,1347,7468,0
2019/02,605,07/02/2019,4,SP 324 da Silla alla intersezione SP 623,7508,00,7192,316,6149,1359,7508,0
2019/02,605,08/02/2019,5,SP 324 da Silla alla intersezione SP 623,8078,00,7763,315,6354,1724,8078,0
2019/02,605,09/02/2019,6,SP 324 da Silla alla intersezione SP 623,7050,00,6949,101,5546,1504,0,7050
2019/02,605,10/02/2019,7,SP 324 da Silla alla intersezione SP 623,5216,00,5176,40,4127,1089,0,5216
2019/02,605,11/02/2019,1,SP 324 da Silla alla intersezione SP 623,7237,00,6937,300,6036,1201,7237,0
2019/02,605,12/02/2019,2,SP 324 da Silla alla intersezione SP 623,7476,00,7125,351,6119,1357,7476,0
2019/02,605,13/02/2019,3,SP 324 da Silla alla intersezione SP 623,7580,10,7251,328,6264,1316,7580,0
2019/02,605,14/02/2019,4,SP 324 da Silla alla intersezione SP 623,7859,00,7576,283,6384,1475,7859,0
2019/02,606,01/02/2019,5,SP 70 Cispadana in località Sant'Agostino/San Carlo,5734,00,5293,441,4650,1084,5734,0
2019/02,606,04/02/2019,1,SP 70 Cispadana in località Sant'Agostino/San Carlo,5896,00,5455,441,4880,1016,5896,0
2019/02,606,05/02/2019,2,SP 70 Cispadana in località Sant'Agostino/San Carlo,4599,10,4232,366,3539,1060,4599,0
2019/02,606,07/02/2019,4,SP 70 Cispadana in località Sant'Agostino/San Carlo,5832,10,5374,457,4713,1119,5832,0
2019/02,606,08/02/2019,5,SP 70 Cispadana in località Sant'Agostino/San Carlo,5774,10,5324,449,4542,1232,5774,0
2019/02,606,09/02/2019,6,SP 70 Cispadana in località Sant'Agostino/San Carlo,4515,20,4430,83,3433,1082,0,4515
2019/02,606,10/02/2019,7,SP 70 Cispadana in località Sant'Agostino/San Carlo,4067,00,4052,15,3106,961,0,4067
2019/02,606,11/02/2019,1,SP 70 Cispadana in località Sant'Agostino/San Carlo,5566,10,5118,447,4512,1054,5566,0
2019/02,606,12/02/2019,2,SP 70 Cispadana in località Sant'Agostino/San Carlo,5656,40,5166,486,4487,1169,5656,0
2019/02,606,13/02/2019,3,SP 70 Cispadana in località Sant'Agostino/San Carlo,6136,30,5596,537,4932,1204,6136,0
2019/02,606,14/02/2019,4,SP 70 Cispadana in località Sant'Agostino/San Carlo,6292,20,5773,517,5028,1264,6292,0
2019/02,607,01/02/2019,5,SP 1 da Villafranca di Forlì al confine provinciale,4018,00,3786,232,3207,811,4018,0
2019/02,607,02/02/2019,6,SP 1 da Villafranca di Forlì al confine provinciale,3063,00,3009,54,2202,861,0,3063
2019/02,607,03/02/2019,7,SP 1 da Villafranca di Forlì al confine provinciale,2816,00,2809,7,2102,714,0,2816
2019/02,607,04/02/2019,1,SP 1 da Villafranca di Forlì al confine provinciale,3657,00,3450,207,2894,763,3657,0
2019/02,607,05/02/2019,2,SP 1 da Villafranca di Forlì al confine provinciale,4167,00,3912,255,3362,805,4167,0
2019/02,607,06/02/2019,3,SP 1 da Villafranca di Forlì al confine provinciale,4278,20,3960,316,3407,871,4278,0
2019/02,607,07/02/2019,4,SP 1 da Villafranca di Forlì al confine provinciale,4223,00,3877,346,3403,820,4223,0
2019/02,607,08/02/2019,5,SP 1 da Villafranca di Forlì al confine provinciale,4240,00,3946,294,3353,887,4240,0
2019/02,607,09/02/2019,6,SP 1 da Villafranca di Forlì al confine provinciale,3219,00,3149,70,2325,894,0,3219
2019/02,607,10/02/2019,7,SP 1 da Villafranca di Forlì al confine provinciale,3196,10,3186,9,2447,749,0,3196
2019/02,607,11/02/2019,1,SP 1 da Villafranca di Forlì al confine provinciale,4006,10,3757,248,3264,742,4006,0
2019/02,607,12/02/2019,2,SP 1 da Villafranca di Forlì al confine provinciale,4282,00,3992,290,3428,854,4282,0
2019/02,607,13/02/2019,3,SP 1 da Villafranca di Forlì al confine provinciale,4346,00,4016,330,3441,905,4346,0
2019/02,607,14/02/2019,4,SP 1 da Villafranca di Forlì al confine provinciale,4448,10,4153,294,3534,914,4448,0
2019/02,608,01/02/2019,5,SP 140 da Diegaro (SS 9) a Pievesestina (E 45),13551,10,12197,1353,10507,3044,13551,0
2019/02,608,02/02/2019,6,SP 140 da Diegaro (SS 9) a Pievesestina (E 45),9824,10,9389,434,6990,2834,0,9824
2019/02,608,03/02/2019,7,SP 140 da Diegaro (SS 9) a Pievesestina (E 45),7418,00,7298,120,5250,2168,0,7418
2019/02,608,04/02/2019,1,SP 140 da Diegaro (SS 9) a Pievesestina (E 45),12790,10,11521,1268,10227,2563,12790,0
2019/02,608,05/02/2019,2,SP 140 da Diegaro (SS 9) a Pievesestina (E 45),13240,00,11834,1406,10516,2724,13240,0
2019/02,608,06/02/2019,3,SP 140 da Diegaro (SS 9) a Pievesestina (E 45),13507,00,12184,1323,10518,2989,13507,0
2019/02,608,07/02/2019,4,SP 140 da Diegaro (SS 9) a Pievesestina (E 45),13765,10,12350,1414,10759,3006,13765,0
2019/02,608,08/02/2019,5,SP 140 da Diegaro (SS 9) a Pievesestina (E 45),13975,10,12609,1365,10850,3125,13975,0
2019/02,608,09/02/2019,6,SP 140 da Diegaro (SS 9) a Pievesestina (E 45),10509,00,9981,528,7573,2936,0,10509
2019/02,608,10/02/2019,7,SP 140 da Diegaro (SS 9) a Pievesestina (E 45),7991,10,7837,153,5733,2258,0,7991
2019/02,608,11/02/2019,1,SP 140 da Diegaro (SS 9) a Pievesestina (E 45),13427,20,11973,1452,10726,2701,13427,0
2019/02,608,12/02/2019,2,SP 140 da Diegaro (SS 9) a Pievesestina (E 45),13496,00,12167,1329,10649,2847,13496,0
2019/02,608,13/02/2019,3,SP 140 da Diegaro (SS 9) a Pievesestina (E 45),14280,30,12828,1449,10869,3411,14280,0
2019/02,608,14/02/2019,4,SP 140 da Diegaro (SS 9) a Pievesestina (E 45),14049,20,12654,1393,10865,3184,14049,0
2019/02,609,01/02/2019,5,SP 4 dal bivio SP22 (per SS 12) al bivio SP 26 (per Pavullo nel Frignano),3241,00,2930,311,2505,736,3241,0
2019/02,609,02/02/2019,6,SP 4 dal bivio SP22 (per SS 12) al bivio SP 26 (per Pavullo nel Frignano),3625,00,3546,79,2933,692,0,3625
2019/02,609,03/02/2019,7,SP 4 dal bivio SP22 (per SS 12) al bivio SP 26 (per Pavullo nel Frignano),4925,00,4852,73,4187,738,0,4925
2019/02,609,04/02/2019,1,SP 4 dal bivio SP22 (per SS 12) al bivio SP 26 (per Pavullo nel Frignano),3479,00,3241,238,2824,655,3479,0
2019/02,609,05/02/2019,2,SP 4 dal bivio SP22 (per SS 12) al bivio SP 26 (per Pavullo nel Frignano),3775,10,3531,243,3163,612,3775,0
2019/02,609,06/02/2019,3,SP 4 dal bivio SP22 (per SS 12) al bivio SP 26 (per Pavullo nel Frignano),4029,00,3746,283,3278,751,4029,0
2019/02,609,07/02/2019,4,SP 4 dal bivio SP22 (per SS 12) al bivio SP 26 (per Pavullo nel Frignano),4286,10,3951,334,3487,799,4286,0
2019/02,609,08/02/2019,5,SP 4 dal bivio SP22 (per SS 12) al bivio SP 26 (per Pavullo nel Frignano),4600,20,4263,335,3578,1022,4600,0
2019/02,609,09/02/2019,6,SP 4 dal bivio SP22 (per SS 12) al bivio SP 26 (per Pavullo nel Frignano),5572,10,5449,122,4624,948,0,5572
2019/02,609,10/02/2019,7,SP 4 dal bivio SP22 (per SS 12) al bivio SP 26 (per Pavullo nel Frignano),5393,00,5341,52,4560,833,0,5393
2019/02,609,11/02/2019,1,SP 4 dal bivio SP22 (per SS 12) al bivio SP 26 (per Pavullo nel Frignano),3538,10,3289,248,2842,696,3538,0
2019/02,609,12/02/2019,2,SP 4 dal bivio SP22 (per SS 12) al bivio SP 26 (per Pavullo nel Frignano),3660,00,3351,309,2983,677,3660,0
2019/02,609,13/02/2019,3,SP 4 dal bivio SP22 (per SS 12) al bivio SP 26 (per Pavullo nel Frignano),4071,20,3730,339,3308,763,4071,0
2019/02,609,14/02/2019,4,SP 4 dal bivio SP22 (per SS 12) al bivio SP 26 (per Pavullo nel Frignano),4317,00,4007,310,3469,848,4317,0
2019/02,610,01/02/2019,5,SP 11 da Soragna a Roncole Verdi,3279,10,3056,222,2547,732,3279,0
2019/02,610,02/02/2019,6,SP 11 da Soragna a Roncole Verdi,2646,00,2553,93,1932,714,0,2646
2019/02,610,03/02/2019,7,SP 11 da Soragna a Roncole Verdi,2277,00,2244,33,1701,576,0,2277
2019/02,610,04/02/2019,1,SP 11 da Soragna a Roncole Verdi,3415,00,3143,272,2741,674,3415,0
2019/02,610,05/02/2019,2,SP 11 da Soragna a Roncole Verdi,3658,00,3366,292,2954,704,3658,0
2019/02,610,06/02/2019,3,SP 11 da Soragna a Roncole Verdi,4055,00,3784,271,3285,770,4055,0
2019/02,610,07/02/2019,4,SP 11 da Soragna a Roncole Verdi,3539,10,3246,292,2824,715,3539,0
2019/02,610,08/02/2019,5,SP 11 da Soragna a Roncole Verdi,3701,10,3375,325,2905,796,3701,0
2019/02,610,09/02/2019,6,SP 11 da Soragna a Roncole Verdi,2987,00,2892,95,2253,734,0,2987
2019/02,610,10/02/2019,7,SP 11 da Soragna a Roncole Verdi,2408,00,2387,21,1805,603,0,2408
2019/02,610,11/02/2019,1,SP 11 da Soragna a Roncole Verdi,3518,00,3209,309,2850,668,3518,0
2019/02,610,12/02/2019,2,SP 11 da Soragna a Roncole Verdi,3683,00,3377,306,2966,717,3683,0
2019/02,610,13/02/2019,3,SP 11 da Soragna a Roncole Verdi,3627,00,3333,294,2882,745,3627,0
2019/02,610,14/02/2019,4,SP 11 da Soragna a Roncole Verdi,3714,00,3412,302,2926,788,3714,0
2019/02,611,01/02/2019,5,SP 357R da Fornovo di Taro al bivio SP 93 per Fidenza,,,,,,,,
2019/02,611,02/02/2019,6,SP 357R da Fornovo di Taro al bivio SP 93 per Fidenza,,,,,,,,
2019/02,611,03/02/2019,7,SP 357R da Fornovo di Taro al bivio SP 93 per Fidenza,,,,,,,,
2019/02,611,04/02/2019,1,SP 357R da Fornovo di Taro al bivio SP 93 per Fidenza,,,,,,,,
2019/02,611,05/02/2019,2,SP 357R da Fornovo di Taro al bivio SP 93 per Fidenza,,,,,,,,
2019/02,611,06/02/2019,3,SP 357R da Fornovo di Taro al bivio SP 93 per Fidenza,,,,,,,,
2019/02,611,07/02/2019,4,SP 357R da Fornovo di Taro al bivio SP 93 per Fidenza,,,,,,,,
2019/02,611,08/02/2019,5,SP 357R da Fornovo di Taro al bivio SP 93 per Fidenza,,,,,,,,
2019/02,611,09/02/2019,6,SP 357R da Fornovo di Taro al bivio SP 93 per Fidenza,,,,,,,,
2019/02,611,10/02/2019,7,SP 357R da Fornovo di Taro al bivio SP 93 per Fidenza,,,,,,,,
2019/02,611,11/02/2019,1,SP 357R da Fornovo di Taro al bivio SP 93 per Fidenza,,,,,,,,
2019/02,611,12/02/2019,2,SP 357R da Fornovo di Taro al bivio SP 93 per Fidenza,,,,,,,,
2019/02,611,13/02/2019,3,SP 357R da Fornovo di Taro al bivio SP 93 per Fidenza,,,,,,,,
2019/02,611,14/02/2019,4,SP 357R da Fornovo di Taro al bivio SP 93 per Fidenza,,,,,,,,
2019/02,612,01/02/2019,5,SP 665R dalla località Pilastro a Langhirano,15828,00,14839,989,12697,3131,15828,0
2019/02,612,02/02/2019,6,SP 665R dalla località Pilastro a Langhirano,12700,10,12484,215,9641,3059,0,12700
2019/02,612,03/02/2019,7,SP 665R dalla località Pilastro a Langhirano,10552,00,10497,55,8062,2490,0,10552
2019/02,612,04/02/2019,1,SP 665R dalla località Pilastro a Langhirano,16895,00,15918,977,13894,3001,16895,0
2019/02,612,05/02/2019,2,SP 665R dalla località Pilastro a Langhirano,17089,00,16081,1008,14005,3084,17089,0
2019/02,612,06/02/2019,3,SP 665R dalla località Pilastro a Langhirano,17673,00,16582,1091,14377,3296,17673,0
2019/02,612,07/02/2019,4,SP 665R dalla località Pilastro a Langhirano,17587,00,16538,1049,14219,3368,17587,0
2019/02,612,08/02/2019,5,SP 665R dalla località Pilastro a Langhirano,18089,00,16979,1110,14225,3864,18089,0
2019/02,612,09/02/2019,6,SP 665R dalla località Pilastro a Langhirano,15129,10,14912,216,11203,3926,0,15129
2019/02,612,10/02/2019,7,SP 665R dalla località Pilastro a Langhirano,10708,00,10653,55,7985,2723,0,10708
2019/02,612,11/02/2019,1,SP 665R dalla località Pilastro a Langhirano,17125,10,16044,1080,14200,2925,17125,0
2019/02,612,12/02/2019,2,SP 665R dalla località Pilastro a Langhirano,16913,10,15864,1048,13774,3139,16913,0
2019/02,612,13/02/2019,3,SP 665R dalla località Pilastro a Langhirano,17387,10,16252,1134,14154,3233,17387,0
2019/02,612,14/02/2019,4,SP 665R dalla località Pilastro a Langhirano,17912,10,16876,1035,14192,3720,17912,0
2019/02,613,01/02/2019,5,SP 16 dalla località Basilicanova al bivio SP 32 centro abitato Mamiano,6364,10,6138,225,4854,1510,6364,0
2019/02,613,02/02/2019,6,SP 16 dalla località Basilicanova al bivio SP 32 centro abitato Mamiano,5275,10,5153,121,3874,1401,0,5275
2019/02,613,03/02/2019,7,SP 16 dalla località Basilicanova al bivio SP 32 centro abitato Mamiano,4024,00,3979,45,2921,1103,0,4024
2019/02,613,04/02/2019,1,SP 16 dalla località Basilicanova al bivio SP 32 centro abitato Mamiano,6346,10,6079,266,5046,1300,6346,0
2019/02,613,05/02/2019,2,SP 16 dalla località Basilicanova al bivio SP 32 centro abitato Mamiano,6587,00,6319,268,5199,1388,6587,0
2019/02,613,06/02/2019,3,SP 16 dalla località Basilicanova al bivio SP 32 centro abitato Mamiano,6666,00,6396,270,5300,1366,6666,0
2019/02,613,07/02/2019,4,SP 16 dalla località Basilicanova al bivio SP 32 centro abitato Mamiano,6600,00,6318,282,5175,1425,6600,0
2019/02,613,08/02/2019,5,SP 16 dalla località Basilicanova al bivio SP 32 centro abitato Mamiano,6852,10,6578,273,5214,1638,6852,0
2019/02,613,09/02/2019,6,SP 16 dalla località Basilicanova al bivio SP 32 centro abitato Mamiano,5859,00,5729,130,4193,1666,0,5859
2019/02,613,10/02/2019,7,SP 16 dalla località Basilicanova al bivio SP 32 centro abitato Mamiano,4360,00,4317,43,3172,1188,0,4360
2019/02,613,11/02/2019,1,SP 16 dalla località Basilicanova al bivio SP 32 centro abitato Mamiano,6405,00,6143,262,5162,1243,6405,0
2019/02,613,12/02/2019,2,SP 16 dalla località Basilicanova al bivio SP 32 centro abitato Mamiano,6483,00,6215,268,5190,1293,6483,0
2019/02,613,13/02/2019,3,SP 16 dalla località Basilicanova al bivio SP 32 centro abitato Mamiano,6652,00,6353,299,5252,1400,6652,0
2019/02,613,14/02/2019,4,SP 16 dalla località Basilicanova al bivio SP 32 centro abitato Mamiano,7051,00,6774,277,5454,1597,7051,0
2019/02,614,01/02/2019,5,SP 587R dal bivio SP 10R alla A 21Dir,5602,00,5225,377,4353,1249,5602,0
2019/02,614,12/02/2019,2,SP 587R dal bivio SP 10R alla A 21Dir,6986,00,6368,618,5662,1324,6986,0
2019/02,614,13/02/2019,3,SP 587R dal bivio SP 10R alla A 21Dir,7020,00,6487,533,5642,1378,7020,0
2019/02,614,14/02/2019,4,SP 587R dal bivio SP 10R alla A 21Dir,7139,00,6588,551,5614,1525,7139,0
2019/02,615,01/02/2019,5,Piazzale Milano (ex SS 9) c/o ponte fiume Po,22405,190,21968,418,16475,5930,22405,0
2019/02,615,02/02/2019,6,Piazzale Milano (ex SS 9) c/o ponte fiume Po,25322,70,25039,276,18730,6592,0,25322
2019/02,615,03/02/2019,7,Piazzale Milano (ex SS 9) c/o ponte fiume Po,21555,20,21479,74,15428,6127,0,21555
2019/02,615,04/02/2019,1,Piazzale Milano (ex SS 9) c/o ponte fiume Po,25735,150,25205,515,19817,5918,25735,0
2019/02,615,05/02/2019,2,Piazzale Milano (ex SS 9) c/o ponte fiume Po,25748,90,25209,530,19769,5979,25748,0
2019/02,615,06/02/2019,3,Piazzale Milano (ex SS 9) c/o ponte fiume Po,26018,150,25470,533,19791,6227,26018,0
2019/02,615,07/02/2019,4,Piazzale Milano (ex SS 9) c/o ponte fiume Po,25791,170,25219,555,19651,6140,25791,0
2019/02,615,08/02/2019,5,Piazzale Milano (ex SS 9) c/o ponte fiume Po,27763,240,27168,571,20534,7229,27763,0
2019/02,615,09/02/2019,6,Piazzale Milano (ex SS 9) c/o ponte fiume Po,27448,60,27123,319,20160,7288,0,27448
2019/02,615,10/02/2019,7,Piazzale Milano (ex SS 9) c/o ponte fiume Po,22165,40,22061,100,15857,6308,0,22165
2019/02,615,11/02/2019,1,Piazzale Milano (ex SS 9) c/o ponte fiume Po,25830,210,25247,562,19731,6099,25830,0
2019/02,615,12/02/2019,2,Piazzale Milano (ex SS 9) c/o ponte fiume Po,26162,220,25534,606,20010,6152,26162,0
2019/02,615,13/02/2019,3,Piazzale Milano (ex SS 9) c/o ponte fiume Po,26369,150,25786,568,20135,6234,26369,0
2019/02,615,14/02/2019,4,Piazzale Milano (ex SS 9) c/o ponte fiume Po,27005,190,26406,580,20082,6923,27005,0
2019/02,616,01/02/2019,5,SP 588R dal casello A 21 di Castelvetro Piacentino a Villanova d'Arda,3653,00,3412,241,2888,765,3653,0
2019/02,616,02/02/2019,6,SP 588R dal casello A 21 di Castelvetro Piacentino a Villanova d'Arda,3719,00,3645,74,2733,986,0,3719
2019/02,616,03/02/2019,7,SP 588R dal casello A 21 di Castelvetro Piacentino a Villanova d'Arda,3201,00,3168,33,2393,808,0,3201
2019/02,616,04/02/2019,1,SP 588R dal casello A 21 di Castelvetro Piacentino a Villanova d'Arda,3845,00,3549,296,3118,727,3845,0
2019/02,616,05/02/2019,2,SP 588R dal casello A 21 di Castelvetro Piacentino a Villanova d'Arda,3868,00,3552,316,3148,720,3868,0
2019/02,616,06/02/2019,3,SP 588R dal casello A 21 di Castelvetro Piacentino a Villanova d'Arda,4163,00,3823,340,3365,798,4163,0
2019/02,616,07/02/2019,4,SP 588R dal casello A 21 di Castelvetro Piacentino a Villanova d'Arda,3932,00,3575,357,3232,700,3932,0
2019/02,616,08/02/2019,5,SP 588R dal casello A 21 di Castelvetro Piacentino a Villanova d'Arda,4169,00,3874,295,3242,927,4169,0
2019/02,616,09/02/2019,6,SP 588R dal casello A 21 di Castelvetro Piacentino a Villanova d'Arda,3945,00,3876,69,2929,1016,0,3945
2019/02,616,10/02/2019,7,SP 588R dal casello A 21 di Castelvetro Piacentino a Villanova d'Arda,3127,00,3104,23,2389,738,0,3127
2019/02,616,11/02/2019,1,SP 588R dal casello A 21 di Castelvetro Piacentino a Villanova d'Arda,3888,00,3596,292,3241,647,3888,0
2019/02,616,12/02/2019,2,SP 588R dal casello A 21 di Castelvetro Piacentino a Villanova d'Arda,3840,00,3539,301,3176,664,3840,0
2019/02,616,13/02/2019,3,SP 588R dal casello A 21 di Castelvetro Piacentino a Villanova d'Arda,4097,00,3803,294,3308,789,4097,0
2019/02,616,14/02/2019,4,SP 588R dal casello A 21 di Castelvetro Piacentino a Villanova d'Arda,4164,00,3836,328,3301,863,4164,0
2019/02,617,01/02/2019,5,SP 7 dalla intersezione tangenziale sud/ovest di Piacenza a San Nicolò,6198,20,5983,213,4830,1368,6198,0
2019/02,617,02/02/2019,6,SP 7 dalla intersezione tangenziale sud/ovest di Piacenza a San Nicolò,6540,00,6459,81,5013,1527,0,6540
2019/02,617,03/02/2019,7,SP 7 dalla intersezione tangenziale sud/ovest di Piacenza a San Nicolò,4801,00,4785,16,3617,1184,0,4801
2019/02,617,04/02/2019,1,SP 7 dalla intersezione tangenziale sud/ovest di Piacenza a San Nicolò,7611,10,7171,439,6258,1353,7611,0
2019/02,617,05/02/2019,2,SP 7 dalla intersezione tangenziale sud/ovest di Piacenza a San Nicolò,7617,00,7172,445,6268,1349,7617,0
2019/02,617,06/02/2019,3,SP 7 dalla intersezione tangenziale sud/ovest di Piacenza a San Nicolò,7671,00,7208,463,6217,1454,7671,0
2019/02,617,07/02/2019,4,SP 7 dalla intersezione tangenziale sud/ovest di Piacenza a San Nicolò,7627,00,7268,359,6238,1389,7627,0
2019/02,617,08/02/2019,5,SP 7 dalla intersezione tangenziale sud/ovest di Piacenza a San Nicolò,7974,00,7541,433,6427,1547,7974,0
2019/02,617,09/02/2019,6,SP 7 dalla intersezione tangenziale sud/ovest di Piacenza a San Nicolò,6947,00,6853,94,5314,1633,0,6947
2019/02,617,10/02/2019,7,SP 7 dalla intersezione tangenziale sud/ovest di Piacenza a San Nicolò,4805,00,4791,14,3662,1143,0,4805
2019/02,617,11/02/2019,1,SP 7 dalla intersezione tangenziale sud/ovest di Piacenza a San Nicolò,7690,00,7249,441,6389,1301,7690,0
2019/02,617,12/02/2019,2,SP 7 dalla intersezione tangenziale sud/ovest di Piacenza a San Nicolò,7507,00,7152,355,6139,1368,7507,0
2019/02,617,13/02/2019,3,SP 7 dalla intersezione tangenziale sud/ovest di Piacenza a San Nicolò,7803,00,7334,469,6340,1463,7803,0
2019/02,617,14/02/2019,4,SP 7 dalla intersezione tangenziale sud/ovest di Piacenza a San Nicolò,7812,00,7369,443,6189,1623,7812,0
2019/02,618,01/02/2019,5,SP 253R fra Bagnacavallo (A14 Dir) e Godo (bivio SP 302R),7554,00,7105,449,5945,1609,7554,0
2019/02,618,02/02/2019,6,SP 253R fra Bagnacavallo (A14 Dir) e Godo (bivio SP 302R),5936,00,5832,104,4423,1513,0,5936
2019/02,618,03/02/2019,7,SP 253R fra Bagnacavallo (A14 Dir) e Godo (bivio SP 302R),4271,00,4254,17,3172,1099,0,4271
2019/02,618,04/02/2019,1,SP 253R fra Bagnacavallo (A14 Dir) e Godo (bivio SP 302R),7345,00,6857,488,6012,1333,7345,0
2019/02,618,05/02/2019,2,SP 253R fra Bagnacavallo (A14 Dir) e Godo (bivio SP 302R),7556,00,7048,508,6090,1466,7556,0
2019/02,618,06/02/2019,3,SP 253R fra Bagnacavallo (A14 Dir) e Godo (bivio SP 302R),7618,00,7062,556,6060,1558,7618,0
2019/02,618,07/02/2019,4,SP 253R fra Bagnacavallo (A14 Dir) e Godo (bivio SP 302R),7522,20,7040,480,6004,1518,7522,0
2019/02,618,08/02/2019,5,SP 253R fra Bagnacavallo (A14 Dir) e Godo (bivio SP 302R),7639,00,7124,515,6088,1551,7639,0
2019/02,618,09/02/2019,6,SP 253R fra Bagnacavallo (A14 Dir) e Godo (bivio SP 302R),6099,10,5957,141,4622,1477,0,6099
2019/02,618,10/02/2019,7,SP 253R fra Bagnacavallo (A14 Dir) e Godo (bivio SP 302R),4543,00,4516,27,3395,1148,0,4543
2019/02,618,11/02/2019,1,SP 253R fra Bagnacavallo (A14 Dir) e Godo (bivio SP 302R),7377,00,6856,521,5985,1392,7377,0
2019/02,618,12/02/2019,2,SP 253R fra Bagnacavallo (A14 Dir) e Godo (bivio SP 302R),7555,00,7014,541,6095,1460,7555,0
2019/02,618,13/02/2019,3,SP 253R fra Bagnacavallo (A14 Dir) e Godo (bivio SP 302R),7641,00,7111,530,6169,1472,7641,0
2019/02,618,14/02/2019,4,SP 253R fra Bagnacavallo (A14 Dir) e Godo (bivio SP 302R),7846,10,7315,530,6210,1636,7846,0
2019/02,619,01/02/2019,5,SP 8 da Bagnacavallo al bivio SS 16,3031,00,2896,135,2363,668,3031,0
2019/02,619,02/02/2019,6,SP 8 da Bagnacavallo al bivio SS 16,2332,00,2302,30,1698,634,0,2332
2019/02,619,03/02/2019,7,SP 8 da Bagnacavallo al bivio SS 16,2092,00,2078,14,1570,522,0,2092
2019/02,619,04/02/2019,1,SP 8 da Bagnacavallo al bivio SS 16,3070,10,2897,172,2451,619,3070,0
2019/02,619,05/02/2019,2,SP 8 da Bagnacavallo al bivio SS 16,3152,00,2947,205,2459,693,3152,0
2019/02,619,06/02/2019,3,SP 8 da Bagnacavallo al bivio SS 16,3143,10,2927,215,2474,669,3143,0
2019/02,619,07/02/2019,4,SP 8 da Bagnacavallo al bivio SS 16,3185,00,2980,205,2536,649,3185,0
2019/02,619,08/02/2019,5,SP 8 da Bagnacavallo al bivio SS 16,3189,00,2984,205,2455,734,3189,0
2019/02,619,09/02/2019,6,SP 8 da Bagnacavallo al bivio SS 16,2559,00,2495,64,1902,657,0,2559
2019/02,619,10/02/2019,7,SP 8 da Bagnacavallo al bivio SS 16,2267,00,2249,18,1690,577,0,2267
2019/02,619,11/02/2019,1,SP 8 da Bagnacavallo al bivio SS 16,3174,10,2955,218,2557,617,3174,0
2019/02,619,12/02/2019,2,SP 8 da Bagnacavallo al bivio SS 16,3192,20,2970,220,2559,633,3192,0
2019/02,619,13/02/2019,3,SP 8 da Bagnacavallo al bivio SS 16,3183,00,2990,193,2501,682,3183,0
2019/02,619,14/02/2019,4,SP 8 da Bagnacavallo al bivio SS 16,3257,00,3058,199,2531,726,3257,0
2019/02,620,01/02/2019,5,SP 113 sulla variante di San Martino in Rio/Correggio c/o le località Prato/Gazzata,7993,10,6943,1049,6363,1630,7993,0
2019/02,620,02/02/2019,6,SP 113 sulla variante di San Martino in Rio/Correggio c/o le località Prato/Gazzata,5384,00,5215,169,3856,1528,0,5384
2019/02,620,03/02/2019,7,SP 113 sulla variante di San Martino in Rio/Correggio c/o le località Prato/Gazzata,4292,00,4242,50,3024,1268,0,4292
2019/02,620,04/02/2019,1,SP 113 sulla variante di San Martino in Rio/Correggio c/o le località Prato/Gazzata,8101,00,7046,1055,6581,1520,8101,0
2019/02,620,05/02/2019,2,SP 113 sulla variante di San Martino in Rio/Correggio c/o le località Prato/Gazzata,8143,00,6991,1152,6575,1568,8143,0
2019/02,620,06/02/2019,3,SP 113 sulla variante di San Martino in Rio/Correggio c/o le località Prato/Gazzata,8304,00,7220,1084,6664,1640,8304,0
2019/02,620,07/02/2019,4,SP 113 sulla variante di San Martino in Rio/Correggio c/o le località Prato/Gazzata,8388,00,7310,1078,6669,1719,8388,0
2019/02,620,08/02/2019,5,SP 113 sulla variante di San Martino in Rio/Correggio c/o le località Prato/Gazzata,8566,00,7404,1162,6683,1883,8566,0
2019/02,620,09/02/2019,6,SP 113 sulla variante di San Martino in Rio/Correggio c/o le località Prato/Gazzata,5791,00,5608,183,4091,1700,0,5791
2019/02,620,10/02/2019,7,SP 113 sulla variante di San Martino in Rio/Correggio c/o le località Prato/Gazzata,4848,00,4785,63,3208,1640,0,4848
2019/02,620,11/02/2019,1,SP 113 sulla variante di San Martino in Rio/Correggio c/o le località Prato/Gazzata,8231,00,7119,1112,6655,1576,8231,0
2019/02,620,12/02/2019,2,SP 113 sulla variante di San Martino in Rio/Correggio c/o le località Prato/Gazzata,8344,00,7255,1089,6773,1571,8344,0
2019/02,620,13/02/2019,3,SP 113 sulla variante di San Martino in Rio/Correggio c/o le località Prato/Gazzata,8276,00,7239,1037,6601,1675,8276,0
2019/02,620,14/02/2019,4,SP 113 sulla variante di San Martino in Rio/Correggio c/o le località Prato/Gazzata,8556,10,7434,1121,6743,1813,8556,0
2019/02,621,01/02/2019,5,SP 513R a nord di Vetto,1658,00,1547,111,1261,397,1658,0
2019/02,621,02/02/2019,6,SP 513R a nord di Vetto,1595,00,1549,46,1257,338,0,1595
2019/02,621,03/02/2019,7,SP 513R a nord di Vetto,1680,00,1670,10,1379,301,0,1680
2019/02,621,04/02/2019,1,SP 513R a nord di Vetto,1947,00,1818,129,1525,422,1947,0
2019/02,621,05/02/2019,2,SP 513R a nord di Vetto,1984,00,1862,122,1580,404,1984,0
2019/02,621,06/02/2019,3,SP 513R a nord di Vetto,1985,10,1877,107,1567,418,1985,0
2019/02,621,07/02/2019,4,SP 513R a nord di Vetto,1981,00,1861,120,1558,423,1981,0
2019/02,621,08/02/2019,5,SP 513R a nord di Vetto,2105,00,1968,137,1612,493,2105,0
2019/02,621,09/02/2019,6,SP 513R a nord di Vetto,2055,00,2010,45,1629,426,0,2055
2019/02,621,10/02/2019,7,SP 513R a nord di Vetto,1805,00,1790,15,1446,359,0,1805
2019/02,621,11/02/2019,1,SP 513R a nord di Vetto,2006,00,1890,116,1574,432,2006,0
2019/02,621,12/02/2019,2,SP 513R a nord di Vetto,1950,00,1837,113,1534,416,1950,0
2019/02,621,13/02/2019,3,SP 513R a nord di Vetto,1961,00,1840,121,1558,403,1961,0
2019/02,621,14/02/2019,4,SP 513R a nord di Vetto,2125,00,1962,163,1652,473,2125,0
2019/02,622,01/02/2019,5,SP 468R tra Correggio e il confine provinciale,,,,,,,,
2019/02,622,02/02/2019,6,SP 468R tra Correggio e il confine provinciale,,,,,,,,
2019/02,622,03/02/2019,7,SP 468R tra Correggio e il confine provinciale,,,,,,,,
2019/02,622,04/02/2019,1,SP 468R tra Correggio e il confine provinciale,,,,,,,,
2019/02,622,05/02/2019,2,SP 468R tra Correggio e il confine provinciale,,,,,,,,
2019/02,622,06/02/2019,3,SP 468R tra Correggio e il confine provinciale,,,,,,,,
2019/02,622,07/02/2019,4,SP 468R tra Correggio e il confine provinciale,,,,,,,,
2019/02,622,08/02/2019,5,SP 468R tra Correggio e il confine provinciale,,,,,,,,
2019/02,622,09/02/2019,6,SP 468R tra Correggio e il confine provinciale,,,,,,,,
2019/02,622,10/02/2019,7,SP 468R tra Correggio e il confine provinciale,,,,,,,,
2019/02,622,11/02/2019,1,SP 468R tra Correggio e il confine provinciale,,,,,,,,
2019/02,622,12/02/2019,2,SP 468R tra Correggio e il confine provinciale,,,,,,,,
2019/02,622,13/02/2019,3,SP 468R tra Correggio e il confine provinciale,,,,,,,,
2019/02,622,14/02/2019,4,SP 468R tra Correggio e il confine provinciale,,,,,,,,
2019/02,623,01/02/2019,5,SP 30 tra Campagnola Emilia e il confine provinciale,14956,00,13885,1071,11485,3471,14956,0
2019/02,623,02/02/2019,6,SP 30 tra Campagnola Emilia e il confine provinciale,12159,00,11914,245,8686,3473,0,12159
2019/02,623,03/02/2019,7,SP 30 tra Campagnola Emilia e il confine provinciale,9412,00,9355,57,6509,2903,0,9412
2019/02,623,04/02/2019,1,SP 30 tra Campagnola Emilia e il confine provinciale,14613,10,13479,1133,11676,2937,14613,0
2019/02,623,05/02/2019,2,SP 30 tra Campagnola Emilia e il confine provinciale,14998,00,13790,1208,12017,2981,14998,0
2019/02,623,06/02/2019,3,SP 30 tra Campagnola Emilia e il confine provinciale,15233,10,14067,1165,12025,3208,15233,0
2019/02,623,07/02/2019,4,SP 30 tra Campagnola Emilia e il confine provinciale,15034,00,13845,1189,11869,3165,15034,0
2019/02,623,08/02/2019,5,SP 30 tra Campagnola Emilia e il confine provinciale,15653,00,14486,1167,12100,3553,15653,0
2019/02,623,09/02/2019,6,SP 30 tra Campagnola Emilia e il confine provinciale,13159,00,12891,268,9360,3799,0,13159
2019/02,623,10/02/2019,7,SP 30 tra Campagnola Emilia e il confine provinciale,9575,00,9515,60,6646,2929,0,9575
2019/02,623,11/02/2019,1,SP 30 tra Campagnola Emilia e il confine provinciale,14632,00,13467,1165,11712,2920,14632,0
2019/02,623,12/02/2019,2,SP 30 tra Campagnola Emilia e il confine provinciale,14995,00,13820,1175,11990,3005,14995,0
2019/02,623,13/02/2019,3,SP 30 tra Campagnola Emilia e il confine provinciale,15656,00,14443,1213,12452,3204,15656,0
2019/02,623,14/02/2019,4,SP 30 tra Campagnola Emilia e il confine provinciale,16176,10,14972,1203,12509,3667,16176,0
2019/02,624,01/02/2019,5,SP 23 tra Rivalta e la variante di Montecavolo,10936,10,10635,300,8429,2507,10936,0
2019/02,624,02/02/2019,6,SP 23 tra Rivalta e la variante di Montecavolo,10242,00,10162,80,7586,2656,0,10242
2019/02,624,03/02/2019,7,SP 23 tra Rivalta e la variante di Montecavolo,7659,00,7635,24,5555,2104,0,7659
2019/02,624,04/02/2019,1,SP 23 tra Rivalta e la variante di Montecavolo,10665,00,10355,310,8431,2234,10665,0
2019/02,624,05/02/2019,2,SP 23 tra Rivalta e la variante di Montecavolo,11054,00,10699,355,8691,2363,11054,0
2019/02,624,06/02/2019,3,SP 23 tra Rivalta e la variante di Montecavolo,11293,00,10934,359,8723,2570,11293,0
2019/02,624,07/02/2019,4,SP 23 tra Rivalta e la variante di Montecavolo,11081,00,10712,369,8650,2431,11081,0
2019/02,624,08/02/2019,5,SP 23 tra Rivalta e la variante di Montecavolo,11753,00,11399,354,8937,2816,11753,0
2019/02,624,09/02/2019,6,SP 23 tra Rivalta e la variante di Montecavolo,10792,00,10686,106,7827,2965,0,10792
2019/02,624,10/02/2019,7,SP 23 tra Rivalta e la variante di Montecavolo,7820,00,7801,19,5604,2216,0,7820
2019/02,624,11/02/2019,1,SP 23 tra Rivalta e la variante di Montecavolo,10825,00,10468,357,8495,2330,10825,0
2019/02,624,12/02/2019,2,SP 23 tra Rivalta e la variante di Montecavolo,11119,00,10770,349,8751,2368,11119,0
2019/02,624,13/02/2019,3,SP 23 tra Rivalta e la variante di Montecavolo,11621,00,11234,387,8962,2659,11621,0
2019/02,624,14/02/2019,4,SP 23 tra Rivalta e la variante di Montecavolo,11510,00,11110,400,8679,2831,11510,0
2019/02,625,01/02/2019,5,SP 14 da Poggio Berni (bivio SP 73) a Sant'Arcangelo di Romagna,,,,,,,,
2019/02,625,02/02/2019,6,SP 14 da Poggio Berni (bivio SP 73) a Sant'Arcangelo di Romagna,,,,,,,,
2019/02,625,03/02/2019,7,SP 14 da Poggio Berni (bivio SP 73) a Sant'Arcangelo di Romagna,,,,,,,,
2019/02,625,04/02/2019,1,SP 14 da Poggio Berni (bivio SP 73) a Sant'Arcangelo di Romagna,,,,,,,,
2019/02,625,05/02/2019,2,SP 14 da Poggio Berni (bivio SP 73) a Sant'Arcangelo di Romagna,,,,,,,,
2019/02,625,06/02/2019,3,SP 14 da Poggio Berni (bivio SP 73) a Sant'Arcangelo di Romagna,,,,,,,,
2019/02,625,07/02/2019,4,SP 14 da Poggio Berni (bivio SP 73) a Sant'Arcangelo di Romagna,,,,,,,,
2019/02,625,08/02/2019,5,SP 14 da Poggio Berni (bivio SP 73) a Sant'Arcangelo di Romagna,,,,,,,,
2019/02,625,09/02/2019,6,SP 14 da Poggio Berni (bivio SP 73) a Sant'Arcangelo di Romagna,,,,,,,,
2019/02,625,10/02/2019,7,SP 14 da Poggio Berni (bivio SP 73) a Sant'Arcangelo di Romagna,,,,,,,,
2019/02,625,11/02/2019,1,SP 14 da Poggio Berni (bivio SP 73) a Sant'Arcangelo di Romagna,,,,,,,,
2019/02,625,12/02/2019,2,SP 14 da Poggio Berni (bivio SP 73) a Sant'Arcangelo di Romagna,,,,,,,,
2019/02,625,13/02/2019,3,SP 14 da Poggio Berni (bivio SP 73) a Sant'Arcangelo di Romagna,,,,,,,,
2019/02,625,14/02/2019,4,SP 14 da Poggio Berni (bivio SP 73) a Sant'Arcangelo di Romagna,,,,,,,,
2019/02,626,01/02/2019,5,SP 18 da San Clemente al bivio SP 132 (località Osteria Nuova),7960,10,7600,359,6335,1625,7960,0
2019/02,626,02/02/2019,6,SP 18 da San Clemente al bivio SP 132 (località Osteria Nuova),7000,10,6872,127,5336,1664,0,7000
2019/02,626,03/02/2019,7,SP 18 da San Clemente al bivio SP 132 (località Osteria Nuova),5329,00,5322,7,3986,1343,0,5329
2019/02,626,04/02/2019,1,SP 18 da San Clemente al bivio SP 132 (località Osteria Nuova),7669,00,7319,350,6293,1376,7669,0
2019/02,626,05/02/2019,2,SP 18 da San Clemente al bivio SP 132 (località Osteria Nuova),7865,00,7485,380,6483,1382,7865,0
2019/02,626,06/02/2019,3,SP 18 da San Clemente al bivio SP 132 (località Osteria Nuova),7785,00,7420,365,6248,1537,7785,0
2019/02,626,07/02/2019,4,SP 18 da San Clemente al bivio SP 132 (località Osteria Nuova),8040,00,7668,372,6481,1559,8040,0
2019/02,626,08/02/2019,5,SP 18 da San Clemente al bivio SP 132 (località Osteria Nuova),8308,00,7930,378,6600,1708,8308,0
2019/02,626,09/02/2019,6,SP 18 da San Clemente al bivio SP 132 (località Osteria Nuova),7601,00,7466,135,5823,1778,0,7601
2019/02,626,10/02/2019,7,SP 18 da San Clemente al bivio SP 132 (località Osteria Nuova),5625,10,5618,6,4222,1403,0,5625
2019/02,626,11/02/2019,1,SP 18 da San Clemente al bivio SP 132 (località Osteria Nuova),7687,00,7319,368,6293,1394,7687,0
2019/02,626,12/02/2019,2,SP 18 da San Clemente al bivio SP 132 (località Osteria Nuova),7794,00,7437,357,6299,1495,7794,0
2019/02,626,13/02/2019,3,SP 18 da San Clemente al bivio SP 132 (località Osteria Nuova),7990,10,7587,402,6470,1520,7990,0
2019/02,626,14/02/2019,4,SP 18 da San Clemente al bivio SP 132 (località Osteria Nuova),8476,00,8105,371,6708,1768,8476,0
2019/02,627,01/02/2019,5,SS 64 variante di Riola di Vergato,7607,30,7203,401,5980,1627,7607,0
2019/02,627,02/02/2019,6,SS 64 variante di Riola di Vergato,6724,00,6602,122,5145,1579,0,6724
2019/02,627,03/02/2019,7,SS 64 variante di Riola di Vergato,5558,00,5533,25,4142,1416,0,5558
2019/02,627,04/02/2019,1,SS 64 variante di Riola di Vergato,7746,00,7344,402,6230,1516,7746,0
2019/02,627,05/02/2019,2,SS 64 variante di Riola di Vergato,7770,10,7319,450,6289,1481,7770,0
2019/02,627,06/02/2019,3,SS 64 variante di Riola di Vergato,8022,10,7579,442,6450,1572,8022,0
2019/02,627,07/02/2019,4,SS 64 variante di Riola di Vergato,8014,00,7546,468,6406,1608,8014,0
2019/02,627,08/02/2019,5,SS 64 variante di Riola di Vergato,8250,30,7762,485,6464,1786,8250,0
2019/02,627,09/02/2019,6,SS 64 variante di Riola di Vergato,7982,10,7862,119,6267,1715,0,7982
2019/02,627,10/02/2019,7,SS 64 variante di Riola di Vergato,6405,00,6376,29,4931,1474,0,6405
2019/02,627,11/02/2019,1,SS 64 variante di Riola di Vergato,7924,20,7472,450,6459,1465,7924,0
2019/02,627,12/02/2019,2,SS 64 variante di Riola di Vergato,7764,00,7309,455,6278,1486,7764,0
2019/02,627,13/02/2019,3,SS 64 variante di Riola di Vergato,7964,00,7506,458,6425,1539,7964,0
2019/02,627,14/02/2019,4,SS 64 variante di Riola di Vergato,8061,00,7637,424,6395,1666,8061,0
2019/02,629,01/02/2019,5,SS 727 (tg Forli') tra intersezione SS 9 e l'intersezione SS 67,16314,00,15219,1095,12746,3568,16314,0
2019/02,629,02/02/2019,6,SS 727 (tg Forli') tra intersezione SS 9 e l'intersezione SS 67,11039,00,10775,264,8036,3003,0,11039
2019/02,629,03/02/2019,7,SS 727 (tg Forli') tra intersezione SS 9 e l'intersezione SS 67,8761,00,8717,44,6427,2334,0,8761
2019/02,629,04/02/2019,1,SS 727 (tg Forli') tra intersezione SS 9 e l'intersezione SS 67,11488,00,10742,746,8926,2562,11488,0
2019/02,629,05/02/2019,2,SS 727 (tg Forli') tra intersezione SS 9 e l'intersezione SS 67,16331,20,15212,1117,13125,3206,16331,0
2019/02,629,06/02/2019,3,SS 727 (tg Forli') tra intersezione SS 9 e l'intersezione SS 67,16428,10,15340,1087,13094,3334,16428,0
2019/02,629,07/02/2019,4,SS 727 (tg Forli') tra intersezione SS 9 e l'intersezione SS 67,16102,00,15050,1052,12801,3301,16102,0
2019/02,629,08/02/2019,5,SS 727 (tg Forli') tra intersezione SS 9 e l'intersezione SS 67,16929,00,15777,1152,13216,3713,16929,0
2019/02,629,09/02/2019,6,SS 727 (tg Forli') tra intersezione SS 9 e l'intersezione SS 67,11824,00,11547,277,8683,3141,0,11824
2019/02,629,10/02/2019,7,SS 727 (tg Forli') tra intersezione SS 9 e l'intersezione SS 67,10040,00,9982,58,7455,2585,0,10040
2019/02,629,11/02/2019,1,SS 727 (tg Forli') tra intersezione SS 9 e l'intersezione SS 67,16370,00,15300,1070,13135,3235,16370,0
2019/02,629,12/02/2019,2,SS 727 (tg Forli') tra intersezione SS 9 e l'intersezione SS 67,16347,00,15161,1186,13121,3226,16347,0
2019/02,629,13/02/2019,3,SS 727 (tg Forli') tra intersezione SS 9 e l'intersezione SS 67,16872,00,15680,1192,13455,3417,16872,0
2019/02,629,14/02/2019,4,SS 727 (tg Forli') tra intersezione SS 9 e l'intersezione SS 67,17564,10,16322,1241,13931,3633,17564,0
2019/02,630,01/02/2019,5,SS 726 (tg Cesena) tra intersezione ex SS 71BIS e l'intersezione SP 304R,,,,,,,,
2019/02,630,02/02/2019,6,SS 726 (tg Cesena) tra intersezione ex SS 71BIS e l'intersezione SP 304R,,,,,,,,
2019/02,630,03/02/2019,7,SS 726 (tg Cesena) tra intersezione ex SS 71BIS e l'intersezione SP 304R,,,,,,,,
2019/02,630,04/02/2019,1,SS 726 (tg Cesena) tra intersezione ex SS 71BIS e l'intersezione SP 304R,,,,,,,,
2019/02,630,05/02/2019,2,SS 726 (tg Cesena) tra intersezione ex SS 71BIS e l'intersezione SP 304R,,,,,,,,
2019/02,630,06/02/2019,3,SS 726 (tg Cesena) tra intersezione ex SS 71BIS e l'intersezione SP 304R,,,,,,,,
2019/02,630,07/02/2019,4,SS 726 (tg Cesena) tra intersezione ex SS 71BIS e l'intersezione SP 304R,,,,,,,,
2019/02,630,08/02/2019,5,SS 726 (tg Cesena) tra intersezione ex SS 71BIS e l'intersezione SP 304R,,,,,,,,
2019/02,630,09/02/2019,6,SS 726 (tg Cesena) tra intersezione ex SS 71BIS e l'intersezione SP 304R,,,,,,,,
2019/02,630,10/02/2019,7,SS 726 (tg Cesena) tra intersezione ex SS 71BIS e l'intersezione SP 304R,,,,,,,,
2019/02,630,11/02/2019,1,SS 726 (tg Cesena) tra intersezione ex SS 71BIS e l'intersezione SP 304R,,,,,,,,
2019/02,630,12/02/2019,2,SS 726 (tg Cesena) tra intersezione ex SS 71BIS e l'intersezione SP 304R,,,,,,,,
2019/02,630,13/02/2019,3,SS 726 (tg Cesena) tra intersezione ex SS 71BIS e l'intersezione SP 304R,,,,,,,,
2019/02,630,14/02/2019,4,SS 726 (tg Cesena) tra intersezione ex SS 71BIS e l'intersezione SP 304R,,,,,,,,
2019/02,631,01/02/2019,5,SS 3Bis/E 45 tra Sarsina e San Piero in Bagno,,,,,,,,
2019/02,631,02/02/2019,6,SS 3Bis/E 45 tra Sarsina e San Piero in Bagno,,,,,,,,
2019/02,631,03/02/2019,7,SS 3Bis/E 45 tra Sarsina e San Piero in Bagno,,,,,,,,
2019/02,631,04/02/2019,1,SS 3Bis/E 45 tra Sarsina e San Piero in Bagno,,,,,,,,
2019/02,631,05/02/2019,2,SS 3Bis/E 45 tra Sarsina e San Piero in Bagno,,,,,,,,
2019/02,631,06/02/2019,3,SS 3Bis/E 45 tra Sarsina e San Piero in Bagno,,,,,,,,
2019/02,631,07/02/2019,4,SS 3Bis/E 45 tra Sarsina e San Piero in Bagno,,,,,,,,
2019/02,631,08/02/2019,5,SS 3Bis/E 45 tra Sarsina e San Piero in Bagno,,,,,,,,
2019/02,631,09/02/2019,6,SS 3Bis/E 45 tra Sarsina e San Piero in Bagno,,,,,,,,
2019/02,631,10/02/2019,7,SS 3Bis/E 45 tra Sarsina e San Piero in Bagno,,,,,,,,
2019/02,631,11/02/2019,1,SS 3Bis/E 45 tra Sarsina e San Piero in Bagno,,,,,,,,
2019/02,631,12/02/2019,2,SS 3Bis/E 45 tra Sarsina e San Piero in Bagno,,,,,,,,
2019/02,631,13/02/2019,3,SS 3Bis/E 45 tra Sarsina e San Piero in Bagno,,,,,,,,
2019/02,631,14/02/2019,4,SS 3Bis/E 45 tra Sarsina e San Piero in Bagno,,,,,,,,
2019/02,633,01/02/2019,5,SS 724Dir/tangenziale complanare sud alla A 1 in direzione Bologna - tra intersezione Modena/Sassuolo e intersezione SS12,6898,00,6482,416,5189,1709,6898,0
2019/02,633,02/02/2019,6,SS 724Dir/tangenziale complanare sud alla A 1 in direzione Bologna - tra intersezione Modena/Sassuolo e intersezione SS12,5511,00,5416,95,3880,1631,0,5511
2019/02,633,03/02/2019,7,SS 724Dir/tangenziale complanare sud alla A 1 in direzione Bologna - tra intersezione Modena/Sassuolo e intersezione SS12,4581,00,4551,30,3162,1419,0,4581
2019/02,633,04/02/2019,1,SS 724Dir/tangenziale complanare sud alla A 1 in direzione Bologna - tra intersezione Modena/Sassuolo e intersezione SS12,7794,00,7231,563,6058,1736,7794,0
2019/02,633,05/02/2019,2,SS 724Dir/tangenziale complanare sud alla A 1 in direzione Bologna - tra intersezione Modena/Sassuolo e intersezione SS12,7899,00,7331,568,6068,1831,7899,0
2019/02,633,06/02/2019,3,SS 724Dir/tangenziale complanare sud alla A 1 in direzione Bologna - tra intersezione Modena/Sassuolo e intersezione SS12,7985,00,7434,551,6045,1940,7985,0
2019/02,633,07/02/2019,4,SS 724Dir/tangenziale complanare sud alla A 1 in direzione Bologna - tra intersezione Modena/Sassuolo e intersezione SS12,8182,00,7661,521,6248,1934,8182,0
2019/02,633,08/02/2019,5,SS 724Dir/tangenziale complanare sud alla A 1 in direzione Bologna - tra intersezione Modena/Sassuolo e intersezione SS12,7999,10,7484,514,6011,1988,7999,0
2019/02,633,09/02/2019,6,SS 724Dir/tangenziale complanare sud alla A 1 in direzione Bologna - tra intersezione Modena/Sassuolo e intersezione SS12,6274,00,6167,107,4358,1916,0,6274
2019/02,633,10/02/2019,7,SS 724Dir/tangenziale complanare sud alla A 1 in direzione Bologna - tra intersezione Modena/Sassuolo e intersezione SS12,4910,00,4878,32,3336,1574,0,4910
2019/02,633,11/02/2019,1,SS 724Dir/tangenziale complanare sud alla A 1 in direzione Bologna - tra intersezione Modena/Sassuolo e intersezione SS12,8109,00,7542,567,6322,1787,8109,0
2019/02,633,12/02/2019,2,SS 724Dir/tangenziale complanare sud alla A 1 in direzione Bologna - tra intersezione Modena/Sassuolo e intersezione SS12,7958,10,7409,548,6111,1847,7958,0
2019/02,633,13/02/2019,3,SS 724Dir/tangenziale complanare sud alla A 1 in direzione Bologna - tra intersezione Modena/Sassuolo e intersezione SS12,7889,00,7422,467,6002,1887,7889,0
2019/02,633,14/02/2019,4,SS 724Dir/tangenziale complanare sud alla A 1 in direzione Bologna - tra intersezione Modena/Sassuolo e intersezione SS12,8068,00,7594,474,6066,2002,8068,0
2019/02,634,01/02/2019,5,SS 12 tra Pavullo e intersezione SP 31,,,,,,,,
2019/02,634,02/02/2019,6,SS 12 tra Pavullo e intersezione SP 31,,,,,,,,
2019/02,634,03/02/2019,7,SS 12 tra Pavullo e intersezione SP 31,,,,,,,,
2019/02,634,04/02/2019,1,SS 12 tra Pavullo e intersezione SP 31,,,,,,,,
2019/02,634,05/02/2019,2,SS 12 tra Pavullo e intersezione SP 31,,,,,,,,
2019/02,634,06/02/2019,3,SS 12 tra Pavullo e intersezione SP 31,,,,,,,,
2019/02,634,07/02/2019,4,SS 12 tra Pavullo e intersezione SP 31,,,,,,,,
2019/02,634,08/02/2019,5,SS 12 tra Pavullo e intersezione SP 31,,,,,,,,
2019/02,634,09/02/2019,6,SS 12 tra Pavullo e intersezione SP 31,,,,,,,,
2019/02,634,10/02/2019,7,SS 12 tra Pavullo e intersezione SP 31,,,,,,,,
2019/02,634,11/02/2019,1,SS 12 tra Pavullo e intersezione SP 31,,,,,,,,
2019/02,634,12/02/2019,2,SS 12 tra Pavullo e intersezione SP 31,,,,,,,,
2019/02,634,13/02/2019,3,SS 12 tra Pavullo e intersezione SP 31,,,,,,,,
2019/02,634,14/02/2019,4,SS 12 tra Pavullo e intersezione SP 31,,,,,,,,
2019/02,635,01/02/2019,5,SS 725 (tg sud Piacenza) tra intersezione SS 45 e l'intersezione SP 6,37292,10,34887,2404,29310,7982,37292,0
2019/02,635,02/02/2019,6,SS 725 (tg sud Piacenza) tra intersezione SS 45 e l'intersezione SP 6,35540,00,34825,715,27492,8048,0,35540
2019/02,635,03/02/2019,7,SS 725 (tg sud Piacenza) tra intersezione SS 45 e l'intersezione SP 6,27260,00,27067,193,20534,6726,0,27260
2019/02,635,04/02/2019,1,SS 725 (tg sud Piacenza) tra intersezione SS 45 e l'intersezione SP 6,44182,00,40994,3188,35962,8220,44182,0
2019/02,635,05/02/2019,2,SS 725 (tg sud Piacenza) tra intersezione SS 45 e l'intersezione SP 6,44223,00,40876,3347,35916,8307,44223,0
2019/02,635,06/02/2019,3,SS 725 (tg sud Piacenza) tra intersezione SS 45 e l'intersezione SP 6,44748,20,41406,3340,36059,8689,44748,0
2019/02,635,07/02/2019,4,SS 725 (tg sud Piacenza) tra intersezione SS 45 e l'intersezione SP 6,44755,10,41402,3352,36257,8498,44755,0
2019/02,635,08/02/2019,5,SS 725 (tg sud Piacenza) tra intersezione SS 45 e l'intersezione SP 6,46997,20,43615,3380,37478,9519,46997,0
2019/02,635,09/02/2019,6,SS 725 (tg sud Piacenza) tra intersezione SS 45 e l'intersezione SP 6,38061,00,37222,839,29342,8719,0,38061
2019/02,635,10/02/2019,7,SS 725 (tg sud Piacenza) tra intersezione SS 45 e l'intersezione SP 6,30510,10,30329,180,23296,7214,0,30510
2019/02,635,11/02/2019,1,SS 725 (tg sud Piacenza) tra intersezione SS 45 e l'intersezione SP 6,43985,10,40934,3050,35723,8262,43985,0
2019/02,635,12/02/2019,2,SS 725 (tg sud Piacenza) tra intersezione SS 45 e l'intersezione SP 6,44458,00,41270,3188,36067,8391,44458,0
2019/02,635,13/02/2019,3,SS 725 (tg sud Piacenza) tra intersezione SS 45 e l'intersezione SP 6,45866,00,42792,3074,36810,9056,45866,0
2019/02,635,14/02/2019,4,SS 725 (tg sud Piacenza) tra intersezione SS 45 e l'intersezione SP 6,46394,10,43252,3141,37009,9385,46394,0
2019/02,636,01/02/2019,5,SS 9Var tra la tangenziale nord di Parma (intersezione SP 343R) e l'intersezione SP 62R,52343,210,49371,2951,41327,11016,52343,0
2019/02,636,02/02/2019,6,SS 9Var tra la tangenziale nord di Parma (intersezione SP 343R) e l'intersezione SP 62R,46629,10,45837,791,34903,11726,0,46629
2019/02,636,03/02/2019,7,SS 9Var tra la tangenziale nord di Parma (intersezione SP 343R) e l'intersezione SP 62R,37448,20,37173,273,26861,10587,0,37448
2019/02,636,04/02/2019,1,SS 9Var tra la tangenziale nord di Parma (intersezione SP 343R) e l'intersezione SP 62R,54101,30,50898,3200,43297,10804,54101,0
2019/02,636,05/02/2019,2,SS 9Var tra la tangenziale nord di Parma (intersezione SP 343R) e l'intersezione SP 62R,54450,50,51169,3276,43467,10983,54450,0
2019/02,636,06/02/2019,3,SS 9Var tra la tangenziale nord di Parma (intersezione SP 343R) e l'intersezione SP 62R,53958,60,50549,3403,42540,11418,53958,0
2019/02,636,07/02/2019,4,SS 9Var tra la tangenziale nord di Parma (intersezione SP 343R) e l'intersezione SP 62R,55012,70,51643,3362,43378,11634,55012,0
2019/02,636,08/02/2019,5,SS 9Var tra la tangenziale nord di Parma (intersezione SP 343R) e l'intersezione SP 62R,57002,80,53669,3325,44293,12709,57002,0
2019/02,636,09/02/2019,6,SS 9Var tra la tangenziale nord di Parma (intersezione SP 343R) e l'intersezione SP 62R,51211,20,50284,925,36469,14742,0,51211
2019/02,636,10/02/2019,7,SS 9Var tra la tangenziale nord di Parma (intersezione SP 343R) e l'intersezione SP 62R,36530,00,36259,271,26445,10085,0,36530
2019/02,636,11/02/2019,1,SS 9Var tra la tangenziale nord di Parma (intersezione SP 343R) e l'intersezione SP 62R,53937,80,50637,3292,43444,10493,53937,0
2019/02,636,12/02/2019,2,SS 9Var tra la tangenziale nord di Parma (intersezione SP 343R) e l'intersezione SP 62R,55105,60,51678,3421,43798,11307,55105,0
2019/02,636,13/02/2019,3,SS 9Var tra la tangenziale nord di Parma (intersezione SP 343R) e l'intersezione SP 62R,55886,70,52445,3434,44281,11605,55886,0
2019/02,636,14/02/2019,4,SS 9Var tra la tangenziale nord di Parma (intersezione SP 343R) e l'intersezione SP 62R,57270,70,53923,3340,44844,12426,57270,0
2019/02,637,01/02/2019,5,SS 62 tra Fornovo di Taro e Collecchio,12278,00,11603,675,9613,2665,12278,0
2019/02,637,02/02/2019,6,SS 62 tra Fornovo di Taro e Collecchio,9976,00,9770,206,7627,2349,0,9976
2019/02,637,03/02/2019,7,SS 62 tra Fornovo di Taro e Collecchio,8401,00,8345,56,6061,2340,0,8401
2019/02,637,04/02/2019,1,SS 62 tra Fornovo di Taro e Collecchio,13181,00,12394,787,10325,2856,13181,0
2019/02,637,05/02/2019,2,SS 62 tra Fornovo di Taro e Collecchio,13747,00,12934,813,10905,2842,13747,0
2019/02,637,06/02/2019,3,SS 62 tra Fornovo di Taro e Collecchio,13657,10,12845,811,10806,2851,13657,0
2019/02,637,07/02/2019,4,SS 62 tra Fornovo di Taro e Collecchio,13557,00,12719,838,10627,2930,13557,0
2019/02,637,08/02/2019,5,SS 62 tra Fornovo di Taro e Collecchio,14088,00,13284,804,10958,3130,14088,0
2019/02,637,09/02/2019,6,SS 62 tra Fornovo di Taro e Collecchio,11574,10,11358,215,8882,2692,0,11574
2019/02,637,10/02/2019,7,SS 62 tra Fornovo di Taro e Collecchio,9023,10,8968,54,6471,2552,0,9023
2019/02,637,11/02/2019,1,SS 62 tra Fornovo di Taro e Collecchio,13262,00,12426,836,10522,2740,13262,0
2019/02,637,12/02/2019,2,SS 62 tra Fornovo di Taro e Collecchio,13668,00,12775,893,10895,2773,13668,0
2019/02,637,13/02/2019,3,SS 62 tra Fornovo di Taro e Collecchio,14225,10,13343,881,11163,3062,14225,0
2019/02,637,14/02/2019,4,SS 62 tra Fornovo di Taro e Collecchio,14399,00,13607,792,11126,3273,14399,0
2019/02,638,01/02/2019,5,SS 9 tra la tangenziale nord di Reggio Emilia e Sant'Ilario d'Enza,18391,00,16900,1491,13424,4967,18391,0
2019/02,638,02/02/2019,6,SS 9 tra la tangenziale nord di Reggio Emilia e Sant'Ilario d'Enza,17198,00,16792,406,11622,5576,0,17198
2019/02,638,03/02/2019,7,SS 9 tra la tangenziale nord di Reggio Emilia e Sant'Ilario d'Enza,14922,00,14772,150,10077,4845,0,14922
2019/02,638,04/02/2019,1,SS 9 tra la tangenziale nord di Reggio Emilia e Sant'Ilario d'Enza,18407,00,16847,1560,13883,4524,18407,0
2019/02,638,05/02/2019,2,SS 9 tra la tangenziale nord di Reggio Emilia e Sant'Ilario d'Enza,19050,00,17458,1592,14460,4590,19050,0
2019/02,638,06/02/2019,3,SS 9 tra la tangenziale nord di Reggio Emilia e Sant'Ilario d'Enza,19092,00,17447,1645,14342,4750,19092,0
2019/02,638,07/02/2019,4,SS 9 tra la tangenziale nord di Reggio Emilia e Sant'Ilario d'Enza,19310,00,17556,1754,14344,4966,19310,0
2019/02,638,08/02/2019,5,SS 9 tra la tangenziale nord di Reggio Emilia e Sant'Ilario d'Enza,20156,10,18410,1745,14434,5722,20156,0
2019/02,638,09/02/2019,6,SS 9 tra la tangenziale nord di Reggio Emilia e Sant'Ilario d'Enza,18318,00,17796,522,12273,6045,0,18318
2019/02,638,10/02/2019,7,SS 9 tra la tangenziale nord di Reggio Emilia e Sant'Ilario d'Enza,15716,00,15543,173,10811,4905,0,15716
2019/02,638,11/02/2019,1,SS 9 tra la tangenziale nord di Reggio Emilia e Sant'Ilario d'Enza,18414,10,16844,1569,13909,4505,18414,0
2019/02,638,12/02/2019,2,SS 9 tra la tangenziale nord di Reggio Emilia e Sant'Ilario d'Enza,18554,00,16871,1683,13852,4702,18554,0
2019/02,638,13/02/2019,3,SS 9 tra la tangenziale nord di Reggio Emilia e Sant'Ilario d'Enza,19554,00,17842,1712,14534,5020,19554,0
2019/02,638,14/02/2019,4,SS 9 tra la tangenziale nord di Reggio Emilia e Sant'Ilario d'Enza,20132,00,18369,1763,14643,5489,20132,0
2019/02,639,01/02/2019,5,SS 63 località Casina (variante abitato),5861,00,5632,229,4504,1357,5861,0
2019/02,639,02/02/2019,6,SS 63 località Casina (variante abitato),5394,10,5265,128,4044,1350,0,5394
2019/02,639,03/02/2019,7,SS 63 località Casina (variante abitato),4761,00,4715,46,3493,1268,0,4761
2019/02,639,04/02/2019,1,SS 63 località Casina (variante abitato),6325,00,6039,286,4924,1401,6325,0
2019/02,639,05/02/2019,2,SS 63 località Casina (variante abitato),6273,20,5980,291,4926,1347,6273,0
2019/02,639,06/02/2019,3,SS 63 località Casina (variante abitato),6720,00,6427,293,5240,1480,6720,0
2019/02,639,07/02/2019,4,SS 63 località Casina (variante abitato),6518,00,6192,326,5062,1456,6518,0
2019/02,639,08/02/2019,5,SS 63 località Casina (variante abitato),7038,10,6717,320,5359,1679,7038,0
2019/02,639,09/02/2019,6,SS 63 località Casina (variante abitato),6533,20,6406,125,5015,1518,0,6533
2019/02,639,10/02/2019,7,SS 63 località Casina (variante abitato),5267,00,5220,47,3918,1349,0,5267
2019/02,639,11/02/2019,1,SS 63 località Casina (variante abitato),6404,00,6086,318,5020,1384,6404,0
2019/02,639,12/02/2019,2,SS 63 località Casina (variante abitato),6657,00,6362,295,5190,1467,6657,0
2019/02,639,13/02/2019,3,SS 63 località Casina (variante abitato),6817,00,6506,311,5262,1555,6817,0
2019/02,639,14/02/2019,4,SS 63 località Casina (variante abitato),6800,10,6459,340,5187,1613,6800,0
2019/02,651,01/02/2019,5,SS 9 da Imola a Castelbolognese (al confine provinciale),16301,00,15673,628,11885,4416,16301,0
2019/02,651,02/02/2019,6,SS 9 da Imola a Castelbolognese (al confine provinciale),15550,00,15377,173,10655,4895,0,15550
2019/02,651,03/02/2019,7,SS 9 da Imola a Castelbolognese (al confine provinciale),12189,00,12116,73,8462,3727,0,12189
2019/02,651,04/02/2019,1,SS 9 da Imola a Castelbolognese (al confine provinciale),15802,00,15072,730,12263,3539,15802,0
2019/02,651,05/02/2019,2,SS 9 da Imola a Castelbolognese (al confine provinciale),16160,00,15404,756,12659,3501,16160,0
2019/02,651,06/02/2019,3,SS 9 da Imola a Castelbolognese (al confine provinciale),16472,00,15730,742,12406,4066,16472,0
2019/02,651,07/02/2019,4,SS 9 da Imola a Castelbolognese (al confine provinciale),16244,00,15492,752,12483,3761,16244,0
2019/02,651,08/02/2019,5,SS 9 da Imola a Castelbolognese (al confine provinciale),17127,00,16314,813,12610,4517,17127,0
2019/02,651,09/02/2019,6,SS 9 da Imola a Castelbolognese (al confine provinciale),15413,00,15211,202,10415,4998,0,15413
2019/02,651,10/02/2019,7,SS 9 da Imola a Castelbolognese (al confine provinciale),12838,00,12785,53,8980,3858,0,12838
2019/02,651,11/02/2019,1,SS 9 da Imola a Castelbolognese (al confine provinciale),16068,00,15343,725,12437,3631,16068,0
2019/02,651,12/02/2019,2,SS 9 da Imola a Castelbolognese (al confine provinciale),16518,00,15662,856,12656,3862,16518,0
2019/02,651,13/02/2019,3,SS 9 da Imola a Castelbolognese (al confine provinciale),16654,00,15850,804,12498,4156,16654,0
2019/02,651,14/02/2019,4,SS 9 da Imola a Castelbolognese (al confine provinciale),17554,00,16753,801,12938,4616,17554,0
2019/02,652,01/02/2019,5,SS 16 dal bivio SP 610R ad Argenta,12277,00,11047,1230,9676,2601,12277,0
2019/02,652,02/02/2019,6,SS 16 dal bivio SP 610R ad Argenta,9702,00,9430,272,7465,2237,0,9702
2019/02,652,03/02/2019,7,SS 16 dal bivio SP 610R ad Argenta,8144,00,8067,77,6054,2090,0,8144
2019/02,652,04/02/2019,1,SS 16 dal bivio SP 610R ad Argenta,11770,00,10485,1285,9461,2309,11770,0
2019/02,652,05/02/2019,2,SS 16 dal bivio SP 610R ad Argenta,11821,00,10456,1365,9556,2265,11821,0
2019/02,652,06/02/2019,3,SS 16 dal bivio SP 610R ad Argenta,11589,00,10316,1273,9308,2281,11589,0
2019/02,652,07/02/2019,4,SS 16 dal bivio SP 610R ad Argenta,12256,00,10886,1370,9900,2356,12256,0
2019/02,652,08/02/2019,5,SS 16 dal bivio SP 610R ad Argenta,12402,00,11101,1301,9669,2733,12402,0
2019/02,652,09/02/2019,6,SS 16 dal bivio SP 610R ad Argenta,10230,00,9911,319,7788,2442,0,10230
2019/02,652,10/02/2019,7,SS 16 dal bivio SP 610R ad Argenta,8569,00,8478,91,6416,2153,0,8569
2019/02,652,11/02/2019,1,SS 16 dal bivio SP 610R ad Argenta,11742,00,10457,1285,9439,2303,11742,0
2019/02,652,12/02/2019,2,SS 16 dal bivio SP 610R ad Argenta,12086,00,10746,1340,9674,2412,12086,0
2019/02,652,13/02/2019,3,SS 16 dal bivio SP 610R ad Argenta,12137,00,10787,1350,9702,2435,12137,0
2019/02,652,14/02/2019,4,SS 16 dal bivio SP 610R ad Argenta,12904,00,11514,1390,10160,2744,12904,0
2019/02,653,01/02/2019,5,SP 254R dal ponte sul fiume Savio alla SS 16,7702,00,7532,170,6005,1697,7702,0
2019/02,653,02/02/2019,6,SP 254R dal ponte sul fiume Savio alla SS 16,6765,00,6714,51,4945,1820,0,6765
2019/02,653,03/02/2019,7,SP 254R dal ponte sul fiume Savio alla SS 16,6968,00,6959,9,5431,1537,0,6968
2019/02,653,04/02/2019,1,SP 254R dal ponte sul fiume Savio alla SS 16,7882,00,7674,208,6453,1429,7882,0
2019/02,653,05/02/2019,2,SP 254R dal ponte sul fiume Savio alla SS 16,7634,00,7448,186,6301,1333,7634,0
2019/02,653,06/02/2019,3,SP 254R dal ponte sul fiume Savio alla SS 16,7637,00,7457,180,6228,1409,7637,0
2019/02,653,07/02/2019,4,SP 254R dal ponte sul fiume Savio alla SS 16,6995,00,6819,176,5475,1520,6995,0
2019/02,653,08/02/2019,5,SP 254R dal ponte sul fiume Savio alla SS 16,8092,00,7917,175,6429,1663,8092,0
2019/02,653,09/02/2019,6,SP 254R dal ponte sul fiume Savio alla SS 16,7261,00,7212,49,5723,1538,0,7261
2019/02,653,11/02/2019,1,SP 254R dal ponte sul fiume Savio alla SS 16,5369,00,5252,117,4441,928,5369,0
2019/02,653,12/02/2019,2,SP 254R dal ponte sul fiume Savio alla SS 16,6651,00,6516,135,5680,971,6651,0
2019/02,654,01/02/2019,5,SP 7IBisR dal bivio SSPP 32/33ter alla SS 16,11320,00,10947,373,8738,2582,11320,0
2019/02,654,02/02/2019,6,SP 7IBisR dal bivio SSPP 32/33ter alla SS 16,9285,00,9128,157,6388,2897,0,9285
2019/02,654,03/02/2019,7,SP 7IBisR dal bivio SSPP 32/33ter alla SS 16,8561,00,8550,11,6228,2333,0,8561
2019/02,654,04/02/2019,1,SP 7IBisR dal bivio SSPP 32/33ter alla SS 16,10540,00,10109,431,8527,2013,10540,0
2019/02,654,05/02/2019,2,SP 7IBisR dal bivio SSPP 32/33ter alla SS 16,10921,00,10479,442,8834,2087,10921,0
2019/02,654,06/02/2019,3,SP 7IBisR dal bivio SSPP 32/33ter alla SS 16,10846,00,10385,461,8789,2057,10846,0
2019/02,654,07/02/2019,4,SP 7IBisR dal bivio SSPP 32/33ter alla SS 16,11624,00,11155,469,9377,2247,11624,0
2019/02,654,08/02/2019,5,SP 7IBisR dal bivio SSPP 32/33ter alla SS 16,12069,00,11581,488,9420,2649,12069,0
2019/02,654,09/02/2019,6,SP 7IBisR dal bivio SSPP 32/33ter alla SS 16,11179,00,11035,144,8085,3094,0,11179
2019/02,654,10/02/2019,7,SP 7IBisR dal bivio SSPP 32/33ter alla SS 16,10715,00,10677,38,7752,2963,0,10715
2019/02,654,11/02/2019,1,SP 7IBisR dal bivio SSPP 32/33ter alla SS 16,10707,00,10201,506,8848,1859,10707,0
2019/02,654,12/02/2019,2,SP 7IBisR dal bivio SSPP 32/33ter alla SS 16,11424,00,11000,424,9276,2148,11424,0
2019/02,654,13/02/2019,3,SP 7IBisR dal bivio SSPP 32/33ter alla SS 16,11722,00,11230,492,9404,2318,11722,0
2019/02,654,14/02/2019,4,SP 7IBisR dal bivio SSPP 32/33ter alla SS 16,13172,00,12648,524,10135,3037,13172,0
2019/02,655,01/02/2019,5,SP 253R dal bivio SP 302R allo svincolo A 14dir a Fornace Zarattini,17220,00,16435,785,13423,3797,17220,0
2019/02,655,02/02/2019,6,SP 253R dal bivio SP 302R allo svincolo A 14dir a Fornace Zarattini,13769,00,13569,200,9963,3806,0,13769
2019/02,655,03/02/2019,7,SP 253R dal bivio SP 302R allo svincolo A 14dir a Fornace Zarattini,10294,00,10238,56,7543,2751,0,10294
2019/02,655,04/02/2019,1,SP 253R dal bivio SP 302R allo svincolo A 14dir a Fornace Zarattini,16801,00,16036,765,13559,3242,16801,0
2019/02,655,05/02/2019,2,SP 253R dal bivio SP 302R allo svincolo A 14dir a Fornace Zarattini,17299,00,16418,881,13935,3364,17299,0
2019/02,655,06/02/2019,3,SP 253R dal bivio SP 302R allo svincolo A 14dir a Fornace Zarattini,17665,00,16768,897,14077,3588,17665,0
2019/02,655,07/02/2019,4,SP 253R dal bivio SP 302R allo svincolo A 14dir a Fornace Zarattini,17506,00,16649,857,14043,3463,17506,0
2019/02,655,08/02/2019,5,SP 253R dal bivio SP 302R allo svincolo A 14dir a Fornace Zarattini,18461,00,17530,931,14426,4035,18461,0
2019/02,655,09/02/2019,6,SP 253R dal bivio SP 302R allo svincolo A 14dir a Fornace Zarattini,14680,00,14409,271,10855,3825,0,14680
2019/02,655,10/02/2019,7,SP 253R dal bivio SP 302R allo svincolo A 14dir a Fornace Zarattini,10838,00,10774,64,8168,2670,0,10838
2019/02,655,11/02/2019,1,SP 253R dal bivio SP 302R allo svincolo A 14dir a Fornace Zarattini,17263,00,16433,830,13988,3275,17263,0
2019/02,655,12/02/2019,2,SP 253R dal bivio SP 302R allo svincolo A 14dir a Fornace Zarattini,17933,00,16937,996,14496,3437,17933,0
2019/02,655,13/02/2019,3,SP 253R dal bivio SP 302R allo svincolo A 14dir a Fornace Zarattini,18007,00,17011,996,14285,3722,18007,0
2019/02,655,14/02/2019,4,SP 253R dal bivio SP 302R allo svincolo A 14dir a Fornace Zarattini,17508,00,16684,824,13359,4149,17508,0
2019/02,660,01/02/2019,5,SP 25 tra intersezione con SS 64 e confine provinciale,,,,,,,,
2019/02,660,02/02/2019,6,SP 25 tra intersezione con SS 64 e confine provinciale,,,,,,,,
2019/02,660,03/02/2019,7,SP 25 tra intersezione con SS 64 e confine provinciale,,,,,,,,
2019/02,660,04/02/2019,1,SP 25 tra intersezione con SS 64 e confine provinciale,,,,,,,,
2019/02,660,05/02/2019,2,SP 25 tra intersezione con SS 64 e confine provinciale,,,,,,,,
2019/02,660,06/02/2019,3,SP 25 tra intersezione con SS 64 e confine provinciale,,,,,,,,
2019/02,660,07/02/2019,4,SP 25 tra intersezione con SS 64 e confine provinciale,,,,,,,,
2019/02,660,08/02/2019,5,SP 25 tra intersezione con SS 64 e confine provinciale,,,,,,,,
2019/02,660,09/02/2019,6,SP 25 tra intersezione con SS 64 e confine provinciale,,,,,,,,
2019/02,660,10/02/2019,7,SP 25 tra intersezione con SS 64 e confine provinciale,,,,,,,,
2019/02,660,11/02/2019,1,SP 25 tra intersezione con SS 64 e confine provinciale,,,,,,,,
2019/02,660,12/02/2019,2,SP 25 tra intersezione con SS 64 e confine provinciale,,,,,,,,
2019/02,660,13/02/2019,3,SP 25 tra intersezione con SS 64 e confine provinciale,,,,,,,,
2019/02,660,14/02/2019,4,SP 25 tra intersezione con SS 64 e confine provinciale,,,,,,,,
2019/02,661,01/02/2019,5,SP 15 tra Tresigallo e Massa Fiscaglia,3242,00,3116,126,2541,701,3242,0
2019/02,661,02/02/2019,6,SP 15 tra Tresigallo e Massa Fiscaglia,2591,00,2559,32,1907,684,0,2591
2019/02,661,03/02/2019,7,SP 15 tra Tresigallo e Massa Fiscaglia,2265,00,2257,8,1673,592,0,2265
2019/02,661,04/02/2019,1,SP 15 tra Tresigallo e Massa Fiscaglia,3095,10,3001,93,2462,633,3095,0
2019/02,661,05/02/2019,2,SP 15 tra Tresigallo e Massa Fiscaglia,3321,10,3204,116,2685,636,3321,0
2019/02,661,06/02/2019,3,SP 15 tra Tresigallo e Massa Fiscaglia,3235,30,3105,127,2585,650,3235,0
2019/02,661,07/02/2019,4,SP 15 tra Tresigallo e Massa Fiscaglia,3539,20,3430,107,2737,802,3539,0
2019/02,661,08/02/2019,5,SP 15 tra Tresigallo e Massa Fiscaglia,3686,00,3561,125,2841,845,3686,0
2019/02,661,09/02/2019,6,SP 15 tra Tresigallo e Massa Fiscaglia,2975,10,2928,46,2208,767,0,2975
2019/02,661,10/02/2019,7,SP 15 tra Tresigallo e Massa Fiscaglia,2448,00,2439,9,1844,604,0,2448
2019/02,661,11/02/2019,1,SP 15 tra Tresigallo e Massa Fiscaglia,3274,00,3164,110,2623,651,3274,0
2019/02,661,12/02/2019,2,SP 15 tra Tresigallo e Massa Fiscaglia,3262,00,3179,83,2586,676,3262,0
2019/02,661,13/02/2019,3,SP 15 tra Tresigallo e Massa Fiscaglia,3437,00,3330,107,2719,718,3437,0
2019/02,661,14/02/2019,4,SP 15 tra Tresigallo e Massa Fiscaglia,3583,00,3460,123,2778,805,3583,0
2019/02,662,01/02/2019,5,SP 2 tra intersezione SP 14 e Copparo,13653,00,13166,487,10899,2754,13653,0
2019/02,662,02/02/2019,6,SP 2 tra intersezione SP 14 e Copparo,10532,00,10408,124,7950,2582,0,10532
2019/02,662,03/02/2019,7,SP 2 tra intersezione SP 14 e Copparo,7935,00,7908,27,5876,2059,0,7935
2019/02,662,04/02/2019,1,SP 2 tra intersezione SP 14 e Copparo,13110,00,12624,486,10674,2436,13110,0
2019/02,662,05/02/2019,2,SP 2 tra intersezione SP 14 e Copparo,13186,20,12656,528,10726,2460,13186,0
2019/02,662,06/02/2019,3,SP 2 tra intersezione SP 14 e Copparo,13189,10,12553,635,10678,2511,13189,0
2019/02,662,07/02/2019,4,SP 2 tra intersezione SP 14 e Copparo,13292,60,12608,678,10741,2551,13292,0
2019/02,662,08/02/2019,5,SP 2 tra intersezione SP 14 e Copparo,13596,10,12973,622,10898,2698,13596,0
2019/02,662,09/02/2019,6,SP 2 tra intersezione SP 14 e Copparo,10669,00,10530,139,8116,2553,0,10669
2019/02,662,10/02/2019,7,SP 2 tra intersezione SP 14 e Copparo,8157,00,8123,34,5973,2184,0,8157
2019/02,662,11/02/2019,1,SP 2 tra intersezione SP 14 e Copparo,13199,00,12609,590,10766,2433,13199,0
2019/02,662,12/02/2019,2,SP 2 tra intersezione SP 14 e Copparo,13434,00,12855,579,10887,2547,13434,0
2019/02,662,13/02/2019,3,SP 2 tra intersezione SP 14 e Copparo,13531,00,12893,638,11009,2522,13531,0
2019/02,662,14/02/2019,4,SP 2 tra intersezione SP 14 e Copparo,14253,10,13639,613,11197,3056,14253,0
2019/02,663,01/02/2019,5,SP 60 tra intersezione SP 68 e SP62,2933,00,2534,399,2259,674,2933,0
2019/02,663,02/02/2019,6,SP 60 tra intersezione SP 68 e SP62,2274,00,2180,94,1661,613,0,2274
2019/02,663,03/02/2019,7,SP 60 tra intersezione SP 68 e SP62,2395,00,2381,14,1818,577,0,2395
2019/02,663,04/02/2019,1,SP 60 tra intersezione SP 68 e SP62,2909,00,2467,442,2353,556,2909,0
2019/02,663,05/02/2019,2,SP 60 tra intersezione SP 68 e SP62,2971,00,2537,434,2395,576,2971,0
2019/02,663,06/02/2019,3,SP 60 tra intersezione SP 68 e SP62,3091,00,2607,484,2462,629,3091,0
2019/02,663,07/02/2019,4,SP 60 tra intersezione SP 68 e SP62,3022,00,2550,472,2364,658,3022,0
2019/02,663,08/02/2019,5,SP 60 tra intersezione SP 68 e SP62,3222,10,2741,480,2533,689,3222,0
2019/02,663,09/02/2019,6,SP 60 tra intersezione SP 68 e SP62,2740,00,2590,150,2073,667,0,2740
2019/02,663,10/02/2019,7,SP 60 tra intersezione SP 68 e SP62,2494,00,2477,17,1894,600,0,2494
2019/02,663,11/02/2019,1,SP 60 tra intersezione SP 68 e SP62,3002,00,2574,428,2377,625,3002,0
2019/02,663,12/02/2019,2,SP 60 tra intersezione SP 68 e SP62,3056,00,2604,452,2458,598,3056,0
2019/02,663,13/02/2019,3,SP 60 tra intersezione SP 68 e SP62,3100,00,2615,485,2464,636,3100,0
2019/02,663,14/02/2019,4,SP 60 tra intersezione SP 68 e SP62,3302,10,2814,487,2542,760,3302,0
2019/02,665,01/02/2019,5,SP 1 tra intersezione SP7 a Piacenza,8969,00,8542,427,6921,2048,8969,0
2019/02,665,02/02/2019,6,SP 1 tra intersezione SP7 a Piacenza,8484,10,8381,102,6338,2146,0,8484
2019/02,665,03/02/2019,7,SP 1 tra intersezione SP7 a Piacenza,6445,00,6400,45,4590,1855,0,6445
2019/02,665,04/02/2019,1,SP 1 tra intersezione SP7 a Piacenza,11516,00,10936,580,9335,2181,11516,0
2019/02,665,05/02/2019,2,SP 1 tra intersezione SP7 a Piacenza,11743,00,11118,625,9477,2266,11743,0
2019/02,665,06/02/2019,3,SP 1 tra intersezione SP7 a Piacenza,11860,00,11171,689,9520,2340,11860,0
2019/02,665,07/02/2019,4,SP 1 tra intersezione SP7 a Piacenza,11874,00,11177,697,9467,2407,11874,0
2019/02,665,08/02/2019,5,SP 1 tra intersezione SP7 a Piacenza,12133,00,11514,619,9602,2531,12133,0
2019/02,665,09/02/2019,6,SP 1 tra intersezione SP7 a Piacenza,9597,00,9469,128,7058,2539,0,9597
2019/02,665,10/02/2019,7,SP 1 tra intersezione SP7 a Piacenza,7073,00,7034,39,5188,1885,0,7073
2019/02,665,11/02/2019,1,SP 1 tra intersezione SP7 a Piacenza,11367,00,10768,599,9219,2148,11367,0
2019/02,665,12/02/2019,2,SP 1 tra intersezione SP7 a Piacenza,11851,10,11168,682,9590,2261,11851,0
2019/02,665,13/02/2019,3,SP 1 tra intersezione SP7 a Piacenza,11932,00,11294,638,9602,2330,11932,0
2019/02,665,14/02/2019,4,SP 1 tra intersezione SP7 a Piacenza,12177,00,11518,659,9565,2612,12177,0
2019/02,666,01/02/2019,5,SP 3 tra via Monda e via Caminate,7393,00,6965,428,5866,1527,7393,0
2019/02,666,02/02/2019,6,SP 3 tra via Monda e via Caminate,5555,00,5473,82,4138,1417,0,5555
2019/02,666,04/02/2019,1,SP 3 tra via Monda e via Caminate,5964,00,5592,372,4697,1267,5964,0
2019/02,666,05/02/2019,2,SP 3 tra via Monda e via Caminate,7548,00,7090,458,6144,1404,7548,0
2019/02,666,06/02/2019,3,SP 3 tra via Monda e via Caminate,7634,00,7180,454,6102,1532,7634,0
2019/02,666,07/02/2019,4,SP 3 tra via Monda e via Caminate,7749,00,7304,445,6210,1539,7749,0
2019/02,666,08/02/2019,5,SP 3 tra via Monda e via Caminate,7858,10,7380,477,6300,1558,7858,0
2019/02,666,09/02/2019,6,SP 3 tra via Monda e via Caminate,6206,00,6109,97,4606,1600,0,6206
2019/02,666,10/02/2019,7,SP 3 tra via Monda e via Caminate,5097,00,5078,19,3762,1335,0,5097
2019/02,666,11/02/2019,1,SP 3 tra via Monda e via Caminate,7542,00,7052,490,6092,1450,7542,0
2019/02,666,12/02/2019,2,SP 3 tra via Monda e via Caminate,7698,00,7172,526,6204,1494,7698,0
2019/02,666,13/02/2019,3,SP 3 tra via Monda e via Caminate,8002,00,7499,503,6341,1661,8002,0
2019/02,666,14/02/2019,4,SP 3 tra via Monda e via Caminate,8034,30,7495,536,6220,1814,8034,0
2019/02,670,01/02/2019,5,SP 114 dalla rotatoria SP 114/viale Parisoli alla rotatoria SP467,16377,00,15734,643,13058,3319,16377,0
2019/02,670,02/02/2019,6,SP 114 dalla rotatoria SP 114/viale Parisoli alla rotatoria SP467,12307,00,12194,113,9150,3157,0,12307
2019/02,670,03/02/2019,7,SP 114 dalla rotatoria SP 114/viale Parisoli alla rotatoria SP467,8703,00,8657,46,6089,2614,0,8703
2019/02,670,04/02/2019,1,SP 114 dalla rotatoria SP 114/viale Parisoli alla rotatoria SP467,16402,00,15713,689,13416,2986,16402,0
2019/02,670,05/02/2019,2,SP 114 dalla rotatoria SP 114/viale Parisoli alla rotatoria SP467,16463,10,15715,747,13497,2966,16463,0
2019/02,670,06/02/2019,3,SP 114 dalla rotatoria SP 114/viale Parisoli alla rotatoria SP467,16888,20,16092,794,13612,3276,16888,0
2019/02,670,07/02/2019,4,SP 114 dalla rotatoria SP 114/viale Parisoli alla rotatoria SP467,16915,00,16050,865,13610,3305,16915,0
2019/02,670,08/02/2019,5,SP 114 dalla rotatoria SP 114/viale Parisoli alla rotatoria SP467,17268,00,16492,776,13845,3423,17268,0
2019/02,670,09/02/2019,6,SP 114 dalla rotatoria SP 114/viale Parisoli alla rotatoria SP467,12915,00,12737,178,9414,3501,0,12915
2019/02,670,10/02/2019,7,SP 114 dalla rotatoria SP 114/viale Parisoli alla rotatoria SP467,9335,00,9291,44,6311,3024,0,9335
2019/02,670,11/02/2019,1,SP 114 dalla rotatoria SP 114/viale Parisoli alla rotatoria SP467,16541,00,15828,713,13462,3079,16541,0
2019/02,670,12/02/2019,2,SP 114 dalla rotatoria SP 114/viale Parisoli alla rotatoria SP467,16956,00,16150,806,13741,3215,16956,0
2019/02,670,13/02/2019,3,SP 114 dalla rotatoria SP 114/viale Parisoli alla rotatoria SP467,17211,00,16403,808,13834,3377,17211,0
2019/02,670,14/02/2019,4,SP 114 dalla rotatoria SP 114/viale Parisoli alla rotatoria SP467,17229,10,16435,793,13700,3529,17229,0
2019/02,6,15/02/2019,5,SS 12 tra Fiumalbo e Abetone,2637,00,2582,55,1975,662,2637,0
2019/02,6,16/02/2019,6,SS 12 tra Fiumalbo e Abetone,3798,00,3775,23,2986,812,0,3798
2019/02,6,17/02/2019,7,SS 12 tra Fiumalbo e Abetone,3918,00,3897,21,3359,559,0,3918
2019/02,6,18/02/2019,1,SS 12 tra Fiumalbo e Abetone,1887,00,1837,50,1639,248,1887,0
2019/02,6,19/02/2019,2,SS 12 tra Fiumalbo e Abetone,1912,00,1860,52,1624,288,1912,0
2019/02,6,20/02/2019,3,SS 12 tra Fiumalbo e Abetone,1860,00,1821,39,1574,286,1860,0
2019/02,6,21/02/2019,4,SS 12 tra Fiumalbo e Abetone,1942,00,1896,46,1606,336,1942,0
2019/02,6,22/02/2019,5,SS 12 tra Fiumalbo e Abetone,2590,00,2540,50,1972,618,2590,0
2019/02,6,23/02/2019,6,SS 12 tra Fiumalbo e Abetone,3472,00,3450,22,2705,767,0,3472
2019/02,6,24/02/2019,7,SS 12 tra Fiumalbo e Abetone,3513,00,3504,9,3076,437,0,3513
2019/02,6,25/02/2019,1,SS 12 tra Fiumalbo e Abetone,1686,00,1632,54,1444,242,1686,0
2019/02,6,26/02/2019,2,SS 12 tra Fiumalbo e Abetone,1743,00,1697,46,1459,284,1743,0
2019/02,6,27/02/2019,3,SS 12 tra Fiumalbo e Abetone,1758,00,1698,60,1470,288,1758,0
2019/02,6,28/02/2019,4,SS 12 tra Fiumalbo e Abetone,1834,00,1780,54,1513,321,1834,0
2019/02,7,15/02/2019,5,SS 64 tra Porretta Terme e Sambuca Pistoiese,7485,10,7264,220,5959,1526,7485,0
2019/02,7,16/02/2019,6,SS 64 tra Porretta Terme e Sambuca Pistoiese,7812,00,7707,105,6414,1398,0,7812
2019/02,7,17/02/2019,7,SS 64 tra Porretta Terme e Sambuca Pistoiese,6945,00,6918,27,5689,1256,0,6945
2019/02,7,18/02/2019,1,SS 64 tra Porretta Terme e Sambuca Pistoiese,6312,00,6115,197,5258,1054,6312,0
2019/02,7,19/02/2019,2,SS 64 tra Porretta Terme e Sambuca Pistoiese,6660,10,6430,229,5444,1216,6660,0
2019/02,7,20/02/2019,3,SS 64 tra Porretta Terme e Sambuca Pistoiese,6623,00,6397,226,5471,1152,6623,0
2019/02,7,21/02/2019,4,SS 64 tra Porretta Terme e Sambuca Pistoiese,6417,00,6211,206,5264,1153,6417,0
2019/02,7,22/02/2019,5,SS 64 tra Porretta Terme e Sambuca Pistoiese,7225,10,6992,232,5810,1415,7225,0
2019/02,7,23/02/2019,6,SS 64 tra Porretta Terme e Sambuca Pistoiese,7766,20,7650,114,6303,1463,0,7766
2019/02,7,24/02/2019,7,SS 64 tra Porretta Terme e Sambuca Pistoiese,6105,10,6062,42,5013,1092,0,6105
2019/02,7,25/02/2019,1,SS 64 tra Porretta Terme e Sambuca Pistoiese,6498,10,6292,205,5348,1150,6498,0
2019/02,7,26/02/2019,2,SS 64 tra Porretta Terme e Sambuca Pistoiese,6514,20,6314,198,5302,1212,6514,0
2019/02,7,27/02/2019,3,SS 64 tra Porretta Terme e Sambuca Pistoiese,6433,00,6212,221,5306,1127,6433,0
2019/02,7,28/02/2019,4,SS 64 tra Porretta Terme e Sambuca Pistoiese,6410,00,6188,222,5189,1221,6410,0
2019/02,9,15/02/2019,5,SS 67 tra Rocca San Casciano e Portico San Benedetto,1193,00,1120,73,942,251,1193,0
2019/02,9,16/02/2019,6,SS 67 tra Rocca San Casciano e Portico San Benedetto,1084,10,1052,31,874,210,0,1084
2019/02,9,17/02/2019,7,SS 67 tra Rocca San Casciano e Portico San Benedetto,1282,00,1278,4,1062,220,0,1282
2019/02,9,18/02/2019,1,SS 67 tra Rocca San Casciano e Portico San Benedetto,1141,00,1065,76,950,191,1141,0
2019/02,9,19/02/2019,2,SS 67 tra Rocca San Casciano e Portico San Benedetto,1121,00,1042,79,915,206,1121,0
2019/02,9,20/02/2019,3,SS 67 tra Rocca San Casciano e Portico San Benedetto,1224,00,1137,87,1030,194,1224,0
2019/02,9,21/02/2019,4,SS 67 tra Rocca San Casciano e Portico San Benedetto,1121,00,1033,88,930,191,1121,0
2019/02,9,22/02/2019,5,SS 67 tra Rocca San Casciano e Portico San Benedetto,1213,00,1125,88,981,232,1213,0
2019/02,9,23/02/2019,6,SS 67 tra Rocca San Casciano e Portico San Benedetto,1152,00,1117,35,924,228,0,1152
2019/02,9,24/02/2019,7,SS 67 tra Rocca San Casciano e Portico San Benedetto,1122,00,1118,4,935,187,0,1122
2019/02,9,25/02/2019,1,SS 67 tra Rocca San Casciano e Portico San Benedetto,1102,00,1018,84,909,193,1102,0
2019/02,9,26/02/2019,2,SS 67 tra Rocca San Casciano e Portico San Benedetto,1170,00,1066,104,966,204,1170,0
2019/02,9,27/02/2019,3,SS 67 tra Rocca San Casciano e Portico San Benedetto,1260,00,1174,86,1033,227,1260,0
2019/02,9,28/02/2019,4,SS 67 tra Rocca San Casciano e Portico San Benedetto,1134,10,1032,101,918,216,1134,0
2019/02,12,15/02/2019,5,SS 16 al Confine regionale (Marche),17188,10,16541,646,13161,4027,17188,0
2019/02,12,16/02/2019,6,SS 16 al Confine regionale (Marche),16623,20,16388,233,11937,4686,0,16623
2019/02,12,17/02/2019,7,SS 16 al Confine regionale (Marche),15730,00,15678,52,11580,4150,0,15730
2019/02,12,18/02/2019,1,SS 16 al Confine regionale (Marche),15824,00,15176,648,12625,3199,15824,0
2019/02,12,19/02/2019,2,SS 16 al Confine regionale (Marche),16276,10,15510,765,12896,3380,16276,0
2019/02,12,20/02/2019,3,SS 16 al Confine regionale (Marche),15998,00,15344,654,12743,3255,15998,0
2019/02,12,21/02/2019,4,SS 16 al Confine regionale (Marche),16754,00,16017,737,13309,3445,16754,0
2019/02,12,22/02/2019,5,SS 16 al Confine regionale (Marche),16958,00,16245,713,13010,3948,16958,0
2019/02,12,23/02/2019,6,SS 16 al Confine regionale (Marche),16341,10,16124,216,11818,4523,0,16341
2019/02,12,24/02/2019,7,SS 16 al Confine regionale (Marche),14482,00,14426,56,10528,3954,0,14482
2019/02,12,25/02/2019,1,SS 16 al Confine regionale (Marche),15879,00,15260,619,12703,3176,15879,0
2019/02,12,26/02/2019,2,SS 16 al Confine regionale (Marche),16326,20,15704,620,13092,3234,16326,0
2019/02,12,27/02/2019,3,SS 16 al Confine regionale (Marche),16394,00,15684,710,13020,3374,16394,0
2019/02,12,28/02/2019,4,SS 16 al Confine regionale (Marche),16717,10,16024,692,13170,3547,16717,0
2019/02,16,15/02/2019,5,SP 69 in località Pilastri al Confine regionale,1503,00,1369,134,1181,322,1503,0
2019/02,16,16/02/2019,6,SP 69 in località Pilastri al Confine regionale,1445,00,1407,38,1104,341,0,1445
2019/02,16,17/02/2019,7,SP 69 in località Pilastri al Confine regionale,1497,00,1475,22,1126,371,0,1497
2019/02,16,18/02/2019,1,SP 69 in località Pilastri al Confine regionale,1454,00,1297,157,1181,273,1454,0
2019/02,16,19/02/2019,2,SP 69 in località Pilastri al Confine regionale,1526,00,1395,131,1231,295,1526,0
2019/02,16,20/02/2019,3,SP 69 in località Pilastri al Confine regionale,1462,00,1319,143,1181,281,1462,0
2019/02,16,21/02/2019,4,SP 69 in località Pilastri al Confine regionale,1462,00,1288,174,1187,275,1462,0
2019/02,16,22/02/2019,5,SP 69 in località Pilastri al Confine regionale,1549,00,1405,144,1235,314,1549,0
2019/02,16,23/02/2019,6,SP 69 in località Pilastri al Confine regionale,1402,00,1359,43,1037,365,0,1402
2019/02,16,24/02/2019,7,SP 69 in località Pilastri al Confine regionale,1488,00,1473,15,1103,385,0,1488
2019/02,16,25/02/2019,1,SP 69 in località Pilastri al Confine regionale,1448,20,1289,157,1167,281,1448,0
2019/02,16,26/02/2019,2,SP 69 in località Pilastri al Confine regionale,1470,00,1340,130,1212,258,1470,0
2019/02,16,27/02/2019,3,SP 69 in località Pilastri al Confine regionale,1472,10,1324,147,1192,280,1472,0
2019/02,16,28/02/2019,4,SP 69 in località Pilastri al Confine regionale,1483,00,1354,129,1203,280,1483,0
2019/02,17,15/02/2019,5,SS 12 al Confine regionale (Lombardia),11316,00,10168,1148,8655,2661,11316,0
2019/02,17,16/02/2019,6,SS 12 al Confine regionale (Lombardia),9272,00,9067,205,6716,2556,0,9272
2019/02,17,17/02/2019,7,SS 12 al Confine regionale (Lombardia),7000,00,6955,45,4863,2137,0,7000
2019/02,17,18/02/2019,1,SS 12 al Confine regionale (Lombardia),10543,00,9402,1141,8415,2128,10543,0
2019/02,17,19/02/2019,2,SS 12 al Confine regionale (Lombardia),10846,00,9615,1231,8548,2298,10846,0
2019/02,17,20/02/2019,3,SS 12 al Confine regionale (Lombardia),10609,00,9473,1136,8307,2302,10609,0
2019/02,17,21/02/2019,4,SS 12 al Confine regionale (Lombardia),11502,10,9974,1527,9120,2382,11502,0
2019/02,17,22/02/2019,5,SS 12 al Confine regionale (Lombardia),11293,00,10205,1088,8606,2687,11293,0
2019/02,17,23/02/2019,6,SS 12 al Confine regionale (Lombardia),9277,00,9069,208,6740,2537,0,9277
2019/02,17,24/02/2019,7,SS 12 al Confine regionale (Lombardia),7534,00,7483,51,5458,2076,0,7534
2019/02,17,25/02/2019,1,SS 12 al Confine regionale (Lombardia),10744,10,9587,1156,8548,2196,10744,0
2019/02,17,26/02/2019,2,SS 12 al Confine regionale (Lombardia),10639,00,9451,1188,8421,2218,10639,0
2019/02,17,27/02/2019,3,SS 12 al Confine regionale (Lombardia),11007,00,9822,1185,8669,2338,11007,0
2019/02,17,28/02/2019,4,SS 12 al Confine regionale (Lombardia),10978,00,9853,1125,8523,2455,10978,0
2019/02,19,15/02/2019,5,SP 343R tra Colorno e Casalmaggiore,1025,10,900,124,875,150,1025,0
2019/02,19,16/02/2019,6,SP 343R tra Colorno e Casalmaggiore,788,00,772,16,684,104,0,788
2019/02,19,17/02/2019,7,SP 343R tra Colorno e Casalmaggiore,652,00,649,3,574,78,0,652
2019/02,19,18/02/2019,1,SP 343R tra Colorno e Casalmaggiore,1017,00,901,116,885,132,1017,0
2019/02,19,19/02/2019,2,SP 343R tra Colorno e Casalmaggiore,955,00,854,101,816,139,955,0
2019/02,19,20/02/2019,3,SP 343R tra Colorno e Casalmaggiore,952,00,860,92,789,163,952,0
2019/02,19,21/02/2019,4,SP 343R tra Colorno e Casalmaggiore,1051,00,948,103,880,171,1051,0
2019/02,19,22/02/2019,5,SP 343R tra Colorno e Casalmaggiore,1020,00,899,121,860,160,1020,0
2019/02,19,23/02/2019,6,SP 343R tra Colorno e Casalmaggiore,764,00,745,19,615,149,0,764
2019/02,19,24/02/2019,7,SP 343R tra Colorno e Casalmaggiore,596,00,590,6,501,95,0,596
2019/02,19,25/02/2019,1,SP 343R tra Colorno e Casalmaggiore,1049,00,933,116,901,148,1049,0
2019/02,19,26/02/2019,2,SP 343R tra Colorno e Casalmaggiore,953,00,859,94,817,136,953,0
2019/02,19,27/02/2019,3,SP 343R tra Colorno e Casalmaggiore,1002,00,894,108,824,178,1002,0
2019/02,19,28/02/2019,4,SP 343R tra Colorno e Casalmaggiore,1027,00,940,87,892,135,1027,0
2019/02,25,15/02/2019,5,SS 9 tra San Prospero (Case Crostolo) e Sant'Ilario d'Enza,31891,10,29853,2037,23137,8754,31891,0
2019/02,25,16/02/2019,6,SS 9 tra San Prospero (Case Crostolo) e Sant'Ilario d'Enza,30036,10,29481,554,20513,9523,0,30036
2019/02,25,17/02/2019,7,SS 9 tra San Prospero (Case Crostolo) e Sant'Ilario d'Enza,26221,10,26072,148,17959,8262,0,26221
2019/02,25,18/02/2019,1,SS 9 tra San Prospero (Case Crostolo) e Sant'Ilario d'Enza,29394,10,27284,2109,22545,6849,29394,0
2019/02,25,19/02/2019,2,SS 9 tra San Prospero (Case Crostolo) e Sant'Ilario d'Enza,29860,20,27688,2170,22609,7251,29860,0
2019/02,25,20/02/2019,3,SS 9 tra San Prospero (Case Crostolo) e Sant'Ilario d'Enza,30237,30,28122,2112,22590,7647,30237,0
2019/02,25,21/02/2019,4,SS 9 tra San Prospero (Case Crostolo) e Sant'Ilario d'Enza,30511,10,28381,2129,22727,7784,30511,0
2019/02,25,22/02/2019,5,SS 9 tra San Prospero (Case Crostolo) e Sant'Ilario d'Enza,32333,30,30158,2172,23337,8996,32333,0
2019/02,25,23/02/2019,6,SS 9 tra San Prospero (Case Crostolo) e Sant'Ilario d'Enza,30520,30,29900,617,20663,9857,0,30520
2019/02,25,24/02/2019,7,SS 9 tra San Prospero (Case Crostolo) e Sant'Ilario d'Enza,25364,10,25178,185,16955,8409,0,25364
2019/02,25,25/02/2019,1,SS 9 tra San Prospero (Case Crostolo) e Sant'Ilario d'Enza,29753,30,27597,2153,22601,7152,29753,0
2019/02,25,26/02/2019,2,SS 9 tra San Prospero (Case Crostolo) e Sant'Ilario d'Enza,30279,70,27990,2282,23047,7232,30279,0
2019/02,25,27/02/2019,3,SS 9 tra San Prospero (Case Crostolo) e Sant'Ilario d'Enza,30868,40,28596,2268,23056,7812,30868,0
2019/02,25,28/02/2019,4,SS 9 tra San Prospero (Case Crostolo) e Sant'Ilario d'Enza,31128,20,28883,2243,23045,8083,31128,0
2019/02,29,15/02/2019,5,SS 9 tra Modena e Rubiera,26142,30,23713,2426,19007,7135,26142,0
2019/02,29,16/02/2019,6,SS 9 tra Modena e Rubiera,25079,20,24692,385,16941,8138,0,25079
2019/02,29,17/02/2019,7,SS 9 tra Modena e Rubiera,24226,20,24098,126,17102,7124,0,24226
2019/02,29,18/02/2019,1,SS 9 tra Modena e Rubiera,23068,40,20781,2283,17295,5773,23068,0
2019/02,29,19/02/2019,2,SS 9 tra Modena e Rubiera,24582,00,21999,2583,18609,5973,24582,0
2019/02,29,20/02/2019,3,SS 9 tra Modena e Rubiera,24742,20,22136,2604,18730,6012,24742,0
2019/02,29,21/02/2019,4,SS 9 tra Modena e Rubiera,24777,20,22239,2536,18522,6255,24777,0
2019/02,29,22/02/2019,5,SS 9 tra Modena e Rubiera,25865,00,23468,2397,18740,7125,25865,0
2019/02,29,23/02/2019,6,SS 9 tra Modena e Rubiera,24286,00,23882,404,16419,7867,0,24286
2019/02,29,24/02/2019,7,SS 9 tra Modena e Rubiera,22611,10,22487,123,15900,6711,0,22611
2019/02,29,25/02/2019,1,SS 9 tra Modena e Rubiera,24173,30,21746,2424,18336,5837,24173,0
2019/02,29,26/02/2019,2,SS 9 tra Modena e Rubiera,24329,10,21889,2439,18390,5939,24329,0
2019/02,29,27/02/2019,3,SS 9 tra Modena e Rubiera,24968,20,22464,2502,18701,6267,24968,0
2019/02,29,28/02/2019,4,SS 9 tra Modena e Rubiera,24933,00,22405,2528,18585,6348,24933,0
2019/02,52,15/02/2019,5,SP 253 tra Sesto Imolese e Medicina,6411,00,5736,675,4915,1496,6411,0
2019/02,52,16/02/2019,6,SP 253 tra Sesto Imolese e Medicina,4987,00,4823,164,3684,1303,0,4987
2019/02,52,17/02/2019,7,SP 253 tra Sesto Imolese e Medicina,4681,00,4641,40,3538,1143,0,4681
2019/02,52,18/02/2019,1,SP 253 tra Sesto Imolese e Medicina,6186,00,5516,670,4824,1362,6186,0
2019/02,52,19/02/2019,2,SP 253 tra Sesto Imolese e Medicina,6260,00,5572,688,4925,1335,6260,0
2019/02,52,20/02/2019,3,SP 253 tra Sesto Imolese e Medicina,6405,00,5752,653,5019,1386,6405,0
2019/02,52,21/02/2019,4,SP 253 tra Sesto Imolese e Medicina,6307,00,5648,659,4913,1394,6307,0
2019/02,52,22/02/2019,5,SP 253 tra Sesto Imolese e Medicina,6592,00,5884,708,5005,1587,6592,0
2019/02,52,23/02/2019,6,SP 253 tra Sesto Imolese e Medicina,5060,00,4911,149,3660,1400,0,5060
2019/02,52,24/02/2019,7,SP 253 tra Sesto Imolese e Medicina,4514,00,4460,54,3314,1200,0,4514
2019/02,52,25/02/2019,1,SP 253 tra Sesto Imolese e Medicina,6211,00,5544,667,4830,1381,6211,0
2019/02,52,26/02/2019,2,SP 253 tra Sesto Imolese e Medicina,6261,00,5595,666,4876,1385,6261,0
2019/02,52,27/02/2019,3,SP 253 tra Sesto Imolese e Medicina,6336,00,5679,657,4898,1438,6336,0
2019/02,52,28/02/2019,4,SP 253 tra Sesto Imolese e Medicina,6425,00,5766,659,5002,1423,6425,0
2019/02,53,15/02/2019,5,SS 309 a San Giuseppe di Comacchio,10208,00,6789,3419,7710,2498,10208,0
2019/02,53,16/02/2019,6,SS 309 a San Giuseppe di Comacchio,8490,00,7569,921,6251,2239,0,8490
2019/02,53,17/02/2019,7,SS 309 a San Giuseppe di Comacchio,9093,00,8750,343,6826,2267,0,9093
2019/02,53,18/02/2019,1,SS 309 a San Giuseppe di Comacchio,9818,00,6370,3448,7599,2219,9818,0
2019/02,53,19/02/2019,2,SS 309 a San Giuseppe di Comacchio,10298,00,6390,3908,8198,2100,10298,0
2019/02,53,20/02/2019,3,SS 309 a San Giuseppe di Comacchio,9987,00,6154,3833,7844,2143,9987,0
2019/02,53,21/02/2019,4,SS 309 a San Giuseppe di Comacchio,9689,00,6034,3655,7548,2141,9689,0
2019/02,53,22/02/2019,5,SS 309 a San Giuseppe di Comacchio,10228,00,6849,3379,7928,2300,10228,0
2019/02,53,23/02/2019,6,SS 309 a San Giuseppe di Comacchio,8027,00,7155,872,5934,2093,0,8027
2019/02,53,24/02/2019,7,SS 309 a San Giuseppe di Comacchio,9683,00,9349,334,7370,2313,0,9683
2019/02,53,25/02/2019,1,SS 309 a San Giuseppe di Comacchio,9577,00,6154,3423,7388,2189,9577,0
2019/02,53,26/02/2019,2,SS 309 a San Giuseppe di Comacchio,9684,00,5945,3739,7574,2110,9684,0
2019/02,53,27/02/2019,3,SS 309 a San Giuseppe di Comacchio,10104,00,6272,3832,7927,2177,10104,0
2019/02,53,28/02/2019,4,SS 309 a San Giuseppe di Comacchio,9789,00,6186,3603,7557,2232,9789,0
2019/02,95,15/02/2019,5,SP 10R tra Castel San Giovanni e Sarmato,,,,,,,,
2019/02,95,16/02/2019,6,SP 10R tra Castel San Giovanni e Sarmato,,,,,,,,
2019/02,95,17/02/2019,7,SP 10R tra Castel San Giovanni e Sarmato,,,,,,,,
2019/02,95,18/02/2019,1,SP 10R tra Castel San Giovanni e Sarmato,,,,,,,,
2019/02,95,19/02/2019,2,SP 10R tra Castel San Giovanni e Sarmato,,,,,,,,
2019/02,95,20/02/2019,3,SP 10R tra Castel San Giovanni e Sarmato,,,,,,,,
2019/02,95,21/02/2019,4,SP 10R tra Castel San Giovanni e Sarmato,,,,,,,,
2019/02,95,22/02/2019,5,SP 10R tra Castel San Giovanni e Sarmato,,,,,,,,
2019/02,95,23/02/2019,6,SP 10R tra Castel San Giovanni e Sarmato,,,,,,,,
2019/02,95,24/02/2019,7,SP 10R tra Castel San Giovanni e Sarmato,,,,,,,,
2019/02,95,25/02/2019,1,SP 10R tra Castel San Giovanni e Sarmato,,,,,,,,
2019/02,95,26/02/2019,2,SP 10R tra Castel San Giovanni e Sarmato,,,,,,,,
2019/02,95,27/02/2019,3,SP 10R tra Castel San Giovanni e Sarmato,,,,,,,,
2019/02,95,28/02/2019,4,SP 10R tra Castel San Giovanni e Sarmato,,,,,,,,
2019/02,98,15/02/2019,5,SP 302R tra Brisighella e Marradi,3175,00,3056,119,2386,789,3175,0
2019/02,98,16/02/2019,6,SP 302R tra Brisighella e Marradi,3028,00,2995,33,2308,720,0,3028
2019/02,98,17/02/2019,7,SP 302R tra Brisighella e Marradi,3154,00,3148,6,2566,588,0,3154
2019/02,98,18/02/2019,1,SP 302R tra Brisighella e Marradi,3040,00,2916,124,2391,649,3040,0
2019/02,98,19/02/2019,2,SP 302R tra Brisighella e Marradi,2921,00,2820,101,2289,632,2921,0
2019/02,98,20/02/2019,3,SP 302R tra Brisighella e Marradi,3039,00,2934,105,2398,641,3039,0
2019/02,98,21/02/2019,4,SP 302R tra Brisighella e Marradi,3039,00,2934,105,2379,660,3039,0
2019/02,98,22/02/2019,5,SP 302R tra Brisighella e Marradi,3239,00,3154,85,2477,762,3239,0
2019/02,98,23/02/2019,6,SP 302R tra Brisighella e Marradi,3315,00,3194,121,2517,798,0,3315
2019/02,98,24/02/2019,7,SP 302R tra Brisighella e Marradi,3005,00,2995,10,2412,593,0,3005
2019/02,98,25/02/2019,1,SP 302R tra Brisighella e Marradi,2931,00,2844,87,2281,650,2931,0
2019/02,98,26/02/2019,2,SP 302R tra Brisighella e Marradi,2994,00,2885,109,2343,651,2994,0
2019/02,98,27/02/2019,3,SP 302R tra Brisighella e Marradi,3267,00,3066,201,2579,688,3267,0
2019/02,98,28/02/2019,4,SP 302R tra Brisighella e Marradi,3043,10,2917,125,2339,704,3043,0
2019/02,100,15/02/2019,5,SP 258R tra Villa Verucchio ed ex Confine regionale (località Dogana),16164,00,14952,1212,12637,3527,16164,0
2019/02,100,16/02/2019,6,SP 258R tra Villa Verucchio ed ex Confine regionale (località Dogana),13914,10,13584,329,10518,3396,0,13914
2019/02,100,17/02/2019,7,SP 258R tra Villa Verucchio ed ex Confine regionale (località Dogana),13574,00,13517,57,10598,2976,0,13574
2019/02,100,18/02/2019,1,SP 258R tra Villa Verucchio ed ex Confine regionale (località Dogana),14758,00,13539,1219,12023,2735,14758,0
2019/02,100,19/02/2019,2,SP 258R tra Villa Verucchio ed ex Confine regionale (località Dogana),14922,00,13711,1211,11993,2929,14922,0
2019/02,100,20/02/2019,3,SP 258R tra Villa Verucchio ed ex Confine regionale (località Dogana),15052,00,13770,1282,12082,2970,15052,0
2019/02,100,21/02/2019,4,SP 258R tra Villa Verucchio ed ex Confine regionale (località Dogana),15045,00,13780,1265,12025,3020,15045,0
2019/02,100,22/02/2019,5,SP 258R tra Villa Verucchio ed ex Confine regionale (località Dogana),15921,00,14720,1201,12569,3352,15921,0
2019/02,100,23/02/2019,6,SP 258R tra Villa Verucchio ed ex Confine regionale (località Dogana),13805,00,13484,321,10405,3400,0,13805
2019/02,100,24/02/2019,7,SP 258R tra Villa Verucchio ed ex Confine regionale (località Dogana),11997,00,11935,62,9114,2883,0,11997
2019/02,100,25/02/2019,1,SP 258R tra Villa Verucchio ed ex Confine regionale (località Dogana),14407,00,13135,1272,11591,2816,14407,0
2019/02,100,26/02/2019,2,SP 258R tra Villa Verucchio ed ex Confine regionale (località Dogana),15016,00,13761,1255,12054,2962,15016,0
2019/02,100,27/02/2019,3,SP 258R tra Villa Verucchio ed ex Confine regionale (località Dogana),15084,20,13855,1227,12102,2982,15084,0
2019/02,100,28/02/2019,4,SP 258R tra Villa Verucchio ed ex Confine regionale (località Dogana),15265,00,14034,1231,12117,3148,15265,0
2019/02,104,15/02/2019,5,SP 10 nuovo ponte sul Po tra innesto variante Zibello e confine regionale (Lombardia),4698,00,3501,1197,3647,1051,4698,0
2019/02,104,16/02/2019,6,SP 10 nuovo ponte sul Po tra innesto variante Zibello e confine regionale (Lombardia),3666,00,3395,271,2780,886,0,3666
2019/02,104,17/02/2019,7,SP 10 nuovo ponte sul Po tra innesto variante Zibello e confine regionale (Lombardia),4147,00,4081,66,3172,975,0,4147
2019/02,104,18/02/2019,1,SP 10 nuovo ponte sul Po tra innesto variante Zibello e confine regionale (Lombardia),4439,00,3183,1256,3574,865,4439,0
2019/02,104,19/02/2019,2,SP 10 nuovo ponte sul Po tra innesto variante Zibello e confine regionale (Lombardia),4498,00,3199,1299,3590,908,4498,0
2019/02,104,20/02/2019,3,SP 10 nuovo ponte sul Po tra innesto variante Zibello e confine regionale (Lombardia),4779,00,3445,1334,3869,910,4779,0
2019/02,104,21/02/2019,4,SP 10 nuovo ponte sul Po tra innesto variante Zibello e confine regionale (Lombardia),4753,00,3405,1348,3823,930,4753,0
2019/02,104,22/02/2019,5,SP 10 nuovo ponte sul Po tra innesto variante Zibello e confine regionale (Lombardia),4815,00,3517,1298,3774,1041,4815,0
2019/02,104,23/02/2019,6,SP 10 nuovo ponte sul Po tra innesto variante Zibello e confine regionale (Lombardia),3681,00,3426,255,2787,894,0,3681
2019/02,104,24/02/2019,7,SP 10 nuovo ponte sul Po tra innesto variante Zibello e confine regionale (Lombardia),4172,00,4116,56,3207,965,0,4172
2019/02,104,25/02/2019,1,SP 10 nuovo ponte sul Po tra innesto variante Zibello e confine regionale (Lombardia),4548,00,3258,1290,3661,887,4548,0
2019/02,104,26/02/2019,2,SP 10 nuovo ponte sul Po tra innesto variante Zibello e confine regionale (Lombardia),4550,20,3298,1250,3669,881,4550,0
2019/02,104,27/02/2019,3,SP 10 nuovo ponte sul Po tra innesto variante Zibello e confine regionale (Lombardia),4707,00,3407,1300,3802,905,4707,0
2019/02,104,28/02/2019,4,SP 10 nuovo ponte sul Po tra innesto variante Zibello e confine regionale (Lombardia),4802,10,3454,1347,3867,935,4802,0
2019/02,107,15/02/2019,5,SP 85 tra Rubiera e bivio SP 13MO (c/o Campogalliano),9345,00,8392,953,7169,2176,9345,0
2019/02,107,16/02/2019,6,SP 85 tra Rubiera e bivio SP 13MO (c/o Campogalliano),8095,10,7945,149,5925,2170,0,8095
2019/02,107,17/02/2019,7,SP 85 tra Rubiera e bivio SP 13MO (c/o Campogalliano),7279,20,7237,40,5433,1846,0,7279
2019/02,107,18/02/2019,1,SP 85 tra Rubiera e bivio SP 13MO (c/o Campogalliano),8640,00,7674,966,6875,1765,8640,0
2019/02,107,19/02/2019,2,SP 85 tra Rubiera e bivio SP 13MO (c/o Campogalliano),8862,10,7818,1043,7038,1824,8862,0
2019/02,107,20/02/2019,3,SP 85 tra Rubiera e bivio SP 13MO (c/o Campogalliano),9136,00,8110,1026,7187,1949,9136,0
2019/02,107,21/02/2019,4,SP 85 tra Rubiera e bivio SP 13MO (c/o Campogalliano),9327,00,8282,1045,7383,1944,9327,0
2019/02,107,22/02/2019,5,SP 85 tra Rubiera e bivio SP 13MO (c/o Campogalliano),9350,00,8309,1041,7229,2121,9350,0
2019/02,107,23/02/2019,6,SP 85 tra Rubiera e bivio SP 13MO (c/o Campogalliano),7755,00,7624,131,5598,2157,0,7755
2019/02,107,24/02/2019,7,SP 85 tra Rubiera e bivio SP 13MO (c/o Campogalliano),6558,00,6511,47,4899,1659,0,6558
2019/02,107,25/02/2019,1,SP 85 tra Rubiera e bivio SP 13MO (c/o Campogalliano),8803,00,7823,980,7022,1781,8803,0
2019/02,107,26/02/2019,2,SP 85 tra Rubiera e bivio SP 13MO (c/o Campogalliano),8803,00,7755,1048,7000,1803,8803,0
2019/02,107,27/02/2019,3,SP 85 tra Rubiera e bivio SP 13MO (c/o Campogalliano),9031,00,7977,1054,7039,1992,9031,0
2019/02,107,28/02/2019,4,SP 85 tra Rubiera e bivio SP 13MO (c/o Campogalliano),9032,00,8072,960,6969,2063,9032,0
2019/02,108,15/02/2019,5,SP 412R tra Castel San Giovanni (Casello A 21) e ponte fiume Po,12482,120,12145,325,9238,3244,12482,0
2019/02,108,16/02/2019,6,SP 412R tra Castel San Giovanni (Casello A 21) e ponte fiume Po,11331,40,11184,143,8635,2696,0,11331
2019/02,108,17/02/2019,7,SP 412R tra Castel San Giovanni (Casello A 21) e ponte fiume Po,10863,00,10825,38,8449,2414,0,10863
2019/02,108,18/02/2019,1,SP 412R tra Castel San Giovanni (Casello A 21) e ponte fiume Po,11185,60,10877,302,8468,2717,11185,0
2019/02,108,19/02/2019,2,SP 412R tra Castel San Giovanni (Casello A 21) e ponte fiume Po,12078,80,11692,378,9139,2939,12078,0
2019/02,108,20/02/2019,3,SP 412R tra Castel San Giovanni (Casello A 21) e ponte fiume Po,12138,180,11686,434,9251,2887,12138,0
2019/02,108,21/02/2019,4,SP 412R tra Castel San Giovanni (Casello A 21) e ponte fiume Po,13963,190,13380,564,11053,2910,13963,0
2019/02,108,22/02/2019,5,SP 412R tra Castel San Giovanni (Casello A 21) e ponte fiume Po,12511,150,12071,425,9371,3140,12511,0
2019/02,108,23/02/2019,6,SP 412R tra Castel San Giovanni (Casello A 21) e ponte fiume Po,11434,40,11301,129,8649,2785,0,11434
2019/02,108,24/02/2019,7,SP 412R tra Castel San Giovanni (Casello A 21) e ponte fiume Po,10748,00,10714,34,8399,2349,0,10748
2019/02,108,25/02/2019,1,SP 412R tra Castel San Giovanni (Casello A 21) e ponte fiume Po,11461,50,11100,356,8715,2746,11461,0
2019/02,108,26/02/2019,2,SP 412R tra Castel San Giovanni (Casello A 21) e ponte fiume Po,11831,90,11425,397,8868,2963,11831,0
2019/02,108,27/02/2019,3,SP 412R tra Castel San Giovanni (Casello A 21) e ponte fiume Po,11933,110,11553,369,9004,2929,11933,0
2019/02,108,28/02/2019,4,SP 412R tra Castel San Giovanni (Casello A 21) e ponte fiume Po,12341,100,11965,366,9310,3031,12341,0
2019/02,112,15/02/2019,5,SP 111 tra Boretto e Viadana sul ponte Po,21712,20,18999,2711,16548,5164,21712,0
2019/02,112,16/02/2019,6,SP 111 tra Boretto e Viadana sul ponte Po,19847,10,19242,604,14815,5032,0,19847
2019/02,112,17/02/2019,7,SP 111 tra Boretto e Viadana sul ponte Po,15661,00,15470,191,11250,4411,0,15661
2019/02,112,18/02/2019,1,SP 111 tra Boretto e Viadana sul ponte Po,19993,60,17100,2887,15632,4361,19993,0
2019/02,112,19/02/2019,2,SP 111 tra Boretto e Viadana sul ponte Po,20326,50,17393,2928,15979,4347,20326,0
2019/02,112,20/02/2019,3,SP 111 tra Boretto e Viadana sul ponte Po,19740,40,17037,2699,15186,4554,19740,0
2019/02,112,21/02/2019,4,SP 111 tra Boretto e Viadana sul ponte Po,21016,30,17930,3083,16370,4646,21016,0
2019/02,112,22/02/2019,5,SP 111 tra Boretto e Viadana sul ponte Po,21407,60,18652,2749,16347,5060,21407,0
2019/02,112,23/02/2019,6,SP 111 tra Boretto e Viadana sul ponte Po,19173,10,18590,582,14067,5106,0,19173
2019/02,112,24/02/2019,7,SP 111 tra Boretto e Viadana sul ponte Po,16050,00,15834,216,11507,4543,0,16050
2019/02,112,25/02/2019,1,SP 111 tra Boretto e Viadana sul ponte Po,20162,40,17398,2760,15783,4379,20162,0
2019/02,112,26/02/2019,2,SP 111 tra Boretto e Viadana sul ponte Po,19509,10,16643,2865,15037,4472,19509,0
2019/02,112,27/02/2019,3,SP 111 tra Boretto e Viadana sul ponte Po,20875,80,17929,2938,16138,4737,20875,0
2019/02,112,28/02/2019,4,SP 111 tra Boretto e Viadana sul ponte Po,21011,30,18102,2906,16191,4820,21011,0
2019/02,115,15/02/2019,5,SP 68 ad Ariano Polesine al Confine regionale (Veneto),2920,00,2551,369,2247,673,2920,0
2019/02,115,16/02/2019,6,SP 68 ad Ariano Polesine al Confine regionale (Veneto),2555,00,2487,68,1916,639,0,2555
2019/02,115,17/02/2019,7,SP 68 ad Ariano Polesine al Confine regionale (Veneto),2251,00,2238,13,1606,645,0,2251
2019/02,115,18/02/2019,1,SP 68 ad Ariano Polesine al Confine regionale (Veneto),2700,00,2363,337,2138,562,2700,0
2019/02,115,19/02/2019,2,SP 68 ad Ariano Polesine al Confine regionale (Veneto),2619,00,2299,320,2111,508,2619,0
2019/02,115,20/02/2019,3,SP 68 ad Ariano Polesine al Confine regionale (Veneto),2592,00,2254,338,2065,527,2592,0
2019/02,115,21/02/2019,4,SP 68 ad Ariano Polesine al Confine regionale (Veneto),2619,10,2317,301,2098,521,2619,0
2019/02,115,22/02/2019,5,SP 68 ad Ariano Polesine al Confine regionale (Veneto),2763,10,2457,305,2143,620,2763,0
2019/02,115,23/02/2019,6,SP 68 ad Ariano Polesine al Confine regionale (Veneto),2410,00,2341,69,1872,538,0,2410
2019/02,115,24/02/2019,7,SP 68 ad Ariano Polesine al Confine regionale (Veneto),2483,00,2463,20,1818,665,0,2483
2019/02,115,25/02/2019,1,SP 68 ad Ariano Polesine al Confine regionale (Veneto),2756,00,2460,296,2183,573,2756,0
2019/02,115,26/02/2019,2,SP 68 ad Ariano Polesine al Confine regionale (Veneto),2669,10,2350,318,2137,532,2669,0
2019/02,115,27/02/2019,3,SP 68 ad Ariano Polesine al Confine regionale (Veneto),2813,00,2513,300,2256,557,2813,0
2019/02,115,28/02/2019,4,SP 68 ad Ariano Polesine al Confine regionale (Veneto),2772,00,2492,280,2178,594,2772,0
2019/02,116,15/02/2019,5,SP 138 tra SPiero in Bagno (E 45) e Bagno di Romagna,5801,00,5511,290,4695,1106,5801,0
2019/02,116,16/02/2019,6,SP 138 tra SPiero in Bagno (E 45) e Bagno di Romagna,5555,00,5431,124,4277,1278,0,5555
2019/02,116,17/02/2019,7,SP 138 tra SPiero in Bagno (E 45) e Bagno di Romagna,5540,00,5514,26,4370,1170,0,5540
2019/02,116,18/02/2019,1,SP 138 tra SPiero in Bagno (E 45) e Bagno di Romagna,4859,00,4595,264,4059,800,4859,0
2019/02,116,19/02/2019,2,SP 138 tra SPiero in Bagno (E 45) e Bagno di Romagna,5042,10,4776,265,4229,813,5042,0
2019/02,116,20/02/2019,3,SP 138 tra SPiero in Bagno (E 45) e Bagno di Romagna,5054,00,4768,286,4272,782,5054,0
2019/02,116,21/02/2019,4,SP 138 tra SPiero in Bagno (E 45) e Bagno di Romagna,4959,10,4680,278,4059,900,4959,0
2019/02,116,22/02/2019,5,SP 138 tra SPiero in Bagno (E 45) e Bagno di Romagna,5467,00,5165,302,4432,1035,5467,0
2019/02,116,23/02/2019,6,SP 138 tra SPiero in Bagno (E 45) e Bagno di Romagna,5424,00,5297,127,4237,1187,0,5424
2019/02,116,24/02/2019,7,SP 138 tra SPiero in Bagno (E 45) e Bagno di Romagna,5210,00,5183,27,4072,1138,0,5210
2019/02,116,25/02/2019,1,SP 138 tra SPiero in Bagno (E 45) e Bagno di Romagna,5035,00,4767,268,4175,860,5035,0
2019/02,116,26/02/2019,2,SP 138 tra SPiero in Bagno (E 45) e Bagno di Romagna,5073,00,4807,266,4241,832,5073,0
2019/02,116,27/02/2019,3,SP 138 tra SPiero in Bagno (E 45) e Bagno di Romagna,5088,00,4817,271,4249,839,5088,0
2019/02,116,28/02/2019,4,SP 138 tra SPiero in Bagno (E 45) e Bagno di Romagna,5174,10,4898,275,4216,958,5174,0
2019/02,117,15/02/2019,5,SS 63 tra Collagna e Sassalbo (Passo del Cerreto),644,00,601,43,562,82,644,0
2019/02,117,16/02/2019,6,SS 63 tra Collagna e Sassalbo (Passo del Cerreto),948,00,928,20,831,117,0,948
2019/02,117,17/02/2019,7,SS 63 tra Collagna e Sassalbo (Passo del Cerreto),1362,00,1361,1,1200,162,0,1362
2019/02,117,18/02/2019,1,SS 63 tra Collagna e Sassalbo (Passo del Cerreto),490,00,446,44,440,50,490,0
2019/02,117,19/02/2019,2,SS 63 tra Collagna e Sassalbo (Passo del Cerreto),545,00,515,30,466,79,545,0
2019/02,117,20/02/2019,3,SS 63 tra Collagna e Sassalbo (Passo del Cerreto),492,00,459,33,450,42,492,0
2019/02,117,21/02/2019,4,SS 63 tra Collagna e Sassalbo (Passo del Cerreto),529,00,495,34,461,68,529,0
2019/02,117,22/02/2019,5,SS 63 tra Collagna e Sassalbo (Passo del Cerreto),673,00,639,34,575,98,673,0
2019/02,117,23/02/2019,6,SS 63 tra Collagna e Sassalbo (Passo del Cerreto),901,00,880,21,791,110,0,901
2019/02,117,24/02/2019,7,SS 63 tra Collagna e Sassalbo (Passo del Cerreto),1188,00,1185,3,1054,134,0,1188
2019/02,117,25/02/2019,1,SS 63 tra Collagna e Sassalbo (Passo del Cerreto),477,00,444,33,414,63,477,0
2019/02,117,26/02/2019,2,SS 63 tra Collagna e Sassalbo (Passo del Cerreto),394,00,366,28,345,49,394,0
2019/02,117,27/02/2019,3,SS 63 tra Collagna e Sassalbo (Passo del Cerreto),512,00,486,26,442,70,512,0
2019/02,117,28/02/2019,4,SS 63 tra Collagna e Sassalbo (Passo del Cerreto),592,00,556,36,501,91,592,0
2019/02,118,23/02/2019,6,SS 45 tra Ottone e Gorreto,528,00,517,11,416,112,0,528
2019/02,118,26/02/2019,2,SS 45 tra Ottone e Gorreto,,,,,,,,
2019/02,122,15/02/2019,5,SP 10R tra Piacenza (ponte fiume Trebbia) e San Nicolo',28100,80,27013,1079,20950,7150,28100,0
2019/02,122,16/02/2019,6,SP 10R tra Piacenza (ponte fiume Trebbia) e San Nicolo',26244,20,25914,328,18511,7733,0,26244
2019/02,122,17/02/2019,7,SP 10R tra Piacenza (ponte fiume Trebbia) e San Nicolo',18388,00,18320,68,13075,5313,0,18388
2019/02,122,18/02/2019,1,SP 10R tra Piacenza (ponte fiume Trebbia) e San Nicolo',26732,90,25606,1117,20655,6077,26732,0
2019/02,122,21/02/2019,4,SP 10R tra Piacenza (ponte fiume Trebbia) e San Nicolo',27220,80,26078,1134,20643,6577,27220,0
2019/02,122,22/02/2019,5,SP 10R tra Piacenza (ponte fiume Trebbia) e San Nicolo',28473,110,27265,1197,21212,7261,28473,0
2019/02,122,23/02/2019,6,SP 10R tra Piacenza (ponte fiume Trebbia) e San Nicolo',14232,10,13915,316,11706,2526,0,14232
2019/02,122,25/02/2019,1,SP 10R tra Piacenza (ponte fiume Trebbia) e San Nicolo',26257,80,25104,1145,20338,5919,26257,0
2019/02,122,26/02/2019,2,SP 10R tra Piacenza (ponte fiume Trebbia) e San Nicolo',25913,130,24751,1149,20069,5844,25913,0
2019/02,122,27/02/2019,3,SP 10R tra Piacenza (ponte fiume Trebbia) e San Nicolo',27590,60,26323,1261,21193,6397,27590,0
2019/02,122,28/02/2019,4,SP 10R tra Piacenza (ponte fiume Trebbia) e San Nicolo',27069,90,25885,1175,20807,6262,27069,0
2019/02,123,15/02/2019,5,SP 28 tra Piacenza (Tangenziale Sud) e Gossolengo,17661,00,17233,428,13815,3846,17661,0
2019/02,123,16/02/2019,6,SP 28 tra Piacenza (Tangenziale Sud) e Gossolengo,16647,00,16419,228,12950,3697,0,16647
2019/02,123,17/02/2019,7,SP 28 tra Piacenza (Tangenziale Sud) e Gossolengo,12434,00,12384,50,9608,2826,0,12434
2019/02,123,18/02/2019,1,SP 28 tra Piacenza (Tangenziale Sud) e Gossolengo,16260,00,15781,479,12961,3299,16260,0
2019/02,123,19/02/2019,2,SP 28 tra Piacenza (Tangenziale Sud) e Gossolengo,16745,00,16281,464,13467,3278,16745,0
2019/02,123,20/02/2019,3,SP 28 tra Piacenza (Tangenziale Sud) e Gossolengo,16596,00,16135,461,13219,3377,16596,0
2019/02,123,21/02/2019,4,SP 28 tra Piacenza (Tangenziale Sud) e Gossolengo,16826,00,16371,455,13349,3477,16826,0
2019/02,123,22/02/2019,5,SP 28 tra Piacenza (Tangenziale Sud) e Gossolengo,17691,00,17203,488,13865,3826,17691,0
2019/02,123,23/02/2019,6,SP 28 tra Piacenza (Tangenziale Sud) e Gossolengo,16561,10,16376,184,13047,3514,0,16561
2019/02,123,24/02/2019,7,SP 28 tra Piacenza (Tangenziale Sud) e Gossolengo,12356,00,12312,44,9603,2753,0,12356
2019/02,123,25/02/2019,1,SP 28 tra Piacenza (Tangenziale Sud) e Gossolengo,16101,10,15693,407,12887,3214,16101,0
2019/02,123,26/02/2019,2,SP 28 tra Piacenza (Tangenziale Sud) e Gossolengo,16595,00,16121,474,13301,3294,16595,0
2019/02,123,27/02/2019,3,SP 28 tra Piacenza (Tangenziale Sud) e Gossolengo,16918,10,16462,455,13420,3498,16918,0
2019/02,123,28/02/2019,4,SP 28 tra Piacenza (Tangenziale Sud) e Gossolengo,17237,00,16778,459,13619,3618,17237,0
2019/02,124,15/02/2019,5,SS 45 tra Piacenza e Settima,17770,00,17037,733,13463,4307,17770,0
2019/02,124,16/02/2019,6,SS 45 tra Piacenza e Settima,16222,00,15969,253,11823,4399,0,16222
2019/02,124,17/02/2019,7,SS 45 tra Piacenza e Settima,14564,00,14510,54,10943,3621,0,14564
2019/02,124,18/02/2019,1,SS 45 tra Piacenza e Settima,16735,00,16017,718,13125,3610,16735,0
2019/02,124,19/02/2019,2,SS 45 tra Piacenza e Settima,16982,00,16274,708,13420,3562,16982,0
2019/02,124,20/02/2019,3,SS 45 tra Piacenza e Settima,16869,00,16180,689,13267,3602,16869,0
2019/02,124,21/02/2019,4,SS 45 tra Piacenza e Settima,16365,10,15649,715,12693,3672,16365,0
2019/02,124,22/02/2019,5,SS 45 tra Piacenza e Settima,16756,00,16063,693,12176,4580,16756,0
2019/02,124,23/02/2019,6,SS 45 tra Piacenza e Settima,15853,10,15612,240,11411,4442,0,15853
2019/02,124,24/02/2019,7,SS 45 tra Piacenza e Settima,14227,00,14173,54,10872,3355,0,14227
2019/02,124,25/02/2019,1,SS 45 tra Piacenza e Settima,16267,00,15569,698,12881,3386,16267,0
2019/02,124,26/02/2019,2,SS 45 tra Piacenza e Settima,15603,20,14825,776,12320,3283,15603,0
2019/02,124,27/02/2019,3,SS 45 tra Piacenza e Settima,17090,00,16202,888,13338,3752,17090,0
2019/02,124,28/02/2019,4,SS 45 tra Piacenza e Settima,17134,20,16294,838,13364,3770,17134,0
2019/02,125,27/02/2019,3,SP 654R tra Piacenza (Tangenziale Sud) e Turro,24247,00,23110,1137,19562,4685,24247,0
2019/02,125,28/02/2019,4,SP 654R tra Piacenza (Tangenziale Sud) e Turro,24241,20,23145,1094,19497,4744,24241,0
2019/02,126,15/02/2019,5,SP 6 tra Piacenza (Tangenziale Sud) e bivio SP 42/ponte fiume Nure in località San Giorgio Piacentino,16896,00,16276,620,12915,3981,16896,0
2019/02,126,16/02/2019,6,SP 6 tra Piacenza (Tangenziale Sud) e bivio SP 42/ponte fiume Nure in località San Giorgio Piacentino,15267,00,15018,249,11100,4167,0,15267
2019/02,126,17/02/2019,7,SP 6 tra Piacenza (Tangenziale Sud) e bivio SP 42/ponte fiume Nure in località San Giorgio Piacentino,11871,00,11815,56,8738,3133,0,11871
2019/02,126,18/02/2019,1,SP 6 tra Piacenza (Tangenziale Sud) e bivio SP 42/ponte fiume Nure in località San Giorgio Piacentino,15593,00,14958,635,12517,3076,15593,0
2019/02,126,19/02/2019,2,SP 6 tra Piacenza (Tangenziale Sud) e bivio SP 42/ponte fiume Nure in località San Giorgio Piacentino,15716,00,15106,610,12427,3289,15716,0
2019/02,126,20/02/2019,3,SP 6 tra Piacenza (Tangenziale Sud) e bivio SP 42/ponte fiume Nure in località San Giorgio Piacentino,15901,00,15283,618,12515,3386,15901,0
2019/02,126,21/02/2019,4,SP 6 tra Piacenza (Tangenziale Sud) e bivio SP 42/ponte fiume Nure in località San Giorgio Piacentino,16084,00,15468,616,12607,3477,16084,0
2019/02,126,22/02/2019,5,SP 6 tra Piacenza (Tangenziale Sud) e bivio SP 42/ponte fiume Nure in località San Giorgio Piacentino,16857,00,16234,623,12833,4024,16857,0
2019/02,126,23/02/2019,6,SP 6 tra Piacenza (Tangenziale Sud) e bivio SP 42/ponte fiume Nure in località San Giorgio Piacentino,15510,00,15261,249,11509,4001,0,15510
2019/02,126,24/02/2019,7,SP 6 tra Piacenza (Tangenziale Sud) e bivio SP 42/ponte fiume Nure in località San Giorgio Piacentino,11701,00,11667,34,8656,3045,0,11701
2019/02,126,25/02/2019,1,SP 6 tra Piacenza (Tangenziale Sud) e bivio SP 42/ponte fiume Nure in località San Giorgio Piacentino,15353,10,14719,633,12359,2994,15353,0
2019/02,126,27/02/2019,3,SP 6 tra Piacenza (Tangenziale Sud) e bivio SP 42/ponte fiume Nure in località San Giorgio Piacentino,16295,20,15616,677,12790,3505,16295,0
2019/02,126,28/02/2019,4,SP 6 tra Piacenza (Tangenziale Sud) e bivio SP 42/ponte fiume Nure in località San Giorgio Piacentino,16409,00,15802,607,12820,3589,16409,0
2019/02,127,15/02/2019,5,SS 9 tra Piacenza e Pontenure,25982,10,24156,1825,19870,6112,25982,0
2019/02,127,16/02/2019,6,SS 9 tra Piacenza e Pontenure,21208,20,20667,539,15190,6018,0,21208
2019/02,127,17/02/2019,7,SS 9 tra Piacenza e Pontenure,16696,00,16564,132,12138,4558,0,16696
2019/02,127,18/02/2019,1,SS 9 tra Piacenza e Pontenure,24384,00,22574,1810,19559,4825,24384,0
2019/02,127,19/02/2019,2,SS 9 tra Piacenza e Pontenure,24508,10,22776,1731,19432,5076,24508,0
2019/02,127,20/02/2019,3,SS 9 tra Piacenza e Pontenure,25499,10,23444,2054,20228,5271,25499,0
2019/02,127,21/02/2019,4,SS 9 tra Piacenza e Pontenure,25245,00,23314,1931,19885,5360,25245,0
2019/02,127,22/02/2019,5,SS 9 tra Piacenza e Pontenure,26094,00,24191,1903,20051,6043,26094,0
2019/02,127,23/02/2019,6,SS 9 tra Piacenza e Pontenure,21456,00,20901,555,15539,5917,0,21456
2019/02,127,24/02/2019,7,SS 9 tra Piacenza e Pontenure,15191,00,15065,126,10746,4445,0,15191
2019/02,127,25/02/2019,1,SS 9 tra Piacenza e Pontenure,24518,00,22617,1901,19356,5162,24518,0
2019/02,127,26/02/2019,2,SS 9 tra Piacenza e Pontenure,24418,20,22567,1849,19368,5050,24418,0
2019/02,127,27/02/2019,3,SS 9 tra Piacenza e Pontenure,24984,20,23068,1914,19577,5407,24984,0
2019/02,127,28/02/2019,4,SS 9 tra Piacenza e Pontenure,25295,30,23453,1839,19836,5459,25295,0
2019/02,128,15/02/2019,5,SP 10R tra Piacenza (Casello A 1/A 21) e il bivio SP 10R e SP 587R,17664,00,15815,1849,13164,4500,17664,0
2019/02,128,16/02/2019,6,SP 10R tra Piacenza (Casello A 1/A 21) e il bivio SP 10R e SP 587R,14008,00,13556,452,9814,4194,0,14008
2019/02,128,17/02/2019,7,SP 10R tra Piacenza (Casello A 1/A 21) e il bivio SP 10R e SP 587R,11005,00,10938,67,7734,3271,0,11005
2019/02,128,18/02/2019,1,SP 10R tra Piacenza (Casello A 1/A 21) e il bivio SP 10R e SP 587R,17054,00,15083,1971,13413,3641,17054,0
2019/02,128,19/02/2019,2,SP 10R tra Piacenza (Casello A 1/A 21) e il bivio SP 10R e SP 587R,17100,00,15079,2021,13106,3994,17100,0
2019/02,128,20/02/2019,3,SP 10R tra Piacenza (Casello A 1/A 21) e il bivio SP 10R e SP 587R,18447,00,16334,2113,14434,4013,18447,0
2019/02,128,21/02/2019,4,SP 10R tra Piacenza (Casello A 1/A 21) e il bivio SP 10R e SP 587R,17939,00,15871,2068,13854,4085,17939,0
2019/02,128,22/02/2019,5,SP 10R tra Piacenza (Casello A 1/A 21) e il bivio SP 10R e SP 587R,18390,00,16546,1844,13730,4660,18390,0
2019/02,128,23/02/2019,6,SP 10R tra Piacenza (Casello A 1/A 21) e il bivio SP 10R e SP 587R,14009,00,13570,439,9739,4270,0,14009
2019/02,128,24/02/2019,7,SP 10R tra Piacenza (Casello A 1/A 21) e il bivio SP 10R e SP 587R,12570,00,12506,64,9128,3442,0,12570
2019/02,128,25/02/2019,1,SP 10R tra Piacenza (Casello A 1/A 21) e il bivio SP 10R e SP 587R,17253,00,15384,1869,13601,3652,17253,0
2019/02,128,26/02/2019,2,SP 10R tra Piacenza (Casello A 1/A 21) e il bivio SP 10R e SP 587R,17762,00,15723,2039,13781,3981,17762,0
2019/02,128,27/02/2019,3,SP 10R tra Piacenza (Casello A 1/A 21) e il bivio SP 10R e SP 587R,17641,00,15609,2032,13739,3902,17641,0
2019/02,128,28/02/2019,4,SP 10R tra Piacenza (Casello A 1/A 21) e il bivio SP 10R e SP 587R,17945,00,15986,1959,13785,4160,17945,0
2019/02,129,15/02/2019,5,SS 9Var tra Parma e ponte fiume Taro (Tangenziale nord di Parma),,,,,,,,
2019/02,129,16/02/2019,6,SS 9Var tra Parma e ponte fiume Taro (Tangenziale nord di Parma),,,,,,,,
2019/02,129,17/02/2019,7,SS 9Var tra Parma e ponte fiume Taro (Tangenziale nord di Parma),,,,,,,,
2019/02,129,18/02/2019,1,SS 9Var tra Parma e ponte fiume Taro (Tangenziale nord di Parma),,,,,,,,
2019/02,129,19/02/2019,2,SS 9Var tra Parma e ponte fiume Taro (Tangenziale nord di Parma),,,,,,,,
2019/02,129,20/02/2019,3,SS 9Var tra Parma e ponte fiume Taro (Tangenziale nord di Parma),,,,,,,,
2019/02,129,21/02/2019,4,SS 9Var tra Parma e ponte fiume Taro (Tangenziale nord di Parma),,,,,,,,
2019/02,129,22/02/2019,5,SS 9Var tra Parma e ponte fiume Taro (Tangenziale nord di Parma),,,,,,,,
2019/02,129,23/02/2019,6,SS 9Var tra Parma e ponte fiume Taro (Tangenziale nord di Parma),,,,,,,,
2019/02,129,24/02/2019,7,SS 9Var tra Parma e ponte fiume Taro (Tangenziale nord di Parma),,,,,,,,
2019/02,129,25/02/2019,1,SS 9Var tra Parma e ponte fiume Taro (Tangenziale nord di Parma),,,,,,,,
2019/02,129,26/02/2019,2,SS 9Var tra Parma e ponte fiume Taro (Tangenziale nord di Parma),,,,,,,,
2019/02,129,27/02/2019,3,SS 9Var tra Parma e ponte fiume Taro (Tangenziale nord di Parma),,,,,,,,
2019/02,129,28/02/2019,4,SS 9Var tra Parma e ponte fiume Taro (Tangenziale nord di Parma),,,,,,,,
2019/02,130,15/02/2019,5,SS 62 tra Parma e Collecchio,22881,20,21627,1252,17358,5523,22881,0
2019/02,130,16/02/2019,6,SS 62 tra Parma e Collecchio,19949,00,19587,362,14469,5480,0,19949
2019/02,130,17/02/2019,7,SS 62 tra Parma e Collecchio,15600,00,15517,83,10884,4716,0,15600
2019/02,130,18/02/2019,1,SS 62 tra Parma e Collecchio,21243,00,20071,1172,16739,4504,21243,0
2019/02,130,19/02/2019,2,SS 62 tra Parma e Collecchio,22022,00,20752,1270,17092,4930,22022,0
2019/02,130,20/02/2019,3,SS 62 tra Parma e Collecchio,22245,00,20923,1322,17286,4959,22245,0
2019/02,130,21/02/2019,4,SS 62 tra Parma e Collecchio,22061,10,20750,1310,17036,5025,22061,0
2019/02,130,22/02/2019,5,SS 62 tra Parma e Collecchio,23096,00,21699,1397,17618,5478,23096,0
2019/02,130,23/02/2019,6,SS 62 tra Parma e Collecchio,19349,00,18982,367,14182,5167,0,19349
2019/02,130,24/02/2019,7,SS 62 tra Parma e Collecchio,15750,00,15648,102,11099,4651,0,15750
2019/02,130,25/02/2019,1,SS 62 tra Parma e Collecchio,21222,00,19807,1415,16720,4502,21222,0
2019/02,130,26/02/2019,2,SS 62 tra Parma e Collecchio,22080,10,20765,1314,17272,4808,22080,0
2019/02,130,27/02/2019,3,SS 62 tra Parma e Collecchio,22517,10,21104,1412,17362,5155,22517,0
2019/02,130,28/02/2019,4,SS 62 tra Parma e Collecchio,22213,00,20842,1371,17146,5067,22213,0
2019/02,131,15/02/2019,5,SP 665R tra Parma e Corcagnano,21452,60,20305,1141,16595,4857,21452,0
2019/02,131,16/02/2019,6,SP 665R tra Parma e Corcagnano,19605,40,19346,255,14446,5159,0,19605
2019/02,131,17/02/2019,7,SP 665R tra Parma e Corcagnano,15675,10,15579,95,11567,4108,0,15675
2019/02,131,18/02/2019,1,SP 665R tra Parma e Corcagnano,19419,20,18197,1220,16326,3093,19419,0
2019/02,131,19/02/2019,2,SP 665R tra Parma e Corcagnano,20732,30,19715,1014,16478,4254,20732,0
2019/02,131,20/02/2019,3,SP 665R tra Parma e Corcagnano,20413,40,19350,1059,16016,4397,20413,0
2019/02,131,21/02/2019,4,SP 665R tra Parma e Corcagnano,21017,30,19904,1110,16527,4490,21017,0
2019/02,131,22/02/2019,5,SP 665R tra Parma e Corcagnano,21718,20,20569,1147,16655,5063,21718,0
2019/02,131,23/02/2019,6,SP 665R tra Parma e Corcagnano,19179,00,18872,307,14169,5010,0,19179
2019/02,131,24/02/2019,7,SP 665R tra Parma e Corcagnano,15382,00,15304,78,11143,4239,0,15382
2019/02,131,25/02/2019,1,SP 665R tra Parma e Corcagnano,20352,60,19195,1151,16301,4051,20352,0
2019/02,131,26/02/2019,2,SP 665R tra Parma e Corcagnano,20734,10,19611,1122,16306,4428,20734,0
2019/02,131,27/02/2019,3,SP 665R tra Parma e Corcagnano,21024,120,19910,1102,16514,4510,21024,0
2019/02,131,28/02/2019,4,SP 665R tra Parma e Corcagnano,21432,30,20314,1115,16828,4604,21432,0
2019/02,132,15/02/2019,5,SP 513R tra Parma e Pilastrello,21995,00,21040,955,16902,5093,21995,0
2019/02,132,16/02/2019,6,SP 513R tra Parma e Pilastrello,18615,10,18351,263,13861,4754,0,18615
2019/02,132,17/02/2019,7,SP 513R tra Parma e Pilastrello,15628,00,15554,74,11870,3758,0,15628
2019/02,132,18/02/2019,1,SP 513R tra Parma e Pilastrello,20367,10,19468,898,16431,3936,20367,0
2019/02,132,19/02/2019,2,SP 513R tra Parma e Pilastrello,21072,10,20093,978,16816,4256,21072,0
2019/02,132,20/02/2019,3,SP 513R tra Parma e Pilastrello,21458,20,20497,959,17005,4453,21458,0
2019/02,132,21/02/2019,4,SP 513R tra Parma e Pilastrello,21222,10,20317,904,16809,4413,21222,0
2019/02,132,22/02/2019,5,SP 513R tra Parma e Pilastrello,22022,00,20970,1052,17143,4879,22022,0
2019/02,132,23/02/2019,6,SP 513R tra Parma e Pilastrello,18798,30,18523,272,13815,4983,0,18798
2019/02,132,24/02/2019,7,SP 513R tra Parma e Pilastrello,15724,00,15655,69,11733,3991,0,15724
2019/02,132,25/02/2019,1,SP 513R tra Parma e Pilastrello,20549,00,19622,927,16525,4024,20549,0
2019/02,132,26/02/2019,2,SP 513R tra Parma e Pilastrello,20995,00,19982,1013,16763,4232,20995,0
2019/02,132,27/02/2019,3,SP 513R tra Parma e Pilastrello,21793,10,20818,974,17180,4613,21793,0
2019/02,132,28/02/2019,4,SP 513R tra Parma e Pilastrello,21803,00,20819,984,17112,4691,21803,0
2019/02,133,15/02/2019,5,SP 62R tra Parma (viadotto A 1) e Sorbolo,19794,00,17685,2109,14752,5042,19794,0
2019/02,133,16/02/2019,6,SP 62R tra Parma (viadotto A 1) e Sorbolo,18879,10,18418,460,13587,5292,0,18879
2019/02,133,17/02/2019,7,SP 62R tra Parma (viadotto A 1) e Sorbolo,16168,20,16047,119,11202,4966,0,16168
2019/02,133,18/02/2019,1,SP 62R tra Parma (viadotto A 1) e Sorbolo,18723,10,16404,2318,14558,4165,18723,0
2019/02,133,19/02/2019,2,SP 62R tra Parma (viadotto A 1) e Sorbolo,18744,00,16479,2265,14470,4274,18744,0
2019/02,133,20/02/2019,3,SP 62R tra Parma (viadotto A 1) e Sorbolo,18852,50,16593,2254,14390,4462,18852,0
2019/02,133,21/02/2019,4,SP 62R tra Parma (viadotto A 1) e Sorbolo,19013,10,16856,2156,14533,4480,19013,0
2019/02,133,22/02/2019,5,SP 62R tra Parma (viadotto A 1) e Sorbolo,20068,30,17900,2165,14855,5213,20068,0
2019/02,133,23/02/2019,6,SP 62R tra Parma (viadotto A 1) e Sorbolo,18181,00,17690,491,12991,5190,0,18181
2019/02,133,24/02/2019,7,SP 62R tra Parma (viadotto A 1) e Sorbolo,16190,00,16074,116,11266,4924,0,16190
2019/02,133,25/02/2019,1,SP 62R tra Parma (viadotto A 1) e Sorbolo,18733,10,16570,2162,14488,4245,18733,0
2019/02,133,26/02/2019,2,SP 62R tra Parma (viadotto A 1) e Sorbolo,18662,10,16497,2164,14325,4337,18662,0
2019/02,133,27/02/2019,3,SP 62R tra Parma (viadotto A 1) e Sorbolo,19193,00,16985,2208,14632,4561,19193,0
2019/02,133,28/02/2019,4,SP 62R tra Parma (viadotto A 1) e Sorbolo,19278,10,17016,2261,14649,4629,19278,0
2019/02,134,15/02/2019,5,SP 343R tra Parma e San Polo,19104,00,16738,2366,14577,4527,19104,0
2019/02,134,16/02/2019,6,SP 343R tra Parma e San Polo,13941,00,13472,469,10127,3814,0,13941
2019/02,134,17/02/2019,7,SP 343R tra Parma e San Polo,10330,00,10197,133,7393,2937,0,10330
2019/02,134,18/02/2019,1,SP 343R tra Parma e San Polo,19058,00,16882,2176,14930,4128,19058,0
2019/02,134,19/02/2019,2,SP 343R tra Parma e San Polo,19584,00,17362,2222,15222,4362,19584,0
2019/02,134,20/02/2019,3,SP 343R tra Parma e San Polo,19276,00,17133,2143,14914,4362,19276,0
2019/02,134,21/02/2019,4,SP 343R tra Parma e San Polo,19302,00,17006,2296,14970,4332,19302,0
2019/02,134,22/02/2019,5,SP 343R tra Parma e San Polo,20296,20,17976,2318,15651,4645,20296,0
2019/02,134,23/02/2019,6,SP 343R tra Parma e San Polo,15225,10,14705,519,11019,4206,0,15225
2019/02,134,24/02/2019,7,SP 343R tra Parma e San Polo,10928,00,10797,131,7663,3265,0,10928
2019/02,134,25/02/2019,1,SP 343R tra Parma e San Polo,19484,00,17198,2286,15339,4145,19484,0
2019/02,134,26/02/2019,2,SP 343R tra Parma e San Polo,19809,10,17336,2472,15502,4307,19809,0
2019/02,134,27/02/2019,3,SP 343R tra Parma e San Polo,20203,00,17864,2339,15740,4463,20203,0
2019/02,134,28/02/2019,4,SP 343R tra Parma e San Polo,20129,00,17762,2367,15553,4576,20129,0
2019/02,135,15/02/2019,5,SP 10 tra Parma (Tangenziale) e Viarolo,,,,,,,,
2019/02,135,16/02/2019,6,SP 10 tra Parma (Tangenziale) e Viarolo,,,,,,,,
2019/02,135,17/02/2019,7,SP 10 tra Parma (Tangenziale) e Viarolo,,,,,,,,
2019/02,135,18/02/2019,1,SP 10 tra Parma (Tangenziale) e Viarolo,,,,,,,,
2019/02,135,19/02/2019,2,SP 10 tra Parma (Tangenziale) e Viarolo,,,,,,,,
2019/02,135,20/02/2019,3,SP 10 tra Parma (Tangenziale) e Viarolo,,,,,,,,
2019/02,135,21/02/2019,4,SP 10 tra Parma (Tangenziale) e Viarolo,,,,,,,,
2019/02,135,22/02/2019,5,SP 10 tra Parma (Tangenziale) e Viarolo,,,,,,,,
2019/02,135,23/02/2019,6,SP 10 tra Parma (Tangenziale) e Viarolo,,,,,,,,
2019/02,135,24/02/2019,7,SP 10 tra Parma (Tangenziale) e Viarolo,,,,,,,,
2019/02,135,25/02/2019,1,SP 10 tra Parma (Tangenziale) e Viarolo,,,,,,,,
2019/02,135,26/02/2019,2,SP 10 tra Parma (Tangenziale) e Viarolo,,,,,,,,
2019/02,135,27/02/2019,3,SP 10 tra Parma (Tangenziale) e Viarolo,,,,,,,,
2019/02,135,28/02/2019,4,SP 10 tra Parma (Tangenziale) e Viarolo,,,,,,,,
2019/02,138,15/02/2019,5,SS 63 tra Reggio Emilia e Puianello,12622,10,12219,402,9318,3304,12622,0
2019/02,138,16/02/2019,6,SS 63 tra Reggio Emilia e Puianello,12874,10,12707,166,9430,3444,0,12874
2019/02,138,17/02/2019,7,SS 63 tra Reggio Emilia e Puianello,11222,10,11166,55,8280,2942,0,11222
2019/02,138,18/02/2019,1,SS 63 tra Reggio Emilia e Puianello,11587,10,11141,445,8884,2703,11587,0
2019/02,138,19/02/2019,2,SS 63 tra Reggio Emilia e Puianello,11874,30,11424,447,9013,2861,11874,0
2019/02,138,20/02/2019,3,SS 63 tra Reggio Emilia e Puianello,12296,00,11861,435,9263,3033,12296,0
2019/02,138,21/02/2019,4,SS 63 tra Reggio Emilia e Puianello,12281,00,11876,405,9272,3009,12281,0
2019/02,138,22/02/2019,5,SS 63 tra Reggio Emilia e Puianello,13010,10,12589,420,9590,3420,13010,0
2019/02,138,23/02/2019,6,SS 63 tra Reggio Emilia e Puianello,12887,30,12696,188,9250,3637,0,12887
2019/02,138,24/02/2019,7,SS 63 tra Reggio Emilia e Puianello,10995,00,10942,53,8132,2863,0,10995
2019/02,138,25/02/2019,1,SS 63 tra Reggio Emilia e Puianello,11769,20,11311,456,9062,2707,11769,0
2019/02,138,26/02/2019,2,SS 63 tra Reggio Emilia e Puianello,12010,30,11584,423,9121,2889,12010,0
2019/02,138,27/02/2019,3,SS 63 tra Reggio Emilia e Puianello,12367,10,11952,414,9280,3087,12367,0
2019/02,138,28/02/2019,4,SS 63 tra Reggio Emilia e Puianello,12463,00,12025,438,9402,3061,12463,0
2019/02,139,15/02/2019,5,SP 467R tra Fogliano e località Pratissolo (c/o Scandiano),18622,10,17957,664,14477,4145,18622,0
2019/02,139,16/02/2019,6,SP 467R tra Fogliano e località Pratissolo (c/o Scandiano),15391,00,15251,140,11287,4104,0,15391
2019/02,139,17/02/2019,7,SP 467R tra Fogliano e località Pratissolo (c/o Scandiano),11542,00,11478,64,8190,3352,0,11542
2019/02,139,18/02/2019,1,SP 467R tra Fogliano e località Pratissolo (c/o Scandiano),17820,00,17141,679,14535,3285,17820,0
2019/02,139,19/02/2019,2,SP 467R tra Fogliano e località Pratissolo (c/o Scandiano),17828,00,17053,775,14274,3554,17828,0
2019/02,139,20/02/2019,3,SP 467R tra Fogliano e località Pratissolo (c/o Scandiano),18063,10,17295,767,14410,3653,18063,0
2019/02,139,21/02/2019,4,SP 467R tra Fogliano e località Pratissolo (c/o Scandiano),18094,10,17276,817,14248,3846,18094,0
2019/02,139,22/02/2019,5,SP 467R tra Fogliano e località Pratissolo (c/o Scandiano),18901,00,18179,722,14648,4253,18901,0
2019/02,139,23/02/2019,6,SP 467R tra Fogliano e località Pratissolo (c/o Scandiano),15242,00,15083,159,11045,4197,0,15242
2019/02,139,24/02/2019,7,SP 467R tra Fogliano e località Pratissolo (c/o Scandiano),11241,00,11181,60,7886,3355,0,11241
2019/02,139,25/02/2019,1,SP 467R tra Fogliano e località Pratissolo (c/o Scandiano),17896,00,17230,666,14529,3367,17896,0
2019/02,139,26/02/2019,2,SP 467R tra Fogliano e località Pratissolo (c/o Scandiano),17901,20,17106,793,14385,3516,17901,0
2019/02,139,27/02/2019,3,SP 467R tra Fogliano e località Pratissolo (c/o Scandiano),18484,00,17724,760,14678,3806,18484,0
2019/02,139,28/02/2019,4,SP 467R tra Fogliano e località Pratissolo (c/o Scandiano),18458,10,17727,730,14449,4009,18458,0
2019/02,140,15/02/2019,5,SS 9 tra Masone e Rubiera,27312,20,24493,2817,19647,7665,27312,0
2019/02,140,16/02/2019,6,SS 9 tra Masone e Rubiera,25121,00,24579,542,16750,8371,0,25121
2019/02,140,17/02/2019,7,SS 9 tra Masone e Rubiera,22197,20,22063,132,15146,7051,0,22197
2019/02,140,18/02/2019,1,SS 9 tra Masone e Rubiera,24615,40,22034,2577,18436,6179,24615,0
2019/02,140,19/02/2019,2,SS 9 tra Masone e Rubiera,26207,30,23397,2807,19566,6641,26207,0
2019/02,140,20/02/2019,3,SS 9 tra Masone e Rubiera,25888,10,23091,2796,19373,6515,25888,0
2019/02,140,21/02/2019,4,SS 9 tra Masone e Rubiera,26136,60,23252,2878,19357,6779,26136,0
2019/02,140,22/02/2019,5,SS 9 tra Masone e Rubiera,27201,20,24298,2901,19736,7465,27201,0
2019/02,140,23/02/2019,6,SS 9 tra Masone e Rubiera,24825,00,24218,607,16593,8232,0,24825
2019/02,140,24/02/2019,7,SS 9 tra Masone e Rubiera,21759,00,21625,134,15209,6550,0,21759
2019/02,140,25/02/2019,1,SS 9 tra Masone e Rubiera,24027,00,21486,2541,17809,6218,24027,0
2019/02,140,26/02/2019,2,SS 9 tra Masone e Rubiera,26088,00,23195,2893,19574,6514,26088,0
2019/02,140,27/02/2019,3,SS 9 tra Masone e Rubiera,26364,20,23498,2864,19609,6755,26364,0
2019/02,140,28/02/2019,4,SS 9 tra Masone e Rubiera,26341,50,23197,3139,19463,6878,26341,0
2019/02,143,15/02/2019,5,SP 63R tra Sesso e Cadelbosco di Sopra (bivio SP 358R),26517,00,25022,1495,20235,6282,26517,0
2019/02,143,16/02/2019,6,SP 63R tra Sesso e Cadelbosco di Sopra (bivio SP 358R),22530,00,22144,386,16044,6486,0,22530
2019/02,143,17/02/2019,7,SP 63R tra Sesso e Cadelbosco di Sopra (bivio SP 358R),18686,00,18590,96,13636,5050,0,18686
2019/02,143,18/02/2019,1,SP 63R tra Sesso e Cadelbosco di Sopra (bivio SP 358R),24901,00,23553,1348,19852,5049,24901,0
2019/02,143,19/02/2019,2,SP 63R tra Sesso e Cadelbosco di Sopra (bivio SP 358R),25947,00,24590,1357,20415,5532,25947,0
2019/02,143,20/02/2019,3,SP 63R tra Sesso e Cadelbosco di Sopra (bivio SP 358R),26027,10,24585,1441,20497,5530,26027,0
2019/02,143,21/02/2019,4,SP 63R tra Sesso e Cadelbosco di Sopra (bivio SP 358R),25181,00,23792,1389,19508,5673,25181,0
2019/02,143,22/02/2019,5,SP 63R tra Sesso e Cadelbosco di Sopra (bivio SP 358R),26616,00,25144,1472,20192,6424,26616,0
2019/02,143,23/02/2019,6,SP 63R tra Sesso e Cadelbosco di Sopra (bivio SP 358R),22640,00,22253,387,16249,6391,0,22640
2019/02,143,24/02/2019,7,SP 63R tra Sesso e Cadelbosco di Sopra (bivio SP 358R),18786,20,18674,110,13542,5244,0,18786
2019/02,143,25/02/2019,1,SP 63R tra Sesso e Cadelbosco di Sopra (bivio SP 358R),25066,00,23732,1334,19980,5086,25066,0
2019/02,143,26/02/2019,2,SP 63R tra Sesso e Cadelbosco di Sopra (bivio SP 358R),25581,10,24210,1370,20319,5262,25581,0
2019/02,143,27/02/2019,3,SP 63R tra Sesso e Cadelbosco di Sopra (bivio SP 358R),26281,00,24824,1457,20410,5871,26281,0
2019/02,143,28/02/2019,4,SP 63R tra Sesso e Cadelbosco di Sopra (bivio SP 358R),26165,00,24772,1393,20298,5867,26165,0
2019/02,146,15/02/2019,5,SS 12 tra Montale e Modena,22831,20,21479,1350,17163,5668,22831,0
2019/02,146,16/02/2019,6,SS 12 tra Montale e Modena,19821,20,19512,307,14066,5755,0,19821
2019/02,146,17/02/2019,7,SS 12 tra Montale e Modena,16897,00,16817,80,12353,4544,0,16897
2019/02,146,18/02/2019,1,SS 12 tra Montale e Modena,20742,30,19454,1285,16212,4530,20742,0
2019/02,146,19/02/2019,2,SS 12 tra Montale e Modena,21341,30,20024,1314,16590,4751,21341,0
2019/02,146,20/02/2019,3,SS 12 tra Montale e Modena,21809,30,20441,1365,16876,4933,21809,0
2019/02,146,21/02/2019,4,SS 12 tra Montale e Modena,22138,10,20753,1384,16892,5246,22138,0
2019/02,146,22/02/2019,5,SS 12 tra Montale e Modena,22568,20,21198,1368,17042,5526,22568,0
2019/02,146,23/02/2019,6,SS 12 tra Montale e Modena,19546,20,19230,314,13729,5817,0,19546
2019/02,146,24/02/2019,7,SS 12 tra Montale e Modena,16763,00,16682,81,12364,4399,0,16763
2019/02,146,25/02/2019,1,SS 12 tra Montale e Modena,20807,10,19494,1312,16306,4501,20807,0
2019/02,146,26/02/2019,2,SS 12 tra Montale e Modena,21159,30,19847,1309,16490,4669,21159,0
2019/02,146,27/02/2019,3,SS 12 tra Montale e Modena,22203,20,20746,1455,17131,5072,22203,0
2019/02,146,28/02/2019,4,SS 12 tra Montale e Modena,21902,30,20571,1328,16604,5298,21902,0
2019/02,147,15/02/2019,5,SP 623 tra Modena Sud/casello A 1 e Spilamberto,20436,00,17189,3247,15345,5091,20436,0
2019/02,147,16/02/2019,6,SP 623 tra Modena Sud/casello A 1 e Spilamberto,16433,00,15877,556,11528,4905,0,16433
2019/02,147,17/02/2019,7,SP 623 tra Modena Sud/casello A 1 e Spilamberto,15982,00,15809,173,11839,4143,0,15982
2019/02,147,18/02/2019,1,SP 623 tra Modena Sud/casello A 1 e Spilamberto,19072,00,15789,3283,14825,4247,19072,0
2019/02,147,19/02/2019,2,SP 623 tra Modena Sud/casello A 1 e Spilamberto,19388,00,16122,3266,15030,4358,19388,0
2019/02,147,20/02/2019,3,SP 623 tra Modena Sud/casello A 1 e Spilamberto,19766,10,16535,3230,15221,4545,19766,0
2019/02,147,21/02/2019,4,SP 623 tra Modena Sud/casello A 1 e Spilamberto,20243,00,16929,3314,15425,4818,20243,0
2019/02,147,22/02/2019,5,SP 623 tra Modena Sud/casello A 1 e Spilamberto,20844,00,17365,3479,15778,5066,20844,0
2019/02,147,23/02/2019,6,SP 623 tra Modena Sud/casello A 1 e Spilamberto,16608,00,16046,562,11428,5180,0,16608
2019/02,147,24/02/2019,7,SP 623 tra Modena Sud/casello A 1 e Spilamberto,14490,00,14332,158,10207,4283,0,14490
2019/02,147,25/02/2019,1,SP 623 tra Modena Sud/casello A 1 e Spilamberto,18768,40,15600,3164,14566,4202,18768,0
2019/02,147,26/02/2019,2,SP 623 tra Modena Sud/casello A 1 e Spilamberto,19466,00,16131,3335,15178,4288,19466,0
2019/02,147,27/02/2019,3,SP 623 tra Modena Sud/casello A 1 e Spilamberto,19821,20,16548,3271,15126,4695,19821,0
2019/02,147,28/02/2019,4,SP 623 tra Modena Sud/casello A 1 e Spilamberto,20238,00,16862,3376,15422,4816,20238,0
2019/02,148,27/02/2019,3,SS 9 tra Sant'Ambrogio e Castelfranco Emilia,18059,00,17119,940,13094,4965,18059,0
2019/02,148,28/02/2019,4,SS 9 tra Sant'Ambrogio e Castelfranco Emilia,28888,10,27026,1861,21317,7571,28888,0
2019/02,149,15/02/2019,5,SP 255 tra Modena e Navicello,37842,440,34655,3143,28226,9616,37842,0
2019/02,149,16/02/2019,6,SP 255 tra Modena e Navicello,30292,10,29708,583,21191,9101,0,30292
2019/02,149,17/02/2019,7,SP 255 tra Modena e Navicello,25421,10,25278,142,17442,7979,0,25421
2019/02,149,18/02/2019,1,SP 255 tra Modena e Navicello,35831,440,32704,3083,27790,8041,35831,0
2019/02,149,19/02/2019,2,SP 255 tra Modena e Navicello,36207,450,32945,3217,28041,8166,36207,0
2019/02,149,20/02/2019,3,SP 255 tra Modena e Navicello,36704,410,33465,3198,28113,8591,36704,0
2019/02,149,21/02/2019,4,SP 255 tra Modena e Navicello,36892,350,33662,3195,28262,8630,36892,0
2019/02,149,22/02/2019,5,SP 255 tra Modena e Navicello,37954,380,34767,3149,28543,9411,37954,0
2019/02,149,23/02/2019,6,SP 255 tra Modena e Navicello,30327,40,29672,651,21292,9035,0,30327
2019/02,149,24/02/2019,7,SP 255 tra Modena e Navicello,23980,00,23818,162,16997,6983,0,23980
2019/02,149,25/02/2019,1,SP 255 tra Modena e Navicello,35702,520,32495,3155,27773,7929,35702,0
2019/02,149,26/02/2019,2,SP 255 tra Modena e Navicello,36300,580,32991,3251,27968,8332,36300,0
2019/02,149,27/02/2019,3,SP 255 tra Modena e Navicello,36819,530,33436,3330,28069,8750,36819,0
2019/02,149,28/02/2019,4,SP 255 tra Modena e Navicello,37115,300,33826,3259,28119,8996,37115,0
2019/02,150,15/02/2019,5,SS 12 tra Modena e Bastiglia,25638,00,23634,2004,19386,6252,25638,0
2019/02,150,16/02/2019,6,SS 12 tra Modena e Bastiglia,20382,00,19992,390,13999,6383,0,20382
2019/02,150,17/02/2019,7,SS 12 tra Modena e Bastiglia,16838,00,16785,53,11550,5288,0,16838
2019/02,150,18/02/2019,1,SS 12 tra Modena e Bastiglia,24029,10,21934,2094,18940,5089,24029,0
2019/02,150,19/02/2019,2,SS 12 tra Modena e Bastiglia,24521,10,22391,2129,19396,5125,24521,0
2019/02,150,20/02/2019,3,SS 12 tra Modena e Bastiglia,24610,00,22614,1996,19361,5249,24610,0
2019/02,150,21/02/2019,4,SS 12 tra Modena e Bastiglia,25034,30,22764,2267,19618,5416,25034,0
2019/02,150,22/02/2019,5,SS 12 tra Modena e Bastiglia,25656,00,23619,2037,19425,6231,25656,0
2019/02,150,23/02/2019,6,SS 12 tra Modena e Bastiglia,20714,00,20322,392,14158,6556,0,20714
2019/02,150,24/02/2019,7,SS 12 tra Modena e Bastiglia,16770,00,16704,66,11729,5041,0,16770
2019/02,150,25/02/2019,1,SS 12 tra Modena e Bastiglia,24032,00,22030,2002,18809,5223,24032,0
2019/02,150,26/02/2019,2,SS 12 tra Modena e Bastiglia,24672,10,22570,2101,19558,5114,24672,0
2019/02,150,27/02/2019,3,SS 12 tra Modena e Bastiglia,24921,00,22862,2059,19278,5643,24921,0
2019/02,150,28/02/2019,4,SS 12 tra Modena e Bastiglia,25066,20,23052,2012,19493,5573,25066,0
2019/02,152,20/02/2019,3,SP 569 tra Innesto tangenziale Bologna e uscita Zola Predosa (Gesso/Rivabella),65083,40,62361,2718,51173,13910,65083,0
2019/02,152,21/02/2019,4,SP 569 tra Innesto tangenziale Bologna e uscita Zola Predosa (Gesso/Rivabella),70001,40,67100,2897,53018,16983,70001,0
2019/02,152,22/02/2019,5,SP 569 tra Innesto tangenziale Bologna e uscita Zola Predosa (Gesso/Rivabella),68887,10,65963,2923,51857,17030,68887,0
2019/02,152,23/02/2019,6,SP 569 tra Innesto tangenziale Bologna e uscita Zola Predosa (Gesso/Rivabella),62590,00,61969,621,45376,17214,0,62590
2019/02,152,24/02/2019,7,SP 569 tra Innesto tangenziale Bologna e uscita Zola Predosa (Gesso/Rivabella),51051,20,50835,214,36998,14053,0,51051
2019/02,152,25/02/2019,1,SP 569 tra Innesto tangenziale Bologna e uscita Zola Predosa (Gesso/Rivabella),64580,00,62013,2567,50017,14563,64580,0
2019/02,152,26/02/2019,2,SP 569 tra Innesto tangenziale Bologna e uscita Zola Predosa (Gesso/Rivabella),64452,30,61538,2911,50537,13915,64452,0
2019/02,152,27/02/2019,3,SP 569 tra Innesto tangenziale Bologna e uscita Zola Predosa (Gesso/Rivabella),64644,50,61731,2908,50336,14308,64644,0
2019/02,152,28/02/2019,4,SP 569 tra Innesto tangenziale Bologna e uscita Zola Predosa (Gesso/Rivabella),65748,20,62880,2866,51083,14665,65748,0
2019/02,153,15/02/2019,5,Via Porrettana (ex SS 64) tra Bologna e Pontecchio Marconi,12387,00,12141,246,9317,3070,12387,0
2019/02,153,16/02/2019,6,Via Porrettana (ex SS 64) tra Bologna e Pontecchio Marconi,11533,00,11412,121,8648,2885,0,11533
2019/02,153,17/02/2019,7,Via Porrettana (ex SS 64) tra Bologna e Pontecchio Marconi,8573,00,8545,28,6376,2197,0,8573
2019/02,153,18/02/2019,1,Via Porrettana (ex SS 64) tra Bologna e Pontecchio Marconi,11065,00,10830,235,8715,2350,11065,0
2019/02,153,19/02/2019,2,Via Porrettana (ex SS 64) tra Bologna e Pontecchio Marconi,11486,00,11232,254,8989,2497,11486,0
2019/02,153,20/02/2019,3,Via Porrettana (ex SS 64) tra Bologna e Pontecchio Marconi,11158,00,10905,253,8534,2624,11158,0
2019/02,153,21/02/2019,4,Via Porrettana (ex SS 64) tra Bologna e Pontecchio Marconi,11556,00,11297,259,8861,2695,11556,0
2019/02,153,22/02/2019,5,Via Porrettana (ex SS 64) tra Bologna e Pontecchio Marconi,11983,00,11727,256,9052,2931,11983,0
2019/02,153,23/02/2019,6,Via Porrettana (ex SS 64) tra Bologna e Pontecchio Marconi,11447,00,11329,118,8492,2955,0,11447
2019/02,153,24/02/2019,7,Via Porrettana (ex SS 64) tra Bologna e Pontecchio Marconi,8483,00,8453,30,6259,2224,0,8483
2019/02,153,25/02/2019,1,Via Porrettana (ex SS 64) tra Bologna e Pontecchio Marconi,10989,00,10722,267,8648,2341,10989,0
2019/02,153,26/02/2019,2,Via Porrettana (ex SS 64) tra Bologna e Pontecchio Marconi,11313,10,11059,253,8891,2422,11313,0
2019/02,153,27/02/2019,3,Via Porrettana (ex SS 64) tra Bologna e Pontecchio Marconi,11415,00,11142,273,8764,2651,11415,0
2019/02,153,28/02/2019,4,Via Porrettana (ex SS 64) tra Bologna e Pontecchio Marconi,11529,00,11318,211,8822,2707,11529,0
2019/02,154,15/02/2019,5,Tra Rastignano e Pian di Macina (SP85 Fondo Valle Savena),12489,00,12212,277,9742,2747,12489,0
2019/02,154,16/02/2019,6,Tra Rastignano e Pian di Macina (SP85 Fondo Valle Savena),10721,00,10648,73,8005,2716,0,10721
2019/02,154,17/02/2019,7,Tra Rastignano e Pian di Macina (SP85 Fondo Valle Savena),9020,00,9009,11,6942,2078,0,9020
2019/02,154,18/02/2019,1,Tra Rastignano e Pian di Macina (SP85 Fondo Valle Savena),11464,10,11247,216,9139,2325,11464,0
2019/02,154,19/02/2019,2,Tra Rastignano e Pian di Macina (SP85 Fondo Valle Savena),11955,00,11689,266,9368,2587,11955,0
2019/02,154,20/02/2019,3,Tra Rastignano e Pian di Macina (SP85 Fondo Valle Savena),12225,00,11978,247,9563,2662,12225,0
2019/02,154,21/02/2019,4,Tra Rastignano e Pian di Macina (SP85 Fondo Valle Savena),11989,10,11736,252,9377,2612,11989,0
2019/02,154,22/02/2019,5,Tra Rastignano e Pian di Macina (SP85 Fondo Valle Savena),12377,10,12095,281,9623,2754,12377,0
2019/02,154,23/02/2019,6,Tra Rastignano e Pian di Macina (SP85 Fondo Valle Savena),10539,30,10452,84,8042,2497,0,10539
2019/02,154,24/02/2019,7,Tra Rastignano e Pian di Macina (SP85 Fondo Valle Savena),8726,10,8702,23,6565,2161,0,8726
2019/02,154,25/02/2019,1,Tra Rastignano e Pian di Macina (SP85 Fondo Valle Savena),11380,30,11150,227,9063,2317,11380,0
2019/02,154,26/02/2019,2,Tra Rastignano e Pian di Macina (SP85 Fondo Valle Savena),11865,20,11612,251,9285,2580,11865,0
2019/02,154,27/02/2019,3,Tra Rastignano e Pian di Macina (SP85 Fondo Valle Savena),12662,20,12399,261,9937,2725,12662,0
2019/02,154,28/02/2019,4,Tra Rastignano e Pian di Macina (SP85 Fondo Valle Savena),12197,40,11925,268,9558,2639,12197,0
2019/02,155,15/02/2019,5,Via Emilia tra San Lazzaro e Idice,15492,00,14993,499,11781,3711,15492,0
2019/02,155,16/02/2019,6,Via Emilia tra San Lazzaro e Idice,14371,20,14102,267,10659,3712,0,14371
2019/02,155,17/02/2019,7,Via Emilia tra San Lazzaro e Idice,11073,10,10987,85,8119,2954,0,11073
2019/02,155,18/02/2019,1,Via Emilia tra San Lazzaro e Idice,14034,30,13533,498,11135,2899,14034,0
2019/02,155,19/02/2019,2,Via Emilia tra San Lazzaro e Idice,14808,00,14307,501,11675,3133,14808,0
2019/02,155,20/02/2019,3,Via Emilia tra San Lazzaro e Idice,15262,20,14758,502,11993,3269,15262,0
2019/02,155,21/02/2019,4,Via Emilia tra San Lazzaro e Idice,15183,10,14685,497,11822,3361,15183,0
2019/02,155,22/02/2019,5,Via Emilia tra San Lazzaro e Idice,15657,10,15185,471,12151,3506,15657,0
2019/02,155,23/02/2019,6,Via Emilia tra San Lazzaro e Idice,14648,10,14390,257,10762,3886,0,14648
2019/02,155,24/02/2019,7,Via Emilia tra San Lazzaro e Idice,11067,00,10992,75,8081,2986,0,11067
2019/02,155,25/02/2019,1,Via Emilia tra San Lazzaro e Idice,14096,20,13618,476,11201,2895,14096,0
2019/02,155,26/02/2019,2,Via Emilia tra San Lazzaro e Idice,14727,10,14240,486,11584,3143,14727,0
2019/02,155,27/02/2019,3,Via Emilia tra San Lazzaro e Idice,15105,10,14607,497,11700,3405,15105,0
2019/02,155,28/02/2019,4,Via Emilia tra San Lazzaro e Idice,15173,10,14677,495,11776,3397,15173,0
2019/02,156,15/02/2019,5,SP 253 tra la località Villanova e inizio variante Castenaso,22264,20,21541,721,17213,5051,22264,0
2019/02,156,16/02/2019,6,SP 253 tra la località Villanova e inizio variante Castenaso,19274,00,19122,152,14523,4751,0,19274
2019/02,156,17/02/2019,7,SP 253 tra la località Villanova e inizio variante Castenaso,14434,00,14394,40,10791,3643,0,14434
2019/02,156,18/02/2019,1,SP 253 tra la località Villanova e inizio variante Castenaso,20851,00,20142,709,16637,4214,20851,0
2019/02,156,19/02/2019,2,SP 253 tra la località Villanova e inizio variante Castenaso,21202,00,20527,675,16922,4280,21202,0
2019/02,156,20/02/2019,3,SP 253 tra la località Villanova e inizio variante Castenaso,21415,00,20703,712,16986,4429,21415,0
2019/02,156,21/02/2019,4,SP 253 tra la località Villanova e inizio variante Castenaso,21273,00,20593,680,16574,4699,21273,0
2019/02,156,22/02/2019,5,SP 253 tra la località Villanova e inizio variante Castenaso,22596,10,21860,735,17455,5141,22596,0
2019/02,156,23/02/2019,6,SP 253 tra la località Villanova e inizio variante Castenaso,19111,10,18938,172,14402,4709,0,19111
2019/02,156,24/02/2019,7,SP 253 tra la località Villanova e inizio variante Castenaso,13781,00,13741,40,10133,3648,0,13781
2019/02,156,25/02/2019,1,SP 253 tra la località Villanova e inizio variante Castenaso,21142,00,20389,753,16814,4328,21142,0
2019/02,156,26/02/2019,2,SP 253 tra la località Villanova e inizio variante Castenaso,21310,10,20539,770,16867,4443,21310,0
2019/02,156,27/02/2019,3,SP 253 tra la località Villanova e inizio variante Castenaso,21930,00,21193,737,17146,4784,21930,0
2019/02,156,28/02/2019,4,SP 253 tra la località Villanova e inizio variante Castenaso,21636,00,20919,717,16794,4842,21636,0
2019/02,157,15/02/2019,5,Via San Donato (ex SP 5) tra Granarolo dell'Emilia e Quarto Inferiore,12346,10,12055,290,9463,2883,12346,0
2019/02,157,16/02/2019,6,Via San Donato (ex SP 5) tra Granarolo dell'Emilia e Quarto Inferiore,11242,10,11094,147,8314,2928,0,11242
2019/02,157,17/02/2019,7,Via San Donato (ex SP 5) tra Granarolo dell'Emilia e Quarto Inferiore,8391,10,8363,27,6072,2319,0,8391
2019/02,157,18/02/2019,1,Via San Donato (ex SP 5) tra Granarolo dell'Emilia e Quarto Inferiore,11509,00,11218,291,9174,2335,11509,0
2019/02,157,19/02/2019,2,Via San Donato (ex SP 5) tra Granarolo dell'Emilia e Quarto Inferiore,11594,10,11306,287,9057,2537,11594,0
2019/02,157,20/02/2019,3,Via San Donato (ex SP 5) tra Granarolo dell'Emilia e Quarto Inferiore,11765,00,11475,290,9188,2577,11765,0
2019/02,157,21/02/2019,4,Via San Donato (ex SP 5) tra Granarolo dell'Emilia e Quarto Inferiore,11890,00,11599,291,9270,2620,11890,0
2019/02,157,22/02/2019,5,Via San Donato (ex SP 5) tra Granarolo dell'Emilia e Quarto Inferiore,12108,00,11815,293,9264,2844,12108,0
2019/02,157,23/02/2019,6,Via San Donato (ex SP 5) tra Granarolo dell'Emilia e Quarto Inferiore,11168,00,11041,127,8233,2935,0,11168
2019/02,157,24/02/2019,7,Via San Donato (ex SP 5) tra Granarolo dell'Emilia e Quarto Inferiore,8511,00,8474,37,6213,2298,0,8511
2019/02,157,25/02/2019,1,Via San Donato (ex SP 5) tra Granarolo dell'Emilia e Quarto Inferiore,11568,10,11275,292,9183,2385,11568,0
2019/02,157,26/02/2019,2,Via San Donato (ex SP 5) tra Granarolo dell'Emilia e Quarto Inferiore,11625,10,11331,293,9117,2508,11625,0
2019/02,157,27/02/2019,3,Via San Donato (ex SP 5) tra Granarolo dell'Emilia e Quarto Inferiore,11843,00,11573,270,9201,2642,11843,0
2019/02,157,28/02/2019,4,Via San Donato (ex SP 5) tra Granarolo dell'Emilia e Quarto Inferiore,12061,00,11759,302,9465,2596,12061,0
2019/02,158,15/02/2019,5,SS 64 tra Bologna e Lovoleto,12209,30,11496,710,9263,2946,12209,0
2019/02,158,16/02/2019,6,SS 64 tra Bologna e Lovoleto,9332,10,9137,194,6647,2685,0,9332
2019/02,158,17/02/2019,7,SS 64 tra Bologna e Lovoleto,7328,00,7264,64,5283,2045,0,7328
2019/02,158,18/02/2019,1,SS 64 tra Bologna e Lovoleto,11728,10,11043,684,9283,2445,11728,0
2019/02,158,19/02/2019,2,SS 64 tra Bologna e Lovoleto,12063,30,11323,737,9334,2729,12063,0
2019/02,158,20/02/2019,3,SS 64 tra Bologna e Lovoleto,12333,20,11576,755,9680,2653,12333,0
2019/02,158,21/02/2019,4,SS 64 tra Bologna e Lovoleto,12196,20,11451,743,9493,2703,12196,0
2019/02,158,22/02/2019,5,SS 64 tra Bologna e Lovoleto,12199,20,11491,706,9297,2902,12199,0
2019/02,158,23/02/2019,6,SS 64 tra Bologna e Lovoleto,9085,20,8888,195,6457,2628,0,9085
2019/02,158,24/02/2019,7,SS 64 tra Bologna e Lovoleto,7240,10,7181,58,5181,2059,0,7240
2019/02,158,25/02/2019,1,SS 64 tra Bologna e Lovoleto,11329,00,10678,651,8876,2453,11329,0
2019/02,158,26/02/2019,2,SS 64 tra Bologna e Lovoleto,11796,00,11081,715,9082,2714,11796,0
2019/02,158,27/02/2019,3,SS 64 tra Bologna e Lovoleto,11981,10,11291,689,9158,2823,11981,0
2019/02,158,28/02/2019,4,SS 64 tra Bologna e Lovoleto,12149,10,11415,733,9271,2878,12149,0
2019/02,160,15/02/2019,5,SP 18 tra Bargellino e Calderara di Reno (c/o Variante SP18),18830,00,17236,1594,14757,4073,18830,0
2019/02,160,16/02/2019,6,SP 18 tra Bargellino e Calderara di Reno (c/o Variante SP18),12949,00,12510,439,9279,3670,0,12949
2019/02,160,17/02/2019,7,SP 18 tra Bargellino e Calderara di Reno (c/o Variante SP18),9927,00,9883,44,7367,2560,0,9927
2019/02,160,18/02/2019,1,SP 18 tra Bargellino e Calderara di Reno (c/o Variante SP18),18530,10,16860,1669,15112,3418,18530,0
2019/02,160,19/02/2019,2,SP 18 tra Bargellino e Calderara di Reno (c/o Variante SP18),18237,00,16579,1658,14418,3819,18237,0
2019/02,160,20/02/2019,3,SP 18 tra Bargellino e Calderara di Reno (c/o Variante SP18),18350,00,16740,1610,14592,3758,18350,0
2019/02,160,21/02/2019,4,SP 18 tra Bargellino e Calderara di Reno (c/o Variante SP18),18534,20,16904,1628,14537,3997,18534,0
2019/02,160,22/02/2019,5,SP 18 tra Bargellino e Calderara di Reno (c/o Variante SP18),19169,00,17557,1612,14855,4314,19169,0
2019/02,160,23/02/2019,6,SP 18 tra Bargellino e Calderara di Reno (c/o Variante SP18),13193,00,12790,403,9533,3660,0,13193
2019/02,160,24/02/2019,7,SP 18 tra Bargellino e Calderara di Reno (c/o Variante SP18),10049,10,9983,65,7482,2567,0,10049
2019/02,160,25/02/2019,1,SP 18 tra Bargellino e Calderara di Reno (c/o Variante SP18),18317,10,16768,1548,14777,3540,18317,0
2019/02,160,26/02/2019,2,SP 18 tra Bargellino e Calderara di Reno (c/o Variante SP18),18203,20,16511,1690,14375,3828,18203,0
2019/02,160,27/02/2019,3,SP 18 tra Bargellino e Calderara di Reno (c/o Variante SP18),18957,20,17162,1793,15067,3890,18957,0
2019/02,160,28/02/2019,4,SP 18 tra Bargellino e Calderara di Reno (c/o Variante SP18),18809,10,17144,1664,14730,4079,18809,0
2019/02,161,15/02/2019,5,SP 568 da Tavernelle all'intersezione della SP3,20145,00,19079,1066,14873,5272,20145,0
2019/02,161,16/02/2019,6,SP 568 da Tavernelle all'intersezione della SP3,17403,00,17161,242,12027,5376,0,17403
2019/02,161,17/02/2019,7,SP 568 da Tavernelle all'intersezione della SP3,14939,00,14883,56,10564,4375,0,14939
2019/02,161,18/02/2019,1,SP 568 da Tavernelle all'intersezione della SP3,18470,00,17442,1028,14162,4308,18470,0
2019/02,161,19/02/2019,2,SP 568 da Tavernelle all'intersezione della SP3,18703,00,17613,1090,14395,4308,18703,0
2019/02,161,20/02/2019,3,SP 568 da Tavernelle all'intersezione della SP3,19175,00,18104,1071,14712,4463,19175,0
2019/02,161,21/02/2019,4,SP 568 da Tavernelle all'intersezione della SP3,19498,00,18383,1115,14770,4728,19498,0
2019/02,161,22/02/2019,5,SP 568 da Tavernelle all'intersezione della SP3,20069,10,19035,1033,14787,5282,20069,0
2019/02,161,23/02/2019,6,SP 568 da Tavernelle all'intersezione della SP3,17113,00,16887,226,11781,5332,0,17113
2019/02,161,24/02/2019,7,SP 568 da Tavernelle all'intersezione della SP3,15468,00,15397,71,11017,4451,0,15468
2019/02,161,25/02/2019,1,SP 568 da Tavernelle all'intersezione della SP3,18603,10,17538,1064,14223,4380,18603,0
2019/02,161,26/02/2019,2,SP 568 da Tavernelle all'intersezione della SP3,18755,00,17671,1084,14432,4323,18755,0
2019/02,161,27/02/2019,3,SP 568 da Tavernelle all'intersezione della SP3,19506,00,18402,1104,14905,4601,19506,0
2019/02,161,28/02/2019,4,SP 568 da Tavernelle all'intersezione della SP3,19610,00,18484,1126,14704,4906,19610,0
2019/02,162,15/02/2019,5,SS 9 località Cavazzona,18394,10,16697,1696,12481,5913,18394,0
2019/02,162,16/02/2019,6,SS 9 località Cavazzona,16265,00,15839,426,10543,5722,0,16265
2019/02,162,17/02/2019,7,SS 9 località Cavazzona,13941,10,13845,95,8921,5020,0,13941
2019/02,162,18/02/2019,1,SS 9 località Cavazzona,16784,00,15177,1607,11956,4828,16784,0
2019/02,162,19/02/2019,2,SS 9 località Cavazzona,17545,00,15863,1682,12399,5146,17545,0
2019/02,162,20/02/2019,3,SS 9 località Cavazzona,17088,00,15474,1614,12122,4966,17088,0
2019/02,162,21/02/2019,4,SS 9 località Cavazzona,17369,10,15681,1687,12217,5152,17369,0
2019/02,162,22/02/2019,5,SS 9 località Cavazzona,18263,40,16538,1721,12417,5846,18263,0
2019/02,162,23/02/2019,6,SS 9 località Cavazzona,16039,10,15605,433,10301,5738,0,16039
2019/02,162,24/02/2019,7,SS 9 località Cavazzona,13770,10,13667,102,9012,4758,0,13770
2019/02,162,25/02/2019,1,SS 9 località Cavazzona,16818,20,15130,1686,11777,5041,16818,0
2019/02,162,26/02/2019,2,SS 9 località Cavazzona,17185,20,15499,1684,12213,4972,17185,0
2019/02,162,28/02/2019,4,SS 9 località Cavazzona,17563,00,15845,1718,12270,5293,17563,0
2019/02,170,15/02/2019,5,SS 67 tra Rovere e Forlì,10555,00,10012,543,8135,2420,10555,0
2019/02,170,16/02/2019,6,SS 67 tra Rovere e Forlì,9343,20,9139,202,6996,2347,0,9343
2019/02,170,17/02/2019,7,SS 67 tra Rovere e Forlì,7839,00,7789,50,5988,1851,0,7839
2019/02,170,18/02/2019,1,SS 67 tra Rovere e Forlì,9781,00,9252,529,7917,1864,9781,0
2019/02,170,19/02/2019,2,SS 67 tra Rovere e Forlì,9662,00,9216,446,7600,2062,9662,0
2019/02,170,20/02/2019,3,SS 67 tra Rovere e Forlì,9491,00,9073,418,7512,1979,9491,0
2019/02,170,21/02/2019,4,SS 67 tra Rovere e Forlì,9365,00,8924,441,7390,1975,9365,0
2019/02,170,22/02/2019,5,SS 67 tra Rovere e Forlì,10002,00,9469,533,7777,2225,10002,0
2019/02,170,23/02/2019,6,SS 67 tra Rovere e Forlì,8659,00,8490,169,6452,2207,0,8659
2019/02,170,24/02/2019,7,SS 67 tra Rovere e Forlì,6884,00,6845,39,5199,1685,0,6884
2019/02,170,25/02/2019,1,SS 67 tra Rovere e Forlì,9406,00,8951,455,7587,1819,9406,0
2019/02,170,26/02/2019,2,SS 67 tra Rovere e Forlì,9704,00,9180,524,7730,1974,9704,0
2019/02,170,27/02/2019,3,SS 67 tra Rovere e Forlì,9763,10,9283,479,7700,2063,9763,0
2019/02,170,28/02/2019,4,SS 67 tra Rovere e Forlì,9943,10,9450,492,7780,2163,9943,0
2019/02,171,15/02/2019,5,SP 56 tra Forlì e bivio SS67 (Castrocaro Terme),6665,00,6521,144,5116,1549,6665,0
2019/02,171,16/02/2019,6,SP 56 tra Forlì e bivio SS67 (Castrocaro Terme),6236,00,6194,42,4714,1522,0,6236
2019/02,171,17/02/2019,7,SP 56 tra Forlì e bivio SS67 (Castrocaro Terme),5045,00,5038,7,3812,1233,0,5045
2019/02,171,18/02/2019,1,SP 56 tra Forlì e bivio SS67 (Castrocaro Terme),6492,00,6342,150,5143,1349,6492,0
2019/02,171,19/02/2019,2,SP 56 tra Forlì e bivio SS67 (Castrocaro Terme),6922,00,6711,211,5529,1393,6922,0
2019/02,171,20/02/2019,3,SP 56 tra Forlì e bivio SS67 (Castrocaro Terme),7036,10,6859,176,5586,1450,7036,0
2019/02,171,21/02/2019,4,SP 56 tra Forlì e bivio SS67 (Castrocaro Terme),7151,10,6977,173,5639,1512,7151,0
2019/02,171,22/02/2019,5,SP 56 tra Forlì e bivio SS67 (Castrocaro Terme),7384,00,7180,204,5700,1684,7384,0
2019/02,171,23/02/2019,6,SP 56 tra Forlì e bivio SS67 (Castrocaro Terme),7002,00,6953,49,5117,1885,0,7002
2019/02,171,24/02/2019,7,SP 56 tra Forlì e bivio SS67 (Castrocaro Terme),5367,10,5355,11,4096,1271,0,5367
2019/02,171,25/02/2019,1,SP 56 tra Forlì e bivio SS67 (Castrocaro Terme),6945,10,6775,169,5503,1442,6945,0
2019/02,171,26/02/2019,2,SP 56 tra Forlì e bivio SS67 (Castrocaro Terme),7105,00,6879,226,5672,1433,7105,0
2019/02,171,27/02/2019,3,SP 56 tra Forlì e bivio SS67 (Castrocaro Terme),7391,00,7212,179,5894,1497,7391,0
2019/02,171,28/02/2019,4,SP 56 tra Forlì e bivio SS67 (Castrocaro Terme),7269,00,7071,198,5647,1622,7269,0
2019/02,173,15/02/2019,5,SP 4 tra Ronco (SS9) e bivio SP 72 (Para),8286,00,7791,495,6548,1738,8286,0
2019/02,173,16/02/2019,6,SP 4 tra Ronco (SS9) e bivio SP 72 (Para),6589,20,6436,151,4888,1701,0,6589
2019/02,173,17/02/2019,7,SP 4 tra Ronco (SS9) e bivio SP 72 (Para),5931,00,5885,46,4532,1399,0,5931
2019/02,173,18/02/2019,1,SP 4 tra Ronco (SS9) e bivio SP 72 (Para),8012,10,7552,459,6527,1485,8012,0
2019/02,173,19/02/2019,2,SP 4 tra Ronco (SS9) e bivio SP 72 (Para),8097,00,7621,476,6512,1585,8097,0
2019/02,173,20/02/2019,3,SP 4 tra Ronco (SS9) e bivio SP 72 (Para),8329,10,7870,458,6693,1636,8329,0
2019/02,173,21/02/2019,4,SP 4 tra Ronco (SS9) e bivio SP 72 (Para),8130,10,7675,454,6499,1631,8130,0
2019/02,173,22/02/2019,5,SP 4 tra Ronco (SS9) e bivio SP 72 (Para),8222,00,7759,463,6388,1834,8222,0
2019/02,173,23/02/2019,6,SP 4 tra Ronco (SS9) e bivio SP 72 (Para),6531,10,6350,180,4918,1613,0,6531
2019/02,173,24/02/2019,7,SP 4 tra Ronco (SS9) e bivio SP 72 (Para),5003,00,4957,46,3732,1271,0,5003
2019/02,173,25/02/2019,1,SP 4 tra Ronco (SS9) e bivio SP 72 (Para),8007,30,7575,429,6486,1521,8007,0
2019/02,173,26/02/2019,2,SP 4 tra Ronco (SS9) e bivio SP 72 (Para),8102,10,7621,480,6479,1623,8102,0
2019/02,173,27/02/2019,3,SP 4 tra Ronco (SS9) e bivio SP 72 (Para),8188,00,7772,416,6519,1669,8188,0
2019/02,173,28/02/2019,4,SP 4 tra Ronco (SS9) e bivio SP 72 (Para),8211,10,7772,438,6473,1738,8211,0
2019/02,174,15/02/2019,5,SS 9 tra Ronco e Forlimpopoli,,,,,,,,
2019/02,174,16/02/2019,6,SS 9 tra Ronco e Forlimpopoli,,,,,,,,
2019/02,174,17/02/2019,7,SS 9 tra Ronco e Forlimpopoli,,,,,,,,
2019/02,174,18/02/2019,1,SS 9 tra Ronco e Forlimpopoli,,,,,,,,
2019/02,174,19/02/2019,2,SS 9 tra Ronco e Forlimpopoli,,,,,,,,
2019/02,174,20/02/2019,3,SS 9 tra Ronco e Forlimpopoli,,,,,,,,
2019/02,174,21/02/2019,4,SS 9 tra Ronco e Forlimpopoli,,,,,,,,
2019/02,174,22/02/2019,5,SS 9 tra Ronco e Forlimpopoli,,,,,,,,
2019/02,174,23/02/2019,6,SS 9 tra Ronco e Forlimpopoli,,,,,,,,
2019/02,174,24/02/2019,7,SS 9 tra Ronco e Forlimpopoli,,,,,,,,
2019/02,174,25/02/2019,1,SS 9 tra Ronco e Forlimpopoli,,,,,,,,
2019/02,174,26/02/2019,2,SS 9 tra Ronco e Forlimpopoli,,,,,,,,
2019/02,174,27/02/2019,3,SS 9 tra Ronco e Forlimpopoli,,,,,,,,
2019/02,174,28/02/2019,4,SS 9 tra Ronco e Forlimpopoli,,,,,,,,
2019/02,176,15/02/2019,5,SP 2 in località La Caserma al Confine Provinciale,8691,00,8076,615,6664,2027,8691,0
2019/02,176,16/02/2019,6,SP 2 in località La Caserma al Confine Provinciale,9319,00,9155,164,6846,2473,0,9319
2019/02,176,17/02/2019,7,SP 2 in località La Caserma al Confine Provinciale,11988,00,11965,23,9932,2056,0,11988
2019/02,176,18/02/2019,1,SP 2 in località La Caserma al Confine Provinciale,7639,00,7050,589,6194,1445,7639,0
2019/02,176,19/02/2019,2,SP 2 in località La Caserma al Confine Provinciale,7902,00,7310,592,6429,1473,7902,0
2019/02,176,20/02/2019,3,SP 2 in località La Caserma al Confine Provinciale,7747,10,7169,577,6305,1442,7747,0
2019/02,176,21/02/2019,4,SP 2 in località La Caserma al Confine Provinciale,8031,10,7433,597,6483,1548,8031,0
2019/02,176,22/02/2019,5,SP 2 in località La Caserma al Confine Provinciale,8625,10,7978,646,6678,1947,8625,0
2019/02,176,23/02/2019,6,SP 2 in località La Caserma al Confine Provinciale,8194,10,8054,139,5892,2302,0,8194
2019/02,176,24/02/2019,7,SP 2 in località La Caserma al Confine Provinciale,8818,00,8792,26,6907,1911,0,8818
2019/02,176,25/02/2019,1,SP 2 in località La Caserma al Confine Provinciale,7888,00,7289,599,6411,1477,7888,0
2019/02,176,26/02/2019,2,SP 2 in località La Caserma al Confine Provinciale,7888,00,7232,656,6371,1517,7888,0
2019/02,176,27/02/2019,3,SP 2 in località La Caserma al Confine Provinciale,8608,00,7903,705,6970,1638,8608,0
2019/02,176,28/02/2019,4,SP 2 in località La Caserma al Confine Provinciale,8729,00,8064,665,7065,1664,8729,0
2019/02,177,15/02/2019,5,NSA 313 - Prosecuzione tangenziale di Bologna complanare sud alla A 14 nel tratto San Lazzaro/Idice,17445,10,16572,872,13101,4344,17445,0
2019/02,177,16/02/2019,6,NSA 313 - Prosecuzione tangenziale di Bologna complanare sud alla A 14 nel tratto San Lazzaro/Idice,13069,10,12867,201,8933,4136,0,13069
2019/02,177,17/02/2019,7,NSA 313 - Prosecuzione tangenziale di Bologna complanare sud alla A 14 nel tratto San Lazzaro/Idice,11411,00,11367,44,7667,3744,0,11411
2019/02,177,18/02/2019,1,NSA 313 - Prosecuzione tangenziale di Bologna complanare sud alla A 14 nel tratto San Lazzaro/Idice,16421,10,15567,853,12682,3739,16421,0
2019/02,177,19/02/2019,2,NSA 313 - Prosecuzione tangenziale di Bologna complanare sud alla A 14 nel tratto San Lazzaro/Idice,17020,00,16142,878,13061,3959,17020,0
2019/02,177,20/02/2019,3,NSA 313 - Prosecuzione tangenziale di Bologna complanare sud alla A 14 nel tratto San Lazzaro/Idice,16997,00,16188,809,12966,4031,16997,0
2019/02,177,21/02/2019,4,NSA 313 - Prosecuzione tangenziale di Bologna complanare sud alla A 14 nel tratto San Lazzaro/Idice,16917,10,16056,860,12893,4024,16917,0
2019/02,177,22/02/2019,5,NSA 313 - Prosecuzione tangenziale di Bologna complanare sud alla A 14 nel tratto San Lazzaro/Idice,17274,00,16444,830,12913,4361,17274,0
2019/02,177,23/02/2019,6,NSA 313 - Prosecuzione tangenziale di Bologna complanare sud alla A 14 nel tratto San Lazzaro/Idice,13486,00,13307,179,9301,4185,0,13486
2019/02,177,24/02/2019,7,NSA 313 - Prosecuzione tangenziale di Bologna complanare sud alla A 14 nel tratto San Lazzaro/Idice,11335,10,11295,39,7626,3709,0,11335
2019/02,177,25/02/2019,1,NSA 313 - Prosecuzione tangenziale di Bologna complanare sud alla A 14 nel tratto San Lazzaro/Idice,16220,00,15443,777,12368,3852,16220,0
2019/02,177,26/02/2019,2,NSA 313 - Prosecuzione tangenziale di Bologna complanare sud alla A 14 nel tratto San Lazzaro/Idice,16773,10,15978,794,12868,3905,16773,0
2019/02,177,27/02/2019,3,NSA 313 - Prosecuzione tangenziale di Bologna complanare sud alla A 14 nel tratto San Lazzaro/Idice,16869,10,16063,805,12708,4161,16869,0
2019/02,177,28/02/2019,4,NSA 313 - Prosecuzione tangenziale di Bologna complanare sud alla A 14 nel tratto San Lazzaro/Idice,17059,10,16235,823,12898,4161,17059,0
2019/02,182,15/02/2019,5,SP 258R tra Rimini e A 14,17914,20,17223,689,13308,4606,17914,0
2019/02,182,16/02/2019,6,SP 258R tra Rimini e A 14,16320,30,16077,240,11466,4854,0,16320
2019/02,182,17/02/2019,7,SP 258R tra Rimini e A 14,14569,00,14506,63,10663,3906,0,14569
2019/02,182,18/02/2019,1,SP 258R tra Rimini e A 14,16872,20,16188,682,13181,3691,16872,0
2019/02,182,19/02/2019,2,SP 258R tra Rimini e A 14,16678,00,16068,610,13083,3595,16678,0
2019/02,182,20/02/2019,3,SP 258R tra Rimini e A 14,16803,10,16101,701,13140,3663,16803,0
2019/02,182,21/02/2019,4,SP 258R tra Rimini e A 14,17052,20,16348,702,13277,3775,17052,0
2019/02,182,22/02/2019,5,SP 258R tra Rimini e A 14,17540,10,16850,689,13224,4316,17540,0
2019/02,182,23/02/2019,6,SP 258R tra Rimini e A 14,15941,10,15684,256,11272,4669,0,15941
2019/02,182,24/02/2019,7,SP 258R tra Rimini e A 14,12670,00,12610,60,9052,3618,0,12670
2019/02,182,25/02/2019,1,SP 258R tra Rimini e A 14,16149,00,15347,802,12663,3486,16149,0
2019/02,182,26/02/2019,2,SP 258R tra Rimini e A 14,16903,40,16164,735,13233,3670,16903,0
2019/02,182,27/02/2019,3,SP 258R tra Rimini e A 14,17154,20,16436,716,13296,3858,17154,0
2019/02,182,28/02/2019,4,SP 258R tra Rimini e A 14,17396,00,16715,681,13426,3970,17396,0
2019/02,186,15/02/2019,5,SS 16 tra Rimini e Igea Marina-Viserba,29919,00,28581,1338,22523,7396,29919,0
2019/02,186,16/02/2019,6,SS 16 tra Rimini e Igea Marina-Viserba,28553,00,28073,480,20762,7791,0,28553
2019/02,186,17/02/2019,7,SS 16 tra Rimini e Igea Marina-Viserba,25898,00,25730,168,19030,6868,0,25898
2019/02,186,18/02/2019,1,SS 16 tra Rimini e Igea Marina-Viserba,28763,10,27541,1221,22829,5934,28763,0
2019/02,186,19/02/2019,2,SS 16 tra Rimini e Igea Marina-Viserba,28565,10,27257,1307,22400,6165,28565,0
2019/02,186,20/02/2019,3,SS 16 tra Rimini e Igea Marina-Viserba,28059,00,26605,1454,22146,5913,28059,0
2019/02,186,21/02/2019,4,SS 16 tra Rimini e Igea Marina-Viserba,27470,10,26153,1316,21461,6009,27470,0
2019/02,186,22/02/2019,5,SS 16 tra Rimini e Igea Marina-Viserba,29559,00,28167,1392,22626,6933,29559,0
2019/02,186,23/02/2019,6,SS 16 tra Rimini e Igea Marina-Viserba,27734,00,27257,477,19892,7842,0,27734
2019/02,186,24/02/2019,7,SS 16 tra Rimini e Igea Marina-Viserba,24615,00,24474,141,17981,6634,0,24615
2019/02,186,25/02/2019,1,SS 16 tra Rimini e Igea Marina-Viserba,27052,10,25900,1151,21378,5674,27052,0
2019/02,186,26/02/2019,2,SS 16 tra Rimini e Igea Marina-Viserba,27716,20,26313,1401,21887,5829,27716,0
2019/02,186,27/02/2019,3,SS 16 tra Rimini e Igea Marina-Viserba,27935,20,26710,1223,21790,6145,27935,0
2019/02,186,28/02/2019,4,SS 16 tra Rimini e Igea Marina-Viserba,28082,10,26749,1332,21854,6228,28082,0
2019/02,188,15/02/2019,5,SS 9 tra Rimini e Santa Giustina,29686,30,28439,1244,22494,7192,29686,0
2019/02,188,16/02/2019,6,SS 9 tra Rimini e Santa Giustina,25596,20,25095,499,18288,7308,0,25596
2019/02,188,17/02/2019,7,SS 9 tra Rimini e Santa Giustina,21434,20,21274,158,15692,5742,0,21434
2019/02,188,18/02/2019,1,SS 9 tra Rimini e Santa Giustina,28897,100,27782,1105,22921,5976,28897,0
2019/02,188,19/02/2019,2,SS 9 tra Rimini e Santa Giustina,28777,40,27657,1116,22582,6195,28777,0
2019/02,188,20/02/2019,3,SS 9 tra Rimini e Santa Giustina,28132,40,26958,1170,21822,6310,28132,0
2019/02,188,21/02/2019,4,SS 9 tra Rimini e Santa Giustina,27908,40,26822,1082,21657,6251,27908,0
2019/02,188,22/02/2019,5,SS 9 tra Rimini e Santa Giustina,28949,20,27795,1152,22211,6738,28949,0
2019/02,188,23/02/2019,6,SS 9 tra Rimini e Santa Giustina,24558,10,24072,485,17779,6779,0,24558
2019/02,188,24/02/2019,7,SS 9 tra Rimini e Santa Giustina,18828,30,18691,134,13251,5577,0,18828
2019/02,188,25/02/2019,1,SS 9 tra Rimini e Santa Giustina,27552,10,26402,1149,21769,5783,27552,0
2019/02,188,26/02/2019,2,SS 9 tra Rimini e Santa Giustina,27794,10,26673,1120,21989,5805,27794,0
2019/02,188,27/02/2019,3,SS 9 tra Rimini e Santa Giustina,28312,30,27134,1175,21902,6410,28312,0
2019/02,188,28/02/2019,4,SS 9 tra Rimini e Santa Giustina,28417,10,27303,1113,21827,6590,28417,0
2019/02,215,15/02/2019,5,SP 3_1 tra accesso interporto Bologna e viadotto A 13,29456,50,22456,6995,21662,7794,29456,0
2019/02,215,16/02/2019,6,SP 3_1 tra accesso interporto Bologna e viadotto A 13,15736,30,14151,1582,10764,4972,0,15736
2019/02,215,17/02/2019,7,SP 3_1 tra accesso interporto Bologna e viadotto A 13,12609,00,12453,156,9192,3417,0,12609
2019/02,215,18/02/2019,1,SP 3_1 tra accesso interporto Bologna e viadotto A 13,27366,50,21337,6024,21228,6138,27366,0
2019/02,215,19/02/2019,2,SP 3_1 tra accesso interporto Bologna e viadotto A 13,29018,40,21981,7033,21712,7306,29018,0
2019/02,215,20/02/2019,3,SP 3_1 tra accesso interporto Bologna e viadotto A 13,28785,30,21680,7102,21472,7313,28785,0
2019/02,215,21/02/2019,4,SP 3_1 tra accesso interporto Bologna e viadotto A 13,28955,20,21947,7006,21493,7462,28955,0
2019/02,215,22/02/2019,5,SP 3_1 tra accesso interporto Bologna e viadotto A 13,29303,30,22281,7019,21744,7559,29303,0
2019/02,215,23/02/2019,6,SP 3_1 tra accesso interporto Bologna e viadotto A 13,15717,20,14126,1589,10682,5035,0,15717
2019/02,215,24/02/2019,7,SP 3_1 tra accesso interporto Bologna e viadotto A 13,12576,00,12418,158,9237,3339,0,12576
2019/02,215,25/02/2019,1,SP 3_1 tra accesso interporto Bologna e viadotto A 13,27640,10,21835,5804,21380,6260,27640,0
2019/02,215,26/02/2019,2,SP 3_1 tra accesso interporto Bologna e viadotto A 13,28967,40,21936,7027,21745,7222,28967,0
2019/02,215,27/02/2019,3,SP 3_1 tra accesso interporto Bologna e viadotto A 13,28037,110,21384,6642,20476,7561,28037,0
2019/02,215,28/02/2019,4,SP 3_1 tra accesso interporto Bologna e viadotto A 13,29808,50,22696,7107,22311,7497,29808,0
2019/02,218,15/02/2019,5,SP 10 tra Polesine e Roccabianca su variante Zibello,2529,00,2205,324,1934,595,2529,0
2019/02,218,16/02/2019,6,SP 10 tra Polesine e Roccabianca su variante Zibello,1849,00,1748,101,1335,514,0,1849
2019/02,218,17/02/2019,7,SP 10 tra Polesine e Roccabianca su variante Zibello,1684,00,1656,28,1303,381,0,1684
2019/02,218,18/02/2019,1,SP 10 tra Polesine e Roccabianca su variante Zibello,2302,00,1950,352,1856,446,2302,0
2019/02,218,19/02/2019,2,SP 10 tra Polesine e Roccabianca su variante Zibello,2361,00,2006,355,1874,487,2361,0
2019/02,218,20/02/2019,3,SP 10 tra Polesine e Roccabianca su variante Zibello,2415,10,2064,350,1937,478,2415,0
2019/02,218,21/02/2019,4,SP 10 tra Polesine e Roccabianca su variante Zibello,2454,00,2097,357,1914,540,2454,0
2019/02,218,22/02/2019,5,SP 10 tra Polesine e Roccabianca su variante Zibello,2500,10,2139,360,1963,537,2500,0
2019/02,218,23/02/2019,6,SP 10 tra Polesine e Roccabianca su variante Zibello,1895,00,1808,87,1386,509,0,1895
2019/02,218,24/02/2019,7,SP 10 tra Polesine e Roccabianca su variante Zibello,1788,00,1757,31,1390,398,0,1788
2019/02,218,25/02/2019,1,SP 10 tra Polesine e Roccabianca su variante Zibello,2348,20,1966,380,1905,443,2348,0
2019/02,218,26/02/2019,2,SP 10 tra Polesine e Roccabianca su variante Zibello,2472,00,2075,397,1988,484,2472,0
2019/02,218,27/02/2019,3,SP 10 tra Polesine e Roccabianca su variante Zibello,2402,00,2010,392,1918,484,2402,0
2019/02,218,28/02/2019,4,SP 10 tra Polesine e Roccabianca su variante Zibello,2476,00,2070,406,1937,539,2476,0
2019/02,219,15/02/2019,5,SS 9 tra Fiorenzuola d'Arda e Pontenure,17121,80,15745,1368,13356,3765,17121,0
2019/02,219,16/02/2019,6,SS 9 tra Fiorenzuola d'Arda e Pontenure,14247,130,13838,396,10530,3717,0,14247
2019/02,219,17/02/2019,7,SS 9 tra Fiorenzuola d'Arda e Pontenure,11897,30,11802,92,8873,3024,0,11897
2019/02,219,18/02/2019,1,SS 9 tra Fiorenzuola d'Arda e Pontenure,16326,90,15026,1291,13182,3144,16326,0
2019/02,219,19/02/2019,2,SS 9 tra Fiorenzuola d'Arda e Pontenure,16548,120,15199,1337,13316,3232,16548,0
2019/02,219,20/02/2019,3,SS 9 tra Fiorenzuola d'Arda e Pontenure,17556,90,15937,1610,14143,3413,17556,0
2019/02,219,21/02/2019,4,SS 9 tra Fiorenzuola d'Arda e Pontenure,17436,80,15936,1492,13947,3489,17436,0
2019/02,219,22/02/2019,5,SS 9 tra Fiorenzuola d'Arda e Pontenure,17495,130,16093,1389,13676,3819,17495,0
2019/02,219,23/02/2019,6,SS 9 tra Fiorenzuola d'Arda e Pontenure,13983,90,13587,387,10479,3504,0,13983
2019/02,219,24/02/2019,7,SS 9 tra Fiorenzuola d'Arda e Pontenure,10902,30,10800,99,8059,2843,0,10902
2019/02,219,25/02/2019,1,SS 9 tra Fiorenzuola d'Arda e Pontenure,16441,140,15062,1365,13134,3307,16441,0
2019/02,219,26/02/2019,2,SS 9 tra Fiorenzuola d'Arda e Pontenure,16559,110,15173,1375,13289,3270,16559,0
2019/02,219,27/02/2019,3,SS 9 tra Fiorenzuola d'Arda e Pontenure,16674,130,15281,1380,13225,3449,16674,0
2019/02,219,28/02/2019,4,SS 9 tra Fiorenzuola d'Arda e Pontenure,17491,110,16034,1446,13845,3646,17491,0
2019/02,220,15/02/2019,5,SS 9 tra Fiorenzuola d'Arda e Fidenza al confine provinciale,14407,00,12788,1619,11112,3295,14407,0
2019/02,220,16/02/2019,6,SS 9 tra Fiorenzuola d'Arda e Fidenza al confine provinciale,13229,20,12824,403,10033,3196,0,13229
2019/02,220,17/02/2019,7,SS 9 tra Fiorenzuola d'Arda e Fidenza al confine provinciale,12514,00,12432,82,9651,2863,0,12514
2019/02,220,18/02/2019,1,SS 9 tra Fiorenzuola d'Arda e Fidenza al confine provinciale,13166,00,11604,1562,10533,2633,13166,0
2019/02,220,19/02/2019,2,SS 9 tra Fiorenzuola d'Arda e Fidenza al confine provinciale,13385,00,11889,1496,10569,2816,13385,0
2019/02,220,20/02/2019,3,SS 9 tra Fiorenzuola d'Arda e Fidenza al confine provinciale,15120,10,13180,1939,12277,2843,15120,0
2019/02,220,21/02/2019,4,SS 9 tra Fiorenzuola d'Arda e Fidenza al confine provinciale,13902,00,12345,1557,10945,2957,13902,0
2019/02,220,22/02/2019,5,SS 9 tra Fiorenzuola d'Arda e Fidenza al confine provinciale,14774,1160,12762,1896,11645,3129,14774,0
2019/02,220,23/02/2019,6,SS 9 tra Fiorenzuola d'Arda e Fidenza al confine provinciale,13445,10,13044,400,10194,3251,0,13445
2019/02,220,24/02/2019,7,SS 9 tra Fiorenzuola d'Arda e Fidenza al confine provinciale,12488,00,12382,106,9655,2833,0,12488
2019/02,220,25/02/2019,1,SS 9 tra Fiorenzuola d'Arda e Fidenza al confine provinciale,,,,,,,,
2019/02,220,26/02/2019,2,SS 9 tra Fiorenzuola d'Arda e Fidenza al confine provinciale,,,,,,,,
2019/02,220,27/02/2019,3,SS 9 tra Fiorenzuola d'Arda e Fidenza al confine provinciale,,,,,,,,
2019/02,220,28/02/2019,4,SS 9 tra Fiorenzuola d'Arda e Fidenza al confine provinciale,,,,,,,,
2019/02,221,15/02/2019,5,SS 9 tra Fidenza e A 15,25615,10,22717,2897,19462,6153,25615,0
2019/02,221,16/02/2019,6,SS 9 tra Fidenza e A 15,19127,00,18437,690,13674,5453,0,19127
2019/02,221,17/02/2019,7,SS 9 tra Fidenza e A 15,16436,00,16287,149,11855,4581,0,16436
2019/02,221,18/02/2019,1,SS 9 tra Fidenza e A 15,19733,00,17212,2521,14943,4790,19733,0
2019/02,221,19/02/2019,2,SS 9 tra Fidenza e A 15,20060,10,17382,2677,15147,4913,20060,0
2019/02,221,20/02/2019,3,SS 9 tra Fidenza e A 15,21968,20,19041,2925,16787,5181,21968,0
2019/02,221,21/02/2019,4,SS 9 tra Fidenza e A 15,23779,00,20982,2797,18304,5475,23779,0
2019/02,221,22/02/2019,5,SS 9 tra Fidenza e A 15,24801,00,21862,2939,18787,6014,24801,0
2019/02,221,23/02/2019,6,SS 9 tra Fidenza e A 15,21169,10,20466,702,15374,5795,0,21169
2019/02,221,24/02/2019,7,SS 9 tra Fidenza e A 15,18701,00,18480,221,13655,5046,0,18701
2019/02,221,25/02/2019,1,SS 9 tra Fidenza e A 15,24175,10,21334,2840,18867,5308,24175,0
2019/02,221,26/02/2019,2,SS 9 tra Fidenza e A 15,24499,10,21574,2924,19049,5450,24499,0
2019/02,221,27/02/2019,3,SS 9 tra Fidenza e A 15,25055,10,22129,2925,19288,5767,25055,0
2019/02,221,28/02/2019,4,SS 9 tra Fidenza e A 15,25360,20,22337,3021,19469,5891,25360,0
2019/02,222,15/02/2019,5,SP 359R tra Fidenza e Salsomaggiore Terme,17242,70,16754,481,12846,4396,17242,0
2019/02,222,16/02/2019,6,SP 359R tra Fidenza e Salsomaggiore Terme,15843,80,15601,234,11253,4590,0,15843
2019/02,222,17/02/2019,7,SP 359R tra Fidenza e Salsomaggiore Terme,12059,00,12008,51,8620,3439,0,12059
2019/02,222,18/02/2019,1,SP 359R tra Fidenza e Salsomaggiore Terme,15691,30,15298,390,12283,3408,15691,0
2019/02,222,19/02/2019,2,SP 359R tra Fidenza e Salsomaggiore Terme,16232,110,15807,414,12610,3622,16232,0
2019/02,222,20/02/2019,3,SP 359R tra Fidenza e Salsomaggiore Terme,16037,50,15590,442,12266,3771,16037,0
2019/02,222,21/02/2019,4,SP 359R tra Fidenza e Salsomaggiore Terme,16293,50,15881,407,12447,3846,16293,0
2019/02,222,22/02/2019,5,SP 359R tra Fidenza e Salsomaggiore Terme,17063,60,16593,464,12710,4353,17063,0
2019/02,222,23/02/2019,6,SP 359R tra Fidenza e Salsomaggiore Terme,16213,20,15961,250,11598,4615,0,16213
2019/02,222,24/02/2019,7,SP 359R tra Fidenza e Salsomaggiore Terme,12302,10,12172,129,8625,3677,0,12302
2019/02,222,25/02/2019,1,SP 359R tra Fidenza e Salsomaggiore Terme,15899,60,15438,455,12411,3488,15899,0
2019/02,222,26/02/2019,2,SP 359R tra Fidenza e Salsomaggiore Terme,16233,40,15771,458,12520,3713,16233,0
2019/02,222,27/02/2019,3,SP 359R tra Fidenza e Salsomaggiore Terme,16188,50,15736,447,12300,3888,16188,0
2019/02,222,28/02/2019,4,SP 359R tra Fidenza e Salsomaggiore Terme,16445,70,16034,404,12458,3987,16445,0
2019/02,223,15/02/2019,5,SP 357R tra SS 9 e Noceto,9599,00,8316,1283,7250,2349,9599,0
2019/02,223,16/02/2019,6,SP 357R tra SS 9 e Noceto,8632,00,8334,298,6233,2399,0,8632
2019/02,223,17/02/2019,7,SP 357R tra SS 9 e Noceto,6997,00,6908,89,5077,1920,0,6997
2019/02,223,18/02/2019,1,SP 357R tra SS 9 e Noceto,9051,30,7895,1153,7009,2042,9051,0
2019/02,223,19/02/2019,2,SP 357R tra SS 9 e Noceto,8689,30,7432,1254,6603,2086,8689,0
2019/02,223,20/02/2019,3,SP 357R tra SS 9 e Noceto,8798,40,7607,1187,6725,2073,8798,0
2019/02,223,21/02/2019,4,SP 357R tra SS 9 e Noceto,8946,20,7689,1255,6823,2123,8946,0
2019/02,223,22/02/2019,5,SP 357R tra SS 9 e Noceto,9764,10,8596,1167,7172,2592,9764,0
2019/02,223,23/02/2019,6,SP 357R tra SS 9 e Noceto,10472,00,10144,328,7704,2768,0,10472
2019/02,223,24/02/2019,7,SP 357R tra SS 9 e Noceto,7730,00,7621,109,5591,2139,0,7730
2019/02,223,25/02/2019,1,SP 357R tra SS 9 e Noceto,11884,00,10549,1335,9613,2271,11884,0
2019/02,223,26/02/2019,2,SP 357R tra SS 9 e Noceto,10553,00,9301,1252,8404,2149,10553,0
2019/02,223,27/02/2019,3,SP 357R tra SS 9 e Noceto,10788,10,9455,1332,8544,2244,10788,0
2019/02,223,28/02/2019,4,SP 357R tra SS 9 e Noceto,10761,00,9461,1300,8435,2326,10761,0
2019/02,226,15/02/2019,5,SP 32 dal bivio SP 16 (per Langhirano) al bivio SP 665R,12087,10,11228,858,9382,2705,12087,0
2019/02,226,16/02/2019,6,SP 32 dal bivio SP 16 (per Langhirano) al bivio SP 665R,9559,00,9350,209,7103,2456,0,9559
2019/02,226,17/02/2019,7,SP 32 dal bivio SP 16 (per Langhirano) al bivio SP 665R,8663,10,8563,99,6597,2066,0,8663
2019/02,226,18/02/2019,1,SP 32 dal bivio SP 16 (per Langhirano) al bivio SP 665R,11239,00,10407,832,9133,2106,11239,0
2019/02,226,19/02/2019,2,SP 32 dal bivio SP 16 (per Langhirano) al bivio SP 665R,11780,00,10977,803,9507,2273,11780,0
2019/02,226,20/02/2019,3,SP 32 dal bivio SP 16 (per Langhirano) al bivio SP 665R,11691,00,10743,948,9428,2263,11691,0
2019/02,226,21/02/2019,4,SP 32 dal bivio SP 16 (per Langhirano) al bivio SP 665R,11912,10,11025,886,9518,2394,11912,0
2019/02,226,22/02/2019,5,SP 32 dal bivio SP 16 (per Langhirano) al bivio SP 665R,12293,00,11370,923,9659,2634,12293,0
2019/02,226,23/02/2019,6,SP 32 dal bivio SP 16 (per Langhirano) al bivio SP 665R,9494,00,9273,221,7100,2394,0,9494
2019/02,226,24/02/2019,7,SP 32 dal bivio SP 16 (per Langhirano) al bivio SP 665R,8512,00,8408,104,6471,2041,0,8512
2019/02,226,25/02/2019,1,SP 32 dal bivio SP 16 (per Langhirano) al bivio SP 665R,11468,10,10651,816,9348,2120,11468,0
2019/02,226,26/02/2019,2,SP 32 dal bivio SP 16 (per Langhirano) al bivio SP 665R,11793,00,10995,798,9488,2305,11793,0
2019/02,226,27/02/2019,3,SP 32 dal bivio SP 16 (per Langhirano) al bivio SP 665R,11554,00,10753,801,9165,2389,11554,0
2019/02,226,28/02/2019,4,SP 32 dal bivio SP 16 (per Langhirano) al bivio SP 665R,11877,10,11034,842,9500,2377,11877,0
2019/02,227,15/02/2019,5,SP 34 da Colorno al bivio SP 60 (al confine provinciale),5557,00,5350,207,4341,1216,5557,0
2019/02,227,16/02/2019,6,SP 34 da Colorno al bivio SP 60 (al confine provinciale),5184,10,5084,99,4027,1157,0,5184
2019/02,227,17/02/2019,7,SP 34 da Colorno al bivio SP 60 (al confine provinciale),3689,00,3657,32,2811,878,0,3689
2019/02,227,18/02/2019,1,SP 34 da Colorno al bivio SP 60 (al confine provinciale),5524,00,5317,207,4435,1089,5524,0
2019/02,227,19/02/2019,2,SP 34 da Colorno al bivio SP 60 (al confine provinciale),5900,00,5693,207,4749,1151,5900,0
2019/02,227,20/02/2019,3,SP 34 da Colorno al bivio SP 60 (al confine provinciale),5828,00,5620,208,4631,1197,5828,0
2019/02,227,21/02/2019,4,SP 34 da Colorno al bivio SP 60 (al confine provinciale),5971,10,5752,218,4778,1193,5971,0
2019/02,227,22/02/2019,5,SP 34 da Colorno al bivio SP 60 (al confine provinciale),5979,00,5766,213,4680,1299,5979,0
2019/02,227,23/02/2019,6,SP 34 da Colorno al bivio SP 60 (al confine provinciale),5024,00,4936,88,3831,1193,0,5024
2019/02,227,24/02/2019,7,SP 34 da Colorno al bivio SP 60 (al confine provinciale),3698,00,3671,27,2790,908,0,3698
2019/02,227,25/02/2019,1,SP 34 da Colorno al bivio SP 60 (al confine provinciale),5678,00,5486,192,4569,1109,5678,0
2019/02,227,26/02/2019,2,SP 34 da Colorno al bivio SP 60 (al confine provinciale),5802,00,5577,225,4617,1185,5802,0
2019/02,227,27/02/2019,3,SP 34 da Colorno al bivio SP 60 (al confine provinciale),5916,00,5675,241,4714,1202,5916,0
2019/02,227,28/02/2019,4,SP 34 da Colorno al bivio SP 60 (al confine provinciale),6362,00,6159,203,4914,1448,6362,0
2019/02,228,15/02/2019,5,SP 62R tra Brescello (bivio SP 41) e Sorbolo (bivio SP 20),11785,00,9956,1829,9120,2665,11785,0
2019/02,228,16/02/2019,6,SP 62R tra Brescello (bivio SP 41) e Sorbolo (bivio SP 20),10337,10,9986,350,7675,2662,0,10337
2019/02,228,17/02/2019,7,SP 62R tra Brescello (bivio SP 41) e Sorbolo (bivio SP 20),9731,10,9631,99,6706,3025,0,9731
2019/02,228,18/02/2019,1,SP 62R tra Brescello (bivio SP 41) e Sorbolo (bivio SP 20),10935,40,8932,1999,8775,2160,10935,0
2019/02,228,19/02/2019,2,SP 62R tra Brescello (bivio SP 41) e Sorbolo (bivio SP 20),10863,30,8897,1963,8645,2218,10863,0
2019/02,228,20/02/2019,3,SP 62R tra Brescello (bivio SP 41) e Sorbolo (bivio SP 20),11147,30,9165,1979,8847,2300,11147,0
2019/02,228,21/02/2019,4,SP 62R tra Brescello (bivio SP 41) e Sorbolo (bivio SP 20),11547,40,9504,2039,9207,2340,11547,0
2019/02,228,22/02/2019,5,SP 62R tra Brescello (bivio SP 41) e Sorbolo (bivio SP 20),11775,80,9892,1875,9219,2556,11775,0
2019/02,228,23/02/2019,6,SP 62R tra Brescello (bivio SP 41) e Sorbolo (bivio SP 20),10032,10,9652,379,7433,2599,0,10032
2019/02,228,24/02/2019,7,SP 62R tra Brescello (bivio SP 41) e Sorbolo (bivio SP 20),9428,20,9331,95,6530,2898,0,9428
2019/02,228,25/02/2019,1,SP 62R tra Brescello (bivio SP 41) e Sorbolo (bivio SP 20),10861,30,8957,1901,8615,2246,10861,0
2019/02,228,26/02/2019,2,SP 62R tra Brescello (bivio SP 41) e Sorbolo (bivio SP 20),10961,60,9037,1918,8752,2209,10961,0
2019/02,228,27/02/2019,3,SP 62R tra Brescello (bivio SP 41) e Sorbolo (bivio SP 20),11354,40,9382,1968,9067,2287,11354,0
2019/02,228,28/02/2019,4,SP 62R tra Brescello (bivio SP 41) e Sorbolo (bivio SP 20),11793,10,9793,1999,9343,2450,11793,0
2019/02,229,15/02/2019,5,SP 111 tra bivio SP 1 (a nord di Poviglio) e Boretto (innesto variante),,,,,,,,
2019/02,229,16/02/2019,6,SP 111 tra bivio SP 1 (a nord di Poviglio) e Boretto (innesto variante),,,,,,,,
2019/02,229,17/02/2019,7,SP 111 tra bivio SP 1 (a nord di Poviglio) e Boretto (innesto variante),,,,,,,,
2019/02,229,18/02/2019,1,SP 111 tra bivio SP 1 (a nord di Poviglio) e Boretto (innesto variante),,,,,,,,
2019/02,229,19/02/2019,2,SP 111 tra bivio SP 1 (a nord di Poviglio) e Boretto (innesto variante),,,,,,,,
2019/02,229,20/02/2019,3,SP 111 tra bivio SP 1 (a nord di Poviglio) e Boretto (innesto variante),,,,,,,,
2019/02,229,21/02/2019,4,SP 111 tra bivio SP 1 (a nord di Poviglio) e Boretto (innesto variante),,,,,,,,
2019/02,229,22/02/2019,5,SP 111 tra bivio SP 1 (a nord di Poviglio) e Boretto (innesto variante),,,,,,,,
2019/02,229,23/02/2019,6,SP 111 tra bivio SP 1 (a nord di Poviglio) e Boretto (innesto variante),,,,,,,,
2019/02,229,24/02/2019,7,SP 111 tra bivio SP 1 (a nord di Poviglio) e Boretto (innesto variante),,,,,,,,
2019/02,229,25/02/2019,1,SP 111 tra bivio SP 1 (a nord di Poviglio) e Boretto (innesto variante),,,,,,,,
2019/02,229,26/02/2019,2,SP 111 tra bivio SP 1 (a nord di Poviglio) e Boretto (innesto variante),,,,,,,,
2019/02,229,27/02/2019,3,SP 111 tra bivio SP 1 (a nord di Poviglio) e Boretto (innesto variante),,,,,,,,
2019/02,229,28/02/2019,4,SP 111 tra bivio SP 1 (a nord di Poviglio) e Boretto (innesto variante),,,,,,,,
2019/02,230,15/02/2019,5,SP 62RVar Cispadana da Boretto (bivio Variante SP 358R) a Gualtieri (bivio SP 63R),11990,00,9502,2488,9338,2652,11990,0
2019/02,230,16/02/2019,6,SP 62RVar Cispadana da Boretto (bivio Variante SP 358R) a Gualtieri (bivio SP 63R),8904,00,8442,462,6517,2387,0,8904
2019/02,230,17/02/2019,7,SP 62RVar Cispadana da Boretto (bivio Variante SP 358R) a Gualtieri (bivio SP 63R),9259,00,9128,131,6567,2692,0,9259
2019/02,230,18/02/2019,1,SP 62RVar Cispadana da Boretto (bivio Variante SP 358R) a Gualtieri (bivio SP 63R),10820,00,8167,2653,8726,2094,10820,0
2019/02,230,19/02/2019,2,SP 62RVar Cispadana da Boretto (bivio Variante SP 358R) a Gualtieri (bivio SP 63R),11310,00,8553,2757,9060,2250,11310,0
2019/02,230,20/02/2019,3,SP 62RVar Cispadana da Boretto (bivio Variante SP 358R) a Gualtieri (bivio SP 63R),11311,00,8649,2662,9024,2287,11311,0
2019/02,230,21/02/2019,4,SP 62RVar Cispadana da Boretto (bivio Variante SP 358R) a Gualtieri (bivio SP 63R),11376,00,8834,2542,9056,2320,11376,0
2019/02,230,22/02/2019,5,SP 62RVar Cispadana da Boretto (bivio Variante SP 358R) a Gualtieri (bivio SP 63R),12151,10,9573,2577,9462,2689,12151,0
2019/02,230,23/02/2019,6,SP 62RVar Cispadana da Boretto (bivio Variante SP 358R) a Gualtieri (bivio SP 63R),8832,00,8449,383,6421,2411,0,8832
2019/02,230,24/02/2019,7,SP 62RVar Cispadana da Boretto (bivio Variante SP 358R) a Gualtieri (bivio SP 63R),8389,00,8259,130,5815,2574,0,8389
2019/02,230,25/02/2019,1,SP 62RVar Cispadana da Boretto (bivio Variante SP 358R) a Gualtieri (bivio SP 63R),11015,00,8421,2594,8787,2228,11015,0
2019/02,230,26/02/2019,2,SP 62RVar Cispadana da Boretto (bivio Variante SP 358R) a Gualtieri (bivio SP 63R),11438,10,8782,2655,9188,2250,11438,0
2019/02,230,27/02/2019,3,SP 62RVar Cispadana da Boretto (bivio Variante SP 358R) a Gualtieri (bivio SP 63R),11524,00,8805,2719,9208,2316,11524,0
2019/02,230,28/02/2019,4,SP 62RVar Cispadana da Boretto (bivio Variante SP 358R) a Gualtieri (bivio SP 63R),11805,00,9106,2699,9420,2385,11805,0
2019/02,231,15/02/2019,5,SP 63R tra la località Santa Vittoria (c/o bivio SP 81) e la Cispadana,7373,10,6878,494,5891,1482,7373,0
2019/02,231,16/02/2019,6,SP 63R tra la località Santa Vittoria (c/o bivio SP 81) e la Cispadana,6262,00,6135,127,4710,1552,0,6262
2019/02,231,17/02/2019,7,SP 63R tra la località Santa Vittoria (c/o bivio SP 81) e la Cispadana,5411,00,5384,27,4101,1310,0,5411
2019/02,231,18/02/2019,1,SP 63R tra la località Santa Vittoria (c/o bivio SP 81) e la Cispadana,6772,00,6298,474,5571,1201,6772,0
2019/02,231,19/02/2019,2,SP 63R tra la località Santa Vittoria (c/o bivio SP 81) e la Cispadana,7113,10,6641,471,5851,1262,7113,0
2019/02,231,20/02/2019,3,SP 63R tra la località Santa Vittoria (c/o bivio SP 81) e la Cispadana,6914,00,6467,447,5582,1332,6914,0
2019/02,231,21/02/2019,4,SP 63R tra la località Santa Vittoria (c/o bivio SP 81) e la Cispadana,7214,10,6749,464,5892,1322,7214,0
2019/02,231,22/02/2019,5,SP 63R tra la località Santa Vittoria (c/o bivio SP 81) e la Cispadana,7264,00,6743,521,5845,1419,7264,0
2019/02,231,23/02/2019,6,SP 63R tra la località Santa Vittoria (c/o bivio SP 81) e la Cispadana,6501,00,6359,142,4932,1569,0,6501
2019/02,231,24/02/2019,7,SP 63R tra la località Santa Vittoria (c/o bivio SP 81) e la Cispadana,4963,00,4949,14,3756,1207,0,4963
2019/02,231,25/02/2019,1,SP 63R tra la località Santa Vittoria (c/o bivio SP 81) e la Cispadana,6693,00,6266,427,5551,1142,6693,0
2019/02,231,26/02/2019,2,SP 63R tra la località Santa Vittoria (c/o bivio SP 81) e la Cispadana,7113,00,6670,443,5763,1350,7113,0
2019/02,231,27/02/2019,3,SP 63R tra la località Santa Vittoria (c/o bivio SP 81) e la Cispadana,7111,00,6638,473,5800,1311,7111,0
2019/02,231,28/02/2019,4,SP 63R tra la località Santa Vittoria (c/o bivio SP 81) e la Cispadana,7280,40,6776,500,5915,1365,7280,0
2019/02,236,15/02/2019,5,SP 468 tra Casumaro e Reno Centese,5806,00,5206,600,4548,1258,5806,0
2019/02,236,16/02/2019,6,SP 468 tra Casumaro e Reno Centese,5095,00,4963,132,3871,1224,0,5095
2019/02,236,17/02/2019,7,SP 468 tra Casumaro e Reno Centese,4345,00,4328,17,3299,1046,0,4345
2019/02,236,18/02/2019,1,SP 468 tra Casumaro e Reno Centese,5369,10,4764,604,4354,1015,5369,0
2019/02,236,19/02/2019,2,SP 468 tra Casumaro e Reno Centese,5319,00,4740,579,4294,1025,5319,0
2019/02,236,20/02/2019,3,SP 468 tra Casumaro e Reno Centese,5445,00,4873,572,4439,1006,5445,0
2019/02,236,21/02/2019,4,SP 468 tra Casumaro e Reno Centese,5320,00,4731,589,4270,1050,5320,0
2019/02,236,22/02/2019,5,SP 468 tra Casumaro e Reno Centese,5648,00,4977,671,4417,1231,5648,0
2019/02,236,23/02/2019,6,SP 468 tra Casumaro e Reno Centese,5000,00,4868,132,3833,1167,0,5000
2019/02,236,24/02/2019,7,SP 468 tra Casumaro e Reno Centese,4192,00,4168,24,3193,999,0,4192
2019/02,236,25/02/2019,1,SP 468 tra Casumaro e Reno Centese,5321,00,4701,620,4263,1058,5321,0
2019/02,236,26/02/2019,2,SP 468 tra Casumaro e Reno Centese,5307,00,4690,617,4311,996,5307,0
2019/02,236,27/02/2019,3,SP 468 tra Casumaro e Reno Centese,5710,00,5047,663,4579,1131,5710,0
2019/02,236,28/02/2019,4,SP 468 tra Casumaro e Reno Centese,5565,00,4951,614,4397,1168,5565,0
2019/02,237,15/02/2019,5,SP 23 tra Quattro Castella e la Variante di Montecavolo (c/o bivio SP 21),15507,00,14724,783,12084,3423,15507,0
2019/02,237,16/02/2019,6,SP 23 tra Quattro Castella e la Variante di Montecavolo (c/o bivio SP 21),13426,00,13238,188,10065,3361,0,13426
2019/02,237,17/02/2019,7,SP 23 tra Quattro Castella e la Variante di Montecavolo (c/o bivio SP 21),11470,00,11429,41,8772,2698,0,11470
2019/02,237,18/02/2019,1,SP 23 tra Quattro Castella e la Variante di Montecavolo (c/o bivio SP 21),14555,10,13783,771,11724,2831,14555,0
2019/02,237,19/02/2019,2,SP 23 tra Quattro Castella e la Variante di Montecavolo (c/o bivio SP 21),15034,00,14226,808,12047,2987,15034,0
2019/02,237,20/02/2019,3,SP 23 tra Quattro Castella e la Variante di Montecavolo (c/o bivio SP 21),15137,00,14384,753,12012,3125,15137,0
2019/02,237,21/02/2019,4,SP 23 tra Quattro Castella e la Variante di Montecavolo (c/o bivio SP 21),15025,00,14166,859,11893,3132,15025,0
2019/02,237,22/02/2019,5,SP 23 tra Quattro Castella e la Variante di Montecavolo (c/o bivio SP 21),15617,00,14858,759,12137,3480,15617,0
2019/02,237,23/02/2019,6,SP 23 tra Quattro Castella e la Variante di Montecavolo (c/o bivio SP 21),13923,00,13716,207,10344,3579,0,13923
2019/02,237,24/02/2019,7,SP 23 tra Quattro Castella e la Variante di Montecavolo (c/o bivio SP 21),11584,00,11550,34,8877,2707,0,11584
2019/02,237,25/02/2019,1,SP 23 tra Quattro Castella e la Variante di Montecavolo (c/o bivio SP 21),14281,10,13498,782,11496,2785,14281,0
2019/02,237,26/02/2019,2,SP 23 tra Quattro Castella e la Variante di Montecavolo (c/o bivio SP 21),14755,00,14010,745,11715,3040,14755,0
2019/02,237,27/02/2019,3,SP 23 tra Quattro Castella e la Variante di Montecavolo (c/o bivio SP 21),15530,00,14725,805,12288,3242,15530,0
2019/02,237,28/02/2019,4,SP 23 tra Quattro Castella e la Variante di Montecavolo (c/o bivio SP 21),15229,00,14411,818,11986,3243,15229,0
2019/02,238,15/02/2019,5,SP 37 fra Albinea e Scandiano (bivio SP 7),11707,00,11091,616,9000,2707,11707,0
2019/02,238,16/02/2019,6,SP 37 fra Albinea e Scandiano (bivio SP 7),9789,00,9630,159,7144,2645,0,9789
2019/02,238,17/02/2019,7,SP 37 fra Albinea e Scandiano (bivio SP 7),8261,00,8221,40,6151,2110,0,8261
2019/02,238,18/02/2019,1,SP 37 fra Albinea e Scandiano (bivio SP 7),11077,00,10547,530,8922,2155,11077,0
2019/02,238,19/02/2019,2,SP 37 fra Albinea e Scandiano (bivio SP 7),11302,00,10764,538,8963,2339,11302,0
2019/02,238,20/02/2019,3,SP 37 fra Albinea e Scandiano (bivio SP 7),11470,00,10923,547,9003,2467,11470,0
2019/02,238,21/02/2019,4,SP 37 fra Albinea e Scandiano (bivio SP 7),11466,00,10837,629,9015,2451,11466,0
2019/02,238,22/02/2019,5,SP 37 fra Albinea e Scandiano (bivio SP 7),12011,00,11405,606,9180,2831,12011,0
2019/02,238,23/02/2019,6,SP 37 fra Albinea e Scandiano (bivio SP 7),9975,00,9836,139,7149,2826,0,9975
2019/02,238,24/02/2019,7,SP 37 fra Albinea e Scandiano (bivio SP 7),7832,00,7795,37,5730,2102,0,7832
2019/02,238,25/02/2019,1,SP 37 fra Albinea e Scandiano (bivio SP 7),11267,00,10708,559,9080,2187,11267,0
2019/02,238,26/02/2019,2,SP 37 fra Albinea e Scandiano (bivio SP 7),11343,00,10749,594,8920,2423,11343,0
2019/02,238,27/02/2019,3,SP 37 fra Albinea e Scandiano (bivio SP 7),11699,00,11072,627,9205,2494,11699,0
2019/02,238,28/02/2019,4,SP 37 fra Albinea e Scandiano (bivio SP 7),11721,00,11093,628,9152,2569,11721,0
2019/02,239,15/02/2019,5,SP 486R fra Sassuolo e Castellarano,28504,30,24972,3529,22268,6236,28504,0
2019/02,239,16/02/2019,6,SP 486R fra Sassuolo e Castellarano,21166,20,20694,470,15587,5579,0,21166
2019/02,239,17/02/2019,7,SP 486R fra Sassuolo e Castellarano,17265,10,17135,129,12696,4569,0,17265
2019/02,239,18/02/2019,1,SP 486R fra Sassuolo e Castellarano,26607,10,23592,3014,21369,5238,26607,0
2019/02,239,19/02/2019,2,SP 486R fra Sassuolo e Castellarano,27032,40,23431,3597,21564,5468,27032,0
2019/02,239,20/02/2019,3,SP 486R fra Sassuolo e Castellarano,27556,00,23829,3727,22030,5526,27556,0
2019/02,239,21/02/2019,4,SP 486R fra Sassuolo e Castellarano,27924,00,23999,3925,22196,5728,27924,0
2019/02,239,22/02/2019,5,SP 486R fra Sassuolo e Castellarano,28254,10,24632,3621,22097,6157,28254,0
2019/02,239,23/02/2019,6,SP 486R fra Sassuolo e Castellarano,21475,10,21032,442,15800,5675,0,21475
2019/02,239,24/02/2019,7,SP 486R fra Sassuolo e Castellarano,17081,00,16947,134,12507,4574,0,17081
2019/02,239,25/02/2019,1,SP 486R fra Sassuolo e Castellarano,26881,10,23572,3308,21400,5481,26881,0
2019/02,239,26/02/2019,2,SP 486R fra Sassuolo e Castellarano,26184,10,22628,3555,20804,5380,26184,0
2019/02,239,27/02/2019,3,SP 486R fra Sassuolo e Castellarano,27533,00,23687,3846,21831,5702,27533,0
2019/02,239,28/02/2019,4,SP 486R fra Sassuolo e Castellarano,28078,10,24078,3999,22239,5839,28078,0
2019/02,242,15/02/2019,5,SS 12 tra Maranello e Pavullo nel Frignano,16448,10,15129,1318,12352,4096,16448,0
2019/02,242,16/02/2019,6,SS 12 tra Maranello e Pavullo nel Frignano,15681,10,15424,256,11534,4147,0,15681
2019/02,242,17/02/2019,7,SS 12 tra Maranello e Pavullo nel Frignano,15225,00,15168,57,11866,3359,0,15225
2019/02,242,18/02/2019,1,SS 12 tra Maranello e Pavullo nel Frignano,14972,10,13753,1218,11718,3254,14972,0
2019/02,242,19/02/2019,2,SS 12 tra Maranello e Pavullo nel Frignano,15152,10,13835,1316,11809,3343,15152,0
2019/02,242,20/02/2019,3,SS 12 tra Maranello e Pavullo nel Frignano,15573,10,14277,1295,12107,3466,15573,0
2019/02,242,21/02/2019,4,SS 12 tra Maranello e Pavullo nel Frignano,15874,20,14445,1427,12302,3572,15874,0
2019/02,242,22/02/2019,5,SS 12 tra Maranello e Pavullo nel Frignano,15969,00,14704,1265,12007,3962,15969,0
2019/02,242,23/02/2019,6,SS 12 tra Maranello e Pavullo nel Frignano,14810,00,14537,273,10905,3905,0,14810
2019/02,242,24/02/2019,7,SS 12 tra Maranello e Pavullo nel Frignano,14315,10,14244,70,11152,3163,0,14315
2019/02,242,25/02/2019,1,SS 12 tra Maranello e Pavullo nel Frignano,15093,00,13824,1269,11777,3316,15093,0
2019/02,242,26/02/2019,2,SS 12 tra Maranello e Pavullo nel Frignano,15036,00,13637,1399,11738,3298,15036,0
2019/02,242,27/02/2019,3,SS 12 tra Maranello e Pavullo nel Frignano,16007,10,14640,1366,12253,3754,16007,0
2019/02,242,28/02/2019,4,SS 12 tra Maranello e Pavullo nel Frignano,15621,10,14281,1339,11924,3697,15621,0
2019/02,243,15/02/2019,5,SP 27 tra Ponte Samoggia e Muffa,11345,00,10549,796,8941,2404,11345,0
2019/02,243,16/02/2019,6,SP 27 tra Ponte Samoggia e Muffa,8890,00,8714,176,6691,2199,0,8890
2019/02,243,17/02/2019,7,SP 27 tra Ponte Samoggia e Muffa,6980,00,6934,46,5379,1601,0,6980
2019/02,243,18/02/2019,1,SP 27 tra Ponte Samoggia e Muffa,10814,00,9969,845,8764,2050,10814,0
2019/02,243,19/02/2019,2,SP 27 tra Ponte Samoggia e Muffa,11372,00,10589,783,9173,2199,11372,0
2019/02,243,20/02/2019,3,SP 27 tra Ponte Samoggia e Muffa,11249,00,10461,788,8937,2312,11249,0
2019/02,243,21/02/2019,4,SP 27 tra Ponte Samoggia e Muffa,11216,00,10383,833,8982,2234,11216,0
2019/02,243,22/02/2019,5,SP 27 tra Ponte Samoggia e Muffa,11613,10,10715,897,9059,2554,11613,0
2019/02,243,23/02/2019,6,SP 27 tra Ponte Samoggia e Muffa,8770,00,8574,196,6587,2183,0,8770
2019/02,243,24/02/2019,7,SP 27 tra Ponte Samoggia e Muffa,6687,10,6632,54,5040,1647,0,6687
2019/02,243,25/02/2019,1,SP 27 tra Ponte Samoggia e Muffa,10907,00,10053,854,8807,2100,10907,0
2019/02,243,26/02/2019,2,SP 27 tra Ponte Samoggia e Muffa,11061,00,10200,861,8853,2208,11061,0
2019/02,243,27/02/2019,3,SP 27 tra Ponte Samoggia e Muffa,11384,00,10564,820,9001,2383,11384,0
2019/02,243,28/02/2019,4,SP 27 tra Ponte Samoggia e Muffa,11416,10,10574,841,9034,2382,11416,0
2019/02,244,15/02/2019,5,SP 569 tra Pragatto e innesto variante Ponte Ronca,29473,00,27621,1852,22238,7235,29473,0
2019/02,244,16/02/2019,6,SP 569 tra Pragatto e innesto variante Ponte Ronca,27923,00,27586,337,20998,6925,0,27923
2019/02,244,17/02/2019,7,SP 569 tra Pragatto e innesto variante Ponte Ronca,23242,00,23138,104,17644,5598,0,23242
2019/02,244,18/02/2019,1,SP 569 tra Pragatto e innesto variante Ponte Ronca,27215,00,25501,1714,21592,5623,27215,0
2019/02,244,19/02/2019,2,SP 569 tra Pragatto e innesto variante Ponte Ronca,26487,40,24785,1698,20251,6236,26487,0
2019/02,244,20/02/2019,3,SP 569 tra Pragatto e innesto variante Ponte Ronca,27969,20,26249,1718,21737,6232,27969,0
2019/02,244,21/02/2019,4,SP 569 tra Pragatto e innesto variante Ponte Ronca,28424,10,26661,1762,22029,6395,28424,0
2019/02,244,22/02/2019,5,SP 569 tra Pragatto e innesto variante Ponte Ronca,29476,10,27614,1861,22327,7149,29476,0
2019/02,244,23/02/2019,6,SP 569 tra Pragatto e innesto variante Ponte Ronca,27886,00,27527,359,20818,7068,0,27886
2019/02,244,24/02/2019,7,SP 569 tra Pragatto e innesto variante Ponte Ronca,22676,00,22585,91,17039,5637,0,22676
2019/02,244,25/02/2019,1,SP 569 tra Pragatto e innesto variante Ponte Ronca,27432,00,25750,1682,21298,6134,27432,0
2019/02,244,26/02/2019,2,SP 569 tra Pragatto e innesto variante Ponte Ronca,27683,00,25902,1781,21557,6126,27683,0
2019/02,244,27/02/2019,3,SP 569 tra Pragatto e innesto variante Ponte Ronca,27645,20,25890,1753,21318,6327,27645,0
2019/02,244,28/02/2019,4,SP 569 tra Pragatto e innesto variante Ponte Ronca,28518,10,26749,1768,21915,6603,28518,0
2019/02,245,15/02/2019,5,SP 569 da intersezione Pedemontana a Savignano sul Panaro,8096,00,7655,441,6092,2004,8096,0
2019/02,245,16/02/2019,6,SP 569 da intersezione Pedemontana a Savignano sul Panaro,8585,00,8429,156,6439,2146,0,8585
2019/02,245,17/02/2019,7,SP 569 da intersezione Pedemontana a Savignano sul Panaro,7628,00,7566,62,5889,1739,0,7628
2019/02,245,18/02/2019,1,SP 569 da intersezione Pedemontana a Savignano sul Panaro,6991,00,6596,395,5503,1488,6991,0
2019/02,245,19/02/2019,2,SP 569 da intersezione Pedemontana a Savignano sul Panaro,7104,00,6697,407,5428,1676,7104,0
2019/02,245,20/02/2019,3,SP 569 da intersezione Pedemontana a Savignano sul Panaro,7488,00,7049,439,5803,1685,7488,0
2019/02,245,21/02/2019,4,SP 569 da intersezione Pedemontana a Savignano sul Panaro,7316,00,6863,453,5699,1617,7316,0
2019/02,245,22/02/2019,5,SP 569 da intersezione Pedemontana a Savignano sul Panaro,8258,00,7747,511,6149,2109,8258,0
2019/02,245,23/02/2019,6,SP 569 da intersezione Pedemontana a Savignano sul Panaro,8441,00,8268,173,6203,2238,0,8441
2019/02,245,24/02/2019,7,SP 569 da intersezione Pedemontana a Savignano sul Panaro,7195,00,7130,65,5411,1784,0,7195
2019/02,245,25/02/2019,1,SP 569 da intersezione Pedemontana a Savignano sul Panaro,7031,00,6586,445,5463,1568,7031,0
2019/02,245,26/02/2019,2,SP 569 da intersezione Pedemontana a Savignano sul Panaro,7208,00,6735,473,5621,1587,7208,0
2019/02,245,27/02/2019,3,SP 569 da intersezione Pedemontana a Savignano sul Panaro,7203,00,6768,435,5499,1704,7203,0
2019/02,245,28/02/2019,4,SP 569 da intersezione Pedemontana a Savignano sul Panaro,7332,00,6886,446,5621,1711,7332,0
2019/02,246,15/02/2019,5,SP 255 da Decima a San Giovanni in Persiceto,15346,00,14232,1114,11617,3729,15346,0
2019/02,246,16/02/2019,6,SP 255 da Decima a San Giovanni in Persiceto,11863,00,11676,187,8467,3396,0,11863
2019/02,246,17/02/2019,7,SP 255 da Decima a San Giovanni in Persiceto,10220,00,10171,49,7383,2837,0,10220
2019/02,246,18/02/2019,1,SP 255 da Decima a San Giovanni in Persiceto,14433,00,13327,1106,11424,3009,14433,0
2019/02,246,19/02/2019,2,SP 255 da Decima a San Giovanni in Persiceto,14557,00,13418,1139,11439,3118,14557,0
2019/02,246,20/02/2019,3,SP 255 da Decima a San Giovanni in Persiceto,15375,10,14217,1157,12100,3275,15375,0
2019/02,246,21/02/2019,4,SP 255 da Decima a San Giovanni in Persiceto,15222,00,14085,1137,11753,3469,15222,0
2019/02,246,22/02/2019,5,SP 255 da Decima a San Giovanni in Persiceto,15749,00,14666,1083,12022,3727,15749,0
2019/02,246,23/02/2019,6,SP 255 da Decima a San Giovanni in Persiceto,12077,00,11867,210,8587,3490,0,12077
2019/02,246,24/02/2019,7,SP 255 da Decima a San Giovanni in Persiceto,10412,00,10343,69,7512,2900,0,10412
2019/02,246,25/02/2019,1,SP 255 da Decima a San Giovanni in Persiceto,14357,10,13333,1023,11209,3148,14357,0
2019/02,246,26/02/2019,2,SP 255 da Decima a San Giovanni in Persiceto,14803,00,13739,1064,11633,3170,14803,0
2019/02,246,27/02/2019,3,SP 255 da Decima a San Giovanni in Persiceto,15067,00,13992,1075,11681,3386,15067,0
2019/02,246,28/02/2019,4,SP 255 da Decima a San Giovanni in Persiceto,15104,10,14030,1073,11634,3470,15104,0
2019/02,247,15/02/2019,5,SP 255 fra Nonantola e Sant'Agata Bolognese,10996,00,9507,1489,8185,2811,10996,0
2019/02,247,16/02/2019,6,SP 255 fra Nonantola e Sant'Agata Bolognese,7450,00,7190,260,5057,2393,0,7450
2019/02,247,17/02/2019,7,SP 255 fra Nonantola e Sant'Agata Bolognese,7347,00,7295,52,5242,2105,0,7347
2019/02,247,18/02/2019,1,SP 255 fra Nonantola e Sant'Agata Bolognese,10194,00,8716,1478,8005,2189,10194,0
2019/02,247,19/02/2019,2,SP 255 fra Nonantola e Sant'Agata Bolognese,10345,10,8807,1537,8100,2245,10345,0
2019/02,247,20/02/2019,3,SP 255 fra Nonantola e Sant'Agata Bolognese,10497,00,8950,1547,8207,2290,10497,0
2019/02,247,21/02/2019,4,SP 255 fra Nonantola e Sant'Agata Bolognese,10698,00,9214,1484,8265,2433,10698,0
2019/02,247,22/02/2019,5,SP 255 fra Nonantola e Sant'Agata Bolognese,11056,00,9528,1528,8379,2677,11056,0
2019/02,247,23/02/2019,6,SP 255 fra Nonantola e Sant'Agata Bolognese,7625,00,7337,288,5285,2340,0,7625
2019/02,247,24/02/2019,7,SP 255 fra Nonantola e Sant'Agata Bolognese,7318,00,7249,69,5234,2084,0,7318
2019/02,247,25/02/2019,1,SP 255 fra Nonantola e Sant'Agata Bolognese,10352,00,8888,1464,8086,2266,10352,0
2019/02,247,26/02/2019,2,SP 255 fra Nonantola e Sant'Agata Bolognese,10366,00,8922,1444,8141,2225,10366,0
2019/02,247,27/02/2019,3,SP 255 fra Nonantola e Sant'Agata Bolognese,10561,00,8990,1571,8240,2321,10561,0
2019/02,247,28/02/2019,4,SP 255 fra Nonantola e Sant'Agata Bolognese,10634,00,9102,1532,8094,2540,10634,0
2019/02,251,15/02/2019,5,SP 610 tra Imola e Casalfiumanese in località Ca' Miseria,13412,20,12733,677,10141,3271,13412,0
2019/02,251,16/02/2019,6,SP 610 tra Imola e Casalfiumanese in località Ca' Miseria,12570,10,12381,188,9428,3142,0,12570
2019/02,251,17/02/2019,7,SP 610 tra Imola e Casalfiumanese in località Ca' Miseria,10492,00,10457,35,8254,2238,0,10492
2019/02,251,18/02/2019,1,SP 610 tra Imola e Casalfiumanese in località Ca' Miseria,12831,20,12178,651,10053,2778,12831,0
2019/02,251,19/02/2019,2,SP 610 tra Imola e Casalfiumanese in località Ca' Miseria,13106,00,12376,730,10195,2911,13106,0
2019/02,251,20/02/2019,3,SP 610 tra Imola e Casalfiumanese in località Ca' Miseria,13321,10,12550,770,10367,2954,13321,0
2019/02,251,21/02/2019,4,SP 610 tra Imola e Casalfiumanese in località Ca' Miseria,13471,10,12746,724,10363,3108,13471,0
2019/02,251,22/02/2019,5,SP 610 tra Imola e Casalfiumanese in località Ca' Miseria,13687,00,12990,697,10400,3287,13687,0
2019/02,251,23/02/2019,6,SP 610 tra Imola e Casalfiumanese in località Ca' Miseria,12496,00,12279,217,9471,3025,0,12496
2019/02,251,24/02/2019,7,SP 610 tra Imola e Casalfiumanese in località Ca' Miseria,10524,10,10479,44,8144,2380,0,10524
2019/02,251,25/02/2019,1,SP 610 tra Imola e Casalfiumanese in località Ca' Miseria,12654,00,11918,736,9940,2714,12654,0
2019/02,251,26/02/2019,2,SP 610 tra Imola e Casalfiumanese in località Ca' Miseria,12867,20,12155,710,10061,2806,12867,0
2019/02,251,27/02/2019,3,SP 610 tra Imola e Casalfiumanese in località Ca' Miseria,13461,10,12671,789,10420,3041,13461,0
2019/02,251,28/02/2019,4,SP 610 tra Imola e Casalfiumanese in località Ca' Miseria,13832,00,13119,713,10597,3235,13832,0
2019/02,252,15/02/2019,5,SP 3_2 tra Budrio e bivio SP 29 per Medicina,9683,10,8891,791,7625,2058,9683,0
2019/02,252,16/02/2019,6,SP 3_2 tra Budrio e bivio SP 29 per Medicina,7245,10,7087,157,5476,1769,0,7245
2019/02,252,17/02/2019,7,SP 3_2 tra Budrio e bivio SP 29 per Medicina,6791,00,6756,35,5158,1633,0,6791
2019/02,252,18/02/2019,1,SP 3_2 tra Budrio e bivio SP 29 per Medicina,9281,10,8482,798,7485,1796,9281,0
2019/02,252,19/02/2019,2,SP 3_2 tra Budrio e bivio SP 29 per Medicina,9119,10,8400,718,7381,1738,9119,0
2019/02,252,20/02/2019,3,SP 3_2 tra Budrio e bivio SP 29 per Medicina,9203,10,8463,739,7380,1823,9203,0
2019/02,252,21/02/2019,4,SP 3_2 tra Budrio e bivio SP 29 per Medicina,9474,00,8697,777,7563,1911,9474,0
2019/02,252,22/02/2019,5,SP 3_2 tra Budrio e bivio SP 29 per Medicina,9729,10,8900,828,7695,2034,9729,0
2019/02,252,23/02/2019,6,SP 3_2 tra Budrio e bivio SP 29 per Medicina,7422,00,7239,183,5538,1884,0,7422
2019/02,252,24/02/2019,7,SP 3_2 tra Budrio e bivio SP 29 per Medicina,6940,10,6891,48,5273,1667,0,6940
2019/02,252,25/02/2019,1,SP 3_2 tra Budrio e bivio SP 29 per Medicina,9220,10,8466,753,7405,1815,9220,0
2019/02,252,26/02/2019,2,SP 3_2 tra Budrio e bivio SP 29 per Medicina,9370,10,8610,759,7541,1829,9370,0
2019/02,252,27/02/2019,3,SP 3_2 tra Budrio e bivio SP 29 per Medicina,9502,10,8713,788,7597,1905,9502,0
2019/02,252,28/02/2019,4,SP 3_2 tra Budrio e bivio SP 29 per Medicina,9813,30,8994,816,7729,2084,9813,0
2019/02,255,15/02/2019,5,SS 9 tra Castel San Pietro e Imola,20744,20,19950,792,15640,5104,20744,0
2019/02,255,16/02/2019,6,SS 9 tra Castel San Pietro e Imola,17973,20,17739,232,13188,4785,0,17973
2019/02,255,17/02/2019,7,SS 9 tra Castel San Pietro e Imola,14910,30,14837,70,11031,3879,0,14910
2019/02,255,18/02/2019,1,SS 9 tra Castel San Pietro e Imola,19478,40,18632,842,15334,4144,19478,0
2019/02,255,19/02/2019,2,SS 9 tra Castel San Pietro e Imola,19725,10,18912,812,15692,4033,19725,0
2019/02,255,20/02/2019,3,SS 9 tra Castel San Pietro e Imola,19970,20,19135,833,15870,4100,19970,0
2019/02,255,21/02/2019,4,SS 9 tra Castel San Pietro e Imola,19781,00,19019,762,15791,3990,19781,0
2019/02,255,22/02/2019,5,SS 9 tra Castel San Pietro e Imola,20682,50,19922,755,15707,4975,20682,0
2019/02,255,23/02/2019,6,SS 9 tra Castel San Pietro e Imola,18691,20,18438,251,13850,4841,0,18691
2019/02,255,24/02/2019,7,SS 9 tra Castel San Pietro e Imola,15151,20,15070,79,11233,3918,0,15151
2019/02,255,25/02/2019,1,SS 9 tra Castel San Pietro e Imola,19604,10,18865,738,15553,4051,19604,0
2019/02,255,26/02/2019,2,SS 9 tra Castel San Pietro e Imola,19955,10,19145,809,15867,4088,19955,0
2019/02,255,27/02/2019,3,SS 9 tra Castel San Pietro e Imola,20048,10,19305,742,15886,4162,20048,0
2019/02,255,28/02/2019,4,SS 9 tra Castel San Pietro e Imola,20045,20,19248,795,15400,4645,20045,0
2019/02,256,15/02/2019,5,SP 302R tra Faenza (bivio SP 66) e Brisighella,8464,00,8200,264,6510,1954,8464,0
2019/02,256,16/02/2019,6,SP 302R tra Faenza (bivio SP 66) e Brisighella,8549,00,8470,79,6358,2191,0,8549
2019/02,256,17/02/2019,7,SP 302R tra Faenza (bivio SP 66) e Brisighella,8144,00,8134,10,6540,1604,0,8144
2019/02,256,18/02/2019,1,SP 302R tra Faenza (bivio SP 66) e Brisighella,8113,00,7886,227,6418,1695,8113,0
2019/02,256,19/02/2019,2,SP 302R tra Faenza (bivio SP 66) e Brisighella,7990,00,7769,221,6260,1730,7990,0
2019/02,256,20/02/2019,3,SP 302R tra Faenza (bivio SP 66) e Brisighella,8158,10,7911,246,6423,1735,8158,0
2019/02,256,21/02/2019,4,SP 302R tra Faenza (bivio SP 66) e Brisighella,8054,10,7820,233,6304,1750,8054,0
2019/02,256,22/02/2019,5,SP 302R tra Faenza (bivio SP 66) e Brisighella,8449,00,8218,231,6476,1973,8449,0
2019/02,256,23/02/2019,6,SP 302R tra Faenza (bivio SP 66) e Brisighella,8329,00,8130,199,6364,1965,0,8329
2019/02,256,24/02/2019,7,SP 302R tra Faenza (bivio SP 66) e Brisighella,7422,00,7409,13,5925,1497,0,7422
2019/02,256,25/02/2019,1,SP 302R tra Faenza (bivio SP 66) e Brisighella,8100,00,7877,223,6374,1726,8100,0
2019/02,256,26/02/2019,2,SP 302R tra Faenza (bivio SP 66) e Brisighella,7917,10,7658,258,6237,1680,7917,0
2019/02,256,27/02/2019,3,SP 302R tra Faenza (bivio SP 66) e Brisighella,8499,00,8170,329,6649,1850,8499,0
2019/02,256,28/02/2019,4,SP 302R tra Faenza (bivio SP 66) e Brisighella,8367,00,8111,256,6495,1872,8367,0
2019/02,257,15/02/2019,5,SP 302R tra Faenza e il bivio SP 4 (a sud di Russi),6762,00,6554,208,5112,1650,6762,0
2019/02,257,16/02/2019,6,SP 302R tra Faenza e il bivio SP 4 (a sud di Russi),6110,00,5999,111,4481,1629,0,6110
2019/02,257,17/02/2019,7,SP 302R tra Faenza e il bivio SP 4 (a sud di Russi),5185,00,5158,27,3865,1320,0,5185
2019/02,257,18/02/2019,1,SP 302R tra Faenza e il bivio SP 4 (a sud di Russi),6332,00,6116,216,4922,1410,6332,0
2019/02,257,19/02/2019,2,SP 302R tra Faenza e il bivio SP 4 (a sud di Russi),6249,00,6043,206,4901,1348,6249,0
2019/02,257,20/02/2019,3,SP 302R tra Faenza e il bivio SP 4 (a sud di Russi),6423,00,6204,219,5032,1391,6423,0
2019/02,257,21/02/2019,4,SP 302R tra Faenza e il bivio SP 4 (a sud di Russi),6320,00,6113,207,4948,1372,6320,0
2019/02,257,22/02/2019,5,SP 302R tra Faenza e il bivio SP 4 (a sud di Russi),6585,00,6383,202,5004,1581,6585,0
2019/02,257,23/02/2019,6,SP 302R tra Faenza e il bivio SP 4 (a sud di Russi),5623,00,5541,82,4117,1506,0,5623
2019/02,257,24/02/2019,7,SP 302R tra Faenza e il bivio SP 4 (a sud di Russi),4639,00,4618,21,3413,1226,0,4639
2019/02,257,25/02/2019,1,SP 302R tra Faenza e il bivio SP 4 (a sud di Russi),6191,00,5993,198,4846,1345,6191,0
2019/02,257,26/02/2019,2,SP 302R tra Faenza e il bivio SP 4 (a sud di Russi),6362,00,6136,226,5034,1328,6362,0
2019/02,257,27/02/2019,3,SP 302R tra Faenza e il bivio SP 4 (a sud di Russi),6181,00,5962,219,4925,1256,6181,0
2019/02,257,28/02/2019,4,SP 302R tra Faenza e il bivio SP 4 (a sud di Russi),6446,00,6227,219,5096,1350,6446,0
2019/02,258,15/02/2019,5,SS 9 tra Forlimpopoli e Cesena,25639,130,23522,2104,19325,6314,25639,0
2019/02,258,16/02/2019,6,SS 9 tra Forlimpopoli e Cesena,22128,10,21376,751,16004,6124,0,22128
2019/02,258,17/02/2019,7,SS 9 tra Forlimpopoli e Cesena,17798,00,17618,180,12933,4865,0,17798
2019/02,258,18/02/2019,1,SS 9 tra Forlimpopoli e Cesena,24015,50,21914,2096,18968,5047,24015,0
2019/02,258,19/02/2019,2,SS 9 tra Forlimpopoli e Cesena,24939,90,22762,2168,19564,5375,24939,0
2019/02,258,20/02/2019,3,SS 9 tra Forlimpopoli e Cesena,25212,50,23198,2009,19774,5438,25212,0
2019/02,258,23/02/2019,6,SS 9 tra Forlimpopoli e Cesena,21649,50,20895,749,15146,6503,0,21649
2019/02,258,24/02/2019,7,SS 9 tra Forlimpopoli e Cesena,17727,10,17545,181,12782,4945,0,17727
2019/02,258,25/02/2019,1,SS 9 tra Forlimpopoli e Cesena,23932,30,21921,2008,18905,5027,23932,0
2019/02,258,26/02/2019,2,SS 9 tra Forlimpopoli e Cesena,24897,130,22719,2165,19449,5448,24897,0
2019/02,258,27/02/2019,3,SS 9 tra Forlimpopoli e Cesena,25274,10,23218,2055,19564,5710,25274,0
2019/02,258,28/02/2019,4,SS 9 tra Forlimpopoli e Cesena,25463,40,23327,2132,19648,5815,25463,0
2019/02,259,15/02/2019,5,SP 7 in località Calabrina al Confine Provinciale,8937,00,8501,436,6683,2254,8937,0
2019/02,259,16/02/2019,6,SP 7 in località Calabrina al Confine Provinciale,9331,00,9143,188,6359,2972,0,9331
2019/02,259,17/02/2019,7,SP 7 in località Calabrina al Confine Provinciale,9594,00,9507,87,6901,2693,0,9594
2019/02,259,18/02/2019,1,SP 7 in località Calabrina al Confine Provinciale,7876,00,7389,487,6264,1612,7876,0
2019/02,259,19/02/2019,2,SP 7 in località Calabrina al Confine Provinciale,8171,00,7686,485,6522,1649,8171,0
2019/02,259,20/02/2019,3,SP 7 in località Calabrina al Confine Provinciale,8051,00,7566,485,6321,1730,8051,0
2019/02,259,21/02/2019,4,SP 7 in località Calabrina al Confine Provinciale,8301,00,7822,479,6475,1826,8301,0
2019/02,259,22/02/2019,5,SP 7 in località Calabrina al Confine Provinciale,8536,00,8114,422,6283,2253,8536,0
2019/02,259,23/02/2019,6,SP 7 in località Calabrina al Confine Provinciale,8482,00,8340,142,5971,2511,0,8482
2019/02,259,24/02/2019,7,SP 7 in località Calabrina al Confine Provinciale,8278,00,8231,47,6197,2081,0,8278
2019/02,259,25/02/2019,1,SP 7 in località Calabrina al Confine Provinciale,7428,00,7009,419,5855,1573,7428,0
2019/02,259,26/02/2019,2,SP 7 in località Calabrina al Confine Provinciale,7800,00,7312,488,6114,1686,7800,0
2019/02,259,27/02/2019,3,SP 7 in località Calabrina al Confine Provinciale,8299,00,7889,410,6393,1906,8299,0
2019/02,259,28/02/2019,4,SP 7 in località Calabrina al Confine Provinciale,8282,00,7832,450,6386,1896,8282,0
2019/02,260,15/02/2019,5,SP 8 tra Cesena e A 14,11836,00,11511,325,9248,2588,11836,0
2019/02,260,16/02/2019,6,SP 8 tra Cesena e A 14,11526,10,11398,127,8568,2958,0,11526
2019/02,260,17/02/2019,7,SP 8 tra Cesena e A 14,10950,00,10926,24,8569,2381,0,10950
2019/02,260,18/02/2019,1,SP 8 tra Cesena e A 14,11173,00,10822,351,9148,2025,11173,0
2019/02,260,19/02/2019,2,SP 8 tra Cesena e A 14,11350,00,11017,333,9211,2139,11350,0
2019/02,260,20/02/2019,3,SP 8 tra Cesena e A 14,11627,20,11302,323,9347,2280,11627,0
2019/02,260,21/02/2019,4,SP 8 tra Cesena e A 14,11538,10,11188,349,9235,2303,11538,0
2019/02,260,22/02/2019,5,SP 8 tra Cesena e A 14,11991,00,11683,308,9271,2720,11991,0
2019/02,260,23/02/2019,6,SP 8 tra Cesena e A 14,10769,00,10654,115,7738,3031,0,10769
2019/02,260,24/02/2019,7,SP 8 tra Cesena e A 14,8376,00,8361,15,6152,2224,0,8376
2019/02,260,25/02/2019,1,SP 8 tra Cesena e A 14,11179,00,10875,304,9170,2009,11179,0
2019/02,260,26/02/2019,2,SP 8 tra Cesena e A 14,11257,00,10915,342,8967,2290,11257,0
2019/02,260,27/02/2019,3,SP 8 tra Cesena e A 14,11611,00,11288,323,9309,2302,11611,0
2019/02,260,28/02/2019,4,SP 8 tra Cesena e A 14,11792,00,11459,333,9457,2335,11792,0
2019/02,261,15/02/2019,5,SS 9 tra Cesena e Savignano sul Rubicone,28984,00,26745,2239,22216,6768,28984,0
2019/02,261,16/02/2019,6,SS 9 tra Cesena e Savignano sul Rubicone,23425,10,22644,780,16864,6561,0,23425
2019/02,261,17/02/2019,7,SS 9 tra Cesena e Savignano sul Rubicone,17372,00,17245,127,12339,5033,0,17372
2019/02,261,18/02/2019,1,SS 9 tra Cesena e Savignano sul Rubicone,28011,00,25793,2218,22405,5606,28011,0
2019/02,261,19/02/2019,2,SS 9 tra Cesena e Savignano sul Rubicone,28513,10,26279,2233,22630,5883,28513,0
2019/02,261,20/02/2019,3,SS 9 tra Cesena e Savignano sul Rubicone,28685,00,26444,2241,22653,6032,28685,0
2019/02,261,21/02/2019,4,SS 9 tra Cesena e Savignano sul Rubicone,28734,10,26506,2227,22618,6116,28734,0
2019/02,261,22/02/2019,5,SS 9 tra Cesena e Savignano sul Rubicone,29808,00,27544,2264,22662,7146,29808,0
2019/02,261,23/02/2019,6,SS 9 tra Cesena e Savignano sul Rubicone,23531,10,22772,758,16773,6758,0,23531
2019/02,261,24/02/2019,7,SS 9 tra Cesena e Savignano sul Rubicone,17217,00,17083,134,12028,5189,0,17217
2019/02,261,25/02/2019,1,SS 9 tra Cesena e Savignano sul Rubicone,28182,00,25992,2190,22570,5612,28182,0
2019/02,261,26/02/2019,2,SS 9 tra Cesena e Savignano sul Rubicone,28533,40,26192,2337,22689,5844,28533,0
2019/02,261,27/02/2019,3,SS 9 tra Cesena e Savignano sul Rubicone,28999,00,26704,2295,22812,6187,28999,0
2019/02,261,28/02/2019,4,SS 9 tra Cesena e Savignano sul Rubicone,29208,10,26886,2321,22718,6490,29208,0
2019/02,262,15/02/2019,5,SS 9 tra Savignano sul Rubicone e Santarcangelo di Romagna,,,,,,,,
2019/02,262,16/02/2019,6,SS 9 tra Savignano sul Rubicone e Santarcangelo di Romagna,,,,,,,,
2019/02,262,17/02/2019,7,SS 9 tra Savignano sul Rubicone e Santarcangelo di Romagna,,,,,,,,
2019/02,262,18/02/2019,1,SS 9 tra Savignano sul Rubicone e Santarcangelo di Romagna,,,,,,,,
2019/02,262,19/02/2019,2,SS 9 tra Savignano sul Rubicone e Santarcangelo di Romagna,,,,,,,,
2019/02,262,20/02/2019,3,SS 9 tra Savignano sul Rubicone e Santarcangelo di Romagna,,,,,,,,
2019/02,262,21/02/2019,4,SS 9 tra Savignano sul Rubicone e Santarcangelo di Romagna,,,,,,,,
2019/02,262,22/02/2019,5,SS 9 tra Savignano sul Rubicone e Santarcangelo di Romagna,,,,,,,,
2019/02,262,23/02/2019,6,SS 9 tra Savignano sul Rubicone e Santarcangelo di Romagna,,,,,,,,
2019/02,262,24/02/2019,7,SS 9 tra Savignano sul Rubicone e Santarcangelo di Romagna,,,,,,,,
2019/02,262,25/02/2019,1,SS 9 tra Savignano sul Rubicone e Santarcangelo di Romagna,,,,,,,,
2019/02,262,26/02/2019,2,SS 9 tra Savignano sul Rubicone e Santarcangelo di Romagna,,,,,,,,
2019/02,262,27/02/2019,3,SS 9 tra Savignano sul Rubicone e Santarcangelo di Romagna,,,,,,,,
2019/02,262,28/02/2019,4,SS 9 tra Savignano sul Rubicone e Santarcangelo di Romagna,,,,,,,,
2019/02,263,15/02/2019,5,Via Adriatica (ex SS 16) tra Riccione e Misano Adriatico,17522,00,17093,429,12964,4558,17522,0
2019/02,263,16/02/2019,6,Via Adriatica (ex SS 16) tra Riccione e Misano Adriatico,16810,00,16659,151,11336,5474,0,16810
2019/02,263,17/02/2019,7,Via Adriatica (ex SS 16) tra Riccione e Misano Adriatico,14795,10,14753,41,10035,4760,0,14795
2019/02,263,18/02/2019,1,Via Adriatica (ex SS 16) tra Riccione e Misano Adriatico,15926,00,15499,427,12614,3312,15926,0
2019/02,263,19/02/2019,2,Via Adriatica (ex SS 16) tra Riccione e Misano Adriatico,16204,00,15767,437,12715,3489,16204,0
2019/02,263,20/02/2019,3,Via Adriatica (ex SS 16) tra Riccione e Misano Adriatico,16344,00,15922,422,12833,3511,16344,0
2019/02,263,21/02/2019,4,Via Adriatica (ex SS 16) tra Riccione e Misano Adriatico,16559,10,16153,405,12878,3681,16559,0
2019/02,263,22/02/2019,5,Via Adriatica (ex SS 16) tra Riccione e Misano Adriatico,17385,00,16963,422,12969,4416,17385,0
2019/02,263,23/02/2019,6,Via Adriatica (ex SS 16) tra Riccione e Misano Adriatico,17035,00,16845,190,11704,5331,0,17035
2019/02,263,24/02/2019,7,Via Adriatica (ex SS 16) tra Riccione e Misano Adriatico,15272,00,15228,44,10588,4684,0,15272
2019/02,263,25/02/2019,1,Via Adriatica (ex SS 16) tra Riccione e Misano Adriatico,16394,00,15973,421,12955,3439,16394,0
2019/02,263,26/02/2019,2,Via Adriatica (ex SS 16) tra Riccione e Misano Adriatico,16257,00,15840,417,12790,3467,16257,0
2019/02,263,27/02/2019,3,Via Adriatica (ex SS 16) tra Riccione e Misano Adriatico,16339,10,15908,430,12752,3587,16339,0
2019/02,263,28/02/2019,4,Via Adriatica (ex SS 16) tra Riccione e Misano Adriatico,16691,00,16273,418,12939,3752,16691,0
2019/02,269,15/02/2019,5,SS 12 a Medolla,20900,00,18885,2015,16362,4538,20900,0
2019/02,269,16/02/2019,6,SS 12 a Medolla,15418,00,15074,344,11039,4379,0,15418
2019/02,269,17/02/2019,7,SS 12 a Medolla,12805,00,12739,66,8973,3832,0,12805
2019/02,269,18/02/2019,1,SS 12 a Medolla,19312,20,17375,1935,15692,3620,19312,0
2019/02,269,19/02/2019,2,SS 12 a Medolla,20374,00,18207,2167,16482,3892,20374,0
2019/02,269,20/02/2019,3,SS 12 a Medolla,20270,10,18334,1935,16364,3906,20270,0
2019/02,269,21/02/2019,4,SS 12 a Medolla,20914,00,18595,2319,16848,4066,20914,0
2019/02,269,22/02/2019,5,SS 12 a Medolla,20973,10,18927,2045,16377,4596,20973,0
2019/02,269,23/02/2019,6,SS 12 a Medolla,16069,00,15713,356,11492,4577,0,16069
2019/02,269,24/02/2019,7,SS 12 a Medolla,12889,00,12816,73,9235,3654,0,12889
2019/02,269,25/02/2019,1,SS 12 a Medolla,19677,10,17743,1933,15800,3877,19677,0
2019/02,269,26/02/2019,2,SS 12 a Medolla,20129,20,18085,2042,16304,3825,20129,0
2019/02,269,27/02/2019,3,SS 12 a Medolla,20630,00,18566,2064,16452,4178,20630,0
2019/02,269,28/02/2019,4,SS 12 a Medolla,20521,00,18576,1945,16172,4349,20521,0
2019/02,275,15/02/2019,5,SP 5 dall'intersezione SP 3 a intersezione per Ca' de Fabbri,11476,00,11010,466,9002,2474,11476,0
2019/02,275,16/02/2019,6,SP 5 dall'intersezione SP 3 a intersezione per Ca' de Fabbri,8813,10,8649,163,6518,2295,0,8813
2019/02,275,17/02/2019,7,SP 5 dall'intersezione SP 3 a intersezione per Ca' de Fabbri,6738,00,6700,38,4917,1821,0,6738
2019/02,275,18/02/2019,1,SP 5 dall'intersezione SP 3 a intersezione per Ca' de Fabbri,10782,00,10303,479,8680,2102,10782,0
2019/02,275,19/02/2019,2,SP 5 dall'intersezione SP 3 a intersezione per Ca' de Fabbri,10874,10,10360,513,8769,2105,10874,0
2019/02,275,20/02/2019,3,SP 5 dall'intersezione SP 3 a intersezione per Ca' de Fabbri,11333,00,10731,602,9044,2289,11333,0
2019/02,275,21/02/2019,4,SP 5 dall'intersezione SP 3 a intersezione per Ca' de Fabbri,11042,00,10484,558,8649,2393,11042,0
2019/02,275,22/02/2019,5,SP 5 dall'intersezione SP 3 a intersezione per Ca' de Fabbri,11241,00,10770,471,8766,2475,11241,0
2019/02,275,23/02/2019,6,SP 5 dall'intersezione SP 3 a intersezione per Ca' de Fabbri,8734,00,8576,158,6257,2477,0,8734
2019/02,275,24/02/2019,7,SP 5 dall'intersezione SP 3 a intersezione per Ca' de Fabbri,6594,00,6561,33,4713,1881,0,6594
2019/02,275,25/02/2019,1,SP 5 dall'intersezione SP 3 a intersezione per Ca' de Fabbri,10838,10,10322,515,8683,2155,10838,0
2019/02,275,26/02/2019,2,SP 5 dall'intersezione SP 3 a intersezione per Ca' de Fabbri,11246,00,10754,492,8966,2280,11246,0
2019/02,275,27/02/2019,3,SP 5 dall'intersezione SP 3 a intersezione per Ca' de Fabbri,11330,10,10842,487,8947,2383,11330,0
2019/02,275,28/02/2019,4,SP 5 dall'intersezione SP 3 a intersezione per Ca' de Fabbri,11017,00,10492,525,8675,2342,11017,0
2019/02,276,15/02/2019,5,SP 3_2 tra intersezione SP 5 e ponte torrente Idice,12473,00,11444,1029,9716,2757,12473,0
2019/02,276,16/02/2019,6,SP 3_2 tra intersezione SP 5 e ponte torrente Idice,8193,00,8009,184,6117,2076,0,8193
2019/02,276,17/02/2019,7,SP 3_2 tra intersezione SP 5 e ponte torrente Idice,7356,00,7303,53,5430,1926,0,7356
2019/02,276,18/02/2019,1,SP 3_2 tra intersezione SP 5 e ponte torrente Idice,12841,00,11637,1204,10393,2448,12841,0
2019/02,276,19/02/2019,2,SP 3_2 tra intersezione SP 5 e ponte torrente Idice,12351,00,11313,1038,10150,2201,12351,0
2019/02,276,20/02/2019,3,SP 3_2 tra intersezione SP 5 e ponte torrente Idice,12526,00,11474,1052,10106,2420,12526,0
2019/02,276,21/02/2019,4,SP 3_2 tra intersezione SP 5 e ponte torrente Idice,12553,00,11417,1136,9940,2613,12553,0
2019/02,276,22/02/2019,5,SP 3_2 tra intersezione SP 5 e ponte torrente Idice,12894,00,11810,1084,10240,2654,12894,0
2019/02,276,23/02/2019,6,SP 3_2 tra intersezione SP 5 e ponte torrente Idice,8978,00,8720,258,6611,2367,0,8978
2019/02,276,24/02/2019,7,SP 3_2 tra intersezione SP 5 e ponte torrente Idice,7224,00,7165,59,5180,2044,0,7224
2019/02,276,25/02/2019,1,SP 3_2 tra intersezione SP 5 e ponte torrente Idice,12085,00,11062,1023,9575,2510,12085,0
2019/02,276,26/02/2019,2,SP 3_2 tra intersezione SP 5 e ponte torrente Idice,12469,00,11400,1069,10157,2312,12469,0
2019/02,276,27/02/2019,3,SP 3_2 tra intersezione SP 5 e ponte torrente Idice,12657,00,11587,1070,10089,2568,12657,0
2019/02,276,28/02/2019,4,SP 3_2 tra intersezione SP 5 e ponte torrente Idice,12501,00,11443,1058,10123,2378,12501,0
2019/02,277,15/02/2019,5,SP 6 tra Budrio e San Martino in Argine,7883,10,7406,476,6045,1838,7883,0
2019/02,277,16/02/2019,6,SP 6 tra Budrio e San Martino in Argine,6053,00,5926,127,4330,1723,0,6053
2019/02,277,17/02/2019,7,SP 6 tra Budrio e San Martino in Argine,4666,00,4629,37,3419,1247,0,4666
2019/02,277,18/02/2019,1,SP 6 tra Budrio e San Martino in Argine,7603,00,7079,524,5992,1611,7603,0
2019/02,277,19/02/2019,2,SP 6 tra Budrio e San Martino in Argine,7951,10,7455,495,6314,1637,7951,0
2019/02,277,20/02/2019,3,SP 6 tra Budrio e San Martino in Argine,7903,00,7439,464,6175,1728,7903,0
2019/02,277,21/02/2019,4,SP 6 tra Budrio e San Martino in Argine,7833,00,7398,435,6096,1737,7833,0
2019/02,277,22/02/2019,5,SP 6 tra Budrio e San Martino in Argine,7936,00,7454,482,6085,1851,7936,0
2019/02,277,23/02/2019,6,SP 6 tra Budrio e San Martino in Argine,6122,00,5969,153,4414,1708,0,6122
2019/02,277,24/02/2019,7,SP 6 tra Budrio e San Martino in Argine,4711,00,4672,39,3407,1304,0,4711
2019/02,277,25/02/2019,1,SP 6 tra Budrio e San Martino in Argine,7664,00,7214,450,6072,1592,7664,0
2019/02,277,26/02/2019,2,SP 6 tra Budrio e San Martino in Argine,7989,00,7465,524,6339,1650,7989,0
2019/02,277,27/02/2019,3,SP 6 tra Budrio e San Martino in Argine,7866,00,7410,456,6148,1718,7866,0
2019/02,277,28/02/2019,4,SP 6 tra Budrio e San Martino in Argine,7940,00,7479,461,6163,1777,7940,0
2019/02,278,15/02/2019,5,SP 6 tra Budrio e bivio SP 253,14510,00,13757,753,11276,3234,14510,0
2019/02,278,16/02/2019,6,SP 6 tra Budrio e bivio SP 253,11261,00,11111,150,8284,2977,0,11261
2019/02,278,17/02/2019,7,SP 6 tra Budrio e bivio SP 253,8854,00,8805,49,6568,2286,0,8854
2019/02,278,18/02/2019,1,SP 6 tra Budrio e bivio SP 253,13775,10,13107,667,11082,2693,13775,0
2019/02,278,19/02/2019,2,SP 6 tra Budrio e bivio SP 253,14004,00,13252,752,11218,2786,14004,0
2019/02,278,20/02/2019,3,SP 6 tra Budrio e bivio SP 253,14098,00,13351,747,11149,2949,14098,0
2019/02,278,21/02/2019,4,SP 6 tra Budrio e bivio SP 253,13973,00,13275,698,11047,2926,13973,0
2019/02,278,22/02/2019,5,SP 6 tra Budrio e bivio SP 253,14592,00,13852,740,11397,3195,14592,0
2019/02,278,23/02/2019,6,SP 6 tra Budrio e bivio SP 253,11539,00,11351,188,8462,3077,0,11539
2019/02,278,24/02/2019,7,SP 6 tra Budrio e bivio SP 253,8162,10,8111,50,5813,2349,0,8162
2019/02,278,25/02/2019,1,SP 6 tra Budrio e bivio SP 253,13683,00,12944,739,10985,2698,13683,0
2019/02,278,26/02/2019,2,SP 6 tra Budrio e bivio SP 253,14344,00,13530,814,11436,2908,14344,0
2019/02,278,27/02/2019,3,SP 6 tra Budrio e bivio SP 253,14408,00,13710,698,11264,3144,14408,0
2019/02,278,28/02/2019,4,SP 6 tra Budrio e bivio SP 253,13948,00,13229,719,10857,3091,13948,0
2019/02,279,15/02/2019,5,SP 31 dal bivio SP 28 per Castenaso a Ponte Rizzoli,14605,00,13630,975,12039,2566,14605,0
2019/02,279,16/02/2019,6,SP 31 dal bivio SP 28 per Castenaso a Ponte Rizzoli,9742,00,9596,146,7457,2285,0,9742
2019/02,279,17/02/2019,7,SP 31 dal bivio SP 28 per Castenaso a Ponte Rizzoli,8265,00,8221,44,6493,1772,0,8265
2019/02,279,18/02/2019,1,SP 31 dal bivio SP 28 per Castenaso a Ponte Rizzoli,14045,30,13011,1031,11799,2246,14045,0
2019/02,279,19/02/2019,2,SP 31 dal bivio SP 28 per Castenaso a Ponte Rizzoli,14321,00,13370,951,11966,2355,14321,0
2019/02,279,20/02/2019,3,SP 31 dal bivio SP 28 per Castenaso a Ponte Rizzoli,14483,00,13476,1007,12213,2270,14483,0
2019/02,279,21/02/2019,4,SP 31 dal bivio SP 28 per Castenaso a Ponte Rizzoli,14485,00,13483,1002,12042,2443,14485,0
2019/02,279,22/02/2019,5,SP 31 dal bivio SP 28 per Castenaso a Ponte Rizzoli,14765,30,13745,1017,12180,2585,14765,0
2019/02,279,23/02/2019,6,SP 31 dal bivio SP 28 per Castenaso a Ponte Rizzoli,10096,20,9934,160,7831,2265,0,10096
2019/02,279,24/02/2019,7,SP 31 dal bivio SP 28 per Castenaso a Ponte Rizzoli,8345,00,8297,48,6523,1822,0,8345
2019/02,279,25/02/2019,1,SP 31 dal bivio SP 28 per Castenaso a Ponte Rizzoli,13868,00,12870,998,11682,2186,13868,0
2019/02,279,26/02/2019,2,SP 31 dal bivio SP 28 per Castenaso a Ponte Rizzoli,14122,00,13156,966,11788,2334,14122,0
2019/02,279,27/02/2019,3,SP 31 dal bivio SP 28 per Castenaso a Ponte Rizzoli,14186,00,13222,964,11793,2393,14186,0
2019/02,279,28/02/2019,4,SP 31 dal bivio SP 28 per Castenaso a Ponte Rizzoli,14416,10,13457,958,12026,2390,14416,0
2019/02,280,15/02/2019,5,SP 26 tra Gesso e Ponte Rivabella,21968,00,21482,486,16723,5245,21968,0
2019/02,280,16/02/2019,6,SP 26 tra Gesso e Ponte Rivabella,18637,00,18461,176,13527,5110,0,18637
2019/02,280,17/02/2019,7,SP 26 tra Gesso e Ponte Rivabella,15206,00,15165,41,11476,3730,0,15206
2019/02,280,18/02/2019,1,SP 26 tra Gesso e Ponte Rivabella,20622,00,20196,426,16226,4396,20622,0
2019/02,280,19/02/2019,2,SP 26 tra Gesso e Ponte Rivabella,20896,10,20402,493,16235,4661,20896,0
2019/02,280,20/02/2019,3,SP 26 tra Gesso e Ponte Rivabella,20978,10,20455,522,16250,4728,20978,0
2019/02,280,21/02/2019,4,SP 26 tra Gesso e Ponte Rivabella,21618,00,21098,520,16576,5042,21618,0
2019/02,280,22/02/2019,5,SP 26 tra Gesso e Ponte Rivabella,22183,00,21606,577,16865,5318,22183,0
2019/02,280,23/02/2019,6,SP 26 tra Gesso e Ponte Rivabella,19417,00,19234,183,14264,5153,0,19417
2019/02,280,24/02/2019,7,SP 26 tra Gesso e Ponte Rivabella,15093,00,15040,53,11383,3710,0,15093
2019/02,280,25/02/2019,1,SP 26 tra Gesso e Ponte Rivabella,20606,00,20128,478,16077,4529,20606,0
2019/02,280,26/02/2019,2,SP 26 tra Gesso e Ponte Rivabella,20995,00,20488,507,16211,4784,20995,0
2019/02,280,27/02/2019,3,SP 26 tra Gesso e Ponte Rivabella,21076,10,20560,515,16220,4856,21076,0
2019/02,280,28/02/2019,4,SP 26 tra Gesso e Ponte Rivabella,21607,00,21112,495,16512,5095,21607,0
2019/02,281,15/02/2019,5,SP 78_1 tra Bazzano e Intersezione SP 27 a Monteveglio,6951,20,6722,227,5347,1604,6951,0
2019/02,281,16/02/2019,6,SP 78_1 tra Bazzano e Intersezione SP 27 a Monteveglio,6663,10,6579,83,5080,1583,0,6663
2019/02,281,17/02/2019,7,SP 78_1 tra Bazzano e Intersezione SP 27 a Monteveglio,4893,10,4859,33,3706,1187,0,4893
2019/02,281,18/02/2019,1,SP 78_1 tra Bazzano e Intersezione SP 27 a Monteveglio,6638,20,6424,212,5306,1332,6638,0
2019/02,281,19/02/2019,2,SP 78_1 tra Bazzano e Intersezione SP 27 a Monteveglio,6803,20,6546,255,5368,1435,6803,0
2019/02,281,20/02/2019,3,SP 78_1 tra Bazzano e Intersezione SP 27 a Monteveglio,6722,10,6495,226,5359,1363,6722,0
2019/02,281,21/02/2019,4,SP 78_1 tra Bazzano e Intersezione SP 27 a Monteveglio,6928,40,6678,246,5416,1512,6928,0
2019/02,281,22/02/2019,5,SP 78_1 tra Bazzano e Intersezione SP 27 a Monteveglio,7028,40,6795,229,5400,1628,7028,0
2019/02,281,23/02/2019,6,SP 78_1 tra Bazzano e Intersezione SP 27 a Monteveglio,6916,40,6822,90,5184,1732,0,6916
2019/02,281,24/02/2019,7,SP 78_1 tra Bazzano e Intersezione SP 27 a Monteveglio,4997,00,4955,42,3824,1173,0,4997
2019/02,281,25/02/2019,1,SP 78_1 tra Bazzano e Intersezione SP 27 a Monteveglio,6678,10,6454,223,5339,1339,6678,0
2019/02,281,26/02/2019,2,SP 78_1 tra Bazzano e Intersezione SP 27 a Monteveglio,6709,20,6474,233,5366,1343,6709,0
2019/02,281,27/02/2019,3,SP 78_1 tra Bazzano e Intersezione SP 27 a Monteveglio,6708,40,6486,218,5282,1426,6708,0
2019/02,281,28/02/2019,4,SP 78_1 tra Bazzano e Intersezione SP 27 a Monteveglio,6850,50,6603,242,5358,1492,6850,0
2019/02,282,15/02/2019,5,SS 9 tra Anzola dell'Emilia e Bologna,24880,10,22579,2300,18505,6375,24880,0
2019/02,282,16/02/2019,6,SS 9 tra Anzola dell'Emilia e Bologna,18001,00,17437,564,12588,5413,0,18001
2019/02,282,17/02/2019,7,SS 9 tra Anzola dell'Emilia e Bologna,14962,00,14854,108,10450,4512,0,14962
2019/02,282,18/02/2019,1,SS 9 tra Anzola dell'Emilia e Bologna,23612,00,21274,2338,18102,5510,23612,0
2019/02,282,19/02/2019,2,SS 9 tra Anzola dell'Emilia e Bologna,24421,00,22094,2327,18703,5718,24421,0
2019/02,282,20/02/2019,3,SS 9 tra Anzola dell'Emilia e Bologna,23955,00,21670,2285,18117,5838,23955,0
2019/02,282,21/02/2019,4,SS 9 tra Anzola dell'Emilia e Bologna,24528,10,22139,2388,18384,6144,24528,0
2019/02,282,22/02/2019,5,SS 9 tra Anzola dell'Emilia e Bologna,24803,10,22514,2288,18313,6490,24803,0
2019/02,282,23/02/2019,6,SS 9 tra Anzola dell'Emilia e Bologna,18386,00,17830,556,12838,5548,0,18386
2019/02,282,24/02/2019,7,SS 9 tra Anzola dell'Emilia e Bologna,15000,00,14888,112,10518,4482,0,15000
2019/02,282,25/02/2019,1,SS 9 tra Anzola dell'Emilia e Bologna,23842,00,21599,2243,18091,5751,23842,0
2019/02,282,26/02/2019,2,SS 9 tra Anzola dell'Emilia e Bologna,23928,00,21620,2308,18108,5820,23928,0
2019/02,282,27/02/2019,3,SS 9 tra Anzola dell'Emilia e Bologna,24364,00,22076,2288,18395,5969,24364,0
2019/02,282,28/02/2019,4,SS 9 tra Anzola dell'Emilia e Bologna,24533,10,22172,2360,18357,6176,24533,0
2019/02,285,15/02/2019,5,SP 1 fra Crevalcore e Decima,6520,00,6113,407,4978,1542,6520,0
2019/02,285,16/02/2019,6,SP 1 fra Crevalcore e Decima,5299,00,5165,134,3708,1591,0,5299
2019/02,285,17/02/2019,7,SP 1 fra Crevalcore e Decima,4227,00,4210,17,3030,1197,0,4227
2019/02,285,18/02/2019,1,SP 1 fra Crevalcore e Decima,6276,00,5767,509,5027,1249,6276,0
2019/02,285,19/02/2019,2,SP 1 fra Crevalcore e Decima,6513,00,6034,479,5126,1387,6513,0
2019/02,285,20/02/2019,3,SP 1 fra Crevalcore e Decima,6248,00,5780,468,4931,1317,6248,0
2019/02,285,21/02/2019,4,SP 1 fra Crevalcore e Decima,6368,00,5908,460,4948,1420,6368,0
2019/02,285,22/02/2019,5,SP 1 fra Crevalcore e Decima,6649,10,6255,393,5068,1581,6649,0
2019/02,285,23/02/2019,6,SP 1 fra Crevalcore e Decima,5458,00,5308,150,3850,1608,0,5458
2019/02,285,24/02/2019,7,SP 1 fra Crevalcore e Decima,4653,00,4608,45,3523,1130,0,4653
2019/02,285,25/02/2019,1,SP 1 fra Crevalcore e Decima,6230,10,5829,400,4908,1322,6230,0
2019/02,285,26/02/2019,2,SP 1 fra Crevalcore e Decima,6372,00,5934,438,5079,1293,6372,0
2019/02,285,27/02/2019,3,SP 1 fra Crevalcore e Decima,6471,00,6014,457,5030,1441,6471,0
2019/02,285,28/02/2019,4,SP 1 fra Crevalcore e Decima,6397,10,5948,448,5016,1381,6397,0
2019/02,287,15/02/2019,5,SP 6 fra Cento e Pilastrello,8160,00,7633,527,6390,1770,8160,0
2019/02,287,16/02/2019,6,SP 6 fra Cento e Pilastrello,7451,00,7307,144,5424,2027,0,7451
2019/02,287,17/02/2019,7,SP 6 fra Cento e Pilastrello,5570,00,5547,23,3979,1591,0,5570
2019/02,287,18/02/2019,1,SP 6 fra Cento e Pilastrello,7822,20,7309,511,6425,1397,7822,0
2019/02,287,19/02/2019,2,SP 6 fra Cento e Pilastrello,7973,10,7470,502,6438,1535,7973,0
2019/02,287,20/02/2019,3,SP 6 fra Cento e Pilastrello,7907,00,7443,464,6328,1579,7907,0
2019/02,287,21/02/2019,4,SP 6 fra Cento e Pilastrello,8111,00,7605,506,6484,1627,8111,0
2019/02,287,22/02/2019,5,SP 6 fra Cento e Pilastrello,8016,00,7509,507,6324,1692,8016,0
2019/02,287,23/02/2019,6,SP 6 fra Cento e Pilastrello,7223,00,7112,111,5213,2010,0,7223
2019/02,287,24/02/2019,7,SP 6 fra Cento e Pilastrello,5646,00,5616,30,4068,1578,0,5646
2019/02,287,25/02/2019,1,SP 6 fra Cento e Pilastrello,7637,00,7115,522,6189,1448,7637,0
2019/02,287,26/02/2019,2,SP 6 fra Cento e Pilastrello,7989,00,7515,474,6428,1561,7989,0
2019/02,287,27/02/2019,3,SP 6 fra Cento e Pilastrello,8115,00,7602,513,6464,1651,8115,0
2019/02,287,28/02/2019,4,SP 6 fra Cento e Pilastrello,7911,00,7453,458,6383,1528,7911,0
2019/02,288,15/02/2019,5,SP 42 fra Pieve di Cento e Castello d'Argile,19657,00,18817,840,14787,4870,19657,0
2019/02,288,16/02/2019,6,SP 42 fra Pieve di Cento e Castello d'Argile,14481,00,14221,260,10349,4132,0,14481
2019/02,288,17/02/2019,7,SP 42 fra Pieve di Cento e Castello d'Argile,12909,00,12819,90,9369,3540,0,12909
2019/02,288,18/02/2019,1,SP 42 fra Pieve di Cento e Castello d'Argile,18258,00,17413,845,14405,3853,18258,0
2019/02,288,19/02/2019,2,SP 42 fra Pieve di Cento e Castello d'Argile,18654,00,17765,889,14583,4071,18654,0
2019/02,288,20/02/2019,3,SP 42 fra Pieve di Cento e Castello d'Argile,18888,00,18028,860,14738,4150,18888,0
2019/02,288,21/02/2019,4,SP 42 fra Pieve di Cento e Castello d'Argile,18886,00,17985,901,14699,4187,18886,0
2019/02,288,22/02/2019,5,SP 42 fra Pieve di Cento e Castello d'Argile,19821,00,18920,901,15122,4699,19821,0
2019/02,288,23/02/2019,6,SP 42 fra Pieve di Cento e Castello d'Argile,14780,00,14552,228,10710,4070,0,14780
2019/02,288,24/02/2019,7,SP 42 fra Pieve di Cento e Castello d'Argile,12234,00,12146,88,8934,3300,0,12234
2019/02,288,25/02/2019,1,SP 42 fra Pieve di Cento e Castello d'Argile,18560,00,17695,865,14529,4031,18560,0
2019/02,288,26/02/2019,2,SP 42 fra Pieve di Cento e Castello d'Argile,18700,00,17789,911,14539,4161,18700,0
2019/02,288,27/02/2019,3,SP 42 fra Pieve di Cento e Castello d'Argile,18919,00,18008,911,14625,4294,18919,0
2019/02,288,28/02/2019,4,SP 42 fra Pieve di Cento e Castello d'Argile,19238,00,18374,864,14942,4296,19238,0
2019/02,290,15/02/2019,5,SP 11 fra Pieve di Cento e San Pietro in Casale,6737,00,6395,342,5074,1663,6737,0
2019/02,290,16/02/2019,6,SP 11 fra Pieve di Cento e San Pietro in Casale,5653,00,5546,107,3891,1762,0,5653
2019/02,290,17/02/2019,7,SP 11 fra Pieve di Cento e San Pietro in Casale,4950,00,4928,22,3514,1436,0,4950
2019/02,290,18/02/2019,1,SP 11 fra Pieve di Cento e San Pietro in Casale,6096,00,5769,327,4931,1165,6096,0
2019/02,290,19/02/2019,2,SP 11 fra Pieve di Cento e San Pietro in Casale,6416,10,6033,382,5126,1290,6416,0
2019/02,290,20/02/2019,3,SP 11 fra Pieve di Cento e San Pietro in Casale,6331,00,5951,380,5021,1310,6331,0
2019/02,290,21/02/2019,4,SP 11 fra Pieve di Cento e San Pietro in Casale,6434,00,6052,382,5157,1277,6434,0
2019/02,290,22/02/2019,5,SP 11 fra Pieve di Cento e San Pietro in Casale,6950,00,6595,355,5329,1621,6950,0
2019/02,290,23/02/2019,6,SP 11 fra Pieve di Cento e San Pietro in Casale,5638,00,5514,124,3985,1653,0,5638
2019/02,290,24/02/2019,7,SP 11 fra Pieve di Cento e San Pietro in Casale,5142,00,5088,54,3688,1454,0,5142
2019/02,290,25/02/2019,1,SP 11 fra Pieve di Cento e San Pietro in Casale,6233,00,5864,369,5008,1225,6233,0
2019/02,290,26/02/2019,2,SP 11 fra Pieve di Cento e San Pietro in Casale,6515,00,6144,371,5292,1223,6515,0
2019/02,290,27/02/2019,3,SP 11 fra Pieve di Cento e San Pietro in Casale,6581,00,6162,419,5258,1323,6581,0
2019/02,290,28/02/2019,4,SP 11 fra Pieve di Cento e San Pietro in Casale,6430,00,6051,379,5118,1312,6430,0
2019/02,291,15/02/2019,5,SP 4 tra San Pietro in Casale e San Vincenzo/San Venanzio,10798,00,10339,459,8179,2619,10798,0
2019/02,291,16/02/2019,6,SP 4 tra San Pietro in Casale e San Vincenzo/San Venanzio,8984,00,8873,111,6679,2305,0,8984
2019/02,291,17/02/2019,7,SP 4 tra San Pietro in Casale e San Vincenzo/San Venanzio,6823,00,6789,34,5080,1743,0,6823
2019/02,291,18/02/2019,1,SP 4 tra San Pietro in Casale e San Vincenzo/San Venanzio,9968,00,9561,407,7710,2258,9968,0
2019/02,291,19/02/2019,2,SP 4 tra San Pietro in Casale e San Vincenzo/San Venanzio,10510,00,10074,436,8102,2408,10510,0
2019/02,291,20/02/2019,3,SP 4 tra San Pietro in Casale e San Vincenzo/San Venanzio,10501,00,10063,438,8108,2393,10501,0
2019/02,291,21/02/2019,4,SP 4 tra San Pietro in Casale e San Vincenzo/San Venanzio,10447,00,9954,493,7994,2453,10447,0
2019/02,291,22/02/2019,5,SP 4 tra San Pietro in Casale e San Vincenzo/San Venanzio,10921,00,10500,421,8210,2711,10921,0
2019/02,291,23/02/2019,6,SP 4 tra San Pietro in Casale e San Vincenzo/San Venanzio,9294,00,9156,138,6800,2494,0,9294
2019/02,291,24/02/2019,7,SP 4 tra San Pietro in Casale e San Vincenzo/San Venanzio,7264,00,7226,38,5389,1875,0,7264
2019/02,291,25/02/2019,1,SP 4 tra San Pietro in Casale e San Vincenzo/San Venanzio,10422,00,9992,430,8161,2261,10422,0
2019/02,291,26/02/2019,2,SP 4 tra San Pietro in Casale e San Vincenzo/San Venanzio,10432,10,9995,436,8030,2402,10432,0
2019/02,291,27/02/2019,3,SP 4 tra San Pietro in Casale e San Vincenzo/San Venanzio,10490,00,10023,467,7978,2512,10490,0
2019/02,291,28/02/2019,4,SP 4 tra San Pietro in Casale e San Vincenzo/San Venanzio,10572,00,10114,458,8073,2499,10572,0
2019/02,292,15/02/2019,5,SP 4 tra San Giorgio di Piano e Intersezione SP 11 c/o San Pietro in Casale,18396,00,17724,672,13687,4709,18396,0
2019/02,292,16/02/2019,6,SP 4 tra San Giorgio di Piano e Intersezione SP 11 c/o San Pietro in Casale,14596,00,14403,193,10507,4089,0,14596
2019/02,292,17/02/2019,7,SP 4 tra San Giorgio di Piano e Intersezione SP 11 c/o San Pietro in Casale,11254,00,11209,45,8025,3229,0,11254
2019/02,292,18/02/2019,1,SP 4 tra San Giorgio di Piano e Intersezione SP 11 c/o San Pietro in Casale,17253,10,16634,618,13432,3821,17253,0
2019/02,292,19/02/2019,2,SP 4 tra San Giorgio di Piano e Intersezione SP 11 c/o San Pietro in Casale,17973,00,17323,650,13854,4119,17973,0
2019/02,292,20/02/2019,3,SP 4 tra San Giorgio di Piano e Intersezione SP 11 c/o San Pietro in Casale,17666,10,17007,658,13529,4137,17666,0
2019/02,292,21/02/2019,4,SP 4 tra San Giorgio di Piano e Intersezione SP 11 c/o San Pietro in Casale,17814,00,17167,647,13581,4233,17814,0
2019/02,292,22/02/2019,5,SP 4 tra San Giorgio di Piano e Intersezione SP 11 c/o San Pietro in Casale,18769,10,18093,675,13954,4815,18769,0
2019/02,292,23/02/2019,6,SP 4 tra San Giorgio di Piano e Intersezione SP 11 c/o San Pietro in Casale,14675,00,14486,189,10528,4147,0,14675
2019/02,292,24/02/2019,7,SP 4 tra San Giorgio di Piano e Intersezione SP 11 c/o San Pietro in Casale,12106,00,12073,33,8869,3237,0,12106
2019/02,292,25/02/2019,1,SP 4 tra San Giorgio di Piano e Intersezione SP 11 c/o San Pietro in Casale,17538,10,16929,608,13580,3958,17538,0
2019/02,292,26/02/2019,2,SP 4 tra San Giorgio di Piano e Intersezione SP 11 c/o San Pietro in Casale,18067,00,17414,653,13894,4173,18067,0
2019/02,292,27/02/2019,3,SP 4 tra San Giorgio di Piano e Intersezione SP 11 c/o San Pietro in Casale,17856,10,17185,670,13557,4299,17856,0
2019/02,292,28/02/2019,4,SP 4 tra San Giorgio di Piano e Intersezione SP 11 c/o San Pietro in Casale,18081,10,17404,676,13713,4368,18081,0
2019/02,295,15/02/2019,5,SP 9 fra Colorno e Torrile centro abitato di Bezze,3812,10,3458,353,3033,779,3812,0
2019/02,295,16/02/2019,6,SP 9 fra Colorno e Torrile centro abitato di Bezze,2917,00,2774,143,2232,685,0,2917
2019/02,295,17/02/2019,7,SP 9 fra Colorno e Torrile centro abitato di Bezze,2273,00,2223,50,1715,558,0,2273
2019/02,295,18/02/2019,1,SP 9 fra Colorno e Torrile centro abitato di Bezze,6543,10,6036,506,5423,1120,6543,0
2019/02,295,19/02/2019,2,SP 9 fra Colorno e Torrile centro abitato di Bezze,6647,00,6166,481,5400,1247,6647,0
2019/02,295,20/02/2019,3,SP 9 fra Colorno e Torrile centro abitato di Bezze,6888,20,6427,459,5576,1312,6888,0
2019/02,295,21/02/2019,4,SP 9 fra Colorno e Torrile centro abitato di Bezze,6800,00,6284,516,5460,1340,6800,0
2019/02,295,22/02/2019,5,SP 9 fra Colorno e Torrile centro abitato di Bezze,6844,00,6359,485,5465,1379,6844,0
2019/02,295,23/02/2019,6,SP 9 fra Colorno e Torrile centro abitato di Bezze,5037,00,4849,188,3846,1191,0,5037
2019/02,295,24/02/2019,7,SP 9 fra Colorno e Torrile centro abitato di Bezze,3547,00,3487,60,2650,897,0,3547
2019/02,295,25/02/2019,1,SP 9 fra Colorno e Torrile centro abitato di Bezze,6696,00,6164,532,5497,1199,6696,0
2019/02,295,26/02/2019,2,SP 9 fra Colorno e Torrile centro abitato di Bezze,6776,00,6263,513,5474,1302,6776,0
2019/02,295,27/02/2019,3,SP 9 fra Colorno e Torrile centro abitato di Bezze,6825,20,6290,533,5503,1322,6825,0
2019/02,295,28/02/2019,4,SP 9 fra Colorno e Torrile centro abitato di Bezze,7014,00,6456,558,5582,1432,7014,0
2019/02,298,15/02/2019,5,SP 588R da Castione Marchesi (A 1) a Busseto,3235,00,3035,200,2588,647,3235,0
2019/02,298,16/02/2019,6,SP 588R da Castione Marchesi (A 1) a Busseto,2534,00,2408,126,1861,673,0,2534
2019/02,298,17/02/2019,7,SP 588R da Castione Marchesi (A 1) a Busseto,2245,00,2217,28,1730,515,0,2245
2019/02,298,18/02/2019,1,SP 588R da Castione Marchesi (A 1) a Busseto,2671,00,2503,168,2174,497,2671,0
2019/02,298,19/02/2019,2,SP 588R da Castione Marchesi (A 1) a Busseto,2821,10,2629,191,2272,549,2821,0
2019/02,298,20/02/2019,3,SP 588R da Castione Marchesi (A 1) a Busseto,2940,00,2769,171,2384,556,2940,0
2019/02,298,21/02/2019,4,SP 588R da Castione Marchesi (A 1) a Busseto,3003,00,2797,206,2441,562,3003,0
2019/02,298,22/02/2019,5,SP 588R da Castione Marchesi (A 1) a Busseto,3201,00,3006,195,2521,680,3201,0
2019/02,298,23/02/2019,6,SP 588R da Castione Marchesi (A 1) a Busseto,2491,00,2435,56,1786,705,0,2491
2019/02,298,24/02/2019,7,SP 588R da Castione Marchesi (A 1) a Busseto,2336,00,2270,66,1743,593,0,2336
2019/02,298,25/02/2019,1,SP 588R da Castione Marchesi (A 1) a Busseto,2785,10,2588,196,2240,545,2785,0
2019/02,298,26/02/2019,2,SP 588R da Castione Marchesi (A 1) a Busseto,2973,00,2756,217,2406,567,2973,0
2019/02,298,27/02/2019,3,SP 588R da Castione Marchesi (A 1) a Busseto,2987,00,2808,179,2384,603,2987,0
2019/02,298,28/02/2019,4,SP 588R da Castione Marchesi (A 1) a Busseto,3008,00,2801,207,2414,594,3008,0
2019/02,300,15/02/2019,5,SP 462R fra Fiorenzuola d'Arda e Cortemaggiore,8581,40,7476,1101,6752,1829,8581,0
2019/02,300,16/02/2019,6,SP 462R fra Fiorenzuola d'Arda e Cortemaggiore,6761,20,6418,341,5064,1697,0,6761
2019/02,300,17/02/2019,7,SP 462R fra Fiorenzuola d'Arda e Cortemaggiore,5620,00,5562,58,4357,1263,0,5620
2019/02,300,18/02/2019,1,SP 462R fra Fiorenzuola d'Arda e Cortemaggiore,8011,10,6912,1098,6551,1460,8011,0
2019/02,300,19/02/2019,2,SP 462R fra Fiorenzuola d'Arda e Cortemaggiore,8376,20,7320,1054,6814,1562,8376,0
2019/02,300,20/02/2019,3,SP 462R fra Fiorenzuola d'Arda e Cortemaggiore,8842,40,7686,1152,7227,1615,8842,0
2019/02,300,21/02/2019,4,SP 462R fra Fiorenzuola d'Arda e Cortemaggiore,8692,20,7611,1079,7034,1658,8692,0
2019/02,300,22/02/2019,5,SP 462R fra Fiorenzuola d'Arda e Cortemaggiore,8825,00,7664,1161,6990,1835,8825,0
2019/02,300,23/02/2019,6,SP 462R fra Fiorenzuola d'Arda e Cortemaggiore,6937,10,6588,348,5192,1745,0,6937
2019/02,300,24/02/2019,7,SP 462R fra Fiorenzuola d'Arda e Cortemaggiore,6133,00,6023,110,4768,1365,0,6133
2019/02,300,25/02/2019,1,SP 462R fra Fiorenzuola d'Arda e Cortemaggiore,8362,30,7273,1086,6784,1578,8362,0
2019/02,300,26/02/2019,2,SP 462R fra Fiorenzuola d'Arda e Cortemaggiore,8301,00,7235,1066,6718,1583,8301,0
2019/02,300,27/02/2019,3,SP 462R fra Fiorenzuola d'Arda e Cortemaggiore,8322,20,7316,1004,6711,1611,8322,0
2019/02,300,28/02/2019,4,SP 462R fra Fiorenzuola d'Arda e Cortemaggiore,8502,50,7491,1006,6766,1736,8502,0
2019/02,301,15/02/2019,5,SP 4 tra Fiorenzuola d'Arda (Tg Sud) e Castell'Arquato,8773,00,8160,613,6652,2121,8773,0
2019/02,301,16/02/2019,6,SP 4 tra Fiorenzuola d'Arda (Tg Sud) e Castell'Arquato,7747,00,7651,96,5821,1926,0,7747
2019/02,301,17/02/2019,7,SP 4 tra Fiorenzuola d'Arda (Tg Sud) e Castell'Arquato,6317,00,6302,15,4809,1508,0,6317
2019/02,301,18/02/2019,1,SP 4 tra Fiorenzuola d'Arda (Tg Sud) e Castell'Arquato,7955,00,7343,612,6314,1641,7955,0
2019/02,301,19/02/2019,2,SP 4 tra Fiorenzuola d'Arda (Tg Sud) e Castell'Arquato,8105,20,7438,665,6437,1668,8105,0
2019/02,301,20/02/2019,3,SP 4 tra Fiorenzuola d'Arda (Tg Sud) e Castell'Arquato,8293,00,7671,622,6547,1746,8293,0
2019/02,301,21/02/2019,4,SP 4 tra Fiorenzuola d'Arda (Tg Sud) e Castell'Arquato,8330,00,7714,616,6548,1782,8330,0
2019/02,301,22/02/2019,5,SP 4 tra Fiorenzuola d'Arda (Tg Sud) e Castell'Arquato,8882,00,8239,643,6802,2080,8882,0
2019/02,301,23/02/2019,6,SP 4 tra Fiorenzuola d'Arda (Tg Sud) e Castell'Arquato,8072,00,7877,195,6184,1888,0,8072
2019/02,301,24/02/2019,7,SP 4 tra Fiorenzuola d'Arda (Tg Sud) e Castell'Arquato,6309,00,6285,24,4805,1504,0,6309
2019/02,301,25/02/2019,1,SP 4 tra Fiorenzuola d'Arda (Tg Sud) e Castell'Arquato,8074,10,7440,633,6468,1606,8074,0
2019/02,301,26/02/2019,2,SP 4 tra Fiorenzuola d'Arda (Tg Sud) e Castell'Arquato,8325,10,7658,666,6660,1665,8325,0
2019/02,301,27/02/2019,3,SP 4 tra Fiorenzuola d'Arda (Tg Sud) e Castell'Arquato,8229,30,7574,652,6464,1765,8229,0
2019/02,301,28/02/2019,4,SP 4 tra Fiorenzuola d'Arda (Tg Sud) e Castell'Arquato,8737,10,8085,651,6793,1944,8737,0
2019/02,302,15/02/2019,5,SP 12 da Fidenza (Casello A 1) a Soragna,8399,20,7381,1016,6577,1822,8399,0
2019/02,302,16/02/2019,6,SP 12 da Fidenza (Casello A 1) a Soragna,7509,00,7295,214,5530,1979,0,7509
2019/02,302,17/02/2019,7,SP 12 da Fidenza (Casello A 1) a Soragna,6644,00,6585,59,5128,1516,0,6644
2019/02,302,18/02/2019,1,SP 12 da Fidenza (Casello A 1) a Soragna,7437,10,6469,967,6152,1285,7437,0
2019/02,302,19/02/2019,2,SP 12 da Fidenza (Casello A 1) a Soragna,7566,10,6627,938,6165,1401,7566,0
2019/02,302,20/02/2019,3,SP 12 da Fidenza (Casello A 1) a Soragna,8274,20,7274,998,6858,1416,8274,0
2019/02,302,21/02/2019,4,SP 12 da Fidenza (Casello A 1) a Soragna,7761,00,6798,963,6233,1528,7761,0
2019/02,302,24/02/2019,7,SP 12 da Fidenza (Casello A 1) a Soragna,7365,00,7287,78,5583,1782,0,7365
2019/02,302,25/02/2019,1,SP 12 da Fidenza (Casello A 1) a Soragna,7644,00,6699,945,6231,1413,7644,0
2019/02,302,26/02/2019,2,SP 12 da Fidenza (Casello A 1) a Soragna,7615,10,6709,905,6223,1392,7615,0
2019/02,303,15/02/2019,5,SP 11 fra Borgonovo e Gragnano,9770,00,9258,512,7609,2161,9770,0
2019/02,303,16/02/2019,6,SP 11 fra Borgonovo e Gragnano,8627,00,8465,162,6364,2263,0,8627
2019/02,303,17/02/2019,7,SP 11 fra Borgonovo e Gragnano,7009,00,6981,28,5272,1737,0,7009
2019/02,303,18/02/2019,1,SP 11 fra Borgonovo e Gragnano,9154,10,8636,517,7355,1799,9154,0
2019/02,303,19/02/2019,2,SP 11 fra Borgonovo e Gragnano,9215,00,8718,497,7312,1903,9215,0
2019/02,303,20/02/2019,3,SP 11 fra Borgonovo e Gragnano,9421,00,8893,528,7453,1968,9421,0
2019/02,303,21/02/2019,4,SP 11 fra Borgonovo e Gragnano,9557,00,9011,546,7648,1909,9557,0
2019/02,303,22/02/2019,5,SP 11 fra Borgonovo e Gragnano,9734,00,9190,544,7663,2071,9734,0
2019/02,303,23/02/2019,6,SP 11 fra Borgonovo e Gragnano,8458,00,8286,172,6326,2132,0,8458
2019/02,303,24/02/2019,7,SP 11 fra Borgonovo e Gragnano,7120,00,7078,42,5400,1720,0,7120
2019/02,303,25/02/2019,1,SP 11 fra Borgonovo e Gragnano,9152,00,8672,480,7375,1777,9152,0
2019/02,303,26/02/2019,2,SP 11 fra Borgonovo e Gragnano,9414,00,8883,531,7628,1786,9414,0
2019/02,303,27/02/2019,3,SP 11 fra Borgonovo e Gragnano,9484,00,8938,546,7641,1843,9484,0
2019/02,303,28/02/2019,4,SP 11 fra Borgonovo e Gragnano,9924,10,9332,591,7871,2053,9924,0
2019/02,304,15/02/2019,5,SP 42 fra Podenzano e bivio SP 6/ponte fiume Nure in località San Giorgio Piacentino,7152,00,6715,437,5556,1596,7152,0
2019/02,304,16/02/2019,6,SP 42 fra Podenzano e bivio SP 6/ponte fiume Nure in località San Giorgio Piacentino,5829,00,5751,78,4232,1597,0,5829
2019/02,304,17/02/2019,7,SP 42 fra Podenzano e bivio SP 6/ponte fiume Nure in località San Giorgio Piacentino,5292,00,5276,16,4107,1185,0,5292
2019/02,304,18/02/2019,1,SP 42 fra Podenzano e bivio SP 6/ponte fiume Nure in località San Giorgio Piacentino,6665,00,6273,392,5331,1334,6665,0
2019/02,304,19/02/2019,2,SP 42 fra Podenzano e bivio SP 6/ponte fiume Nure in località San Giorgio Piacentino,6855,00,6420,435,5526,1329,6855,0
2019/02,304,20/02/2019,3,SP 42 fra Podenzano e bivio SP 6/ponte fiume Nure in località San Giorgio Piacentino,7065,10,6556,508,5693,1372,7065,0
2019/02,304,21/02/2019,4,SP 42 fra Podenzano e bivio SP 6/ponte fiume Nure in località San Giorgio Piacentino,7003,00,6510,493,5540,1463,7003,0
2019/02,304,22/02/2019,5,SP 42 fra Podenzano e bivio SP 6/ponte fiume Nure in località San Giorgio Piacentino,7062,00,6583,479,5476,1586,7062,0
2019/02,304,23/02/2019,6,SP 42 fra Podenzano e bivio SP 6/ponte fiume Nure in località San Giorgio Piacentino,5676,00,5582,94,4254,1422,0,5676
2019/02,304,24/02/2019,7,SP 42 fra Podenzano e bivio SP 6/ponte fiume Nure in località San Giorgio Piacentino,5167,00,5154,13,4043,1124,0,5167
2019/02,304,25/02/2019,1,SP 42 fra Podenzano e bivio SP 6/ponte fiume Nure in località San Giorgio Piacentino,6862,00,6413,449,5444,1418,6862,0
2019/02,304,26/02/2019,2,SP 42 fra Podenzano e bivio SP 6/ponte fiume Nure in località San Giorgio Piacentino,6861,00,6332,529,5483,1378,6861,0
2019/02,304,27/02/2019,3,SP 42 fra Podenzano e bivio SP 6/ponte fiume Nure in località San Giorgio Piacentino,7294,00,6713,581,5832,1462,7294,0
2019/02,304,28/02/2019,4,SP 42 fra Podenzano e bivio SP 6/ponte fiume Nure in località San Giorgio Piacentino,7088,00,6600,488,5632,1456,7088,0
2019/02,305,15/02/2019,5,SP 6Bis fra Carpaneto e Castell'Arquato,4714,10,4250,463,3568,1146,4714,0
2019/02,305,16/02/2019,6,SP 6Bis fra Carpaneto e Castell'Arquato,4415,00,4264,151,3242,1173,0,4415
2019/02,305,17/02/2019,7,SP 6Bis fra Carpaneto e Castell'Arquato,4214,20,4182,30,3375,839,0,4214
2019/02,305,18/02/2019,1,SP 6Bis fra Carpaneto e Castell'Arquato,4190,00,3776,414,3396,794,4190,0
2019/02,305,19/02/2019,2,SP 6Bis fra Carpaneto e Castell'Arquato,4159,00,3732,427,3384,775,4159,0
2019/02,305,20/02/2019,3,SP 6Bis fra Carpaneto e Castell'Arquato,4603,00,4152,451,3672,931,4603,0
2019/02,305,21/02/2019,4,SP 6Bis fra Carpaneto e Castell'Arquato,4472,10,4019,452,3507,965,4472,0
2019/02,305,22/02/2019,5,SP 6Bis fra Carpaneto e Castell'Arquato,4779,10,4320,458,3615,1164,4779,0
2019/02,305,23/02/2019,6,SP 6Bis fra Carpaneto e Castell'Arquato,4657,00,4362,295,3488,1169,0,4657
2019/02,305,24/02/2019,7,SP 6Bis fra Carpaneto e Castell'Arquato,4114,00,4082,32,3333,781,0,4114
2019/02,305,25/02/2019,1,SP 6Bis fra Carpaneto e Castell'Arquato,4200,00,3754,446,3358,842,4200,0
2019/02,305,26/02/2019,2,SP 6Bis fra Carpaneto e Castell'Arquato,4365,10,3859,505,3529,836,4365,0
2019/02,305,27/02/2019,3,SP 6Bis fra Carpaneto e Castell'Arquato,4605,00,4116,489,3663,942,4605,0
2019/02,305,28/02/2019,4,SP 6Bis fra Carpaneto e Castell'Arquato,4445,10,3976,468,3498,947,4445,0
2019/02,306,15/02/2019,5,SP 654R fra Ponte dell'Olio e Bettola,4446,10,4270,175,3426,1020,4446,0
2019/02,306,16/02/2019,6,SP 654R fra Ponte dell'Olio e Bettola,4566,10,4503,62,3549,1017,0,4566
2019/02,306,17/02/2019,7,SP 654R fra Ponte dell'Olio e Bettola,4721,20,4687,32,3811,910,0,4721
2019/02,306,18/02/2019,1,SP 654R fra Ponte dell'Olio e Bettola,4519,10,4356,162,3710,809,4519,0
2019/02,306,19/02/2019,2,SP 654R fra Ponte dell'Olio e Bettola,4353,10,4174,178,3548,805,4353,0
2019/02,306,20/02/2019,3,SP 654R fra Ponte dell'Olio e Bettola,4164,10,3998,165,3339,825,4164,0
2019/02,306,21/02/2019,4,SP 654R fra Ponte dell'Olio e Bettola,4326,00,4145,181,3471,855,4326,0
2019/02,306,22/02/2019,5,SP 654R fra Ponte dell'Olio e Bettola,4559,10,4390,168,3534,1025,4559,0
2019/02,306,23/02/2019,6,SP 654R fra Ponte dell'Olio e Bettola,4476,10,4397,78,3477,999,0,4476
2019/02,306,24/02/2019,7,SP 654R fra Ponte dell'Olio e Bettola,4567,00,4548,19,3586,981,0,4567
2019/02,306,25/02/2019,1,SP 654R fra Ponte dell'Olio e Bettola,4663,00,4490,173,3830,833,4663,0
2019/02,306,26/02/2019,2,SP 654R fra Ponte dell'Olio e Bettola,4326,00,4156,170,3493,833,4326,0
2019/02,306,27/02/2019,3,SP 654R fra Ponte dell'Olio e Bettola,4451,10,4257,193,3405,1046,4451,0
2019/02,306,28/02/2019,4,SP 654R fra Ponte dell'Olio e Bettola,4475,00,4268,207,3661,814,4475,0
2019/02,307,15/02/2019,5,SS 45 tra Rivergaro e Perino,4543,00,4364,179,3516,1027,4543,0
2019/02,307,16/02/2019,6,SS 45 tra Rivergaro e Perino,5220,00,5105,115,4219,1001,0,5220
2019/02,307,17/02/2019,7,SS 45 tra Rivergaro e Perino,6222,00,6208,14,5227,995,0,6222
2019/02,307,18/02/2019,1,SS 45 tra Rivergaro e Perino,3942,00,3752,190,3201,741,3942,0
2019/02,307,19/02/2019,2,SS 45 tra Rivergaro e Perino,4009,10,3815,193,3243,766,4009,0
2019/02,307,20/02/2019,3,SS 45 tra Rivergaro e Perino,4232,00,4030,202,3427,805,4232,0
2019/02,307,21/02/2019,4,SS 45 tra Rivergaro e Perino,4153,00,3951,202,3246,907,4153,0
2019/02,307,22/02/2019,5,SS 45 tra Rivergaro e Perino,4493,00,4298,195,3485,1008,4493,0
2019/02,307,23/02/2019,6,SS 45 tra Rivergaro e Perino,5212,00,5089,123,4122,1090,0,5212
2019/02,307,24/02/2019,7,SS 45 tra Rivergaro e Perino,6193,00,6179,14,5203,990,0,6193
2019/02,307,25/02/2019,1,SS 45 tra Rivergaro e Perino,3978,10,3774,203,3153,825,3978,0
2019/02,307,26/02/2019,2,SS 45 tra Rivergaro e Perino,4007,00,3801,206,3266,741,4007,0
2019/02,307,27/02/2019,3,SS 45 tra Rivergaro e Perino,4227,00,4055,172,3323,904,4227,0
2019/02,307,28/02/2019,4,SS 45 tra Rivergaro e Perino,4170,00,4001,169,3336,834,4170,0
2019/02,308,15/02/2019,5,SP 412R fra Pianello Val Tidone e Borgonovo Val Tidone,7055,10,6733,321,5482,1573,7055,0
2019/02,308,16/02/2019,6,SP 412R fra Pianello Val Tidone e Borgonovo Val Tidone,6912,00,6785,127,5309,1603,0,6912
2019/02,308,17/02/2019,7,SP 412R fra Pianello Val Tidone e Borgonovo Val Tidone,6014,00,5990,24,4758,1256,0,6014
2019/02,308,18/02/2019,1,SP 412R fra Pianello Val Tidone e Borgonovo Val Tidone,6271,00,5970,301,5079,1192,6271,0
2019/02,308,19/02/2019,2,SP 412R fra Pianello Val Tidone e Borgonovo Val Tidone,6419,00,6141,278,5141,1278,6419,0
2019/02,308,20/02/2019,3,SP 412R fra Pianello Val Tidone e Borgonovo Val Tidone,7094,00,6757,337,5792,1302,7094,0
2019/02,308,21/02/2019,4,SP 412R fra Pianello Val Tidone e Borgonovo Val Tidone,6561,10,6255,305,5270,1291,6561,0
2019/02,308,22/02/2019,5,SP 412R fra Pianello Val Tidone e Borgonovo Val Tidone,7137,00,6812,325,5720,1417,7137,0
2019/02,308,23/02/2019,6,SP 412R fra Pianello Val Tidone e Borgonovo Val Tidone,6816,00,6691,125,5271,1545,0,6816
2019/02,308,24/02/2019,7,SP 412R fra Pianello Val Tidone e Borgonovo Val Tidone,5830,00,5799,31,4597,1233,0,5830
2019/02,308,25/02/2019,1,SP 412R fra Pianello Val Tidone e Borgonovo Val Tidone,6353,00,6022,331,5135,1218,6353,0
2019/02,308,26/02/2019,2,SP 412R fra Pianello Val Tidone e Borgonovo Val Tidone,6333,00,6032,301,5102,1231,6333,0
2019/02,308,27/02/2019,3,SP 412R fra Pianello Val Tidone e Borgonovo Val Tidone,7124,00,6797,327,5798,1326,7124,0
2019/02,308,28/02/2019,4,SP 412R fra Pianello Val Tidone e Borgonovo Val Tidone,6688,10,6347,340,5364,1324,6688,0
2019/02,309,15/02/2019,5,SP 10R fra Castelvetro Piacentino e Monticelli d'Ongina,11841,10,11314,526,9226,2615,11841,0
2019/02,309,16/02/2019,6,SP 10R fra Castelvetro Piacentino e Monticelli d'Ongina,10590,00,10411,179,7773,2817,0,10590
2019/02,309,17/02/2019,7,SP 10R fra Castelvetro Piacentino e Monticelli d'Ongina,9576,00,9508,68,7391,2185,0,9576
2019/02,309,18/02/2019,1,SP 10R fra Castelvetro Piacentino e Monticelli d'Ongina,10785,20,10251,532,8667,2118,10785,0
2019/02,309,19/02/2019,2,SP 10R fra Castelvetro Piacentino e Monticelli d'Ongina,11051,20,10540,509,8817,2234,11051,0
2019/02,309,20/02/2019,3,SP 10R fra Castelvetro Piacentino e Monticelli d'Ongina,11194,00,10688,506,8881,2313,11194,0
2019/02,309,21/02/2019,4,SP 10R fra Castelvetro Piacentino e Monticelli d'Ongina,11060,00,10493,567,8820,2240,11060,0
2019/02,309,22/02/2019,5,SP 10R fra Castelvetro Piacentino e Monticelli d'Ongina,11875,00,11342,533,9236,2639,11875,0
2019/02,309,23/02/2019,6,SP 10R fra Castelvetro Piacentino e Monticelli d'Ongina,11072,10,10897,174,8185,2887,0,11072
2019/02,309,24/02/2019,7,SP 10R fra Castelvetro Piacentino e Monticelli d'Ongina,10357,00,10296,61,8007,2350,0,10357
2019/02,309,25/02/2019,1,SP 10R fra Castelvetro Piacentino e Monticelli d'Ongina,10790,10,10307,482,8629,2161,10790,0
2019/02,309,26/02/2019,2,SP 10R fra Castelvetro Piacentino e Monticelli d'Ongina,10985,20,10476,507,8806,2179,10985,0
2019/02,309,27/02/2019,3,SP 10R fra Castelvetro Piacentino e Monticelli d'Ongina,11180,00,10662,518,8840,2340,11180,0
2019/02,309,28/02/2019,4,SP 10R fra Castelvetro Piacentino e Monticelli d'Ongina,11432,30,10895,534,9075,2357,11432,0
2019/02,310,15/02/2019,5,SP 358R fra Cadelbosco di Sopra e Castelnovo di Sotto,16432,00,15509,923,12511,3921,16432,0
2019/02,310,16/02/2019,6,SP 358R fra Cadelbosco di Sopra e Castelnovo di Sotto,13325,00,13110,215,9491,3834,0,13325
2019/02,310,17/02/2019,7,SP 358R fra Cadelbosco di Sopra e Castelnovo di Sotto,12226,00,12165,61,9176,3050,0,12226
2019/02,310,18/02/2019,1,SP 358R fra Cadelbosco di Sopra e Castelnovo di Sotto,15489,00,14571,918,12360,3129,15489,0
2019/02,310,19/02/2019,2,SP 358R fra Cadelbosco di Sopra e Castelnovo di Sotto,16051,00,15207,844,12626,3425,16051,0
2019/02,310,20/02/2019,3,SP 358R fra Cadelbosco di Sopra e Castelnovo di Sotto,15997,00,15093,904,12532,3465,15997,0
2019/02,310,21/02/2019,4,SP 358R fra Cadelbosco di Sopra e Castelnovo di Sotto,16157,10,15267,889,12578,3579,16157,0
2019/02,310,22/02/2019,5,SP 358R fra Cadelbosco di Sopra e Castelnovo di Sotto,16528,20,15626,900,12623,3905,16528,0
2019/02,310,23/02/2019,6,SP 358R fra Cadelbosco di Sopra e Castelnovo di Sotto,13447,00,13210,237,9573,3874,0,13447
2019/02,310,24/02/2019,7,SP 358R fra Cadelbosco di Sopra e Castelnovo di Sotto,12322,00,12245,77,9125,3197,0,12322
2019/02,310,25/02/2019,1,SP 358R fra Cadelbosco di Sopra e Castelnovo di Sotto,15817,10,14926,890,12624,3193,15817,0
2019/02,310,26/02/2019,2,SP 358R fra Cadelbosco di Sopra e Castelnovo di Sotto,15783,00,14914,869,12474,3309,15783,0
2019/02,310,27/02/2019,3,SP 358R fra Cadelbosco di Sopra e Castelnovo di Sotto,16209,00,15280,929,12653,3556,16209,0
2019/02,310,28/02/2019,4,SP 358R fra Cadelbosco di Sopra e Castelnovo di Sotto,16497,10,15622,874,12896,3601,16497,0
2019/02,311,15/02/2019,5,SP 62RVar tra la località San Giacomo (bivio SP 42) ed SP 2 (c/o Tagliata),12110,10,9581,2528,9424,2686,12110,0
2019/02,311,16/02/2019,6,SP 62RVar tra la località San Giacomo (bivio SP 42) ed SP 2 (c/o Tagliata),8894,00,8433,461,6495,2399,0,8894
2019/02,311,17/02/2019,7,SP 62RVar tra la località San Giacomo (bivio SP 42) ed SP 2 (c/o Tagliata),9157,10,9042,114,6488,2669,0,9157
2019/02,311,18/02/2019,1,SP 62RVar tra la località San Giacomo (bivio SP 42) ed SP 2 (c/o Tagliata),11375,00,8676,2699,9233,2142,11375,0
2019/02,311,19/02/2019,2,SP 62RVar tra la località San Giacomo (bivio SP 42) ed SP 2 (c/o Tagliata),11245,00,8482,2763,9002,2243,11245,0
2019/02,311,20/02/2019,3,SP 62RVar tra la località San Giacomo (bivio SP 42) ed SP 2 (c/o Tagliata),11502,00,8669,2833,9139,2363,11502,0
2019/02,311,21/02/2019,4,SP 62RVar tra la località San Giacomo (bivio SP 42) ed SP 2 (c/o Tagliata),11525,00,8849,2676,9289,2236,11525,0
2019/02,311,22/02/2019,5,SP 62RVar tra la località San Giacomo (bivio SP 42) ed SP 2 (c/o Tagliata),11819,10,9241,2577,9324,2495,11819,0
2019/02,311,23/02/2019,6,SP 62RVar tra la località San Giacomo (bivio SP 42) ed SP 2 (c/o Tagliata),8590,00,8154,436,6242,2348,0,8590
2019/02,311,24/02/2019,7,SP 62RVar tra la località San Giacomo (bivio SP 42) ed SP 2 (c/o Tagliata),8536,00,8423,113,6016,2520,0,8536
2019/02,311,25/02/2019,1,SP 62RVar tra la località San Giacomo (bivio SP 42) ed SP 2 (c/o Tagliata),11104,10,8523,2580,8936,2168,11104,0
2019/02,311,26/02/2019,2,SP 62RVar tra la località San Giacomo (bivio SP 42) ed SP 2 (c/o Tagliata),11310,00,8592,2718,9154,2156,11310,0
2019/02,311,27/02/2019,3,SP 62RVar tra la località San Giacomo (bivio SP 42) ed SP 2 (c/o Tagliata),11526,10,8847,2678,9212,2314,11526,0
2019/02,311,28/02/2019,4,SP 62RVar tra la località San Giacomo (bivio SP 42) ed SP 2 (c/o Tagliata),11724,00,9041,2683,9381,2343,11724,0
2019/02,312,15/02/2019,5,SP 42 fra Novellara e San Giacomo (SP 62R),14253,00,12942,1311,11049,3204,14253,0
2019/02,312,16/02/2019,6,SP 42 fra Novellara e San Giacomo (SP 62R),11876,00,11607,269,8416,3460,0,11876
2019/02,312,17/02/2019,7,SP 42 fra Novellara e San Giacomo (SP 62R),9879,00,9795,84,7068,2811,0,9879
2019/02,312,18/02/2019,1,SP 42 fra Novellara e San Giacomo (SP 62R),13516,00,12141,1375,10846,2670,13516,0
2019/02,312,19/02/2019,2,SP 42 fra Novellara e San Giacomo (SP 62R),13768,00,12429,1339,11111,2657,13768,0
2019/02,312,20/02/2019,3,SP 42 fra Novellara e San Giacomo (SP 62R),14415,00,12933,1482,11460,2955,14415,0
2019/02,312,21/02/2019,4,SP 42 fra Novellara e San Giacomo (SP 62R),14489,10,13062,1426,11641,2848,14489,0
2019/02,312,22/02/2019,5,SP 42 fra Novellara e San Giacomo (SP 62R),,,,,,,,
2019/02,312,23/02/2019,6,SP 42 fra Novellara e San Giacomo (SP 62R),11472,760,11166,230,8056,3416,0,11472
2019/02,312,24/02/2019,7,SP 42 fra Novellara e San Giacomo (SP 62R),,,,,,,,
2019/02,312,25/02/2019,1,SP 42 fra Novellara e San Giacomo (SP 62R),,,,,,,,
2019/02,312,26/02/2019,2,SP 42 fra Novellara e San Giacomo (SP 62R),14293,00,12918,1375,11455,2838,14293,0
2019/02,312,27/02/2019,3,SP 42 fra Novellara e San Giacomo (SP 62R),14430,00,12979,1451,11458,2972,14430,0
2019/02,312,28/02/2019,4,SP 42 fra Novellara e San Giacomo (SP 62R),,,,,,,,
2019/02,314,15/02/2019,5,SP 2 fra Reggiolo (bivio SP 2) e località Villarotta (SP 84),9510,00,9062,448,7372,2138,9510,0
2019/02,314,16/02/2019,6,SP 2 fra Reggiolo (bivio SP 2) e località Villarotta (SP 84),7790,00,7642,148,5546,2244,0,7790
2019/02,314,17/02/2019,7,SP 2 fra Reggiolo (bivio SP 2) e località Villarotta (SP 84),6343,00,6307,36,4409,1934,0,6343
2019/02,314,18/02/2019,1,SP 2 fra Reggiolo (bivio SP 2) e località Villarotta (SP 84),8698,00,8296,402,6997,1701,8698,0
2019/02,314,19/02/2019,2,SP 2 fra Reggiolo (bivio SP 2) e località Villarotta (SP 84),8616,00,8213,403,6818,1798,8616,0
2019/02,314,20/02/2019,3,SP 2 fra Reggiolo (bivio SP 2) e località Villarotta (SP 84),8849,00,8436,413,7036,1813,8849,0
2019/02,314,21/02/2019,4,SP 2 fra Reggiolo (bivio SP 2) e località Villarotta (SP 84),8850,00,8435,415,7072,1778,8850,0
2019/02,314,22/02/2019,5,SP 2 fra Reggiolo (bivio SP 2) e località Villarotta (SP 84),9248,00,8852,396,7126,2122,9248,0
2019/02,314,23/02/2019,6,SP 2 fra Reggiolo (bivio SP 2) e località Villarotta (SP 84),7557,00,7411,146,5272,2285,0,7557
2019/02,314,24/02/2019,7,SP 2 fra Reggiolo (bivio SP 2) e località Villarotta (SP 84),5652,00,5611,41,3893,1759,0,5652
2019/02,314,25/02/2019,1,SP 2 fra Reggiolo (bivio SP 2) e località Villarotta (SP 84),8565,10,8205,359,6771,1794,8565,0
2019/02,314,26/02/2019,2,SP 2 fra Reggiolo (bivio SP 2) e località Villarotta (SP 84),8762,00,8356,406,6976,1786,8762,0
2019/02,314,27/02/2019,3,SP 2 fra Reggiolo (bivio SP 2) e località Villarotta (SP 84),8960,00,8553,407,7076,1884,8960,0
2019/02,314,28/02/2019,4,SP 2 fra Reggiolo (bivio SP 2) e località Villarotta (SP 84),8762,10,8344,417,6888,1874,8762,0
2019/02,318,15/02/2019,5,SP 51 fra Sassuolo (bivio SP 467R) e Rubiera,11728,00,9216,2512,9074,2654,11728,0
2019/02,318,16/02/2019,6,SP 51 fra Sassuolo (bivio SP 467R) e Rubiera,8285,10,8059,225,5722,2563,0,8285
2019/02,318,17/02/2019,7,SP 51 fra Sassuolo (bivio SP 467R) e Rubiera,7352,10,7287,64,5295,2057,0,7352
2019/02,318,18/02/2019,1,SP 51 fra Sassuolo (bivio SP 467R) e Rubiera,10845,20,8540,2303,8854,1991,10845,0
2019/02,318,19/02/2019,2,SP 51 fra Sassuolo (bivio SP 467R) e Rubiera,11226,00,8589,2637,9100,2126,11226,0
2019/02,318,20/02/2019,3,SP 51 fra Sassuolo (bivio SP 467R) e Rubiera,11452,00,8585,2867,9249,2203,11452,0
2019/02,318,21/02/2019,4,SP 51 fra Sassuolo (bivio SP 467R) e Rubiera,11439,10,8573,2865,9242,2197,11439,0
2019/02,318,22/02/2019,5,SP 51 fra Sassuolo (bivio SP 467R) e Rubiera,11682,30,9061,2618,9174,2508,11682,0
2019/02,318,23/02/2019,6,SP 51 fra Sassuolo (bivio SP 467R) e Rubiera,8210,00,7973,237,5700,2510,0,8210
2019/02,318,24/02/2019,7,SP 51 fra Sassuolo (bivio SP 467R) e Rubiera,7373,00,7310,63,5340,2033,0,7373
2019/02,318,25/02/2019,1,SP 51 fra Sassuolo (bivio SP 467R) e Rubiera,10749,50,8365,2379,8733,2016,10749,0
2019/02,318,26/02/2019,2,SP 51 fra Sassuolo (bivio SP 467R) e Rubiera,11396,00,8431,2965,9305,2091,11396,0
2019/02,318,27/02/2019,3,SP 51 fra Sassuolo (bivio SP 467R) e Rubiera,11582,10,8675,2906,9279,2303,11582,0
2019/02,318,28/02/2019,4,SP 51 fra Sassuolo (bivio SP 467R) e Rubiera,11775,10,8634,3140,9442,2333,11775,0
2019/02,319,15/02/2019,5,SP 15 tra Sassuolo e Magreta,,,,,,,,
2019/02,319,16/02/2019,6,SP 15 tra Sassuolo e Magreta,,,,,,,,
2019/02,319,17/02/2019,7,SP 15 tra Sassuolo e Magreta,,,,,,,,
2019/02,319,18/02/2019,1,SP 15 tra Sassuolo e Magreta,,,,,,,,
2019/02,319,19/02/2019,2,SP 15 tra Sassuolo e Magreta,,,,,,,,
2019/02,319,20/02/2019,3,SP 15 tra Sassuolo e Magreta,,,,,,,,
2019/02,319,21/02/2019,4,SP 15 tra Sassuolo e Magreta,,,,,,,,
2019/02,319,22/02/2019,5,SP 15 tra Sassuolo e Magreta,,,,,,,,
2019/02,319,23/02/2019,6,SP 15 tra Sassuolo e Magreta,,,,,,,,
2019/02,319,24/02/2019,7,SP 15 tra Sassuolo e Magreta,,,,,,,,
2019/02,319,25/02/2019,1,SP 15 tra Sassuolo e Magreta,,,,,,,,
2019/02,319,26/02/2019,2,SP 15 tra Sassuolo e Magreta,,,,,,,,
2019/02,319,27/02/2019,3,SP 15 tra Sassuolo e Magreta,,,,,,,,
2019/02,319,28/02/2019,4,SP 15 tra Sassuolo e Magreta,,,,,,,,
2019/02,321,15/02/2019,5,SP 467 tra SP 486 e confine provinciale,,,,,,,,
2019/02,321,16/02/2019,6,SP 467 tra SP 486 e confine provinciale,,,,,,,,
2019/02,321,17/02/2019,7,SP 467 tra SP 486 e confine provinciale,,,,,,,,
2019/02,321,18/02/2019,1,SP 467 tra SP 486 e confine provinciale,,,,,,,,
2019/02,321,19/02/2019,2,SP 467 tra SP 486 e confine provinciale,,,,,,,,
2019/02,321,20/02/2019,3,SP 467 tra SP 486 e confine provinciale,,,,,,,,
2019/02,321,21/02/2019,4,SP 467 tra SP 486 e confine provinciale,,,,,,,,
2019/02,321,22/02/2019,5,SP 467 tra SP 486 e confine provinciale,,,,,,,,
2019/02,321,23/02/2019,6,SP 467 tra SP 486 e confine provinciale,,,,,,,,
2019/02,321,24/02/2019,7,SP 467 tra SP 486 e confine provinciale,,,,,,,,
2019/02,321,25/02/2019,1,SP 467 tra SP 486 e confine provinciale,,,,,,,,
2019/02,321,26/02/2019,2,SP 467 tra SP 486 e confine provinciale,,,,,,,,
2019/02,321,27/02/2019,3,SP 467 tra SP 486 e confine provinciale,,,,,,,,
2019/02,321,28/02/2019,4,SP 467 tra SP 486 e confine provinciale,,,,,,,,
2019/02,323,15/02/2019,5,SP 467 fra SP 3 e SS 12,27937,10,24263,3673,21684,6253,27937,0
2019/02,323,16/02/2019,6,SP 467 fra SP 3 e SS 12,18640,10,17991,648,13540,5100,0,18640
2019/02,323,17/02/2019,7,SP 467 fra SP 3 e SS 12,14710,00,14612,98,10837,3873,0,14710
2019/02,323,18/02/2019,1,SP 467 fra SP 3 e SS 12,26418,20,22811,3605,21064,5354,26418,0
2019/02,323,19/02/2019,2,SP 467 fra SP 3 e SS 12,26423,00,22723,3700,20804,5619,26423,0
2019/02,323,20/02/2019,3,SP 467 fra SP 3 e SS 12,26775,00,23016,3759,21291,5484,26775,0
2019/02,323,21/02/2019,4,SP 467 fra SP 3 e SS 12,27191,00,23387,3804,21283,5908,27191,0
2019/02,323,22/02/2019,5,SP 467 fra SP 3 e SS 12,27689,10,23977,3711,21263,6426,27689,0
2019/02,323,23/02/2019,6,SP 467 fra SP 3 e SS 12,18495,00,17855,640,13213,5282,0,18495
2019/02,323,24/02/2019,7,SP 467 fra SP 3 e SS 12,14384,00,14274,110,10605,3779,0,14384
2019/02,323,25/02/2019,1,SP 467 fra SP 3 e SS 12,26380,20,22860,3518,20841,5539,26380,0
2019/02,323,26/02/2019,2,SP 467 fra SP 3 e SS 12,26536,00,22687,3849,20884,5652,26536,0
2019/02,323,27/02/2019,3,SP 467 fra SP 3 e SS 12,26945,00,23097,3848,21054,5891,26945,0
2019/02,323,28/02/2019,4,SP 467 fra SP 3 e SS 12,26888,20,23189,3697,20948,5940,26888,0
2019/02,328,15/02/2019,5,SP 486 tra Modena e Baggiovara,25514,30,24909,602,19394,6120,25514,0
2019/02,328,16/02/2019,6,SP 486 tra Modena e Baggiovara,22610,00,22338,272,16009,6601,0,22610
2019/02,328,17/02/2019,7,SP 486 tra Modena e Baggiovara,16535,10,16418,116,11478,5057,0,16535
2019/02,328,18/02/2019,1,SP 486 tra Modena e Baggiovara,24396,40,23839,553,19266,5130,24396,0
2019/02,328,19/02/2019,2,SP 486 tra Modena e Baggiovara,24499,10,23905,593,19182,5317,24499,0
2019/02,328,20/02/2019,3,SP 486 tra Modena e Baggiovara,25200,50,24598,597,19503,5697,25200,0
2019/02,328,21/02/2019,4,SP 486 tra Modena e Baggiovara,25249,40,24618,627,19409,5840,25249,0
2019/02,328,22/02/2019,5,SP 486 tra Modena e Baggiovara,25549,20,24907,640,19414,6135,25549,0
2019/02,328,23/02/2019,6,SP 486 tra Modena e Baggiovara,22672,00,22408,264,16249,6423,0,22672
2019/02,328,24/02/2019,7,SP 486 tra Modena e Baggiovara,16252,00,16159,93,11243,5009,0,16252
2019/02,328,25/02/2019,1,SP 486 tra Modena e Baggiovara,24414,20,23876,536,19079,5335,24414,0
2019/02,328,26/02/2019,2,SP 486 tra Modena e Baggiovara,24657,20,24054,601,19172,5485,24657,0
2019/02,328,27/02/2019,3,SP 486 tra Modena e Baggiovara,24616,40,23997,615,19034,5582,24616,0
2019/02,328,28/02/2019,4,SP 486 tra Modena e Baggiovara,24971,00,24388,583,19180,5791,24971,0
2019/02,330,28/02/2019,4,SS 64 tra Sasso Marconi e Marzabotto,8180,00,7820,360,6317,1863,8180,0
2019/02,332,15/02/2019,5,SP 306R fra Castel Bolognese e Riolo Terme,8826,10,8313,512,6729,2097,8826,0
2019/02,332,16/02/2019,6,SP 306R fra Castel Bolognese e Riolo Terme,7650,00,7472,178,5739,1911,0,7650
2019/02,332,17/02/2019,7,SP 306R fra Castel Bolognese e Riolo Terme,6952,00,6920,32,5333,1619,0,6952
2019/02,332,18/02/2019,1,SP 306R fra Castel Bolognese e Riolo Terme,8325,00,7780,545,6658,1667,8325,0
2019/02,332,19/02/2019,2,SP 306R fra Castel Bolognese e Riolo Terme,8270,20,7785,483,6488,1782,8270,0
2019/02,332,20/02/2019,3,SP 306R fra Castel Bolognese e Riolo Terme,8460,10,7965,494,6749,1711,8460,0
2019/02,332,21/02/2019,4,SP 306R fra Castel Bolognese e Riolo Terme,8795,20,8258,535,6847,1948,8795,0
2019/02,332,22/02/2019,5,SP 306R fra Castel Bolognese e Riolo Terme,8838,00,8347,491,6752,2086,8838,0
2019/02,332,23/02/2019,6,SP 306R fra Castel Bolognese e Riolo Terme,7771,00,7598,173,5672,2099,0,7771
2019/02,332,24/02/2019,7,SP 306R fra Castel Bolognese e Riolo Terme,6449,10,6422,26,4884,1565,0,6449
2019/02,332,25/02/2019,1,SP 306R fra Castel Bolognese e Riolo Terme,8329,00,7823,506,6588,1741,8329,0
2019/02,332,26/02/2019,2,SP 306R fra Castel Bolognese e Riolo Terme,8450,20,7937,511,6564,1886,8450,0
2019/02,332,27/02/2019,3,SP 306R fra Castel Bolognese e Riolo Terme,8506,00,8043,463,6626,1880,8506,0
2019/02,332,28/02/2019,4,SP 306R fra Castel Bolognese e Riolo Terme,8683,10,8232,450,6662,2021,8683,0
2019/02,333,15/02/2019,5,SS 9 tra Castel Bolognese e Faenza,23747,00,22879,868,17252,6495,23747,0
2019/02,333,16/02/2019,6,SS 9 tra Castel Bolognese e Faenza,21588,00,21320,268,14406,7182,0,21588
2019/02,333,17/02/2019,7,SS 9 tra Castel Bolognese e Faenza,18027,00,17938,89,12469,5558,0,18027
2019/02,333,18/02/2019,1,SS 9 tra Castel Bolognese e Faenza,22418,10,21546,871,17282,5136,22418,0
2019/02,333,19/02/2019,2,SS 9 tra Castel Bolognese e Faenza,22618,00,21785,833,17239,5379,22618,0
2019/02,333,20/02/2019,3,SS 9 tra Castel Bolognese e Faenza,22656,00,21776,880,17361,5295,22656,0
2019/02,333,21/02/2019,4,SS 9 tra Castel Bolognese e Faenza,22712,00,21878,834,17250,5462,22712,0
2019/02,333,22/02/2019,5,SS 9 tra Castel Bolognese e Faenza,23983,00,23123,860,17487,6496,23983,0
2019/02,333,23/02/2019,6,SS 9 tra Castel Bolognese e Faenza,21427,00,21140,287,14391,7036,0,21427
2019/02,333,24/02/2019,7,SS 9 tra Castel Bolognese e Faenza,16875,00,16811,64,11630,5245,0,16875
2019/02,333,25/02/2019,1,SS 9 tra Castel Bolognese e Faenza,22122,00,21320,802,16963,5159,22122,0
2019/02,333,26/02/2019,2,SS 9 tra Castel Bolognese e Faenza,23147,30,22143,1001,17442,5705,23147,0
2019/02,333,27/02/2019,3,SS 9 tra Castel Bolognese e Faenza,23092,00,22238,854,17342,5750,23092,0
2019/02,333,28/02/2019,4,SS 9 tra Castel Bolognese e Faenza,22895,00,22066,829,17193,5702,22895,0
2019/02,334,15/02/2019,5,SP 8 dal Casello A 1 (Faenza) a Cotignola,14702,00,13827,875,10994,3708,14702,0
2019/02,334,16/02/2019,6,SP 8 dal Casello A 1 (Faenza) a Cotignola,13233,00,13045,188,9269,3964,0,13233
2019/02,334,17/02/2019,7,SP 8 dal Casello A 1 (Faenza) a Cotignola,12577,00,12541,36,9451,3126,0,12577
2019/02,334,18/02/2019,1,SP 8 dal Casello A 1 (Faenza) a Cotignola,13859,00,12831,1028,11035,2824,13859,0
2019/02,334,19/02/2019,2,SP 8 dal Casello A 1 (Faenza) a Cotignola,14219,00,13154,1065,11150,3069,14219,0
2019/02,334,20/02/2019,3,SP 8 dal Casello A 1 (Faenza) a Cotignola,14458,00,13481,977,11464,2994,14458,0
2019/02,334,21/02/2019,4,SP 8 dal Casello A 1 (Faenza) a Cotignola,14538,00,13490,1048,11336,3202,14538,0
2019/02,334,22/02/2019,5,SP 8 dal Casello A 1 (Faenza) a Cotignola,14741,00,13883,858,11071,3670,14741,0
2019/02,334,23/02/2019,6,SP 8 dal Casello A 1 (Faenza) a Cotignola,13313,00,13031,282,9290,4023,0,13313
2019/02,334,24/02/2019,7,SP 8 dal Casello A 1 (Faenza) a Cotignola,12082,00,12043,39,8908,3174,0,12082
2019/02,334,25/02/2019,1,SP 8 dal Casello A 1 (Faenza) a Cotignola,13568,00,12560,1008,10653,2915,13568,0
2019/02,334,26/02/2019,2,SP 8 dal Casello A 1 (Faenza) a Cotignola,14586,00,13607,979,11682,2904,14586,0
2019/02,334,27/02/2019,3,SP 8 dal Casello A 1 (Faenza) a Cotignola,14754,00,13786,968,11249,3505,14754,0
2019/02,334,28/02/2019,4,SP 8 dal Casello A 1 (Faenza) a Cotignola,14296,00,13357,939,10984,3312,14296,0
2019/02,335,15/02/2019,5,SP 7 tra l'A 14 (bivio SP 29) e l'A 14dir (Barbiano),7871,00,7297,574,6232,1639,7871,0
2019/02,335,16/02/2019,6,SP 7 tra l'A 14 (bivio SP 29) e l'A 14dir (Barbiano),5949,00,5840,109,4187,1762,0,5949
2019/02,335,17/02/2019,7,SP 7 tra l'A 14 (bivio SP 29) e l'A 14dir (Barbiano),5326,00,5306,20,3863,1463,0,5326
2019/02,335,18/02/2019,1,SP 7 tra l'A 14 (bivio SP 29) e l'A 14dir (Barbiano),7499,00,6921,578,6066,1433,7499,0
2019/02,335,19/02/2019,2,SP 7 tra l'A 14 (bivio SP 29) e l'A 14dir (Barbiano),7563,10,7026,536,6089,1474,7563,0
2019/02,335,20/02/2019,3,SP 7 tra l'A 14 (bivio SP 29) e l'A 14dir (Barbiano),7853,00,7292,561,6366,1487,7853,0
2019/02,335,21/02/2019,4,SP 7 tra l'A 14 (bivio SP 29) e l'A 14dir (Barbiano),7840,00,7264,576,6164,1676,7840,0
2019/02,335,22/02/2019,5,SP 7 tra l'A 14 (bivio SP 29) e l'A 14dir (Barbiano),7894,00,7375,519,6205,1689,7894,0
2019/02,335,23/02/2019,6,SP 7 tra l'A 14 (bivio SP 29) e l'A 14dir (Barbiano),6389,00,6262,127,4451,1938,0,6389
2019/02,335,24/02/2019,7,SP 7 tra l'A 14 (bivio SP 29) e l'A 14dir (Barbiano),5099,00,5071,28,3583,1516,0,5099
2019/02,335,25/02/2019,1,SP 7 tra l'A 14 (bivio SP 29) e l'A 14dir (Barbiano),7450,00,6863,587,5996,1454,7450,0
2019/02,335,26/02/2019,2,SP 7 tra l'A 14 (bivio SP 29) e l'A 14dir (Barbiano),7712,00,7145,567,6210,1502,7712,0
2019/02,335,27/02/2019,3,SP 7 tra l'A 14 (bivio SP 29) e l'A 14dir (Barbiano),7871,10,7287,583,6328,1543,7871,0
2019/02,335,28/02/2019,4,SP 7 tra l'A 14 (bivio SP 29) e l'A 14dir (Barbiano),7926,00,7319,607,6178,1748,7926,0
2019/02,336,15/02/2019,5,SP 253R tra Lugo (ponte fiume Senio) e Bagnacavallo,11757,10,11070,686,9259,2498,11757,0
2019/02,336,16/02/2019,6,SP 253R tra Lugo (ponte fiume Senio) e Bagnacavallo,9818,00,9658,160,7397,2421,0,9818
2019/02,336,17/02/2019,7,SP 253R tra Lugo (ponte fiume Senio) e Bagnacavallo,7308,00,7269,39,5401,1907,0,7308
2019/02,336,18/02/2019,1,SP 253R tra Lugo (ponte fiume Senio) e Bagnacavallo,11577,20,10900,675,9378,2199,11577,0
2019/02,336,19/02/2019,2,SP 253R tra Lugo (ponte fiume Senio) e Bagnacavallo,11542,10,10806,735,9305,2237,11542,0
2019/02,336,20/02/2019,3,SP 253R tra Lugo (ponte fiume Senio) e Bagnacavallo,11772,00,11062,710,9478,2294,11772,0
2019/02,336,21/02/2019,4,SP 253R tra Lugo (ponte fiume Senio) e Bagnacavallo,11388,10,10643,744,9142,2246,11388,0
2019/02,336,22/02/2019,5,SP 253R tra Lugo (ponte fiume Senio) e Bagnacavallo,11768,10,11127,640,9233,2535,11768,0
2019/02,336,23/02/2019,6,SP 253R tra Lugo (ponte fiume Senio) e Bagnacavallo,9951,10,9783,167,7398,2553,0,9951
2019/02,336,24/02/2019,7,SP 253R tra Lugo (ponte fiume Senio) e Bagnacavallo,6775,00,6740,35,4964,1811,0,6775
2019/02,336,25/02/2019,1,SP 253R tra Lugo (ponte fiume Senio) e Bagnacavallo,10931,10,10300,630,8779,2152,10931,0
2019/02,336,26/02/2019,2,SP 253R tra Lugo (ponte fiume Senio) e Bagnacavallo,11345,00,10658,687,8995,2350,11345,0
2019/02,336,27/02/2019,3,SP 253R tra Lugo (ponte fiume Senio) e Bagnacavallo,11172,00,10537,635,8832,2340,11172,0
2019/02,336,28/02/2019,4,SP 253R tra Lugo (ponte fiume Senio) e Bagnacavallo,11282,00,10605,677,8929,2353,11282,0
2019/02,337,15/02/2019,5,SP 14 fra Lugo (bivio SSPP 41/46) e Fusignano,12282,20,11721,559,9632,2650,12282,0
2019/02,337,16/02/2019,6,SP 14 fra Lugo (bivio SSPP 41/46) e Fusignano,10138,10,9951,186,7649,2489,0,10138
2019/02,337,17/02/2019,7,SP 14 fra Lugo (bivio SSPP 41/46) e Fusignano,6857,00,6831,26,4961,1896,0,6857
2019/02,337,18/02/2019,1,SP 14 fra Lugo (bivio SSPP 41/46) e Fusignano,12782,00,12134,648,10448,2334,12782,0
2019/02,337,19/02/2019,2,SP 14 fra Lugo (bivio SSPP 41/46) e Fusignano,13093,00,12424,669,10747,2346,13093,0
2019/02,337,20/02/2019,3,SP 14 fra Lugo (bivio SSPP 41/46) e Fusignano,13047,00,12406,641,10645,2402,13047,0
2019/02,337,21/02/2019,4,SP 14 fra Lugo (bivio SSPP 41/46) e Fusignano,12552,10,11952,599,10226,2326,12552,0
2019/02,337,22/02/2019,5,SP 14 fra Lugo (bivio SSPP 41/46) e Fusignano,12500,10,11903,596,9823,2677,12500,0
2019/02,337,23/02/2019,6,SP 14 fra Lugo (bivio SSPP 41/46) e Fusignano,10110,20,9925,183,7543,2567,0,10110
2019/02,337,24/02/2019,7,SP 14 fra Lugo (bivio SSPP 41/46) e Fusignano,7028,00,6997,31,5160,1868,0,7028
2019/02,337,25/02/2019,1,SP 14 fra Lugo (bivio SSPP 41/46) e Fusignano,12141,10,11507,633,9892,2249,12141,0
2019/02,337,26/02/2019,2,SP 14 fra Lugo (bivio SSPP 41/46) e Fusignano,12187,10,11568,618,9793,2394,12187,0
2019/02,337,27/02/2019,3,SP 14 fra Lugo (bivio SSPP 41/46) e Fusignano,12271,10,11683,587,9853,2418,12271,0
2019/02,337,28/02/2019,4,SP 14 fra Lugo (bivio SSPP 41/46) e Fusignano,11975,00,11410,565,9558,2417,11975,0
2019/02,339,15/02/2019,5,SP 3 tra San Lorenzo in Noceto e Predappio,8183,00,7800,383,6297,1886,8183,0
2019/02,339,16/02/2019,6,SP 3 tra San Lorenzo in Noceto e Predappio,7465,10,7338,126,5393,2072,0,7465
2019/02,339,17/02/2019,7,SP 3 tra San Lorenzo in Noceto e Predappio,6331,10,6309,21,4780,1551,0,6331
2019/02,339,18/02/2019,1,SP 3 tra San Lorenzo in Noceto e Predappio,7530,00,7148,382,6150,1380,7530,0
2019/02,339,19/02/2019,2,SP 3 tra San Lorenzo in Noceto e Predappio,7632,00,7264,368,6120,1512,7632,0
2019/02,339,20/02/2019,3,SP 3 tra San Lorenzo in Noceto e Predappio,7842,00,7476,366,6293,1549,7842,0
2019/02,339,21/02/2019,4,SP 3 tra San Lorenzo in Noceto e Predappio,7711,00,7339,372,6095,1616,7711,0
2019/02,339,22/02/2019,5,SP 3 tra San Lorenzo in Noceto e Predappio,8055,00,7678,377,6342,1713,8055,0
2019/02,339,23/02/2019,6,SP 3 tra San Lorenzo in Noceto e Predappio,6945,00,6846,99,5218,1727,0,6945
2019/02,339,24/02/2019,7,SP 3 tra San Lorenzo in Noceto e Predappio,5773,00,5755,18,4418,1355,0,5773
2019/02,339,25/02/2019,1,SP 3 tra San Lorenzo in Noceto e Predappio,7362,00,7001,361,5952,1410,7362,0
2019/02,339,26/02/2019,2,SP 3 tra San Lorenzo in Noceto e Predappio,7456,00,7125,331,5965,1491,7456,0
2019/02,339,27/02/2019,3,SP 3 tra San Lorenzo in Noceto e Predappio,7789,00,7436,353,6175,1614,7789,0
2019/02,339,28/02/2019,4,SP 3 tra San Lorenzo in Noceto e Predappio,7848,00,7486,362,6198,1650,7848,0
2019/02,340,15/02/2019,5,SP 72 tra San Martino in Strada e bivio ex SS 310R (Meldola),10412,00,9917,495,8001,2411,10412,0
2019/02,340,16/02/2019,6,SP 72 tra San Martino in Strada e bivio ex SS 310R (Meldola),8436,00,8257,179,6172,2264,0,8436
2019/02,340,17/02/2019,7,SP 72 tra San Martino in Strada e bivio ex SS 310R (Meldola),7334,00,7306,28,5435,1899,0,7334
2019/02,340,18/02/2019,1,SP 72 tra San Martino in Strada e bivio ex SS 310R (Meldola),9974,00,9518,456,8032,1942,9974,0
2019/02,340,19/02/2019,2,SP 72 tra San Martino in Strada e bivio ex SS 310R (Meldola),10169,00,9774,395,8179,1990,10169,0
2019/02,340,20/02/2019,3,SP 72 tra San Martino in Strada e bivio ex SS 310R (Meldola),10114,00,9721,393,8039,2075,10114,0
2019/02,340,21/02/2019,4,SP 72 tra San Martino in Strada e bivio ex SS 310R (Meldola),10075,00,9614,461,7966,2109,10075,0
2019/02,340,22/02/2019,5,SP 72 tra San Martino in Strada e bivio ex SS 310R (Meldola),10771,00,10292,479,8395,2376,10771,0
2019/02,340,23/02/2019,6,SP 72 tra San Martino in Strada e bivio ex SS 310R (Meldola),8262,00,8133,129,6132,2130,0,8262
2019/02,340,24/02/2019,7,SP 72 tra San Martino in Strada e bivio ex SS 310R (Meldola),6957,00,6935,22,5073,1884,0,6957
2019/02,340,25/02/2019,1,SP 72 tra San Martino in Strada e bivio ex SS 310R (Meldola),9837,10,9455,381,7894,1943,9837,0
2019/02,340,26/02/2019,2,SP 72 tra San Martino in Strada e bivio ex SS 310R (Meldola),10120,00,9670,450,8078,2042,10120,0
2019/02,340,27/02/2019,3,SP 72 tra San Martino in Strada e bivio ex SS 310R (Meldola),10414,10,9978,435,8148,2266,10414,0
2019/02,340,28/02/2019,4,SP 72 tra San Martino in Strada e bivio ex SS 310R (Meldola),10562,00,10150,412,8315,2247,10562,0
2019/02,342,15/02/2019,5,SP 33 in località Gatteo,18887,00,17262,1625,14709,4178,18887,0
2019/02,342,16/02/2019,6,SP 33 in località Gatteo,15361,00,14910,451,11387,3974,0,15361
2019/02,342,17/02/2019,7,SP 33 in località Gatteo,12646,00,12552,94,9354,3292,0,12646
2019/02,342,18/02/2019,1,SP 33 in località Gatteo,17324,30,15656,1665,14156,3168,17324,0
2019/02,342,19/02/2019,2,SP 33 in località Gatteo,17704,10,16041,1662,14286,3418,17704,0
2019/02,342,20/02/2019,3,SP 33 in località Gatteo,17553,10,15995,1557,14098,3455,17553,0
2019/02,342,21/02/2019,4,SP 33 in località Gatteo,17829,00,16166,1663,14054,3775,17829,0
2019/02,342,22/02/2019,5,SP 33 in località Gatteo,18847,10,17106,1740,14686,4161,18847,0
2019/02,342,23/02/2019,6,SP 33 in località Gatteo,15115,00,14605,510,11054,4061,0,15115
2019/02,342,24/02/2019,7,SP 33 in località Gatteo,11853,00,11766,87,8704,3149,0,11853
2019/02,342,25/02/2019,1,SP 33 in località Gatteo,17652,10,16022,1629,14324,3328,17652,0
2019/02,342,26/02/2019,2,SP 33 in località Gatteo,18030,10,16268,1761,14637,3393,18030,0
2019/02,342,27/02/2019,3,SP 33 in località Gatteo,17785,00,16098,1687,14321,3464,17785,0
2019/02,342,28/02/2019,4,SP 33 in località Gatteo,18182,10,16533,1648,14255,3927,18182,0
2019/02,343,15/02/2019,5,SP 4 tra Galeata e Santa Sofia,5517,00,5151,366,4222,1295,5517,0
2019/02,343,16/02/2019,6,SP 4 tra Galeata e Santa Sofia,5452,00,5288,164,4049,1403,0,5452
2019/02,343,17/02/2019,7,SP 4 tra Galeata e Santa Sofia,5689,00,5647,42,4712,977,0,5689
2019/02,343,18/02/2019,1,SP 4 tra Galeata e Santa Sofia,5451,20,5090,359,4331,1120,5451,0
2019/02,343,19/02/2019,2,SP 4 tra Galeata e Santa Sofia,5493,00,5164,329,4305,1188,5493,0
2019/02,343,20/02/2019,3,SP 4 tra Galeata e Santa Sofia,5304,00,4986,318,4119,1185,5304,0
2019/02,343,21/02/2019,4,SP 4 tra Galeata e Santa Sofia,5420,10,5084,335,4202,1218,5420,0
2019/02,343,22/02/2019,5,SP 4 tra Galeata e Santa Sofia,5585,00,5270,315,4326,1259,5585,0
2019/02,343,23/02/2019,6,SP 4 tra Galeata e Santa Sofia,5292,00,5115,177,3938,1354,0,5292
2019/02,343,24/02/2019,7,SP 4 tra Galeata e Santa Sofia,4559,00,4524,35,3633,926,0,4559
2019/02,343,25/02/2019,1,SP 4 tra Galeata e Santa Sofia,5202,00,4903,299,4052,1150,5202,0
2019/02,343,26/02/2019,2,SP 4 tra Galeata e Santa Sofia,5558,00,5242,316,4359,1199,5558,0
2019/02,343,27/02/2019,3,SP 4 tra Galeata e Santa Sofia,5456,00,5170,286,4188,1268,5456,0
2019/02,343,28/02/2019,4,SP 4 tra Galeata e Santa Sofia,5840,00,5539,301,4491,1349,5840,0
2019/02,344,15/02/2019,5,SS 3Bis/E 45 tra Borello e Mercato Saraceno,15678,10,14501,1176,12077,3601,15678,0
2019/02,344,16/02/2019,6,SS 3Bis/E 45 tra Borello e Mercato Saraceno,13870,00,13532,338,10543,3327,0,13870
2019/02,344,17/02/2019,7,SS 3Bis/E 45 tra Borello e Mercato Saraceno,14986,00,14811,175,11685,3301,0,14986
2019/02,344,18/02/2019,1,SS 3Bis/E 45 tra Borello e Mercato Saraceno,14281,00,13296,985,11343,2938,14281,0
2019/02,344,19/02/2019,2,SS 3Bis/E 45 tra Borello e Mercato Saraceno,13941,10,12966,974,11126,2815,13941,0
2019/02,344,20/02/2019,3,SS 3Bis/E 45 tra Borello e Mercato Saraceno,14326,30,13249,1074,11462,2864,14326,0
2019/02,344,21/02/2019,4,SS 3Bis/E 45 tra Borello e Mercato Saraceno,14841,20,13742,1097,11728,3113,14841,0
2019/02,344,22/02/2019,5,SS 3Bis/E 45 tra Borello e Mercato Saraceno,16562,30,15391,1168,12812,3750,16562,0
2019/02,344,23/02/2019,6,SS 3Bis/E 45 tra Borello e Mercato Saraceno,14403,00,14054,349,10872,3531,0,14403
2019/02,344,24/02/2019,7,SS 3Bis/E 45 tra Borello e Mercato Saraceno,15131,00,14953,178,11550,3581,0,15131
2019/02,344,25/02/2019,1,SS 3Bis/E 45 tra Borello e Mercato Saraceno,15072,40,14037,1031,12047,3025,15072,0
2019/02,344,26/02/2019,2,SS 3Bis/E 45 tra Borello e Mercato Saraceno,14774,10,13762,1011,11778,2996,14774,0
2019/02,344,27/02/2019,3,SS 3Bis/E 45 tra Borello e Mercato Saraceno,15071,10,13939,1131,11867,3204,15071,0
2019/02,344,28/02/2019,4,SS 3Bis/E 45 tra Borello e Mercato Saraceno,15228,20,14161,1065,11836,3392,15228,0
2019/02,348,15/02/2019,5,SP 10 dal bivio con SP 89 (San Mauro Pascoli) c/o A 14  al bivio SS 16 (San Mauro Mare),,,,,,,,
2019/02,348,16/02/2019,6,SP 10 dal bivio con SP 89 (San Mauro Pascoli) c/o A 14  al bivio SS 16 (San Mauro Mare),,,,,,,,
2019/02,348,17/02/2019,7,SP 10 dal bivio con SP 89 (San Mauro Pascoli) c/o A 14  al bivio SS 16 (San Mauro Mare),,,,,,,,
2019/02,348,18/02/2019,1,SP 10 dal bivio con SP 89 (San Mauro Pascoli) c/o A 14  al bivio SS 16 (San Mauro Mare),,,,,,,,
2019/02,348,19/02/2019,2,SP 10 dal bivio con SP 89 (San Mauro Pascoli) c/o A 14  al bivio SS 16 (San Mauro Mare),,,,,,,,
2019/02,348,20/02/2019,3,SP 10 dal bivio con SP 89 (San Mauro Pascoli) c/o A 14  al bivio SS 16 (San Mauro Mare),,,,,,,,
2019/02,348,21/02/2019,4,SP 10 dal bivio con SP 89 (San Mauro Pascoli) c/o A 14  al bivio SS 16 (San Mauro Mare),,,,,,,,
2019/02,348,22/02/2019,5,SP 10 dal bivio con SP 89 (San Mauro Pascoli) c/o A 14  al bivio SS 16 (San Mauro Mare),,,,,,,,
2019/02,348,23/02/2019,6,SP 10 dal bivio con SP 89 (San Mauro Pascoli) c/o A 14  al bivio SS 16 (San Mauro Mare),,,,,,,,
2019/02,348,24/02/2019,7,SP 10 dal bivio con SP 89 (San Mauro Pascoli) c/o A 14  al bivio SS 16 (San Mauro Mare),,,,,,,,
2019/02,348,25/02/2019,1,SP 10 dal bivio con SP 89 (San Mauro Pascoli) c/o A 14  al bivio SS 16 (San Mauro Mare),,,,,,,,
2019/02,348,26/02/2019,2,SP 10 dal bivio con SP 89 (San Mauro Pascoli) c/o A 14  al bivio SS 16 (San Mauro Mare),,,,,,,,
2019/02,348,27/02/2019,3,SP 10 dal bivio con SP 89 (San Mauro Pascoli) c/o A 14  al bivio SS 16 (San Mauro Mare),,,,,,,,
2019/02,348,28/02/2019,4,SP 10 dal bivio con SP 89 (San Mauro Pascoli) c/o A 14  al bivio SS 16 (San Mauro Mare),,,,,,,,
2019/02,349,15/02/2019,5,SS 16 tra Cervia e Cesenatico,22472,10,20144,2327,16689,5783,22472,0
2019/02,349,16/02/2019,6,SS 16 tra Cervia e Cesenatico,22915,20,22296,617,15860,7055,0,22915
2019/02,349,17/02/2019,7,SS 16 tra Cervia e Cesenatico,24530,10,24354,175,18504,6026,0,24530
2019/02,349,18/02/2019,1,SS 16 tra Cervia e Cesenatico,20045,00,17573,2472,15942,4103,20045,0
2019/02,349,19/02/2019,2,SS 16 tra Cervia e Cesenatico,19952,20,17452,2498,15730,4222,19952,0
2019/02,349,20/02/2019,3,SS 16 tra Cervia e Cesenatico,20070,00,17509,2561,15863,4207,20070,0
2019/02,349,21/02/2019,4,SS 16 tra Cervia e Cesenatico,20000,30,17593,2404,15774,4226,20000,0
2019/02,349,22/02/2019,5,SS 16 tra Cervia e Cesenatico,21593,10,19188,2404,16345,5248,21593,0
2019/02,349,23/02/2019,6,SS 16 tra Cervia e Cesenatico,21483,00,20908,575,14948,6535,0,21483
2019/02,349,24/02/2019,7,SS 16 tra Cervia e Cesenatico,20569,10,20359,209,15301,5268,0,20569
2019/02,349,25/02/2019,1,SS 16 tra Cervia e Cesenatico,19669,10,17447,2221,15431,4238,19669,0
2019/02,349,26/02/2019,2,SS 16 tra Cervia e Cesenatico,20343,00,17759,2584,16017,4326,20343,0
2019/02,349,27/02/2019,3,SS 16 tra Cervia e Cesenatico,20679,30,18381,2295,16086,4593,20679,0
2019/02,349,28/02/2019,4,SS 16 tra Cervia e Cesenatico,20943,20,18556,2385,16344,4599,20943,0
2019/02,350,16/02/2019,6,SP 41 tra Rimini (viadotto A 14) e bivio SP 49 (località Ospedaletto),8868,00,8716,152,6582,2286,0,8868
2019/02,350,17/02/2019,7,SP 41 tra Rimini (viadotto A 14) e bivio SP 49 (località Ospedaletto),6948,00,6916,32,5104,1844,0,6948
2019/02,350,18/02/2019,1,SP 41 tra Rimini (viadotto A 14) e bivio SP 49 (località Ospedaletto),8997,20,8616,379,7299,1698,8997,0
2019/02,350,19/02/2019,2,SP 41 tra Rimini (viadotto A 14) e bivio SP 49 (località Ospedaletto),9334,00,8975,359,7428,1906,9334,0
2019/02,350,20/02/2019,3,SP 41 tra Rimini (viadotto A 14) e bivio SP 49 (località Ospedaletto),9175,00,8836,339,7247,1928,9175,0
2019/02,350,21/02/2019,4,SP 41 tra Rimini (viadotto A 14) e bivio SP 49 (località Ospedaletto),9276,10,8898,377,7286,1990,9276,0
2019/02,350,22/02/2019,5,SP 41 tra Rimini (viadotto A 14) e bivio SP 49 (località Ospedaletto),9630,10,9291,338,7410,2220,9630,0
2019/02,350,23/02/2019,6,SP 41 tra Rimini (viadotto A 14) e bivio SP 49 (località Ospedaletto),8726,00,8575,151,6532,2194,0,8726
2019/02,350,24/02/2019,7,SP 41 tra Rimini (viadotto A 14) e bivio SP 49 (località Ospedaletto),6642,00,6607,35,4846,1796,0,6642
2019/02,350,25/02/2019,1,SP 41 tra Rimini (viadotto A 14) e bivio SP 49 (località Ospedaletto),9305,10,8941,363,7546,1759,9305,0
2019/02,350,26/02/2019,2,SP 41 tra Rimini (viadotto A 14) e bivio SP 49 (località Ospedaletto),9629,00,9271,358,7823,1806,9629,0
2019/02,350,27/02/2019,3,SP 41 tra Rimini (viadotto A 14) e bivio SP 49 (località Ospedaletto),9979,10,9597,381,8067,1912,9979,0
2019/02,350,28/02/2019,4,SP 41 tra Rimini (viadotto A 14) e bivio SP 49 (località Ospedaletto),10214,00,9812,402,8113,2101,10214,0
2019/02,351,15/02/2019,5,SS 72 tra Rimini e  San Marino,,,,,,,,
2019/02,351,16/02/2019,6,SS 72 tra Rimini e  San Marino,,,,,,,,
2019/02,351,17/02/2019,7,SS 72 tra Rimini e  San Marino,,,,,,,,
2019/02,351,18/02/2019,1,SS 72 tra Rimini e  San Marino,,,,,,,,
2019/02,351,19/02/2019,2,SS 72 tra Rimini e  San Marino,,,,,,,,
2019/02,351,20/02/2019,3,SS 72 tra Rimini e  San Marino,,,,,,,,
2019/02,351,21/02/2019,4,SS 72 tra Rimini e  San Marino,,,,,,,,
2019/02,351,22/02/2019,5,SS 72 tra Rimini e  San Marino,,,,,,,,
2019/02,351,23/02/2019,6,SS 72 tra Rimini e  San Marino,,,,,,,,
2019/02,351,24/02/2019,7,SS 72 tra Rimini e  San Marino,,,,,,,,
2019/02,351,25/02/2019,1,SS 72 tra Rimini e  San Marino,,,,,,,,
2019/02,351,26/02/2019,2,SS 72 tra Rimini e  San Marino,,,,,,,,
2019/02,351,27/02/2019,3,SS 72 tra Rimini e  San Marino,,,,,,,,
2019/02,351,28/02/2019,4,SS 72 tra Rimini e  San Marino,,,,,,,,
2019/02,354,15/02/2019,5,SP 31 tra Viadotto A 14 e Coriano,13076,00,12756,320,10002,3074,13076,0
2019/02,354,16/02/2019,6,SP 31 tra Viadotto A 14 e Coriano,11718,10,11572,145,8492,3226,0,11718
2019/02,354,17/02/2019,7,SP 31 tra Viadotto A 14 e Coriano,9951,00,9915,36,7224,2727,0,9951
2019/02,354,18/02/2019,1,SP 31 tra Viadotto A 14 e Coriano,12366,20,12054,310,9869,2497,12366,0
2019/02,354,19/02/2019,2,SP 31 tra Viadotto A 14 e Coriano,12073,00,11712,361,9625,2448,12073,0
2019/02,354,20/02/2019,3,SP 31 tra Viadotto A 14 e Coriano,12297,30,11955,339,9849,2448,12297,0
2019/02,354,21/02/2019,4,SP 31 tra Viadotto A 14 e Coriano,12394,10,12068,325,9825,2569,12394,0
2019/02,354,22/02/2019,5,SP 31 tra Viadotto A 14 e Coriano,12864,00,12520,344,9988,2876,12864,0
2019/02,354,23/02/2019,6,SP 31 tra Viadotto A 14 e Coriano,11307,10,11171,135,8136,3171,0,11307
2019/02,354,24/02/2019,7,SP 31 tra Viadotto A 14 e Coriano,9228,00,9191,37,6575,2653,0,9228
2019/02,354,25/02/2019,1,SP 31 tra Viadotto A 14 e Coriano,12137,10,11791,345,9751,2386,12137,0
2019/02,354,26/02/2019,2,SP 31 tra Viadotto A 14 e Coriano,12169,20,11839,328,9653,2516,12169,0
2019/02,354,27/02/2019,3,SP 31 tra Viadotto A 14 e Coriano,12276,10,11962,313,9686,2590,12276,0
2019/02,354,28/02/2019,4,SP 31 tra Viadotto A 14 e Coriano,12421,00,12072,349,9744,2677,12421,0
2019/02,355,15/02/2019,5,SP 17V tra San Giovanni in Marignano e Morciano di Romagna (variante),16820,00,16083,737,13293,3527,16820,0
2019/02,355,16/02/2019,6,SP 17V tra San Giovanni in Marignano e Morciano di Romagna (variante),14113,00,13972,141,10621,3492,0,14113
2019/02,355,17/02/2019,7,SP 17V tra San Giovanni in Marignano e Morciano di Romagna (variante),11665,00,11644,21,8827,2838,0,11665
2019/02,355,18/02/2019,1,SP 17V tra San Giovanni in Marignano e Morciano di Romagna (variante),15996,00,15281,715,13004,2992,15996,0
2019/02,355,19/02/2019,2,SP 17V tra San Giovanni in Marignano e Morciano di Romagna (variante),15835,00,15153,682,12741,3094,15835,0
2019/02,355,20/02/2019,3,SP 17V tra San Giovanni in Marignano e Morciano di Romagna (variante),16440,00,15742,698,13281,3159,16440,0
2019/02,355,21/02/2019,4,SP 17V tra San Giovanni in Marignano e Morciano di Romagna (variante),16728,00,16023,705,13404,3324,16728,0
2019/02,355,22/02/2019,5,SP 17V tra San Giovanni in Marignano e Morciano di Romagna (variante),16420,00,15775,645,12901,3519,16420,0
2019/02,355,23/02/2019,6,SP 17V tra San Giovanni in Marignano e Morciano di Romagna (variante),14216,00,14090,126,10836,3380,0,14216
2019/02,355,24/02/2019,7,SP 17V tra San Giovanni in Marignano e Morciano di Romagna (variante),11026,00,10994,32,8283,2743,0,11026
2019/02,355,25/02/2019,1,SP 17V tra San Giovanni in Marignano e Morciano di Romagna (variante),16360,00,15656,704,13393,2967,16360,0
2019/02,355,26/02/2019,2,SP 17V tra San Giovanni in Marignano e Morciano di Romagna (variante),15911,00,15276,635,12752,3159,15911,0
2019/02,355,27/02/2019,3,SP 17V tra San Giovanni in Marignano e Morciano di Romagna (variante),16449,00,15746,703,13183,3266,16449,0
2019/02,355,28/02/2019,4,SP 17V tra San Giovanni in Marignano e Morciano di Romagna (variante),16537,00,15853,684,13401,3136,16537,0
2019/02,356,15/02/2019,5,SP 2 fra Reggiolo c/o bivio variante nord e confine regionale,8200,00,7280,920,6282,1918,8200,0
2019/02,356,16/02/2019,6,SP 2 fra Reggiolo c/o bivio variante nord e confine regionale,7284,20,7101,181,5383,1901,0,7284
2019/02,356,17/02/2019,7,SP 2 fra Reggiolo c/o bivio variante nord e confine regionale,5877,00,5803,74,4240,1637,0,5877
2019/02,356,18/02/2019,1,SP 2 fra Reggiolo c/o bivio variante nord e confine regionale,7993,00,6881,1112,6092,1901,7993,0
2019/02,356,19/02/2019,2,SP 2 fra Reggiolo c/o bivio variante nord e confine regionale,8545,20,6905,1638,6157,2388,8545,0
2019/02,356,20/02/2019,3,SP 2 fra Reggiolo c/o bivio variante nord e confine regionale,7592,00,6640,952,6014,1578,7592,0
2019/02,356,21/02/2019,4,SP 2 fra Reggiolo c/o bivio variante nord e confine regionale,8395,00,7208,1187,6829,1566,8395,0
2019/02,356,22/02/2019,5,SP 2 fra Reggiolo c/o bivio variante nord e confine regionale,8072,00,7118,954,6135,1937,8072,0
2019/02,356,23/02/2019,6,SP 2 fra Reggiolo c/o bivio variante nord e confine regionale,6517,00,6339,178,4646,1871,0,6517
2019/02,356,24/02/2019,7,SP 2 fra Reggiolo c/o bivio variante nord e confine regionale,5169,00,5106,63,3639,1530,0,5169
2019/02,356,25/02/2019,1,SP 2 fra Reggiolo c/o bivio variante nord e confine regionale,7424,10,6418,1005,5917,1507,7424,0
2019/02,356,26/02/2019,2,SP 2 fra Reggiolo c/o bivio variante nord e confine regionale,7611,00,6642,969,6048,1563,7611,0
2019/02,356,27/02/2019,3,SP 2 fra Reggiolo c/o bivio variante nord e confine regionale,7816,00,6889,927,6205,1611,7816,0
2019/02,356,28/02/2019,4,SP 2 fra Reggiolo c/o bivio variante nord e confine regionale,7837,00,6782,1055,6227,1610,7837,0
2019/02,357,15/02/2019,5,SP 306R fra Casola Valsenio e bivio SP 65 c/o località Isola,3514,00,3156,358,2779,735,3514,0
2019/02,357,16/02/2019,6,SP 306R fra Casola Valsenio e bivio SP 65 c/o località Isola,3104,10,2986,117,2390,714,0,3104
2019/02,357,17/02/2019,7,SP 306R fra Casola Valsenio e bivio SP 65 c/o località Isola,3022,00,3005,17,2441,581,0,3022
2019/02,357,18/02/2019,1,SP 306R fra Casola Valsenio e bivio SP 65 c/o località Isola,3162,00,2834,328,2585,577,3162,0
2019/02,357,19/02/2019,2,SP 306R fra Casola Valsenio e bivio SP 65 c/o località Isola,3331,00,3038,293,2693,638,3331,0
2019/02,357,20/02/2019,3,SP 306R fra Casola Valsenio e bivio SP 65 c/o località Isola,3253,10,2914,338,2648,605,3253,0
2019/02,357,21/02/2019,4,SP 306R fra Casola Valsenio e bivio SP 65 c/o località Isola,3268,20,2960,306,2617,651,3268,0
2019/02,357,22/02/2019,5,SP 306R fra Casola Valsenio e bivio SP 65 c/o località Isola,3444,00,3108,336,2758,686,3444,0
2019/02,357,23/02/2019,6,SP 306R fra Casola Valsenio e bivio SP 65 c/o località Isola,3127,00,3017,110,2388,739,0,3127
2019/02,357,24/02/2019,7,SP 306R fra Casola Valsenio e bivio SP 65 c/o località Isola,2864,00,2854,10,2302,562,0,2864
2019/02,357,25/02/2019,1,SP 306R fra Casola Valsenio e bivio SP 65 c/o località Isola,3317,00,2957,360,2680,637,3317,0
2019/02,357,26/02/2019,2,SP 306R fra Casola Valsenio e bivio SP 65 c/o località Isola,3415,00,3110,305,2741,674,3415,0
2019/02,357,27/02/2019,3,SP 306R fra Casola Valsenio e bivio SP 65 c/o località Isola,3281,00,2988,293,2664,617,3281,0
2019/02,357,28/02/2019,4,SP 306R fra Casola Valsenio e bivio SP 65 c/o località Isola,3305,30,3016,286,2614,691,3305,0
2019/02,376,15/02/2019,5,SP 68 tra Portomaggiore e la Superstrada Ferrara-Mare,3371,00,3197,174,2637,734,3371,0
2019/02,376,16/02/2019,6,SP 68 tra Portomaggiore e la Superstrada Ferrara-Mare,2783,10,2714,68,2067,716,0,2783
2019/02,376,17/02/2019,7,SP 68 tra Portomaggiore e la Superstrada Ferrara-Mare,2398,00,2381,17,1874,524,0,2398
2019/02,376,18/02/2019,1,SP 68 tra Portomaggiore e la Superstrada Ferrara-Mare,3126,00,2931,195,2525,601,3126,0
2019/02,376,19/02/2019,2,SP 68 tra Portomaggiore e la Superstrada Ferrara-Mare,3330,00,3135,195,2718,612,3330,0
2019/02,376,20/02/2019,3,SP 68 tra Portomaggiore e la Superstrada Ferrara-Mare,3184,00,3003,181,2566,618,3184,0
2019/02,376,21/02/2019,4,SP 68 tra Portomaggiore e la Superstrada Ferrara-Mare,3257,00,3071,186,2652,605,3257,0
2019/02,376,22/02/2019,5,SP 68 tra Portomaggiore e la Superstrada Ferrara-Mare,3511,00,3323,188,2799,712,3511,0
2019/02,376,23/02/2019,6,SP 68 tra Portomaggiore e la Superstrada Ferrara-Mare,2779,00,2673,106,2096,683,0,2779
2019/02,376,24/02/2019,7,SP 68 tra Portomaggiore e la Superstrada Ferrara-Mare,2564,00,2556,8,2010,554,0,2564
2019/02,376,25/02/2019,1,SP 68 tra Portomaggiore e la Superstrada Ferrara-Mare,3086,00,2930,156,2470,616,3086,0
2019/02,376,26/02/2019,2,SP 68 tra Portomaggiore e la Superstrada Ferrara-Mare,3263,00,3092,171,2628,635,3263,0
2019/02,376,27/02/2019,3,SP 68 tra Portomaggiore e la Superstrada Ferrara-Mare,3211,30,3004,204,2590,621,3211,0
2019/02,376,28/02/2019,4,SP 68 tra Portomaggiore e la Superstrada Ferrara-Mare,3214,00,3052,162,2536,678,3214,0
2019/02,377,15/02/2019,5,SP 18 tra Bondeno e il confine regionale (Lombardia),5287,00,4897,390,4120,1167,5287,0
2019/02,377,16/02/2019,6,SP 18 tra Bondeno e il confine regionale (Lombardia),4082,00,3997,85,2913,1169,0,4082
2019/02,377,17/02/2019,7,SP 18 tra Bondeno e il confine regionale (Lombardia),3599,00,3581,18,2632,967,0,3599
2019/02,377,18/02/2019,1,SP 18 tra Bondeno e il confine regionale (Lombardia),4890,00,4489,401,3955,935,4890,0
2019/02,377,19/02/2019,2,SP 18 tra Bondeno e il confine regionale (Lombardia),5219,00,4797,422,4235,984,5219,0
2019/02,377,20/02/2019,3,SP 18 tra Bondeno e il confine regionale (Lombardia),5023,00,4628,395,4023,1000,5023,0
2019/02,377,21/02/2019,4,SP 18 tra Bondeno e il confine regionale (Lombardia),4990,00,4594,396,3996,994,4990,0
2019/02,377,22/02/2019,5,SP 18 tra Bondeno e il confine regionale (Lombardia),5353,10,4955,397,4257,1096,5353,0
2019/02,377,23/02/2019,6,SP 18 tra Bondeno e il confine regionale (Lombardia),4278,00,4184,94,3158,1120,0,4278
2019/02,377,24/02/2019,7,SP 18 tra Bondeno e il confine regionale (Lombardia),3652,00,3635,17,2630,1022,0,3652
2019/02,377,25/02/2019,1,SP 18 tra Bondeno e il confine regionale (Lombardia),4985,10,4571,413,4023,962,4985,0
2019/02,377,26/02/2019,2,SP 18 tra Bondeno e il confine regionale (Lombardia),5030,00,4663,367,4015,1015,5030,0
2019/02,377,27/02/2019,3,SP 18 tra Bondeno e il confine regionale (Lombardia),5221,00,4788,433,4174,1047,5221,0
2019/02,377,28/02/2019,4,SP 18 tra Bondeno e il confine regionale (Lombardia),5288,00,4904,384,4247,1041,5288,0
2019/02,381,15/02/2019,5,SS 724 Tangenziale nord di Modena,,,,,,,,
2019/02,381,16/02/2019,6,SS 724 Tangenziale nord di Modena,,,,,,,,
2019/02,381,18/02/2019,1,SS 724 Tangenziale nord di Modena,,,,,,,,
2019/02,381,19/02/2019,2,SS 724 Tangenziale nord di Modena,,,,,,,,
2019/02,381,20/02/2019,3,SS 724 Tangenziale nord di Modena,,,,,,,,
2019/02,381,21/02/2019,4,SS 724 Tangenziale nord di Modena,,,,,,,,
2019/02,381,22/02/2019,5,SS 724 Tangenziale nord di Modena,,,,,,,,
2019/02,381,23/02/2019,6,SS 724 Tangenziale nord di Modena,,,,,,,,
2019/02,381,24/02/2019,7,SS 724 Tangenziale nord di Modena,,,,,,,,
2019/02,381,25/02/2019,1,SS 724 Tangenziale nord di Modena,,,,,,,,
2019/02,381,26/02/2019,2,SS 724 Tangenziale nord di Modena,,,,,,,,
2019/02,381,27/02/2019,3,SS 724 Tangenziale nord di Modena,,,,,,,,
2019/02,381,28/02/2019,4,SS 724 Tangenziale nord di Modena,,,,,,,,
2019/02,383,15/02/2019,5,SS 722 Tangenziale nord di Reggio Emilia,34660,80,30665,3987,26941,7719,34660,0
2019/02,383,16/02/2019,6,SS 722 Tangenziale nord di Reggio Emilia,25278,00,24517,761,17900,7378,0,25278
2019/02,383,17/02/2019,7,SS 722 Tangenziale nord di Reggio Emilia,21006,10,20808,197,14879,6127,0,21006
2019/02,383,18/02/2019,1,SS 722 Tangenziale nord di Reggio Emilia,32241,60,28509,3726,25784,6457,32241,0
2019/02,383,19/02/2019,2,SS 722 Tangenziale nord di Reggio Emilia,33919,20,29832,4085,27157,6762,33919,0
2019/02,383,20/02/2019,3,SS 722 Tangenziale nord di Reggio Emilia,33322,60,29315,4001,26737,6585,33322,0
2019/02,383,21/02/2019,4,SS 722 Tangenziale nord di Reggio Emilia,33904,70,29801,4096,26943,6961,33904,0
2019/02,383,22/02/2019,5,SS 722 Tangenziale nord di Reggio Emilia,34045,80,29980,4057,26443,7602,34045,0
2019/02,383,23/02/2019,6,SS 722 Tangenziale nord di Reggio Emilia,25266,10,24466,799,18066,7200,0,25266
2019/02,383,24/02/2019,7,SS 722 Tangenziale nord di Reggio Emilia,21156,10,20976,179,15207,5949,0,21156
2019/02,383,25/02/2019,1,SS 722 Tangenziale nord di Reggio Emilia,32738,70,28926,3805,26034,6704,32738,0
2019/02,383,26/02/2019,2,SS 722 Tangenziale nord di Reggio Emilia,33807,40,29753,4050,27092,6715,33807,0
2019/02,383,27/02/2019,3,SS 722 Tangenziale nord di Reggio Emilia,34613,90,30468,4136,27499,7114,34613,0
2019/02,383,28/02/2019,4,SS 722 Tangenziale nord di Reggio Emilia,34666,90,30303,4354,27103,7563,34666,0
2019/02,385,15/02/2019,5,SP 10R fra Castel San Giovanni e Confine regionale (Lombardia),12958,10,11673,1284,9894,3064,12958,0
2019/02,385,16/02/2019,6,SP 10R fra Castel San Giovanni e Confine regionale (Lombardia),10754,10,10477,276,7873,2881,0,10754
2019/02,385,17/02/2019,7,SP 10R fra Castel San Giovanni e Confine regionale (Lombardia),8816,00,8729,87,6439,2377,0,8816
2019/02,385,18/02/2019,1,SP 10R fra Castel San Giovanni e Confine regionale (Lombardia),11957,00,10637,1320,9326,2631,11957,0
2019/02,385,19/02/2019,2,SP 10R fra Castel San Giovanni e Confine regionale (Lombardia),12849,10,11456,1392,10097,2752,12849,0
2019/02,385,20/02/2019,3,SP 10R fra Castel San Giovanni e Confine regionale (Lombardia),12834,00,11415,1419,10010,2824,12834,0
2019/02,385,21/02/2019,4,SP 10R fra Castel San Giovanni e Confine regionale (Lombardia),13039,10,11572,1466,10133,2906,13039,0
2019/02,385,22/02/2019,5,SP 10R fra Castel San Giovanni e Confine regionale (Lombardia),13291,00,11933,1358,10157,3134,13291,0
2019/02,385,23/02/2019,6,SP 10R fra Castel San Giovanni e Confine regionale (Lombardia),10820,00,10568,252,7972,2848,0,10820
2019/02,385,24/02/2019,7,SP 10R fra Castel San Giovanni e Confine regionale (Lombardia),8627,00,8541,86,6343,2284,0,8627
2019/02,385,25/02/2019,1,SP 10R fra Castel San Giovanni e Confine regionale (Lombardia),12064,10,10657,1406,9373,2691,12064,0
2019/02,385,26/02/2019,2,SP 10R fra Castel San Giovanni e Confine regionale (Lombardia),12498,00,11109,1389,9692,2806,12498,0
2019/02,385,27/02/2019,3,SP 10R fra Castel San Giovanni e Confine regionale (Lombardia),12877,10,11399,1477,10093,2784,12877,0
2019/02,385,28/02/2019,4,SP 10R fra Castel San Giovanni e Confine regionale (Lombardia),13014,00,11617,1397,10192,2822,13014,0
2019/02,388,15/02/2019,5,SP 31 fra bivio SP 12 in località Castelnuovo Fogliani e il confine provinciale,4827,00,4700,127,3606,1221,4827,0
2019/02,388,16/02/2019,6,SP 31 fra bivio SP 12 in località Castelnuovo Fogliani e il confine provinciale,4639,00,4580,59,3507,1132,0,4639
2019/02,388,17/02/2019,7,SP 31 fra bivio SP 12 in località Castelnuovo Fogliani e il confine provinciale,4162,00,4154,8,3281,881,0,4162
2019/02,388,18/02/2019,1,SP 31 fra bivio SP 12 in località Castelnuovo Fogliani e il confine provinciale,4233,00,4129,104,3447,786,4233,0
2019/02,388,19/02/2019,2,SP 31 fra bivio SP 12 in località Castelnuovo Fogliani e il confine provinciale,4319,00,4199,120,3567,752,4319,0
2019/02,388,20/02/2019,3,SP 31 fra bivio SP 12 in località Castelnuovo Fogliani e il confine provinciale,4346,00,4213,133,3509,837,4346,0
2019/02,388,21/02/2019,4,SP 31 fra bivio SP 12 in località Castelnuovo Fogliani e il confine provinciale,4448,00,4333,115,3576,872,4448,0
2019/02,388,22/02/2019,5,SP 31 fra bivio SP 12 in località Castelnuovo Fogliani e il confine provinciale,4767,10,4625,141,3738,1029,4767,0
2019/02,388,23/02/2019,6,SP 31 fra bivio SP 12 in località Castelnuovo Fogliani e il confine provinciale,4728,00,4639,89,3634,1094,0,4728
2019/02,388,24/02/2019,7,SP 31 fra bivio SP 12 in località Castelnuovo Fogliani e il confine provinciale,4395,00,4369,26,3525,870,0,4395
2019/02,388,25/02/2019,1,SP 31 fra bivio SP 12 in località Castelnuovo Fogliani e il confine provinciale,4423,00,4294,129,3613,810,4423,0
2019/02,388,26/02/2019,2,SP 31 fra bivio SP 12 in località Castelnuovo Fogliani e il confine provinciale,4393,00,4255,138,3648,745,4393,0
2019/02,388,27/02/2019,3,SP 31 fra bivio SP 12 in località Castelnuovo Fogliani e il confine provinciale,4395,00,4257,138,3543,852,4395,0
2019/02,388,28/02/2019,4,SP 31 fra bivio SP 12 in località Castelnuovo Fogliani e il confine provinciale,4567,00,4445,122,3647,920,4567,0
2019/02,389,15/02/2019,5,SP 588R fra Villanova d’Arda e confine provinciale,4173,10,3805,367,3254,919,4173,0
2019/02,389,16/02/2019,6,SP 588R fra Villanova d’Arda e confine provinciale,3694,00,3565,129,2738,956,0,3694
2019/02,389,17/02/2019,7,SP 588R fra Villanova d’Arda e confine provinciale,3470,00,3410,60,2715,755,0,3470
2019/02,389,18/02/2019,1,SP 588R fra Villanova d’Arda e confine provinciale,3731,10,3392,338,3017,714,3731,0
2019/02,389,19/02/2019,2,SP 588R fra Villanova d’Arda e confine provinciale,4052,00,3632,420,3314,738,4052,0
2019/02,389,20/02/2019,3,SP 588R fra Villanova d’Arda e confine provinciale,4148,00,3718,430,3353,795,4148,0
2019/02,389,21/02/2019,4,SP 588R fra Villanova d’Arda e confine provinciale,4041,10,3651,389,3237,804,4041,0
2019/02,389,22/02/2019,5,SP 588R fra Villanova d’Arda e confine provinciale,4303,00,3933,370,3379,924,4303,0
2019/02,389,23/02/2019,6,SP 588R fra Villanova d’Arda e confine provinciale,3691,00,3607,84,2674,1017,0,3691
2019/02,389,24/02/2019,7,SP 588R fra Villanova d’Arda e confine provinciale,3404,00,3368,36,2581,823,0,3404
2019/02,389,25/02/2019,1,SP 588R fra Villanova d’Arda e confine provinciale,3856,00,3501,355,3147,709,3856,0
2019/02,389,26/02/2019,2,SP 588R fra Villanova d’Arda e confine provinciale,4058,10,3681,376,3303,755,4058,0
2019/02,389,27/02/2019,3,SP 588R fra Villanova d’Arda e confine provinciale,4027,20,3629,396,3203,824,4027,0
2019/02,389,28/02/2019,4,SP 588R fra Villanova d’Arda e confine provinciale,4056,10,3674,381,3243,813,4056,0
2019/02,390,15/02/2019,5,SP 462R dal bivio SP 10R in località Monticelli a Cortemaggiore,3068,00,2914,154,2360,708,3068,0
2019/02,390,16/02/2019,6,SP 462R dal bivio SP 10R in località Monticelli a Cortemaggiore,2831,00,2784,47,2077,754,0,2831
2019/02,390,17/02/2019,7,SP 462R dal bivio SP 10R in località Monticelli a Cortemaggiore,2640,00,2619,21,2057,583,0,2640
2019/02,390,18/02/2019,1,SP 462R dal bivio SP 10R in località Monticelli a Cortemaggiore,2714,00,2555,159,2219,495,2714,0
2019/02,390,19/02/2019,2,SP 462R dal bivio SP 10R in località Monticelli a Cortemaggiore,3077,00,2912,165,2502,575,3077,0
2019/02,390,20/02/2019,3,SP 462R dal bivio SP 10R in località Monticelli a Cortemaggiore,2937,10,2746,190,2373,564,2937,0
2019/02,390,21/02/2019,4,SP 462R dal bivio SP 10R in località Monticelli a Cortemaggiore,2971,10,2804,166,2374,597,2971,0
2019/02,390,22/02/2019,5,SP 462R dal bivio SP 10R in località Monticelli a Cortemaggiore,3106,10,2933,172,2374,732,3106,0
2019/02,390,23/02/2019,6,SP 462R dal bivio SP 10R in località Monticelli a Cortemaggiore,2978,00,2929,49,2200,778,0,2978
2019/02,390,24/02/2019,7,SP 462R dal bivio SP 10R in località Monticelli a Cortemaggiore,2815,00,2791,24,2199,616,0,2815
2019/02,390,25/02/2019,1,SP 462R dal bivio SP 10R in località Monticelli a Cortemaggiore,2774,00,2660,114,2197,577,2774,0
2019/02,390,26/02/2019,2,SP 462R dal bivio SP 10R in località Monticelli a Cortemaggiore,2934,10,2796,137,2387,547,2934,0
2019/02,390,27/02/2019,3,SP 462R dal bivio SP 10R in località Monticelli a Cortemaggiore,3000,00,2843,157,2375,625,3000,0
2019/02,390,28/02/2019,4,SP 462R dal bivio SP 10R in località Monticelli a Cortemaggiore,3014,00,2868,146,2326,688,3014,0
2019/02,391,15/02/2019,5,SP 10R fra Castelvetro Piacentino e confine regionale (Lombardia),21746,00,21226,520,16404,5342,21746,0
2019/02,391,16/02/2019,6,SP 10R fra Castelvetro Piacentino e confine regionale (Lombardia),21014,20,20762,250,15034,5980,0,21014
2019/02,391,17/02/2019,7,SP 10R fra Castelvetro Piacentino e confine regionale (Lombardia),19508,00,19394,114,14656,4852,0,19508
2019/02,391,18/02/2019,1,SP 10R fra Castelvetro Piacentino e confine regionale (Lombardia),19623,00,19103,520,15554,4069,19623,0
2019/02,391,19/02/2019,2,SP 10R fra Castelvetro Piacentino e confine regionale (Lombardia),19975,00,19431,544,15763,4212,19975,0
2019/02,391,20/02/2019,3,SP 10R fra Castelvetro Piacentino e confine regionale (Lombardia),20392,00,19855,537,16014,4378,20392,0
2019/02,391,21/02/2019,4,SP 10R fra Castelvetro Piacentino e confine regionale (Lombardia),19813,20,19209,602,15426,4387,19813,0
2019/02,391,22/02/2019,5,SP 10R fra Castelvetro Piacentino e confine regionale (Lombardia),20452,10,19937,514,15143,5309,20452,0
2019/02,391,23/02/2019,6,SP 10R fra Castelvetro Piacentino e confine regionale (Lombardia),21318,00,21068,250,15371,5947,0,21318
2019/02,391,24/02/2019,7,SP 10R fra Castelvetro Piacentino e confine regionale (Lombardia),19839,00,19763,76,14849,4990,0,19839
2019/02,391,25/02/2019,1,SP 10R fra Castelvetro Piacentino e confine regionale (Lombardia),19552,00,19068,484,15396,4156,19552,0
2019/02,391,26/02/2019,2,SP 10R fra Castelvetro Piacentino e confine regionale (Lombardia),19828,00,19304,524,15688,4140,19828,0
2019/02,391,27/02/2019,3,SP 10R fra Castelvetro Piacentino e confine regionale (Lombardia),20607,00,20058,549,16167,4440,20607,0
2019/02,391,28/02/2019,4,SP 10R fra Castelvetro Piacentino e confine regionale (Lombardia),20482,20,19953,527,15879,4603,20482,0
2019/02,393,15/02/2019,5,SP 10R fra Caorso e Roncaglia,11597,00,10170,1427,8918,2679,11597,0
2019/02,393,16/02/2019,6,SP 10R fra Caorso e Roncaglia,8778,10,8442,335,6178,2600,0,8778
2019/02,393,17/02/2019,7,SP 10R fra Caorso e Roncaglia,7026,10,6960,65,5096,1930,0,7026
2019/02,393,18/02/2019,1,SP 10R fra Caorso e Roncaglia,11043,00,9548,1495,8701,2342,11043,0
2019/02,393,19/02/2019,2,SP 10R fra Caorso e Roncaglia,11327,20,9756,1569,8865,2462,11327,0
2019/02,393,20/02/2019,3,SP 10R fra Caorso e Roncaglia,11522,10,9974,1547,9054,2468,11522,0
2019/02,393,21/02/2019,4,SP 10R fra Caorso e Roncaglia,11496,00,9906,1590,9017,2479,11496,0
2019/02,393,22/02/2019,5,SP 10R fra Caorso e Roncaglia,11736,20,10390,1344,8822,2914,11736,0
2019/02,393,23/02/2019,6,SP 10R fra Caorso e Roncaglia,8754,00,8445,309,6143,2611,0,8754
2019/02,393,24/02/2019,7,SP 10R fra Caorso e Roncaglia,8624,10,8565,58,6626,1998,0,8624
2019/02,393,25/02/2019,1,SP 10R fra Caorso e Roncaglia,11223,20,9776,1445,8939,2284,11223,0
2019/02,393,26/02/2019,2,SP 10R fra Caorso e Roncaglia,11198,10,9664,1533,8656,2542,11198,0
2019/02,393,27/02/2019,3,SP 10R fra Caorso e Roncaglia,11597,10,9989,1607,9023,2574,11597,0
2019/02,393,28/02/2019,4,SP 10R fra Caorso e Roncaglia,11608,10,10075,1532,8932,2676,11608,0
2019/02,394,15/02/2019,5,SP 523R da Roccamurata (bivio SP 308R) a Borgo Val di Taro,4760,00,4376,384,3683,1077,4760,0
2019/02,394,16/02/2019,6,SP 523R da Roccamurata (bivio SP 308R) a Borgo Val di Taro,3819,00,3727,92,2954,865,0,3819
2019/02,394,17/02/2019,7,SP 523R da Roccamurata (bivio SP 308R) a Borgo Val di Taro,3612,00,3577,35,2743,869,0,3612
2019/02,394,18/02/2019,1,SP 523R da Roccamurata (bivio SP 308R) a Borgo Val di Taro,4826,10,4450,375,3836,990,4826,0
2019/02,394,19/02/2019,2,SP 523R da Roccamurata (bivio SP 308R) a Borgo Val di Taro,4533,00,4125,408,3613,920,4533,0
2019/02,394,20/02/2019,3,SP 523R da Roccamurata (bivio SP 308R) a Borgo Val di Taro,4568,00,4154,414,3684,884,4568,0
2019/02,394,21/02/2019,4,SP 523R da Roccamurata (bivio SP 308R) a Borgo Val di Taro,4652,00,4220,432,3720,932,4652,0
2019/02,394,22/02/2019,5,SP 523R da Roccamurata (bivio SP 308R) a Borgo Val di Taro,4887,00,4460,427,3775,1112,4887,0
2019/02,394,23/02/2019,6,SP 523R da Roccamurata (bivio SP 308R) a Borgo Val di Taro,3999,00,3886,113,3117,882,0,3999
2019/02,394,24/02/2019,7,SP 523R da Roccamurata (bivio SP 308R) a Borgo Val di Taro,3579,00,3549,30,2637,942,0,3579
2019/02,394,25/02/2019,1,SP 523R da Roccamurata (bivio SP 308R) a Borgo Val di Taro,4867,00,4416,451,3862,1005,4867,0
2019/02,394,26/02/2019,2,SP 523R da Roccamurata (bivio SP 308R) a Borgo Val di Taro,4624,00,4197,427,3708,916,4624,0
2019/02,394,27/02/2019,3,SP 523R da Roccamurata (bivio SP 308R) a Borgo Val di Taro,4707,00,4289,418,3767,940,4707,0
2019/02,394,28/02/2019,4,SP 523R da Roccamurata (bivio SP 308R) a Borgo Val di Taro,4728,00,4288,440,3638,1090,4728,0
2019/02,395,15/02/2019,5,SP 308R da Fornovo di Taro (bivio SS 62) a Solignano,4406,00,4187,219,3377,1029,4406,0
2019/02,395,16/02/2019,6,SP 308R da Fornovo di Taro (bivio SS 62) a Solignano,3498,00,3404,94,2677,821,0,3498
2019/02,395,17/02/2019,7,SP 308R da Fornovo di Taro (bivio SS 62) a Solignano,3355,00,3336,19,2563,792,0,3355
2019/02,395,18/02/2019,1,SP 308R da Fornovo di Taro (bivio SS 62) a Solignano,4304,00,4105,199,3380,924,4304,0
2019/02,395,19/02/2019,2,SP 308R da Fornovo di Taro (bivio SS 62) a Solignano,4465,00,4247,218,3505,960,4465,0
2019/02,395,20/02/2019,3,SP 308R da Fornovo di Taro (bivio SS 62) a Solignano,4328,00,4109,219,3382,946,4328,0
2019/02,395,21/02/2019,4,SP 308R da Fornovo di Taro (bivio SS 62) a Solignano,4327,00,4110,217,3398,929,4327,0
2019/02,395,22/02/2019,5,SP 308R da Fornovo di Taro (bivio SS 62) a Solignano,4602,10,4364,237,3559,1043,4602,0
2019/02,395,23/02/2019,6,SP 308R da Fornovo di Taro (bivio SS 62) a Solignano,3612,10,3529,82,2796,816,0,3612
2019/02,395,24/02/2019,7,SP 308R da Fornovo di Taro (bivio SS 62) a Solignano,3433,10,3406,26,2594,839,0,3433
2019/02,395,25/02/2019,1,SP 308R da Fornovo di Taro (bivio SS 62) a Solignano,4206,00,3988,218,3270,936,4206,0
2019/02,395,26/02/2019,2,SP 308R da Fornovo di Taro (bivio SS 62) a Solignano,4467,00,4215,252,3568,899,4467,0
2019/02,395,27/02/2019,3,SP 308R da Fornovo di Taro (bivio SS 62) a Solignano,4494,00,4254,240,3538,956,4494,0
2019/02,395,28/02/2019,4,SP 308R da Fornovo di Taro (bivio SS 62) a Solignano,4478,00,4230,248,3491,987,4478,0
2019/02,396,15/02/2019,5,SP 28 fra Fornovo di Taro e Varano de Melegari centro abitato Viazzano,8066,00,7667,399,6451,1615,8066,0
2019/02,396,16/02/2019,6,SP 28 fra Fornovo di Taro e Varano de Melegari centro abitato Viazzano,6665,00,6550,115,5283,1382,0,6665
2019/02,396,17/02/2019,7,SP 28 fra Fornovo di Taro e Varano de Melegari centro abitato Viazzano,5742,00,5702,40,4580,1162,0,5742
2019/02,396,18/02/2019,1,SP 28 fra Fornovo di Taro e Varano de Melegari centro abitato Viazzano,7405,10,7062,342,6066,1339,7405,0
2019/02,396,19/02/2019,2,SP 28 fra Fornovo di Taro e Varano de Melegari centro abitato Viazzano,7915,00,7583,332,6435,1480,7915,0
2019/02,396,20/02/2019,3,SP 28 fra Fornovo di Taro e Varano de Melegari centro abitato Viazzano,7752,00,7421,331,6326,1426,7752,0
2019/02,396,21/02/2019,4,SP 28 fra Fornovo di Taro e Varano de Melegari centro abitato Viazzano,7545,10,7207,337,6047,1498,7545,0
2019/02,396,22/02/2019,5,SP 28 fra Fornovo di Taro e Varano de Melegari centro abitato Viazzano,8015,00,7637,378,6423,1592,8015,0
2019/02,396,23/02/2019,6,SP 28 fra Fornovo di Taro e Varano de Melegari centro abitato Viazzano,6705,00,6580,125,5252,1453,0,6705
2019/02,396,24/02/2019,7,SP 28 fra Fornovo di Taro e Varano de Melegari centro abitato Viazzano,5699,00,5644,55,4526,1173,0,5699
2019/02,396,25/02/2019,1,SP 28 fra Fornovo di Taro e Varano de Melegari centro abitato Viazzano,7289,00,6963,326,5983,1306,7289,0
2019/02,396,26/02/2019,2,SP 28 fra Fornovo di Taro e Varano de Melegari centro abitato Viazzano,7896,10,7585,310,6448,1448,7896,0
2019/02,396,27/02/2019,3,SP 28 fra Fornovo di Taro e Varano de Melegari centro abitato Viazzano,7951,10,7579,371,6323,1628,7951,0
2019/02,396,28/02/2019,4,SP 28 fra Fornovo di Taro e Varano de Melegari centro abitato Viazzano,8145,00,7772,373,6575,1570,8145,0
2019/02,397,15/02/2019,5,SP 12 fra casello A 1 e Fidenza,,,,,,,,
2019/02,397,16/02/2019,6,SP 12 fra casello A 1 e Fidenza,,,,,,,,
2019/02,397,17/02/2019,7,SP 12 fra casello A 1 e Fidenza,,,,,,,,
2019/02,397,18/02/2019,1,SP 12 fra casello A 1 e Fidenza,,,,,,,,
2019/02,397,19/02/2019,2,SP 12 fra casello A 1 e Fidenza,,,,,,,,
2019/02,397,20/02/2019,3,SP 12 fra casello A 1 e Fidenza,,,,,,,,
2019/02,397,21/02/2019,4,SP 12 fra casello A 1 e Fidenza,,,,,,,,
2019/02,397,22/02/2019,5,SP 12 fra casello A 1 e Fidenza,,,,,,,,
2019/02,397,23/02/2019,6,SP 12 fra casello A 1 e Fidenza,,,,,,,,
2019/02,397,24/02/2019,7,SP 12 fra casello A 1 e Fidenza,,,,,,,,
2019/02,397,25/02/2019,1,SP 12 fra casello A 1 e Fidenza,,,,,,,,
2019/02,397,26/02/2019,2,SP 12 fra casello A 1 e Fidenza,,,,,,,,
2019/02,397,27/02/2019,3,SP 12 fra casello A 1 e Fidenza,,,,,,,,
2019/02,397,28/02/2019,4,SP 12 fra casello A 1 e Fidenza,,,,,,,,
2019/02,398,15/02/2019,5,SP 11 tra Fontevivo e Cispadana (tangenziale),,,,,,,,
2019/02,398,16/02/2019,6,SP 11 tra Fontevivo e Cispadana (tangenziale),,,,,,,,
2019/02,398,17/02/2019,7,SP 11 tra Fontevivo e Cispadana (tangenziale),,,,,,,,
2019/02,398,18/02/2019,1,SP 11 tra Fontevivo e Cispadana (tangenziale),,,,,,,,
2019/02,398,19/02/2019,2,SP 11 tra Fontevivo e Cispadana (tangenziale),,,,,,,,
2019/02,398,20/02/2019,3,SP 11 tra Fontevivo e Cispadana (tangenziale),,,,,,,,
2019/02,398,21/02/2019,4,SP 11 tra Fontevivo e Cispadana (tangenziale),,,,,,,,
2019/02,398,22/02/2019,5,SP 11 tra Fontevivo e Cispadana (tangenziale),,,,,,,,
2019/02,398,23/02/2019,6,SP 11 tra Fontevivo e Cispadana (tangenziale),,,,,,,,
2019/02,398,24/02/2019,7,SP 11 tra Fontevivo e Cispadana (tangenziale),,,,,,,,
2019/02,398,25/02/2019,1,SP 11 tra Fontevivo e Cispadana (tangenziale),,,,,,,,
2019/02,398,26/02/2019,2,SP 11 tra Fontevivo e Cispadana (tangenziale),,,,,,,,
2019/02,398,27/02/2019,3,SP 11 tra Fontevivo e Cispadana (tangenziale),,,,,,,,
2019/02,398,28/02/2019,4,SP 11 tra Fontevivo e Cispadana (tangenziale),,,,,,,,
2019/02,399,20/02/2019,3,SP 43 tra Trecasali (bivio SP 8) e Torrile,3712,00,3369,343,2925,787,3712,0
2019/02,399,21/02/2019,4,SP 43 tra Trecasali (bivio SP 8) e Torrile,3716,00,3306,410,2904,812,3716,0
2019/02,399,22/02/2019,5,SP 43 tra Trecasali (bivio SP 8) e Torrile,3787,00,3456,331,2912,875,3787,0
2019/02,399,23/02/2019,6,SP 43 tra Trecasali (bivio SP 8) e Torrile,2710,00,2593,117,2019,691,0,2710
2019/02,399,24/02/2019,7,SP 43 tra Trecasali (bivio SP 8) e Torrile,2020,10,1975,44,1482,538,0,2020
2019/02,399,25/02/2019,1,SP 43 tra Trecasali (bivio SP 8) e Torrile,3603,00,3224,379,2850,753,3603,0
2019/02,399,26/02/2019,2,SP 43 tra Trecasali (bivio SP 8) e Torrile,3651,10,3259,391,2871,780,3651,0
2019/02,399,27/02/2019,3,SP 43 tra Trecasali (bivio SP 8) e Torrile,3754,20,3332,420,2928,826,3754,0
2019/02,399,28/02/2019,4,SP 43 tra Trecasali (bivio SP 8) e Torrile,3889,10,3449,439,3022,867,3889,0
2019/02,400,21/02/2019,4,SP 10 da San Secondo Parmense al bivio per Roccabianca centro abitato Pizzo,7476,00,6286,1190,5993,1483,7476,0
2019/02,400,22/02/2019,5,SP 10 da San Secondo Parmense al bivio per Roccabianca centro abitato Pizzo,7459,10,6340,1118,5917,1542,7459,0
2019/02,400,23/02/2019,6,SP 10 da San Secondo Parmense al bivio per Roccabianca centro abitato Pizzo,6013,00,5726,287,4542,1471,0,6013
2019/02,400,24/02/2019,7,SP 10 da San Secondo Parmense al bivio per Roccabianca centro abitato Pizzo,4933,00,4846,87,3598,1335,0,4933
2019/02,400,25/02/2019,1,SP 10 da San Secondo Parmense al bivio per Roccabianca centro abitato Pizzo,7151,00,5993,1158,5774,1377,7151,0
2019/02,400,26/02/2019,2,SP 10 da San Secondo Parmense al bivio per Roccabianca centro abitato Pizzo,7198,10,6062,1135,5793,1405,7198,0
2019/02,400,27/02/2019,3,SP 10 da San Secondo Parmense al bivio per Roccabianca centro abitato Pizzo,7704,00,6527,1177,6243,1461,7704,0
2019/02,400,28/02/2019,4,SP 10 da San Secondo Parmense al bivio per Roccabianca centro abitato Pizzo,7469,00,6300,1169,5943,1526,7469,0
2019/02,401,15/02/2019,5,SP 513R fra Traversetolo e confine provinciale,7406,10,6759,646,5910,1496,7406,0
2019/02,401,16/02/2019,6,SP 513R fra Traversetolo e confine provinciale,6417,10,6242,174,4938,1479,0,6417
2019/02,401,17/02/2019,7,SP 513R fra Traversetolo e confine provinciale,7499,40,7449,46,6236,1263,0,7499
2019/02,401,18/02/2019,1,SP 513R fra Traversetolo e confine provinciale,6901,10,6307,593,5644,1257,6901,0
2019/02,401,19/02/2019,2,SP 513R fra Traversetolo e confine provinciale,7157,10,6546,610,5841,1316,7157,0
2019/02,401,20/02/2019,3,SP 513R fra Traversetolo e confine provinciale,7072,10,6457,614,5772,1300,7072,0
2019/02,401,21/02/2019,4,SP 513R fra Traversetolo e confine provinciale,7229,40,6600,625,5936,1293,7229,0
2019/02,401,22/02/2019,5,SP 513R fra Traversetolo e confine provinciale,7441,00,6833,608,5942,1499,7441,0
2019/02,401,23/02/2019,6,SP 513R fra Traversetolo e confine provinciale,6491,20,6350,139,5090,1401,0,6491
2019/02,401,24/02/2019,7,SP 513R fra Traversetolo e confine provinciale,7212,20,7162,48,5978,1234,0,7212
2019/02,401,25/02/2019,1,SP 513R fra Traversetolo e confine provinciale,6933,10,6316,616,5694,1239,6933,0
2019/02,401,26/02/2019,2,SP 513R fra Traversetolo e confine provinciale,7247,00,6623,624,5913,1334,7247,0
2019/02,401,27/02/2019,3,SP 513R fra Traversetolo e confine provinciale,7231,20,6597,632,5891,1340,7231,0
2019/02,401,28/02/2019,4,SP 513R fra Traversetolo e confine provinciale,7015,10,6403,611,5698,1317,7015,0
2019/02,402,15/02/2019,5,SP 18 da Pilastrello (bivio SP 513R) al bivio per la Pedemontana,14328,00,13981,347,11170,3158,14328,0
2019/02,402,16/02/2019,6,SP 18 da Pilastrello (bivio SP 513R) al bivio per la Pedemontana,12274,00,12147,127,9336,2938,0,12274
2019/02,402,17/02/2019,7,SP 18 da Pilastrello (bivio SP 513R) al bivio per la Pedemontana,9196,00,9161,35,6921,2275,0,9196
2019/02,402,18/02/2019,1,SP 18 da Pilastrello (bivio SP 513R) al bivio per la Pedemontana,13633,00,13320,313,11131,2502,13633,0
2019/02,402,19/02/2019,2,SP 18 da Pilastrello (bivio SP 513R) al bivio per la Pedemontana,14046,00,13699,347,11338,2708,14046,0
2019/02,402,20/02/2019,3,SP 18 da Pilastrello (bivio SP 513R) al bivio per la Pedemontana,14298,00,13984,314,11433,2865,14298,0
2019/02,402,21/02/2019,4,SP 18 da Pilastrello (bivio SP 513R) al bivio per la Pedemontana,14147,10,13839,307,11373,2774,14147,0
2019/02,402,22/02/2019,5,SP 18 da Pilastrello (bivio SP 513R) al bivio per la Pedemontana,14615,20,14268,345,11455,3160,14615,0
2019/02,402,23/02/2019,6,SP 18 da Pilastrello (bivio SP 513R) al bivio per la Pedemontana,12414,00,12297,117,9407,3007,0,12414
2019/02,402,24/02/2019,7,SP 18 da Pilastrello (bivio SP 513R) al bivio per la Pedemontana,9608,00,9572,36,7151,2457,0,9608
2019/02,402,25/02/2019,1,SP 18 da Pilastrello (bivio SP 513R) al bivio per la Pedemontana,13803,00,13485,318,11258,2545,13803,0
2019/02,402,26/02/2019,2,SP 18 da Pilastrello (bivio SP 513R) al bivio per la Pedemontana,14073,00,13711,362,11388,2685,14073,0
2019/02,402,27/02/2019,3,SP 18 da Pilastrello (bivio SP 513R) al bivio per la Pedemontana,14211,00,13905,306,11366,2845,14211,0
2019/02,402,28/02/2019,4,SP 18 da Pilastrello (bivio SP 513R) al bivio per la Pedemontana,14424,00,14145,279,11556,2868,14424,0
2019/02,403,15/02/2019,5,SP 72 tra Parma e Mezzani,8141,00,7484,657,6592,1549,8141,0
2019/02,403,16/02/2019,6,SP 72 tra Parma e Mezzani,5748,10,5654,93,4318,1430,0,5748
2019/02,403,17/02/2019,7,SP 72 tra Parma e Mezzani,4257,00,4238,19,3175,1082,0,4257
2019/02,403,18/02/2019,1,SP 72 tra Parma e Mezzani,8158,00,7438,720,6832,1326,8158,0
2019/02,403,19/02/2019,2,SP 72 tra Parma e Mezzani,8341,00,7621,720,6834,1507,8341,0
2019/02,403,20/02/2019,3,SP 72 tra Parma e Mezzani,8443,00,7698,745,7046,1397,8443,0
2019/02,403,21/02/2019,4,SP 72 tra Parma e Mezzani,8486,30,7830,653,6964,1522,8486,0
2019/02,403,22/02/2019,5,SP 72 tra Parma e Mezzani,8418,00,7768,650,6805,1613,8418,0
2019/02,403,23/02/2019,6,SP 72 tra Parma e Mezzani,5834,10,5743,90,4327,1507,0,5834
2019/02,403,24/02/2019,7,SP 72 tra Parma e Mezzani,4531,00,4506,25,3326,1205,0,4531
2019/02,403,25/02/2019,1,SP 72 tra Parma e Mezzani,8215,20,7567,646,6881,1334,8215,0
2019/02,403,26/02/2019,2,SP 72 tra Parma e Mezzani,8146,00,7545,601,6669,1477,8146,0
2019/02,403,27/02/2019,3,SP 72 tra Parma e Mezzani,8434,00,7812,622,6854,1580,8434,0
2019/02,403,28/02/2019,4,SP 72 tra Parma e Mezzani,8632,00,7989,643,7078,1554,8632,0
2019/02,404,15/02/2019,5,exSP 32 (via Dante Alighieri) da Felino a Pilastro,7334,00,7142,192,5610,1724,7334,0
2019/02,404,16/02/2019,6,exSP 32 (via Dante Alighieri) da Felino a Pilastro,6444,20,6356,86,4863,1581,0,6444
2019/02,404,17/02/2019,7,exSP 32 (via Dante Alighieri) da Felino a Pilastro,5101,30,5068,30,3898,1203,0,5101
2019/02,404,18/02/2019,1,exSP 32 (via Dante Alighieri) da Felino a Pilastro,6971,20,6815,154,5658,1313,6971,0
2019/02,404,19/02/2019,2,exSP 32 (via Dante Alighieri) da Felino a Pilastro,7180,20,6967,211,5814,1366,7180,0
2019/02,404,20/02/2019,3,exSP 32 (via Dante Alighieri) da Felino a Pilastro,7183,20,6983,198,5733,1450,7183,0
2019/02,404,21/02/2019,4,exSP 32 (via Dante Alighieri) da Felino a Pilastro,7350,10,7154,195,5822,1528,7350,0
2019/02,404,22/02/2019,5,exSP 32 (via Dante Alighieri) da Felino a Pilastro,7730,10,7527,202,6059,1671,7730,0
2019/02,404,23/02/2019,6,exSP 32 (via Dante Alighieri) da Felino a Pilastro,6555,30,6474,78,4896,1659,0,6555
2019/02,404,24/02/2019,7,exSP 32 (via Dante Alighieri) da Felino a Pilastro,5176,10,5147,28,3870,1306,0,5176
2019/02,404,25/02/2019,1,exSP 32 (via Dante Alighieri) da Felino a Pilastro,7020,70,6832,181,5670,1350,7020,0
2019/02,404,26/02/2019,2,exSP 32 (via Dante Alighieri) da Felino a Pilastro,7105,40,6911,190,5653,1452,7105,0
2019/02,404,27/02/2019,3,exSP 32 (via Dante Alighieri) da Felino a Pilastro,7338,20,7120,216,5819,1519,7338,0
2019/02,404,28/02/2019,4,exSP 32 (via Dante Alighieri) da Felino a Pilastro,7378,40,7186,188,5789,1589,7378,0
2019/02,405,15/02/2019,5,SP 15 fra SS62 e Sala Baganza,11189,00,10326,863,8857,2332,11189,0
2019/02,405,16/02/2019,6,SP 15 fra SS62 e Sala Baganza,8828,00,8633,195,6434,2394,0,8828
2019/02,405,17/02/2019,7,SP 15 fra SS62 e Sala Baganza,6458,00,6434,24,4755,1703,0,6458
2019/02,405,18/02/2019,1,SP 15 fra SS62 e Sala Baganza,10586,00,9810,776,8600,1986,10586,0
2019/02,405,19/02/2019,2,SP 15 fra SS62 e Sala Baganza,10907,00,10055,852,8797,2110,10907,0
2019/02,405,20/02/2019,3,SP 15 fra SS62 e Sala Baganza,11233,00,10342,891,9012,2221,11233,0
2019/02,405,21/02/2019,4,SP 15 fra SS62 e Sala Baganza,11137,00,10242,895,8901,2236,11137,0
2019/02,405,22/02/2019,5,SP 15 fra SS62 e Sala Baganza,11395,00,10461,934,9109,2286,11395,0
2019/02,405,23/02/2019,6,SP 15 fra SS62 e Sala Baganza,8838,00,8603,235,6531,2307,0,8838
2019/02,405,24/02/2019,7,SP 15 fra SS62 e Sala Baganza,6573,00,6539,34,4743,1830,0,6573
2019/02,405,25/02/2019,1,SP 15 fra SS62 e Sala Baganza,10394,00,9523,871,8543,1851,10394,0
2019/02,405,26/02/2019,2,SP 15 fra SS62 e Sala Baganza,10833,00,9949,884,8724,2109,10833,0
2019/02,405,27/02/2019,3,SP 15 fra SS62 e Sala Baganza,11297,00,10394,903,9003,2294,11297,0
2019/02,405,28/02/2019,4,SP 15 fra SS62 e Sala Baganza,11364,00,10433,931,9091,2273,11364,0
2019/02,410,15/02/2019,5,SP 54 fra Pomposa e Codigoro,4705,10,4399,305,3711,994,4705,0
2019/02,410,16/02/2019,6,SP 54 fra Pomposa e Codigoro,4353,00,4238,115,3148,1205,0,4353
2019/02,410,17/02/2019,7,SP 54 fra Pomposa e Codigoro,3831,00,3824,7,2819,1012,0,3831
2019/02,410,18/02/2019,1,SP 54 fra Pomposa e Codigoro,4287,00,4021,266,3518,769,4287,0
2019/02,410,19/02/2019,2,SP 54 fra Pomposa e Codigoro,4360,20,4072,286,3590,770,4360,0
2019/02,410,20/02/2019,3,SP 54 fra Pomposa e Codigoro,4218,00,3943,275,3468,750,4218,0
2019/02,410,21/02/2019,4,SP 54 fra Pomposa e Codigoro,4416,00,4179,237,3613,803,4416,0
2019/02,410,22/02/2019,5,SP 54 fra Pomposa e Codigoro,4668,10,4386,281,3737,931,4668,0
2019/02,410,23/02/2019,6,SP 54 fra Pomposa e Codigoro,4061,00,3958,103,2916,1145,0,4061
2019/02,410,24/02/2019,7,SP 54 fra Pomposa e Codigoro,3494,00,3484,10,2574,920,0,3494
2019/02,410,25/02/2019,1,SP 54 fra Pomposa e Codigoro,4352,00,4051,301,3574,778,4352,0
2019/02,410,26/02/2019,2,SP 54 fra Pomposa e Codigoro,4519,10,4209,309,3696,823,4519,0
2019/02,410,27/02/2019,3,SP 54 fra Pomposa e Codigoro,4439,00,4142,297,3641,798,4439,0
2019/02,410,28/02/2019,4,SP 54 fra Pomposa e Codigoro,4587,00,4325,262,3705,882,4587,0
2019/02,411,15/02/2019,5,SP 53 fra Codigoro e Marozzo,5472,00,5371,101,4367,1105,5472,0
2019/02,411,16/02/2019,6,SP 53 fra Codigoro e Marozzo,4252,00,4207,45,3162,1090,0,4252
2019/02,411,17/02/2019,7,SP 53 fra Codigoro e Marozzo,3344,10,3330,13,2406,938,0,3344
2019/02,411,18/02/2019,1,SP 53 fra Codigoro e Marozzo,5424,10,5317,106,4404,1020,5424,0
2019/02,411,19/02/2019,2,SP 53 fra Codigoro e Marozzo,5337,00,5222,115,4441,896,5337,0
2019/02,411,20/02/2019,3,SP 53 fra Codigoro e Marozzo,5223,00,5115,108,4272,951,5223,0
2019/02,411,21/02/2019,4,SP 53 fra Codigoro e Marozzo,5252,00,5148,104,4318,934,5252,0
2019/02,411,22/02/2019,5,SP 53 fra Codigoro e Marozzo,5554,00,5440,114,4475,1079,5554,0
2019/02,411,23/02/2019,6,SP 53 fra Codigoro e Marozzo,4284,00,4241,43,3186,1098,0,4284
2019/02,411,24/02/2019,7,SP 53 fra Codigoro e Marozzo,3586,00,3581,5,2690,896,0,3586
2019/02,411,25/02/2019,1,SP 53 fra Codigoro e Marozzo,5309,10,5208,100,4331,978,5309,0
2019/02,411,26/02/2019,2,SP 53 fra Codigoro e Marozzo,5460,00,5358,102,4475,985,5460,0
2019/02,411,27/02/2019,3,SP 53 fra Codigoro e Marozzo,5356,00,5253,103,4380,976,5356,0
2019/02,411,28/02/2019,4,SP 53 fra Codigoro e Marozzo,5334,00,5235,99,4298,1036,5334,0
2019/02,425,23/02/2019,6,SS 67 tra Dovadola e Rocca San Casciano,3329,00,3243,86,2551,778,0,3329
2019/02,425,24/02/2019,7,SS 67 tra Dovadola e Rocca San Casciano,2832,00,2812,20,2310,522,0,2832
2019/02,425,25/02/2019,1,SS 67 tra Dovadola e Rocca San Casciano,3394,00,3191,203,2743,651,3394,0
2019/02,425,26/02/2019,2,SS 67 tra Dovadola e Rocca San Casciano,3380,10,3172,207,2758,622,3380,0
2019/02,425,27/02/2019,3,SS 67 tra Dovadola e Rocca San Casciano,3647,00,3426,221,2945,702,3647,0
2019/02,425,28/02/2019,4,SS 67 tra Dovadola e Rocca San Casciano,3513,00,3311,202,2772,741,3513,0
2019/02,426,15/02/2019,5,SS 63 tra Casina e Vezzano sul Crostolo,15258,00,14744,514,11525,3733,15258,0
2019/02,426,16/02/2019,6,SS 63 tra Casina e Vezzano sul Crostolo,14466,00,14278,188,10786,3680,0,14466
2019/02,426,17/02/2019,7,SS 63 tra Casina e Vezzano sul Crostolo,13058,00,12983,75,9919,3139,0,13058
2019/02,426,18/02/2019,1,SS 63 tra Casina e Vezzano sul Crostolo,14002,00,13472,530,10916,3086,14002,0
2019/02,426,19/02/2019,2,SS 63 tra Casina e Vezzano sul Crostolo,14308,00,13833,475,11132,3176,14308,0
2019/02,426,20/02/2019,3,SS 63 tra Casina e Vezzano sul Crostolo,14461,00,13957,504,11269,3192,14461,0
2019/02,426,21/02/2019,4,SS 63 tra Casina e Vezzano sul Crostolo,14623,10,14122,500,11233,3390,14623,0
2019/02,426,22/02/2019,5,SS 63 tra Casina e Vezzano sul Crostolo,15235,10,14739,495,11507,3728,15235,0
2019/02,426,23/02/2019,6,SS 63 tra Casina e Vezzano sul Crostolo,14559,10,14348,210,10821,3738,0,14559
2019/02,426,24/02/2019,7,SS 63 tra Casina e Vezzano sul Crostolo,12297,00,12229,68,9298,2999,0,12297
2019/02,426,25/02/2019,1,SS 63 tra Casina e Vezzano sul Crostolo,14126,00,13585,541,11112,3014,14126,0
2019/02,426,26/02/2019,2,SS 63 tra Casina e Vezzano sul Crostolo,13990,00,13467,523,10891,3099,13990,0
2019/02,426,27/02/2019,3,SS 63 tra Casina e Vezzano sul Crostolo,14781,10,14290,490,11432,3349,14781,0
2019/02,426,28/02/2019,4,SS 63 tra Casina e Vezzano sul Crostolo,14931,10,14454,476,11513,3418,14931,0
2019/02,427,15/02/2019,5,SP 7 fra Viano e Scandiano (bivio SP 37),,,,,,,,
2019/02,427,16/02/2019,6,SP 7 fra Viano e Scandiano (bivio SP 37),,,,,,,,
2019/02,428,15/02/2019,5,SP 19 fra Colombaia (bivio SP 76) e il Bivio SP 486R al confine provinciale,3999,00,3569,430,3026,973,3999,0
2019/02,428,16/02/2019,6,SP 19 fra Colombaia (bivio SP 76) e il Bivio SP 486R al confine provinciale,3257,00,3184,73,2616,641,0,3257
2019/02,428,17/02/2019,7,SP 19 fra Colombaia (bivio SP 76) e il Bivio SP 486R al confine provinciale,3323,00,3296,27,2639,684,0,3323
2019/02,428,18/02/2019,1,SP 19 fra Colombaia (bivio SP 76) e il Bivio SP 486R al confine provinciale,3578,00,3187,391,2825,753,3578,0
2019/02,428,19/02/2019,2,SP 19 fra Colombaia (bivio SP 76) e il Bivio SP 486R al confine provinciale,3628,00,3148,480,2791,837,3628,0
2019/02,428,20/02/2019,3,SP 19 fra Colombaia (bivio SP 76) e il Bivio SP 486R al confine provinciale,3627,00,3208,419,2809,818,3627,0
2019/02,428,21/02/2019,4,SP 19 fra Colombaia (bivio SP 76) e il Bivio SP 486R al confine provinciale,3658,00,3261,397,2826,832,3658,0
2019/02,428,22/02/2019,5,SP 19 fra Colombaia (bivio SP 76) e il Bivio SP 486R al confine provinciale,3471,00,3093,378,2526,945,3471,0
2019/02,428,23/02/2019,6,SP 19 fra Colombaia (bivio SP 76) e il Bivio SP 486R al confine provinciale,2788,00,2740,48,1995,793,0,2788
2019/02,428,24/02/2019,7,SP 19 fra Colombaia (bivio SP 76) e il Bivio SP 486R al confine provinciale,3187,00,3159,28,2504,683,0,3187
2019/02,428,25/02/2019,1,SP 19 fra Colombaia (bivio SP 76) e il Bivio SP 486R al confine provinciale,3662,00,3254,408,2791,871,3662,0
2019/02,428,26/02/2019,2,SP 19 fra Colombaia (bivio SP 76) e il Bivio SP 486R al confine provinciale,3552,00,3169,383,2806,746,3552,0
2019/02,428,27/02/2019,3,SP 19 fra Colombaia (bivio SP 76) e il Bivio SP 486R al confine provinciale,3795,00,3364,431,2917,878,3795,0
2019/02,428,28/02/2019,4,SP 19 fra Colombaia (bivio SP 76) e il Bivio SP 486R al confine provinciale,3932,00,3457,475,3107,825,3932,0
2019/02,429,15/02/2019,5,SP 12 fra San Polo d'Enza e Montecchio Emilia (variante a sud abitato),8347,10,7444,902,6599,1748,8347,0
2019/02,429,16/02/2019,6,SP 12 fra San Polo d'Enza e Montecchio Emilia (variante a sud abitato),6944,00,6765,179,5337,1607,0,6944
2019/02,429,17/02/2019,7,SP 12 fra San Polo d'Enza e Montecchio Emilia (variante a sud abitato),5974,00,5885,89,4649,1325,0,5974
2019/02,429,18/02/2019,1,SP 12 fra San Polo d'Enza e Montecchio Emilia (variante a sud abitato),8113,00,7196,917,6692,1421,8113,0
2019/02,429,19/02/2019,2,SP 12 fra San Polo d'Enza e Montecchio Emilia (variante a sud abitato),7933,00,7063,870,6473,1460,7933,0
2019/02,429,20/02/2019,3,SP 12 fra San Polo d'Enza e Montecchio Emilia (variante a sud abitato),7963,10,7156,806,6453,1510,7963,0
2019/02,429,21/02/2019,4,SP 12 fra San Polo d'Enza e Montecchio Emilia (variante a sud abitato),8137,00,7312,825,6529,1608,8137,0
2019/02,429,22/02/2019,5,SP 12 fra San Polo d'Enza e Montecchio Emilia (variante a sud abitato),8188,00,7363,825,6514,1674,8188,0
2019/02,429,23/02/2019,6,SP 12 fra San Polo d'Enza e Montecchio Emilia (variante a sud abitato),6980,00,6795,185,5361,1619,0,6980
2019/02,429,24/02/2019,7,SP 12 fra San Polo d'Enza e Montecchio Emilia (variante a sud abitato),6074,00,5999,75,4644,1430,0,6074
2019/02,429,25/02/2019,1,SP 12 fra San Polo d'Enza e Montecchio Emilia (variante a sud abitato),7865,10,7035,829,6341,1524,7865,0
2019/02,429,26/02/2019,2,SP 12 fra San Polo d'Enza e Montecchio Emilia (variante a sud abitato),7804,00,6989,815,6333,1471,7804,0
2019/02,429,27/02/2019,3,SP 12 fra San Polo d'Enza e Montecchio Emilia (variante a sud abitato),8064,00,7290,774,6475,1589,8064,0
2019/02,429,28/02/2019,4,SP 12 fra San Polo d'Enza e Montecchio Emilia (variante a sud abitato),8021,00,7280,741,6479,1542,8021,0
2019/02,430,15/02/2019,5,SP 28 tra Montecchio Emilia e bivio circonvallazione,11100,10,10406,693,8789,2311,11100,0
2019/02,430,16/02/2019,6,SP 28 tra Montecchio Emilia e bivio circonvallazione,8567,10,8430,136,6311,2256,0,8567
2019/02,430,17/02/2019,7,SP 28 tra Montecchio Emilia e bivio circonvallazione,6271,00,6234,37,4535,1736,0,6271
2019/02,430,18/02/2019,1,SP 28 tra Montecchio Emilia e bivio circonvallazione,10442,00,9825,617,8670,1772,10442,0
2019/02,430,19/02/2019,2,SP 28 tra Montecchio Emilia e bivio circonvallazione,10704,00,10045,659,8784,1920,10704,0
2019/02,430,20/02/2019,3,SP 28 tra Montecchio Emilia e bivio circonvallazione,10855,00,10189,666,8876,1979,10855,0
2019/02,430,21/02/2019,4,SP 28 tra Montecchio Emilia e bivio circonvallazione,11071,10,10399,671,8968,2103,11071,0
2019/02,430,22/02/2019,5,SP 28 tra Montecchio Emilia e bivio circonvallazione,11349,20,10626,721,9010,2339,11349,0
2019/02,430,23/02/2019,6,SP 28 tra Montecchio Emilia e bivio circonvallazione,8450,00,8306,144,6247,2203,0,8450
2019/02,430,24/02/2019,7,SP 28 tra Montecchio Emilia e bivio circonvallazione,6909,00,6866,43,5141,1768,0,6909
2019/02,430,25/02/2019,1,SP 28 tra Montecchio Emilia e bivio circonvallazione,10673,00,10083,590,8860,1813,10673,0
2019/02,430,26/02/2019,2,SP 28 tra Montecchio Emilia e bivio circonvallazione,10861,10,10205,655,8971,1890,10861,0
2019/02,430,27/02/2019,3,SP 28 tra Montecchio Emilia e bivio circonvallazione,10829,00,10179,650,8790,2039,10829,0
2019/02,430,28/02/2019,4,SP 28 tra Montecchio Emilia e bivio circonvallazione,10402,00,9787,615,8292,2110,10402,0
2019/02,431,15/02/2019,5,SP 12 fra Sant'Ilario d'Enza (variante a sud) e Montecchio Emilia,6765,00,6500,265,5282,1483,6765,0
2019/02,431,16/02/2019,6,SP 12 fra Sant'Ilario d'Enza (variante a sud) e Montecchio Emilia,5850,00,5768,82,4547,1303,0,5850
2019/02,431,17/02/2019,7,SP 12 fra Sant'Ilario d'Enza (variante a sud) e Montecchio Emilia,4483,00,4469,14,3352,1131,0,4483
2019/02,431,18/02/2019,1,SP 12 fra Sant'Ilario d'Enza (variante a sud) e Montecchio Emilia,6602,10,6306,295,5445,1157,6602,0
2019/02,431,19/02/2019,2,SP 12 fra Sant'Ilario d'Enza (variante a sud) e Montecchio Emilia,6697,10,6412,284,5446,1251,6697,0
2019/02,431,20/02/2019,3,SP 12 fra Sant'Ilario d'Enza (variante a sud) e Montecchio Emilia,6695,00,6386,309,5399,1296,6695,0
2019/02,431,21/02/2019,4,SP 12 fra Sant'Ilario d'Enza (variante a sud) e Montecchio Emilia,6470,00,6252,218,5161,1309,6470,0
2019/02,431,22/02/2019,5,SP 12 fra Sant'Ilario d'Enza (variante a sud) e Montecchio Emilia,6778,00,6506,272,5343,1435,6778,0
2019/02,431,23/02/2019,6,SP 12 fra Sant'Ilario d'Enza (variante a sud) e Montecchio Emilia,5976,00,5910,66,4604,1372,0,5976
2019/02,431,24/02/2019,7,SP 12 fra Sant'Ilario d'Enza (variante a sud) e Montecchio Emilia,4553,00,4538,15,3402,1151,0,4553
2019/02,431,25/02/2019,1,SP 12 fra Sant'Ilario d'Enza (variante a sud) e Montecchio Emilia,6352,00,6097,255,5204,1148,6352,0
2019/02,431,26/02/2019,2,SP 12 fra Sant'Ilario d'Enza (variante a sud) e Montecchio Emilia,6505,00,6207,298,5237,1268,6505,0
2019/02,431,27/02/2019,3,SP 12 fra Sant'Ilario d'Enza (variante a sud) e Montecchio Emilia,6832,00,6483,349,5514,1318,6832,0
2019/02,431,28/02/2019,4,SP 12 fra Sant'Ilario d'Enza (variante a sud) e Montecchio Emilia,6759,00,6485,274,5393,1366,6759,0
2019/02,432,15/02/2019,5,SP 67 fra Calerno e Montecchio Emilia,11133,00,9786,1347,8869,2264,11133,0
2019/02,432,16/02/2019,6,SP 67 fra Calerno e Montecchio Emilia,7473,00,7257,216,5558,1915,0,7473
2019/02,432,17/02/2019,7,SP 67 fra Calerno e Montecchio Emilia,7136,00,7025,111,5379,1757,0,7136
2019/02,432,18/02/2019,1,SP 67 fra Calerno e Montecchio Emilia,10512,00,9222,1290,8609,1903,10512,0
2019/02,432,19/02/2019,2,SP 67 fra Calerno e Montecchio Emilia,10562,00,9194,1368,8524,2038,10562,0
2019/02,432,20/02/2019,3,SP 67 fra Calerno e Montecchio Emilia,10504,00,9224,1280,8535,1969,10504,0
2019/02,432,21/02/2019,4,SP 67 fra Calerno e Montecchio Emilia,10406,10,9141,1264,8368,2038,10406,0
2019/02,432,22/02/2019,5,SP 67 fra Calerno e Montecchio Emilia,11014,00,9701,1313,8717,2297,11014,0
2019/02,432,23/02/2019,6,SP 67 fra Calerno e Montecchio Emilia,7634,00,7377,257,5673,1961,0,7634
2019/02,432,24/02/2019,7,SP 67 fra Calerno e Montecchio Emilia,7087,00,6978,109,5217,1870,0,7087
2019/02,432,25/02/2019,1,SP 67 fra Calerno e Montecchio Emilia,10556,00,9221,1335,8555,2001,10556,0
2019/02,432,26/02/2019,2,SP 67 fra Calerno e Montecchio Emilia,10668,10,9354,1313,8695,1973,10668,0
2019/02,432,27/02/2019,3,SP 67 fra Calerno e Montecchio Emilia,10660,00,9374,1286,8624,2036,10660,0
2019/02,432,28/02/2019,4,SP 67 fra Calerno e Montecchio Emilia,10987,00,9669,1318,8883,2104,10987,0
2019/02,434,15/02/2019,5,Via San Nicola (ex SP 39) tra bivio per Taneto a Caprara,3479,00,3405,74,2711,768,3479,0
2019/02,434,16/02/2019,6,Via San Nicola (ex SP 39) tra bivio per Taneto a Caprara,2883,00,2845,38,2175,708,0,2883
2019/02,434,17/02/2019,7,Via San Nicola (ex SP 39) tra bivio per Taneto a Caprara,2378,00,2365,13,1740,638,0,2378
2019/02,434,18/02/2019,1,Via San Nicola (ex SP 39) tra bivio per Taneto a Caprara,3256,10,3165,90,2611,645,3256,0
2019/02,434,19/02/2019,2,Via San Nicola (ex SP 39) tra bivio per Taneto a Caprara,3398,00,3300,98,2754,644,3398,0
2019/02,434,20/02/2019,3,Via San Nicola (ex SP 39) tra bivio per Taneto a Caprara,3427,00,3326,101,2742,685,3427,0
2019/02,434,21/02/2019,4,Via San Nicola (ex SP 39) tra bivio per Taneto a Caprara,3432,00,3348,84,2734,698,3432,0
2019/02,434,22/02/2019,5,Via San Nicola (ex SP 39) tra bivio per Taneto a Caprara,3458,10,3362,95,2654,804,3458,0
2019/02,434,23/02/2019,6,Via San Nicola (ex SP 39) tra bivio per Taneto a Caprara,2973,00,2925,48,2242,731,0,2973
2019/02,434,24/02/2019,7,Via San Nicola (ex SP 39) tra bivio per Taneto a Caprara,2222,00,2210,12,1612,610,0,2222
2019/02,434,25/02/2019,1,Via San Nicola (ex SP 39) tra bivio per Taneto a Caprara,3259,00,3178,81,2642,617,3259,0
2019/02,434,26/02/2019,2,Via San Nicola (ex SP 39) tra bivio per Taneto a Caprara,3383,00,3284,99,2680,703,3383,0
2019/02,434,27/02/2019,3,Via San Nicola (ex SP 39) tra bivio per Taneto a Caprara,3486,00,3411,75,2791,695,3486,0
2019/02,434,28/02/2019,4,Via San Nicola (ex SP 39) tra bivio per Taneto a Caprara,3395,00,3308,87,2690,705,3395,0
2019/02,435,22/02/2019,5,SP 37Bis dalla località Selbagnone al bivio SP 72 (Meldola),5934,20,5622,310,4684,1250,5934,0
2019/02,435,23/02/2019,6,SP 37Bis dalla località Selbagnone al bivio SP 72 (Meldola),6711,40,6562,145,4778,1933,0,6711
2019/02,435,24/02/2019,7,SP 37Bis dalla località Selbagnone al bivio SP 72 (Meldola),5653,30,5621,29,4214,1439,0,5653
2019/02,435,25/02/2019,1,SP 37Bis dalla località Selbagnone al bivio SP 72 (Meldola),7087,30,6641,443,5693,1394,7087,0
2019/02,435,26/02/2019,2,SP 37Bis dalla località Selbagnone al bivio SP 72 (Meldola),7426,30,6940,483,5899,1527,7426,0
2019/02,435,27/02/2019,3,SP 37Bis dalla località Selbagnone al bivio SP 72 (Meldola),7691,10,7240,450,6007,1684,7691,0
2019/02,435,28/02/2019,4,SP 37Bis dalla località Selbagnone al bivio SP 72 (Meldola),7878,40,7396,478,6167,1711,7878,0
2019/02,436,15/02/2019,5,SP 26 da Santa Sofia a San Piero in Bagno,889,00,844,45,681,208,889,0
2019/02,436,16/02/2019,6,SP 26 da Santa Sofia a San Piero in Bagno,899,00,878,21,644,255,0,899
2019/02,436,17/02/2019,7,SP 26 da Santa Sofia a San Piero in Bagno,981,00,980,1,771,210,0,981
2019/02,436,18/02/2019,1,SP 26 da Santa Sofia a San Piero in Bagno,781,00,749,32,618,163,781,0
2019/02,436,19/02/2019,2,SP 26 da Santa Sofia a San Piero in Bagno,849,00,808,41,680,169,849,0
2019/02,436,20/02/2019,3,SP 26 da Santa Sofia a San Piero in Bagno,902,10,852,49,739,163,902,0
2019/02,436,21/02/2019,4,SP 26 da Santa Sofia a San Piero in Bagno,828,00,776,52,661,167,828,0
2019/02,436,22/02/2019,5,SP 26 da Santa Sofia a San Piero in Bagno,825,00,780,45,622,203,825,0
2019/02,436,23/02/2019,6,SP 26 da Santa Sofia a San Piero in Bagno,866,00,846,20,633,233,0,866
2019/02,436,24/02/2019,7,SP 26 da Santa Sofia a San Piero in Bagno,864,00,861,3,677,187,0,864
2019/02,436,25/02/2019,1,SP 26 da Santa Sofia a San Piero in Bagno,818,00,777,41,629,189,818,0
2019/02,436,26/02/2019,2,SP 26 da Santa Sofia a San Piero in Bagno,806,10,750,55,642,164,806,0
2019/02,436,27/02/2019,3,SP 26 da Santa Sofia a San Piero in Bagno,899,10,844,54,726,173,899,0
2019/02,436,28/02/2019,4,SP 26 da Santa Sofia a San Piero in Bagno,873,10,824,48,672,201,873,0
2019/02,437,15/02/2019,5,SP 13 tra SS 9 (Santarcangelo di Romagna) e SP 92 (località Camerano),7311,00,6300,1011,5758,1553,7311,0
2019/02,437,16/02/2019,6,SP 13 tra SS 9 (Santarcangelo di Romagna) e SP 92 (località Camerano),6016,00,5771,245,4501,1515,0,6016
2019/02,437,17/02/2019,7,SP 13 tra SS 9 (Santarcangelo di Romagna) e SP 92 (località Camerano),4793,10,4771,21,3650,1143,0,4793
2019/02,437,18/02/2019,1,SP 13 tra SS 9 (Santarcangelo di Romagna) e SP 92 (località Camerano),7033,00,5981,1052,5768,1265,7033,0
2019/02,437,19/02/2019,2,SP 13 tra SS 9 (Santarcangelo di Romagna) e SP 92 (località Camerano),7061,00,6034,1027,5703,1358,7061,0
2019/02,437,20/02/2019,3,SP 13 tra SS 9 (Santarcangelo di Romagna) e SP 92 (località Camerano),6927,10,5950,976,5590,1337,6927,0
2019/02,437,21/02/2019,4,SP 13 tra SS 9 (Santarcangelo di Romagna) e SP 92 (località Camerano),7048,20,6049,997,5589,1459,7048,0
2019/02,437,22/02/2019,5,SP 13 tra SS 9 (Santarcangelo di Romagna) e SP 92 (località Camerano),7108,10,6130,977,5604,1504,7108,0
2019/02,437,23/02/2019,6,SP 13 tra SS 9 (Santarcangelo di Romagna) e SP 92 (località Camerano),5727,00,5498,229,4312,1415,0,5727
2019/02,437,24/02/2019,7,SP 13 tra SS 9 (Santarcangelo di Romagna) e SP 92 (località Camerano),4638,00,4622,16,3399,1239,0,4638
2019/02,437,25/02/2019,1,SP 13 tra SS 9 (Santarcangelo di Romagna) e SP 92 (località Camerano),7035,10,5979,1055,5698,1337,7035,0
2019/02,437,26/02/2019,2,SP 13 tra SS 9 (Santarcangelo di Romagna) e SP 92 (località Camerano),7090,10,6028,1061,5742,1348,7090,0
2019/02,437,27/02/2019,3,SP 13 tra SS 9 (Santarcangelo di Romagna) e SP 92 (località Camerano),7060,00,6000,1060,5664,1396,7060,0
2019/02,437,28/02/2019,4,SP 13 tra SS 9 (Santarcangelo di Romagna) e SP 92 (località Camerano),7133,00,6044,1089,5742,1391,7133,0
2019/02,438,15/02/2019,5,SP 14 tra Colombare (bivio SP 14Ter) e bivio SP 258R,8616,00,7990,626,6794,1822,8616,0
2019/02,438,16/02/2019,6,SP 14 tra Colombare (bivio SP 14Ter) e bivio SP 258R,6834,10,6665,168,5140,1694,0,6834
2019/02,438,17/02/2019,7,SP 14 tra Colombare (bivio SP 14Ter) e bivio SP 258R,7097,00,7079,18,5656,1441,0,7097
2019/02,438,18/02/2019,1,SP 14 tra Colombare (bivio SP 14Ter) e bivio SP 258R,7854,00,7171,683,6474,1380,7854,0
2019/02,438,19/02/2019,2,SP 14 tra Colombare (bivio SP 14Ter) e bivio SP 258R,7857,10,7216,640,6394,1463,7857,0
2019/02,438,20/02/2019,3,SP 14 tra Colombare (bivio SP 14Ter) e bivio SP 258R,8081,00,7413,668,6489,1592,8081,0
2019/02,438,21/02/2019,4,SP 14 tra Colombare (bivio SP 14Ter) e bivio SP 258R,8118,10,7509,608,6537,1581,8118,0
2019/02,438,22/02/2019,5,SP 14 tra Colombare (bivio SP 14Ter) e bivio SP 258R,8576,00,7965,611,6795,1781,8576,0
2019/02,438,23/02/2019,6,SP 14 tra Colombare (bivio SP 14Ter) e bivio SP 258R,6922,00,6747,175,5150,1772,0,6922
2019/02,438,24/02/2019,7,SP 14 tra Colombare (bivio SP 14Ter) e bivio SP 258R,6090,00,6071,19,4593,1497,0,6090
2019/02,438,25/02/2019,1,SP 14 tra Colombare (bivio SP 14Ter) e bivio SP 258R,7733,00,7076,657,6238,1495,7733,0
2019/02,438,26/02/2019,2,SP 14 tra Colombare (bivio SP 14Ter) e bivio SP 258R,8010,00,7317,693,6517,1493,8010,0
2019/02,438,27/02/2019,3,SP 14 tra Colombare (bivio SP 14Ter) e bivio SP 258R,8124,00,7485,639,6582,1542,8124,0
2019/02,438,28/02/2019,4,SP 14 tra Colombare (bivio SP 14Ter) e bivio SP 258R,8217,20,7582,633,6564,1653,8217,0
2019/02,439,15/02/2019,5,SP 49 da Santarcangelo di Romagna alla località Posta (bivio SP 258R),13531,10,12642,888,10509,3022,13531,0
2019/02,439,16/02/2019,6,SP 49 da Santarcangelo di Romagna alla località Posta (bivio SP 258R),11647,00,11445,202,8529,3118,0,11647
2019/02,439,17/02/2019,7,SP 49 da Santarcangelo di Romagna alla località Posta (bivio SP 258R),10403,00,10367,36,7976,2427,0,10403
2019/02,439,18/02/2019,1,SP 49 da Santarcangelo di Romagna alla località Posta (bivio SP 258R),12219,00,11423,796,9834,2385,12219,0
2019/02,439,19/02/2019,2,SP 49 da Santarcangelo di Romagna alla località Posta (bivio SP 258R),12623,20,11751,870,10080,2543,12623,0
2019/02,439,20/02/2019,3,SP 49 da Santarcangelo di Romagna alla località Posta (bivio SP 258R),12493,10,11534,958,10011,2482,12493,0
2019/02,439,21/02/2019,4,SP 49 da Santarcangelo di Romagna alla località Posta (bivio SP 258R),12674,00,11751,923,10136,2538,12674,0
2019/02,439,22/02/2019,5,SP 49 da Santarcangelo di Romagna alla località Posta (bivio SP 258R),13157,00,12245,912,10219,2938,13157,0
2019/02,439,23/02/2019,6,SP 49 da Santarcangelo di Romagna alla località Posta (bivio SP 258R),11458,00,11211,247,8435,3023,0,11458
2019/02,439,24/02/2019,7,SP 49 da Santarcangelo di Romagna alla località Posta (bivio SP 258R),8854,00,8832,22,6488,2366,0,8854
2019/02,439,25/02/2019,1,SP 49 da Santarcangelo di Romagna alla località Posta (bivio SP 258R),12253,20,11390,861,9862,2391,12253,0
2019/02,439,26/02/2019,2,SP 49 da Santarcangelo di Romagna alla località Posta (bivio SP 258R),12492,10,11595,896,10017,2475,12492,0
2019/02,439,27/02/2019,3,SP 49 da Santarcangelo di Romagna alla località Posta (bivio SP 258R),12505,30,11657,845,9982,2523,12505,0
2019/02,439,28/02/2019,4,SP 49 da Santarcangelo di Romagna alla località Posta (bivio SP 258R),12701,20,11776,923,10077,2624,12701,0
2019/02,440,15/02/2019,5,SP 35 tra bivio SP 50 (località Cella) e Sant'Andrea in Casale,12988,00,12619,369,10016,2972,12988,0
2019/02,440,16/02/2019,6,SP 35 tra bivio SP 50 (località Cella) e Sant'Andrea in Casale,11864,00,11715,149,8701,3163,0,11864
2019/02,440,17/02/2019,7,SP 35 tra bivio SP 50 (località Cella) e Sant'Andrea in Casale,9320,00,9302,18,6717,2603,0,9320
2019/02,440,18/02/2019,1,SP 35 tra bivio SP 50 (località Cella) e Sant'Andrea in Casale,12198,10,11825,372,9854,2344,12198,0
2019/02,440,19/02/2019,2,SP 35 tra bivio SP 50 (località Cella) e Sant'Andrea in Casale,13240,00,12851,389,10635,2605,13240,0
2019/02,440,20/02/2019,3,SP 35 tra bivio SP 50 (località Cella) e Sant'Andrea in Casale,13153,00,12762,391,10527,2626,13153,0
2019/02,440,21/02/2019,4,SP 35 tra bivio SP 50 (località Cella) e Sant'Andrea in Casale,13527,00,13187,340,10770,2757,13527,0
2019/02,440,22/02/2019,5,SP 35 tra bivio SP 50 (località Cella) e Sant'Andrea in Casale,13704,10,13353,350,10555,3149,13704,0
2019/02,440,23/02/2019,6,SP 35 tra bivio SP 50 (località Cella) e Sant'Andrea in Casale,12426,00,12281,145,9007,3419,0,12426
2019/02,440,24/02/2019,7,SP 35 tra bivio SP 50 (località Cella) e Sant'Andrea in Casale,9700,00,9673,27,6951,2749,0,9700
2019/02,440,25/02/2019,1,SP 35 tra bivio SP 50 (località Cella) e Sant'Andrea in Casale,13188,00,12809,379,10748,2440,13188,0
2019/02,440,26/02/2019,2,SP 35 tra bivio SP 50 (località Cella) e Sant'Andrea in Casale,13102,00,12757,345,10505,2597,13102,0
2019/02,440,27/02/2019,3,SP 35 tra bivio SP 50 (località Cella) e Sant'Andrea in Casale,13701,00,13370,331,10827,2874,13701,0
2019/02,440,28/02/2019,4,SP 35 tra bivio SP 50 (località Cella) e Sant'Andrea in Casale,13855,00,13476,379,10937,2918,13855,0
2019/02,441,15/02/2019,5,SP 58 tra San Giovanni in Marignano e il confine regionale (Marche),9238,00,8860,378,7144,2094,9238,0
2019/02,441,16/02/2019,6,SP 58 tra San Giovanni in Marignano e il confine regionale (Marche),8371,00,8281,90,6060,2311,0,8371
2019/02,441,17/02/2019,7,SP 58 tra San Giovanni in Marignano e il confine regionale (Marche),7066,00,7051,15,5181,1885,0,7066
2019/02,441,18/02/2019,1,SP 58 tra San Giovanni in Marignano e il confine regionale (Marche),8715,00,8309,406,7018,1697,8715,0
2019/02,441,19/02/2019,2,SP 58 tra San Giovanni in Marignano e il confine regionale (Marche),8761,10,8341,419,7042,1719,8761,0
2019/02,441,20/02/2019,3,SP 58 tra San Giovanni in Marignano e il confine regionale (Marche),8850,00,8437,413,7103,1747,8850,0
2019/02,441,21/02/2019,4,SP 58 tra San Giovanni in Marignano e il confine regionale (Marche),9118,00,8713,405,7252,1866,9118,0
2019/02,441,22/02/2019,5,SP 58 tra San Giovanni in Marignano e il confine regionale (Marche),9145,10,8712,432,7161,1984,9145,0
2019/02,441,23/02/2019,6,SP 58 tra San Giovanni in Marignano e il confine regionale (Marche),7756,00,7659,97,5599,2157,0,7756
2019/02,441,24/02/2019,7,SP 58 tra San Giovanni in Marignano e il confine regionale (Marche),6766,10,6749,16,4824,1942,0,6766
2019/02,441,25/02/2019,1,SP 58 tra San Giovanni in Marignano e il confine regionale (Marche),8864,10,8469,394,7165,1699,8864,0
2019/02,441,26/02/2019,2,SP 58 tra San Giovanni in Marignano e il confine regionale (Marche),8949,00,8515,434,7228,1721,8949,0
2019/02,441,27/02/2019,3,SP 58 tra San Giovanni in Marignano e il confine regionale (Marche),8964,00,8530,434,7179,1785,8964,0
2019/02,441,28/02/2019,4,SP 58 tra San Giovanni in Marignano e il confine regionale (Marche),9356,10,8941,414,7418,1938,9356,0
2019/02,442,15/02/2019,5,SP 118 tra Casemurate (bivio SP 254R) e il confine provinciale,5215,20,4611,602,4014,1201,5215,0
2019/02,442,16/02/2019,6,SP 118 tra Casemurate (bivio SP 254R) e il confine provinciale,4956,00,4744,212,3713,1243,0,4956
2019/02,442,17/02/2019,7,SP 118 tra Casemurate (bivio SP 254R) e il confine provinciale,4532,00,4475,57,3453,1079,0,4532
2019/02,442,18/02/2019,1,SP 118 tra Casemurate (bivio SP 254R) e il confine provinciale,4843,20,4236,605,3871,972,4843,0
2019/02,442,19/02/2019,2,SP 118 tra Casemurate (bivio SP 254R) e il confine provinciale,4788,20,4169,617,3840,948,4788,0
2019/02,442,20/02/2019,3,SP 118 tra Casemurate (bivio SP 254R) e il confine provinciale,4863,30,4238,622,3874,989,4863,0
2019/02,442,21/02/2019,4,SP 118 tra Casemurate (bivio SP 254R) e il confine provinciale,4157,10,3673,483,3317,840,4157,0
2019/02,442,22/02/2019,5,SP 118 tra Casemurate (bivio SP 254R) e il confine provinciale,4114,10,3745,368,3135,979,4114,0
2019/02,442,23/02/2019,6,SP 118 tra Casemurate (bivio SP 254R) e il confine provinciale,3855,00,3730,125,2862,993,0,3855
2019/02,442,24/02/2019,7,SP 118 tra Casemurate (bivio SP 254R) e il confine provinciale,3158,00,3119,39,2328,830,0,3158
2019/02,442,25/02/2019,1,SP 118 tra Casemurate (bivio SP 254R) e il confine provinciale,3692,00,3311,381,2929,763,3692,0
2019/02,442,26/02/2019,2,SP 118 tra Casemurate (bivio SP 254R) e il confine provinciale,3578,00,3234,344,2859,719,3578,0
2019/02,442,27/02/2019,3,SP 118 tra Casemurate (bivio SP 254R) e il confine provinciale,3742,00,3441,301,2998,744,3742,0
2019/02,442,28/02/2019,4,SP 118 tra Casemurate (bivio SP 254R) e il confine provinciale,3716,00,3386,330,2942,774,3716,0
2019/02,443,15/02/2019,5,SP 16 tra Faenza e il confine provinciale,5733,00,5437,296,4433,1300,5733,0
2019/02,443,16/02/2019,6,SP 16 tra Faenza e il confine provinciale,5319,00,5208,111,4102,1217,0,5319
2019/02,443,17/02/2019,7,SP 16 tra Faenza e il confine provinciale,4643,10,4626,16,3618,1025,0,4643
2019/02,443,18/02/2019,1,SP 16 tra Faenza e il confine provinciale,5354,00,5070,284,4284,1070,5354,0
2019/02,443,19/02/2019,2,SP 16 tra Faenza e il confine provinciale,5637,00,5363,274,4515,1122,5637,0
2019/02,443,20/02/2019,3,SP 16 tra Faenza e il confine provinciale,5517,00,5200,317,4416,1101,5517,0
2019/02,443,21/02/2019,4,SP 16 tra Faenza e il confine provinciale,5695,00,5442,253,4512,1183,5695,0
2019/02,443,22/02/2019,5,SP 16 tra Faenza e il confine provinciale,5949,00,5631,318,4522,1427,5949,0
2019/02,443,23/02/2019,6,SP 16 tra Faenza e il confine provinciale,5485,10,5398,86,4143,1342,0,5485
2019/02,443,24/02/2019,7,SP 16 tra Faenza e il confine provinciale,4661,00,4644,17,3637,1024,0,4661
2019/02,443,25/02/2019,1,SP 16 tra Faenza e il confine provinciale,5353,10,5090,262,4263,1090,5353,0
2019/02,443,26/02/2019,2,SP 16 tra Faenza e il confine provinciale,5521,00,5268,253,4371,1150,5521,0
2019/02,443,27/02/2019,3,SP 16 tra Faenza e il confine provinciale,5646,00,5362,284,4511,1135,5646,0
2019/02,443,28/02/2019,4,SP 16 tra Faenza e il confine provinciale,5650,10,5382,267,4462,1188,5650,0
2019/02,444,15/02/2019,5,SP 5 fra Russi e San Pancrazio,,,,,,,,
2019/02,444,16/02/2019,6,SP 5 fra Russi e San Pancrazio,,,,,,,,
2019/02,444,17/02/2019,7,SP 5 fra Russi e San Pancrazio,,,,,,,,
2019/02,444,18/02/2019,1,SP 5 fra Russi e San Pancrazio,,,,,,,,
2019/02,444,19/02/2019,2,SP 5 fra Russi e San Pancrazio,,,,,,,,
2019/02,444,20/02/2019,3,SP 5 fra Russi e San Pancrazio,,,,,,,,
2019/02,444,21/02/2019,4,SP 5 fra Russi e San Pancrazio,,,,,,,,
2019/02,444,22/02/2019,5,SP 5 fra Russi e San Pancrazio,,,,,,,,
2019/02,444,23/02/2019,6,SP 5 fra Russi e San Pancrazio,,,,,,,,
2019/02,444,24/02/2019,7,SP 5 fra Russi e San Pancrazio,,,,,,,,
2019/02,444,25/02/2019,1,SP 5 fra Russi e San Pancrazio,,,,,,,,
2019/02,444,26/02/2019,2,SP 5 fra Russi e San Pancrazio,,,,,,,,
2019/02,444,27/02/2019,3,SP 5 fra Russi e San Pancrazio,,,,,,,,
2019/02,444,28/02/2019,4,SP 5 fra Russi e San Pancrazio,,,,,,,,
2019/02,445,15/02/2019,5,SP 610R fra SP 253R e Conselice,5928,10,5090,837,4547,1381,5928,0
2019/02,445,16/02/2019,6,SP 610R fra SP 253R e Conselice,4480,00,4306,174,3256,1224,0,4480
2019/02,445,17/02/2019,7,SP 610R fra SP 253R e Conselice,3995,10,3949,45,2959,1036,0,3995
2019/02,445,18/02/2019,1,SP 610R fra SP 253R e Conselice,5555,00,4735,820,4417,1138,5555,0
2019/02,445,19/02/2019,2,SP 610R fra SP 253R e Conselice,5928,10,5072,855,4702,1226,5928,0
2019/02,445,20/02/2019,3,SP 610R fra SP 253R e Conselice,5821,00,4955,866,4523,1298,5821,0
2019/02,445,21/02/2019,4,SP 610R fra SP 253R e Conselice,5942,00,5154,788,4678,1264,5942,0
2019/02,445,22/02/2019,5,SP 610R fra SP 253R e Conselice,5948,10,5194,753,4582,1366,5948,0
2019/02,445,23/02/2019,6,SP 610R fra SP 253R e Conselice,4635,00,4473,162,3351,1284,0,4635
2019/02,445,24/02/2019,7,SP 610R fra SP 253R e Conselice,4209,00,4161,48,3178,1031,0,4209
2019/02,445,25/02/2019,1,SP 610R fra SP 253R e Conselice,5474,10,4704,769,4353,1121,5474,0
2019/02,445,26/02/2019,2,SP 610R fra SP 253R e Conselice,5600,10,4778,821,4473,1127,5600,0
2019/02,445,27/02/2019,3,SP 610R fra SP 253R e Conselice,5787,10,4949,837,4548,1239,5787,0
2019/02,445,28/02/2019,4,SP 610R fra SP 253R e Conselice,5649,00,4879,770,4410,1239,5649,0
2019/02,446,15/02/2019,5,SP 13 in località Santa Maria di Fabriago,9388,00,8775,613,7293,2095,9388,0
2019/02,446,16/02/2019,6,SP 13 in località Santa Maria di Fabriago,7454,00,7287,167,5465,1989,0,7454
2019/02,446,17/02/2019,7,SP 13 in località Santa Maria di Fabriago,5635,00,5597,38,4047,1588,0,5635
2019/02,446,18/02/2019,1,SP 13 in località Santa Maria di Fabriago,8880,20,8238,640,7176,1704,8880,0
2019/02,446,19/02/2019,2,SP 13 in località Santa Maria di Fabriago,9139,00,8431,708,7408,1731,9139,0
2019/02,446,20/02/2019,3,SP 13 in località Santa Maria di Fabriago,9301,10,8655,645,7484,1817,9301,0
2019/02,446,21/02/2019,4,SP 13 in località Santa Maria di Fabriago,9272,00,8541,731,7400,1872,9272,0
2019/02,446,22/02/2019,5,SP 13 in località Santa Maria di Fabriago,9393,00,8673,720,7329,2064,9393,0
2019/02,446,23/02/2019,6,SP 13 in località Santa Maria di Fabriago,7542,00,7310,232,5535,2007,0,7542
2019/02,446,24/02/2019,7,SP 13 in località Santa Maria di Fabriago,5730,00,5698,32,4116,1614,0,5730
2019/02,446,25/02/2019,1,SP 13 in località Santa Maria di Fabriago,8924,00,8231,693,7259,1665,8924,0
2019/02,446,26/02/2019,2,SP 13 in località Santa Maria di Fabriago,9320,00,8600,720,7517,1803,9320,0
2019/02,446,27/02/2019,3,SP 13 in località Santa Maria di Fabriago,9595,00,8917,678,7697,1898,9595,0
2019/02,446,28/02/2019,4,SP 13 in località Santa Maria di Fabriago,8812,10,8107,704,6985,1827,8812,0
2019/02,447,15/02/2019,5,SP 28 in località Molinazzo (Comune di Gossolengo),5541,00,5354,187,4331,1210,5541,0
2019/02,447,16/02/2019,6,SP 28 in località Molinazzo (Comune di Gossolengo),5021,00,4942,79,3790,1231,0,5021
2019/02,447,17/02/2019,7,SP 28 in località Molinazzo (Comune di Gossolengo),5032,00,5012,20,4150,882,0,5032
2019/02,447,18/02/2019,1,SP 28 in località Molinazzo (Comune di Gossolengo),5171,10,4874,296,4194,977,5171,0
2019/02,447,19/02/2019,2,SP 28 in località Molinazzo (Comune di Gossolengo),4983,00,4770,213,4046,937,4983,0
2019/02,447,20/02/2019,3,SP 28 in località Molinazzo (Comune di Gossolengo),5362,00,5089,273,4337,1025,5362,0
2019/02,447,21/02/2019,4,SP 28 in località Molinazzo (Comune di Gossolengo),5267,00,5033,234,4214,1053,5267,0
2019/02,447,22/02/2019,5,SP 28 in località Molinazzo (Comune di Gossolengo),5716,00,5480,236,4466,1250,5716,0
2019/02,447,23/02/2019,6,SP 28 in località Molinazzo (Comune di Gossolengo),5080,00,4996,84,3858,1222,0,5080
2019/02,447,24/02/2019,7,SP 28 in località Molinazzo (Comune di Gossolengo),5305,00,5280,25,4349,956,0,5305
2019/02,447,25/02/2019,1,SP 28 in località Molinazzo (Comune di Gossolengo),5034,00,4790,244,4064,970,5034,0
2019/02,447,26/02/2019,2,SP 28 in località Molinazzo (Comune di Gossolengo),5114,00,4870,244,4177,937,5114,0
2019/02,447,27/02/2019,3,SP 28 in località Molinazzo (Comune di Gossolengo),5468,00,5212,256,4333,1135,5468,0
2019/02,447,28/02/2019,4,SP 28 in località Molinazzo (Comune di Gossolengo),5500,00,5201,299,4369,1131,5500,0
2019/02,448,15/02/2019,5,SP 5 fra Reggiolo e intersezione SP 45 per Fabbrico,8017,00,7172,845,6136,1881,8017,0
2019/02,448,16/02/2019,6,SP 5 fra Reggiolo e intersezione SP 45 per Fabbrico,6642,00,6486,156,4727,1915,0,6642
2019/02,448,17/02/2019,7,SP 5 fra Reggiolo e intersezione SP 45 per Fabbrico,6280,00,6233,47,4310,1970,0,6280
2019/02,448,18/02/2019,1,SP 5 fra Reggiolo e intersezione SP 45 per Fabbrico,7313,00,6448,865,5904,1409,7313,0
2019/02,448,19/02/2019,2,SP 5 fra Reggiolo e intersezione SP 45 per Fabbrico,7406,00,6653,753,5883,1523,7406,0
2019/02,448,20/02/2019,3,SP 5 fra Reggiolo e intersezione SP 45 per Fabbrico,7464,00,6601,863,5901,1563,7464,0
2019/02,448,21/02/2019,4,SP 5 fra Reggiolo e intersezione SP 45 per Fabbrico,7691,00,6836,855,6042,1649,7691,0
2019/02,448,22/02/2019,5,SP 5 fra Reggiolo e intersezione SP 45 per Fabbrico,7978,10,7201,776,6129,1849,7978,0
2019/02,448,23/02/2019,6,SP 5 fra Reggiolo e intersezione SP 45 per Fabbrico,6263,10,6113,149,4332,1931,0,6263
2019/02,448,24/02/2019,7,SP 5 fra Reggiolo e intersezione SP 45 per Fabbrico,5603,00,5562,41,3945,1658,0,5603
2019/02,448,25/02/2019,1,SP 5 fra Reggiolo e intersezione SP 45 per Fabbrico,7204,10,6439,764,5698,1506,7204,0
2019/02,448,26/02/2019,2,SP 5 fra Reggiolo e intersezione SP 45 per Fabbrico,7589,10,6727,861,6074,1515,7589,0
2019/02,448,27/02/2019,3,SP 5 fra Reggiolo e intersezione SP 45 per Fabbrico,7538,00,6773,765,5989,1549,7538,0
2019/02,448,28/02/2019,4,SP 5 fra Reggiolo e intersezione SP 45 per Fabbrico,7697,00,6884,813,6096,1601,7697,0
2019/02,449,15/02/2019,5,SP 111 fra via Emilia e la variante Asse Val d'Enza,13127,00,10891,2236,10523,2604,13127,0
2019/02,449,16/02/2019,6,SP 111 fra via Emilia e la variante Asse Val d'Enza,8112,10,7715,396,5911,2201,0,8112
2019/02,449,17/02/2019,7,SP 111 fra via Emilia e la variante Asse Val d'Enza,8125,00,7966,159,6004,2121,0,8125
2019/02,449,18/02/2019,1,SP 111 fra via Emilia e la variante Asse Val d'Enza,12081,00,9957,2124,9772,2309,12081,0
2019/02,449,19/02/2019,2,SP 111 fra via Emilia e la variante Asse Val d'Enza,12411,00,10184,2227,9994,2417,12411,0
2019/02,449,20/02/2019,3,SP 111 fra via Emilia e la variante Asse Val d'Enza,12330,00,10186,2144,9968,2362,12330,0
2019/02,449,21/02/2019,4,SP 111 fra via Emilia e la variante Asse Val d'Enza,12314,10,10103,2210,9777,2537,12314,0
2019/02,449,22/02/2019,5,SP 111 fra via Emilia e la variante Asse Val d'Enza,12659,10,10537,2121,9959,2700,12659,0
2019/02,449,23/02/2019,6,SP 111 fra via Emilia e la variante Asse Val d'Enza,8352,00,7966,386,6049,2303,0,8352
2019/02,449,24/02/2019,7,SP 111 fra via Emilia e la variante Asse Val d'Enza,8092,00,7934,158,5887,2205,0,8092
2019/02,449,25/02/2019,1,SP 111 fra via Emilia e la variante Asse Val d'Enza,11862,10,9809,2052,9570,2292,11862,0
2019/02,449,26/02/2019,2,SP 111 fra via Emilia e la variante Asse Val d'Enza,12355,10,10153,2201,10073,2282,12355,0
2019/02,449,27/02/2019,3,SP 111 fra via Emilia e la variante Asse Val d'Enza,12335,10,10222,2112,9933,2402,12335,0
2019/02,449,28/02/2019,4,SP 111 fra via Emilia e la variante Asse Val d'Enza,12521,00,10360,2161,10097,2424,12521,0
2019/02,450,15/02/2019,5,SP 35 sul Ponte Po,8943,60,7906,1031,6792,2151,8943,0
2019/02,450,16/02/2019,6,SP 35 sul Ponte Po,7404,00,7232,172,5360,2044,0,7404
2019/02,450,17/02/2019,7,SP 35 sul Ponte Po,5479,10,5447,31,3883,1596,0,5479
2019/02,450,18/02/2019,1,SP 35 sul Ponte Po,8339,10,7283,1055,6787,1552,8339,0
2019/02,450,19/02/2019,2,SP 35 sul Ponte Po,8372,30,7298,1071,6771,1601,8372,0
2019/02,450,20/02/2019,3,SP 35 sul Ponte Po,8040,20,7059,979,6358,1682,8040,0
2019/02,450,21/02/2019,4,SP 35 sul Ponte Po,8512,40,7518,990,6803,1709,8512,0
2019/02,450,22/02/2019,5,SP 35 sul Ponte Po,8986,60,8024,956,6974,2012,8986,0
2019/02,450,23/02/2019,6,SP 35 sul Ponte Po,7475,00,7302,173,5375,2100,0,7475
2019/02,450,24/02/2019,7,SP 35 sul Ponte Po,5394,00,5359,35,3839,1555,0,5394
2019/02,450,25/02/2019,1,SP 35 sul Ponte Po,8118,160,7108,994,6485,1633,8118,0
2019/02,450,26/02/2019,2,SP 35 sul Ponte Po,9219,120,8117,1090,7558,1661,9219,0
2019/02,450,27/02/2019,3,SP 35 sul Ponte Po,8703,130,7645,1045,6863,1840,8703,0
2019/02,450,28/02/2019,4,SP 35 sul Ponte Po,8512,40,7477,1031,6723,1789,8512,0
2019/02,451,15/02/2019,5,SP 62RVar sulla variante di Luzzara (c/o Codisotto),13099,10,10113,2985,10053,3046,13099,0
2019/02,451,16/02/2019,6,SP 62RVar sulla variante di Luzzara (c/o Codisotto),9757,10,9323,433,7034,2723,0,9757
2019/02,451,17/02/2019,7,SP 62RVar sulla variante di Luzzara (c/o Codisotto),9165,00,9049,116,6361,2804,0,9165
2019/02,451,18/02/2019,1,SP 62RVar sulla variante di Luzzara (c/o Codisotto),11952,00,8910,3042,9535,2417,11952,0
2019/02,451,19/02/2019,2,SP 62RVar sulla variante di Luzzara (c/o Codisotto),12387,00,9104,3283,9944,2443,12387,0
2019/02,451,20/02/2019,3,SP 62RVar sulla variante di Luzzara (c/o Codisotto),12150,00,8994,3156,9602,2548,12150,0
2019/02,451,21/02/2019,4,SP 62RVar sulla variante di Luzzara (c/o Codisotto),12254,00,9257,2997,9687,2567,12254,0
2019/02,451,22/02/2019,5,SP 62RVar sulla variante di Luzzara (c/o Codisotto),12971,00,9982,2989,9987,2984,12971,0
2019/02,451,23/02/2019,6,SP 62RVar sulla variante di Luzzara (c/o Codisotto),9674,00,9250,424,6887,2787,0,9674
2019/02,451,24/02/2019,7,SP 62RVar sulla variante di Luzzara (c/o Codisotto),9096,00,8954,142,6347,2749,0,9096
2019/02,451,25/02/2019,1,SP 62RVar sulla variante di Luzzara (c/o Codisotto),11878,00,8806,3072,9462,2416,11878,0
2019/02,451,26/02/2019,2,SP 62RVar sulla variante di Luzzara (c/o Codisotto),12054,00,8945,3109,9709,2345,12054,0
2019/02,451,27/02/2019,3,SP 62RVar sulla variante di Luzzara (c/o Codisotto),12438,20,9385,3051,9745,2693,12438,0
2019/02,451,28/02/2019,4,SP 62RVar sulla variante di Luzzara (c/o Codisotto),12506,00,9320,3186,9882,2624,12506,0
2019/02,452,15/02/2019,5,SP 3 sulla variante tra Bagnolo in Piano e il casello A 1 di Reggio Emilia,13008,00,11657,1351,10167,2841,13008,0
2019/02,452,16/02/2019,6,SP 3 sulla variante tra Bagnolo in Piano e il casello A 1 di Reggio Emilia,9985,00,9742,243,7062,2923,0,9985
2019/02,452,17/02/2019,7,SP 3 sulla variante tra Bagnolo in Piano e il casello A 1 di Reggio Emilia,9161,00,9098,63,6358,2803,0,9161
2019/02,452,18/02/2019,1,SP 3 sulla variante tra Bagnolo in Piano e il casello A 1 di Reggio Emilia,12274,00,10921,1353,9834,2440,12274,0
2019/02,452,19/02/2019,2,SP 3 sulla variante tra Bagnolo in Piano e il casello A 1 di Reggio Emilia,12416,10,11084,1331,10014,2402,12416,0
2019/02,452,20/02/2019,3,SP 3 sulla variante tra Bagnolo in Piano e il casello A 1 di Reggio Emilia,12877,00,11515,1362,10265,2612,12877,0
2019/02,452,21/02/2019,4,SP 3 sulla variante tra Bagnolo in Piano e il casello A 1 di Reggio Emilia,12787,00,11369,1418,10103,2684,12787,0
2019/02,452,22/02/2019,5,SP 3 sulla variante tra Bagnolo in Piano e il casello A 1 di Reggio Emilia,12939,10,11651,1287,10082,2857,12939,0
2019/02,452,23/02/2019,6,SP 3 sulla variante tra Bagnolo in Piano e il casello A 1 di Reggio Emilia,9746,00,9500,246,6882,2864,0,9746
2019/02,452,24/02/2019,7,SP 3 sulla variante tra Bagnolo in Piano e il casello A 1 di Reggio Emilia,8745,00,8679,66,6149,2596,0,8745
2019/02,452,25/02/2019,1,SP 3 sulla variante tra Bagnolo in Piano e il casello A 1 di Reggio Emilia,12209,00,10927,1282,9818,2391,12209,0
2019/02,452,26/02/2019,2,SP 3 sulla variante tra Bagnolo in Piano e il casello A 1 di Reggio Emilia,12640,00,11347,1293,10099,2541,12640,0
2019/02,452,27/02/2019,3,SP 3 sulla variante tra Bagnolo in Piano e il casello A 1 di Reggio Emilia,12909,10,11590,1318,10199,2710,12909,0
2019/02,452,28/02/2019,4,SP 3 sulla variante tra Bagnolo in Piano e il casello A 1 di Reggio Emilia,12889,10,11538,1350,10118,2771,12889,0
2019/02,453,15/02/2019,5,Asse viario Modena-Sassuolo tra Modena e Baggiovara,57967,30,51875,6089,44836,13131,57967,0
2019/02,453,16/02/2019,6,Asse viario Modena-Sassuolo tra Modena e Baggiovara,42364,10,41475,888,29697,12667,0,42364
2019/02,453,17/02/2019,7,Asse viario Modena-Sassuolo tra Modena e Baggiovara,34707,00,34491,216,23974,10733,0,34707
2019/02,453,18/02/2019,1,Asse viario Modena-Sassuolo tra Modena e Baggiovara,53456,20,48081,5373,42793,10663,53456,0
2019/02,453,19/02/2019,2,Asse viario Modena-Sassuolo tra Modena e Baggiovara,54445,30,48509,5933,43365,11080,54445,0
2019/02,453,20/02/2019,3,Asse viario Modena-Sassuolo tra Modena e Baggiovara,54894,30,48853,6038,43563,11331,54894,0
2019/02,453,21/02/2019,4,Asse viario Modena-Sassuolo tra Modena e Baggiovara,55633,80,49475,6150,43809,11824,55633,0
2019/02,453,22/02/2019,5,Asse viario Modena-Sassuolo tra Modena e Baggiovara,56115,10,50174,5940,43066,13049,56115,0
2019/02,453,23/02/2019,6,Asse viario Modena-Sassuolo tra Modena e Baggiovara,42591,20,41687,902,30020,12571,0,42591
2019/02,453,24/02/2019,7,Asse viario Modena-Sassuolo tra Modena e Baggiovara,34181,00,33978,203,23743,10438,0,34181
2019/02,453,25/02/2019,1,Asse viario Modena-Sassuolo tra Modena e Baggiovara,53172,20,47954,5216,42595,10577,53172,0
2019/02,453,26/02/2019,2,Asse viario Modena-Sassuolo tra Modena e Baggiovara,54401,10,48397,6003,43490,10911,54401,0
2019/02,453,27/02/2019,3,Asse viario Modena-Sassuolo tra Modena e Baggiovara,55300,20,49123,6175,43418,11882,55300,0
2019/02,453,28/02/2019,4,Asse viario Modena-Sassuolo tra Modena e Baggiovara,56569,20,50104,6463,44512,12057,56569,0
2019/02,502,15/02/2019,5,SP 26 tra località Pioppa e viadotto A 1 (c/o Zola Predosa),14464,00,13505,959,11778,2686,14464,0
2019/02,502,16/02/2019,6,SP 26 tra località Pioppa e viadotto A 1 (c/o Zola Predosa),9434,00,9291,143,7149,2285,0,9434
2019/02,502,17/02/2019,7,SP 26 tra località Pioppa e viadotto A 1 (c/o Zola Predosa),7240,00,7202,38,5563,1677,0,7240
2019/02,502,18/02/2019,1,SP 26 tra località Pioppa e viadotto A 1 (c/o Zola Predosa),13512,00,12566,946,11254,2258,13512,0
2019/02,502,19/02/2019,2,SP 26 tra località Pioppa e viadotto A 1 (c/o Zola Predosa),14017,10,13016,1000,11701,2316,14017,0
2019/02,502,20/02/2019,3,SP 26 tra località Pioppa e viadotto A 1 (c/o Zola Predosa),13801,00,12815,986,11442,2359,13801,0
2019/02,502,21/02/2019,4,SP 26 tra località Pioppa e viadotto A 1 (c/o Zola Predosa),14303,00,13336,967,11789,2514,14303,0
2019/02,502,22/02/2019,5,SP 26 tra località Pioppa e viadotto A 1 (c/o Zola Predosa),14420,00,13441,979,11771,2649,14420,0
2019/02,502,23/02/2019,6,SP 26 tra località Pioppa e viadotto A 1 (c/o Zola Predosa),9281,00,9150,131,6913,2368,0,9281
2019/02,502,24/02/2019,7,SP 26 tra località Pioppa e viadotto A 1 (c/o Zola Predosa),7352,00,7293,59,5421,1931,0,7352
2019/02,502,25/02/2019,1,SP 26 tra località Pioppa e viadotto A 1 (c/o Zola Predosa),13927,00,12894,1033,11514,2413,13927,0
2019/02,502,26/02/2019,2,SP 26 tra località Pioppa e viadotto A 1 (c/o Zola Predosa),13676,10,12756,919,11429,2247,13676,0
2019/02,502,27/02/2019,3,SP 26 tra località Pioppa e viadotto A 1 (c/o Zola Predosa),14340,00,13368,972,11843,2497,14340,0
2019/02,502,28/02/2019,4,SP 26 tra località Pioppa e viadotto A 1 (c/o Zola Predosa),14193,00,13247,946,11616,2577,14193,0
2019/02,504,15/02/2019,5,SP 7 dalla località Ca de' Mandorli al bivio per Castel de Britti,11588,00,11231,357,8840,2748,11588,0
2019/02,504,16/02/2019,6,SP 7 dalla località Ca de' Mandorli al bivio per Castel de Britti,10368,00,10206,162,7725,2643,0,10368
2019/02,504,17/02/2019,7,SP 7 dalla località Ca de' Mandorli al bivio per Castel de Britti,8700,00,8654,46,6668,2032,0,8700
2019/02,504,18/02/2019,1,SP 7 dalla località Ca de' Mandorli al bivio per Castel de Britti,10887,00,10572,315,8547,2340,10887,0
2019/02,504,19/02/2019,2,SP 7 dalla località Ca de' Mandorli al bivio per Castel de Britti,11336,20,10984,350,8862,2474,11336,0
2019/02,504,20/02/2019,3,SP 7 dalla località Ca de' Mandorli al bivio per Castel de Britti,11320,00,10989,331,8879,2441,11320,0
2019/02,504,21/02/2019,4,SP 7 dalla località Ca de' Mandorli al bivio per Castel de Britti,11235,00,10923,312,8779,2456,11235,0
2019/02,504,22/02/2019,5,SP 7 dalla località Ca de' Mandorli al bivio per Castel de Britti,11813,00,11516,297,9012,2801,11813,0
2019/02,504,23/02/2019,6,SP 7 dalla località Ca de' Mandorli al bivio per Castel de Britti,10406,10,10267,138,7829,2577,0,10406
2019/02,504,24/02/2019,7,SP 7 dalla località Ca de' Mandorli al bivio per Castel de Britti,8327,00,8292,35,6318,2009,0,8327
2019/02,504,25/02/2019,1,SP 7 dalla località Ca de' Mandorli al bivio per Castel de Britti,10982,00,10637,345,8515,2467,10982,0
2019/02,504,26/02/2019,2,SP 7 dalla località Ca de' Mandorli al bivio per Castel de Britti,11138,00,10792,346,8704,2434,11138,0
2019/02,504,27/02/2019,3,SP 7 dalla località Ca de' Mandorli al bivio per Castel de Britti,11467,00,11118,349,8808,2659,11467,0
2019/02,504,28/02/2019,4,SP 7 dalla località Ca de' Mandorli al bivio per Castel de Britti,11394,00,11060,334,8803,2591,11394,0
2019/02,505,15/02/2019,5,SP 610 tra casello A 1 (Imola) e bivio SP 51 per Castel Guelfo di Bologna,13682,120,11463,2207,10339,3343,13682,0
2019/02,505,16/02/2019,6,SP 610 tra casello A 1 (Imola) e bivio SP 51 per Castel Guelfo di Bologna,10256,00,9847,409,7146,3110,0,10256
2019/02,505,17/02/2019,7,SP 610 tra casello A 1 (Imola) e bivio SP 51 per Castel Guelfo di Bologna,8739,00,8576,163,6146,2593,0,8739
2019/02,505,18/02/2019,1,SP 610 tra casello A 1 (Imola) e bivio SP 51 per Castel Guelfo di Bologna,13005,10,10818,2186,10104,2901,13005,0
2019/02,505,19/02/2019,2,SP 610 tra casello A 1 (Imola) e bivio SP 51 per Castel Guelfo di Bologna,13371,20,11013,2356,10518,2853,13371,0
2019/02,505,20/02/2019,3,SP 610 tra casello A 1 (Imola) e bivio SP 51 per Castel Guelfo di Bologna,13946,00,11488,2458,10901,3045,13946,0
2019/02,505,21/02/2019,4,SP 610 tra casello A 1 (Imola) e bivio SP 51 per Castel Guelfo di Bologna,14115,20,11798,2315,10955,3160,14115,0
2019/02,505,22/02/2019,5,SP 610 tra casello A 1 (Imola) e bivio SP 51 per Castel Guelfo di Bologna,13895,00,11686,2209,10598,3297,13895,0
2019/02,505,23/02/2019,6,SP 610 tra casello A 1 (Imola) e bivio SP 51 per Castel Guelfo di Bologna,10372,00,9945,427,7229,3143,0,10372
2019/02,505,24/02/2019,7,SP 610 tra casello A 1 (Imola) e bivio SP 51 per Castel Guelfo di Bologna,9158,00,8993,165,6543,2615,0,9158
2019/02,505,25/02/2019,1,SP 610 tra casello A 1 (Imola) e bivio SP 51 per Castel Guelfo di Bologna,13041,00,10826,2215,10270,2771,13041,0
2019/02,505,26/02/2019,2,SP 610 tra casello A 1 (Imola) e bivio SP 51 per Castel Guelfo di Bologna,13641,00,11246,2395,10710,2931,13641,0
2019/02,505,27/02/2019,3,SP 610 tra casello A 1 (Imola) e bivio SP 51 per Castel Guelfo di Bologna,13821,00,11490,2331,10806,3015,13821,0
2019/02,505,28/02/2019,4,SP 610 tra casello A 1 (Imola) e bivio SP 51 per Castel Guelfo di Bologna,13490,40,11245,2241,10398,3092,13490,0
2019/02,600,15/02/2019,5,SP 19 tra SP31 e Medicina,7946,00,7137,809,6357,1589,7946,0
2019/02,600,16/02/2019,6,SP 19 tra SP31 e Medicina,6337,10,6209,127,4869,1468,0,6337
2019/02,600,17/02/2019,7,SP 19 tra SP31 e Medicina,6059,00,6027,32,4717,1342,0,6059
2019/02,600,18/02/2019,1,SP 19 tra SP31 e Medicina,7154,00,6392,762,5854,1300,7154,0
2019/02,600,19/02/2019,2,SP 19 tra SP31 e Medicina,7425,00,6602,823,6112,1313,7425,0
2019/02,600,20/02/2019,3,SP 19 tra SP31 e Medicina,7687,00,6860,827,6288,1399,7687,0
2019/02,600,21/02/2019,4,SP 19 tra SP31 e Medicina,7658,10,6850,807,6196,1462,7658,0
2019/02,600,22/02/2019,5,SP 19 tra SP31 e Medicina,8007,10,7139,867,6492,1515,8007,0
2019/02,600,23/02/2019,6,SP 19 tra SP31 e Medicina,6513,00,6345,168,4929,1584,0,6513
2019/02,600,24/02/2019,7,SP 19 tra SP31 e Medicina,6240,00,6205,35,4784,1456,0,6240
2019/02,600,25/02/2019,1,SP 19 tra SP31 e Medicina,7563,10,6803,759,6262,1301,7563,0
2019/02,600,26/02/2019,2,SP 19 tra SP31 e Medicina,7643,10,6780,862,6238,1405,7643,0
2019/02,600,27/02/2019,3,SP 19 tra SP31 e Medicina,5900,10,5316,583,4472,1428,5900,0
2019/02,600,28/02/2019,4,SP 19 tra SP31 e Medicina,7926,20,7083,841,6386,1540,7926,0
2019/02,601,15/02/2019,5,SP 21 da Castel San Pietro al bivio SP 35 (c/o Sassoleone),3441,00,3329,112,2568,873,3441,0
2019/02,601,16/02/2019,6,SP 21 da Castel San Pietro al bivio SP 35 (c/o Sassoleone),3652,10,3615,36,2740,912,0,3652
2019/02,601,17/02/2019,7,SP 21 da Castel San Pietro al bivio SP 35 (c/o Sassoleone),3330,00,3311,19,2663,667,0,3330
2019/02,601,18/02/2019,1,SP 21 da Castel San Pietro al bivio SP 35 (c/o Sassoleone),3209,00,3133,76,2541,668,3209,0
2019/02,601,19/02/2019,2,SP 21 da Castel San Pietro al bivio SP 35 (c/o Sassoleone),3282,00,3196,86,2544,738,3282,0
2019/02,601,20/02/2019,3,SP 21 da Castel San Pietro al bivio SP 35 (c/o Sassoleone),3180,10,3093,86,2468,712,3180,0
2019/02,601,21/02/2019,4,SP 21 da Castel San Pietro al bivio SP 35 (c/o Sassoleone),3158,00,3084,74,2461,697,3158,0
2019/02,601,22/02/2019,5,SP 21 da Castel San Pietro al bivio SP 35 (c/o Sassoleone),3481,10,3403,77,2674,807,3481,0
2019/02,601,23/02/2019,6,SP 21 da Castel San Pietro al bivio SP 35 (c/o Sassoleone),3567,10,3531,35,2691,876,0,3567
2019/02,601,24/02/2019,7,SP 21 da Castel San Pietro al bivio SP 35 (c/o Sassoleone),3305,00,3297,8,2506,799,0,3305
2019/02,601,25/02/2019,1,SP 21 da Castel San Pietro al bivio SP 35 (c/o Sassoleone),3210,00,3154,56,2476,734,3210,0
2019/02,601,26/02/2019,2,SP 21 da Castel San Pietro al bivio SP 35 (c/o Sassoleone),3288,00,3209,79,2570,718,3288,0
2019/02,601,27/02/2019,3,SP 21 da Castel San Pietro al bivio SP 35 (c/o Sassoleone),3224,10,3136,87,2536,688,3224,0
2019/02,601,28/02/2019,4,SP 21 da Castel San Pietro al bivio SP 35 (c/o Sassoleone),3503,00,3420,83,2604,899,3503,0
2019/02,602,15/02/2019,5,SP 9_1 da Crevalcore alla località Caselle,1733,00,1643,90,1389,344,1733,0
2019/02,602,16/02/2019,6,SP 9_1 da Crevalcore alla località Caselle,1544,00,1496,48,1185,359,0,1544
2019/02,602,17/02/2019,7,SP 9_1 da Crevalcore alla località Caselle,1215,00,1211,4,932,283,0,1215
2019/02,602,18/02/2019,1,SP 9_1 da Crevalcore alla località Caselle,1646,00,1573,73,1365,281,1646,0
2019/02,602,19/02/2019,2,SP 9_1 da Crevalcore alla località Caselle,1655,00,1571,84,1327,328,1655,0
2019/02,602,20/02/2019,3,SP 9_1 da Crevalcore alla località Caselle,1651,00,1590,61,1347,304,1651,0
2019/02,602,21/02/2019,4,SP 9_1 da Crevalcore alla località Caselle,1675,00,1597,78,1345,330,1675,0
2019/02,602,22/02/2019,5,SP 9_1 da Crevalcore alla località Caselle,1835,00,1777,58,1446,389,1835,0
2019/02,602,23/02/2019,6,SP 9_1 da Crevalcore alla località Caselle,1454,00,1418,36,1125,329,0,1454
2019/02,602,24/02/2019,7,SP 9_1 da Crevalcore alla località Caselle,1135,00,1128,7,867,268,0,1135
2019/02,602,25/02/2019,1,SP 9_1 da Crevalcore alla località Caselle,1667,00,1593,74,1320,347,1667,0
2019/02,602,26/02/2019,2,SP 9_1 da Crevalcore alla località Caselle,1650,00,1574,76,1328,322,1650,0
2019/02,602,27/02/2019,3,SP 9_1 da Crevalcore alla località Caselle,1659,00,1585,74,1333,326,1659,0
2019/02,602,28/02/2019,4,SP 9_1 da Crevalcore alla località Caselle,1653,00,1583,70,1308,345,1653,0
2019/02,603,15/02/2019,5,SP 10 dalla località Decima ai confini provinciali di Bologna e Ferrara,4370,20,4194,174,3261,1109,4370,0
2019/02,603,16/02/2019,6,SP 10 dalla località Decima ai confini provinciali di Bologna e Ferrara,3357,00,3273,84,2382,975,0,3357
2019/02,603,17/02/2019,7,SP 10 dalla località Decima ai confini provinciali di Bologna e Ferrara,2822,00,2808,14,1994,828,0,2822
2019/02,603,18/02/2019,1,SP 10 dalla località Decima ai confini provinciali di Bologna e Ferrara,3877,00,3725,152,2952,925,3877,0
2019/02,603,19/02/2019,2,SP 10 dalla località Decima ai confini provinciali di Bologna e Ferrara,4051,10,3876,174,3134,917,4051,0
2019/02,603,20/02/2019,3,SP 10 dalla località Decima ai confini provinciali di Bologna e Ferrara,4126,00,3968,158,3115,1011,4126,0
2019/02,603,21/02/2019,4,SP 10 dalla località Decima ai confini provinciali di Bologna e Ferrara,4143,00,3968,175,3117,1026,4143,0
2019/02,603,22/02/2019,5,SP 10 dalla località Decima ai confini provinciali di Bologna e Ferrara,4279,00,4118,161,3137,1142,4279,0
2019/02,603,23/02/2019,6,SP 10 dalla località Decima ai confini provinciali di Bologna e Ferrara,3237,00,3178,59,2263,974,0,3237
2019/02,603,24/02/2019,7,SP 10 dalla località Decima ai confini provinciali di Bologna e Ferrara,2873,00,2859,14,2060,813,0,2873
2019/02,603,25/02/2019,1,SP 10 dalla località Decima ai confini provinciali di Bologna e Ferrara,3851,00,3698,153,2949,902,3851,0
2019/02,603,26/02/2019,2,SP 10 dalla località Decima ai confini provinciali di Bologna e Ferrara,3990,00,3825,165,3023,967,3990,0
2019/02,603,27/02/2019,3,SP 10 dalla località Decima ai confini provinciali di Bologna e Ferrara,4172,00,4032,140,3155,1017,4172,0
2019/02,603,28/02/2019,4,SP 10 dalla località Decima ai confini provinciali di Bologna e Ferrara,4160,00,3992,168,3078,1082,4160,0
2019/02,604,15/02/2019,5,SP 37 da Sasso Marconi alla intersezione SP 58,5208,00,4987,221,4259,949,5208,0
2019/02,604,16/02/2019,6,SP 37 da Sasso Marconi alla intersezione SP 58,4158,00,4123,35,3285,873,0,4158
2019/02,604,17/02/2019,7,SP 37 da Sasso Marconi alla intersezione SP 58,3655,00,3647,8,2936,719,0,3655
2019/02,604,18/02/2019,1,SP 37 da Sasso Marconi alla intersezione SP 58,5079,10,4871,207,4307,772,5079,0
2019/02,604,19/02/2019,2,SP 37 da Sasso Marconi alla intersezione SP 58,5102,10,4886,215,4264,838,5102,0
2019/02,604,20/02/2019,3,SP 37 da Sasso Marconi alla intersezione SP 58,5326,10,5094,231,4491,835,5326,0
2019/02,604,21/02/2019,4,SP 37 da Sasso Marconi alla intersezione SP 58,5265,00,5051,214,4388,877,5265,0
2019/02,604,22/02/2019,5,SP 37 da Sasso Marconi alla intersezione SP 58,5399,00,5210,189,4437,962,5399,0
2019/02,604,23/02/2019,6,SP 37 da Sasso Marconi alla intersezione SP 58,3820,10,3792,27,3053,767,0,3820
2019/02,604,24/02/2019,7,SP 37 da Sasso Marconi alla intersezione SP 58,3601,00,3591,10,2870,731,0,3601
2019/02,604,25/02/2019,1,SP 37 da Sasso Marconi alla intersezione SP 58,4879,00,4669,210,4097,782,4879,0
2019/02,604,26/02/2019,2,SP 37 da Sasso Marconi alla intersezione SP 58,5040,00,4820,220,4229,811,5040,0
2019/02,604,27/02/2019,3,SP 37 da Sasso Marconi alla intersezione SP 58,5473,10,5232,240,4596,877,5473,0
2019/02,604,28/02/2019,4,SP 37 da Sasso Marconi alla intersezione SP 58,5149,10,4928,220,4307,842,5149,0
2019/02,605,15/02/2019,5,SP 324 da Silla alla intersezione SP 623,8420,20,8083,335,6696,1724,8420,0
2019/02,605,16/02/2019,6,SP 324 da Silla alla intersezione SP 623,7424,00,7332,92,5847,1577,0,7424
2019/02,605,17/02/2019,7,SP 324 da Silla alla intersezione SP 623,6736,00,6692,44,5517,1219,0,6736
2019/02,605,18/02/2019,1,SP 324 da Silla alla intersezione SP 623,7399,00,7075,324,6189,1210,7399,0
2019/02,605,19/02/2019,2,SP 324 da Silla alla intersezione SP 623,7870,10,7535,334,6512,1358,7870,0
2019/02,605,20/02/2019,3,SP 324 da Silla alla intersezione SP 623,7334,20,7017,315,6083,1251,7334,0
2019/02,605,21/02/2019,4,SP 324 da Silla alla intersezione SP 623,7576,00,7233,343,6199,1377,7576,0
2019/02,605,22/02/2019,5,SP 324 da Silla alla intersezione SP 623,8085,10,7773,311,6412,1673,8085,0
2019/02,605,23/02/2019,6,SP 324 da Silla alla intersezione SP 623,7226,10,7111,114,5586,1640,0,7226
2019/02,605,24/02/2019,7,SP 324 da Silla alla intersezione SP 623,5873,00,5831,42,4692,1181,0,5873
2019/02,605,25/02/2019,1,SP 324 da Silla alla intersezione SP 623,7477,00,7176,301,6170,1307,7477,0
2019/02,605,26/02/2019,2,SP 324 da Silla alla intersezione SP 623,7504,20,7183,319,6240,1264,7504,0
2019/02,605,27/02/2019,3,SP 324 da Silla alla intersezione SP 623,7411,00,7046,365,6028,1383,7411,0
2019/02,605,28/02/2019,4,SP 324 da Silla alla intersezione SP 623,7318,10,6972,345,5956,1362,7318,0
2019/02,606,15/02/2019,5,SP 70 Cispadana in località Sant'Agostino/San Carlo,6111,00,5578,533,4804,1307,6111,0
2019/02,606,16/02/2019,6,SP 70 Cispadana in località Sant'Agostino/San Carlo,4574,10,4509,64,3425,1149,0,4574
2019/02,606,17/02/2019,7,SP 70 Cispadana in località Sant'Agostino/San Carlo,4985,40,4961,20,3837,1148,0,4985
2019/02,606,18/02/2019,1,SP 70 Cispadana in località Sant'Agostino/San Carlo,5814,00,5357,457,4713,1101,5814,0
2019/02,606,19/02/2019,2,SP 70 Cispadana in località Sant'Agostino/San Carlo,5935,20,5416,517,4758,1177,5935,0
2019/02,606,20/02/2019,3,SP 70 Cispadana in località Sant'Agostino/San Carlo,6096,00,5625,471,4977,1119,6096,0
2019/02,606,21/02/2019,4,SP 70 Cispadana in località Sant'Agostino/San Carlo,6193,30,5680,510,5076,1117,6193,0
2019/02,606,22/02/2019,5,SP 70 Cispadana in località Sant'Agostino/San Carlo,5916,40,5446,466,4620,1296,5916,0
2019/02,606,23/02/2019,6,SP 70 Cispadana in località Sant'Agostino/San Carlo,5048,20,4973,73,3816,1232,0,5048
2019/02,606,24/02/2019,7,SP 70 Cispadana in località Sant'Agostino/San Carlo,5220,60,5193,21,4053,1167,0,5220
2019/02,606,25/02/2019,1,SP 70 Cispadana in località Sant'Agostino/San Carlo,6098,50,5623,470,4945,1153,6098,0
2019/02,606,26/02/2019,2,SP 70 Cispadana in località Sant'Agostino/San Carlo,5705,10,5241,463,4543,1162,5705,0
2019/02,606,27/02/2019,3,SP 70 Cispadana in località Sant'Agostino/San Carlo,6125,00,5612,513,4928,1197,6125,0
2019/02,606,28/02/2019,4,SP 70 Cispadana in località Sant'Agostino/San Carlo,6004,10,5545,458,4852,1152,6004,0
2019/02,607,15/02/2019,5,SP 1 da Villafranca di Forlì al confine provinciale,4364,00,4109,255,3436,928,4364,0
2019/02,607,16/02/2019,6,SP 1 da Villafranca di Forlì al confine provinciale,3249,00,3173,76,2371,878,0,3249
2019/02,607,17/02/2019,7,SP 1 da Villafranca di Forlì al confine provinciale,3092,00,3077,15,2296,796,0,3092
2019/02,607,18/02/2019,1,SP 1 da Villafranca di Forlì al confine provinciale,4070,00,3778,292,3285,785,4070,0
2019/02,607,19/02/2019,2,SP 1 da Villafranca di Forlì al confine provinciale,4360,00,4029,331,3530,830,4360,0
2019/02,607,20/02/2019,3,SP 1 da Villafranca di Forlì al confine provinciale,4256,00,3946,310,3433,823,4256,0
2019/02,607,21/02/2019,4,SP 1 da Villafranca di Forlì al confine provinciale,4343,00,4086,257,3472,871,4343,0
2019/02,607,22/02/2019,5,SP 1 da Villafranca di Forlì al confine provinciale,4333,00,4074,259,3421,912,4333,0
2019/02,607,23/02/2019,6,SP 1 da Villafranca di Forlì al confine provinciale,3477,00,3412,65,2554,923,0,3477
2019/02,607,24/02/2019,7,SP 1 da Villafranca di Forlì al confine provinciale,3279,00,3267,12,2498,781,0,3279
2019/02,607,25/02/2019,1,SP 1 da Villafranca di Forlì al confine provinciale,4275,00,3941,334,3464,811,4275,0
2019/02,607,26/02/2019,2,SP 1 da Villafranca di Forlì al confine provinciale,4442,10,4093,348,3554,888,4442,0
2019/02,607,27/02/2019,3,SP 1 da Villafranca di Forlì al confine provinciale,4501,00,4155,346,3646,855,4501,0
2019/02,607,28/02/2019,4,SP 1 da Villafranca di Forlì al confine provinciale,4496,00,4185,311,3571,925,4496,0
2019/02,608,15/02/2019,5,SP 140 da Diegaro (SS 9) a Pievesestina (E 45),14230,00,12819,1411,10982,3248,14230,0
2019/02,608,16/02/2019,6,SP 140 da Diegaro (SS 9) a Pievesestina (E 45),11459,10,10974,484,8421,3038,0,11459
2019/02,608,17/02/2019,7,SP 140 da Diegaro (SS 9) a Pievesestina (E 45),8805,10,8661,143,6458,2347,0,8805
2019/02,608,18/02/2019,1,SP 140 da Diegaro (SS 9) a Pievesestina (E 45),13491,00,12084,1407,10726,2765,13491,0
2019/02,608,19/02/2019,2,SP 140 da Diegaro (SS 9) a Pievesestina (E 45),13669,20,12220,1447,10811,2858,13669,0
2019/02,608,20/02/2019,3,SP 140 da Diegaro (SS 9) a Pievesestina (E 45),14103,00,12711,1392,11115,2988,14103,0
2019/02,608,21/02/2019,4,SP 140 da Diegaro (SS 9) a Pievesestina (E 45),13867,10,12464,1402,10897,2970,13867,0
2019/02,608,22/02/2019,5,SP 140 da Diegaro (SS 9) a Pievesestina (E 45),14427,00,13045,1382,10965,3462,14427,0
2019/02,608,23/02/2019,6,SP 140 da Diegaro (SS 9) a Pievesestina (E 45),11552,10,11051,500,8158,3394,0,11552
2019/02,608,24/02/2019,7,SP 140 da Diegaro (SS 9) a Pievesestina (E 45),9527,00,9417,110,7023,2504,0,9527
2019/02,608,25/02/2019,1,SP 140 da Diegaro (SS 9) a Pievesestina (E 45),13386,10,12017,1368,10793,2593,13386,0
2019/02,608,26/02/2019,2,SP 140 da Diegaro (SS 9) a Pievesestina (E 45),13745,10,12325,1419,10890,2855,13745,0
2019/02,608,27/02/2019,3,SP 140 da Diegaro (SS 9) a Pievesestina (E 45),13894,00,12560,1334,10965,2929,13894,0
2019/02,608,28/02/2019,4,SP 140 da Diegaro (SS 9) a Pievesestina (E 45),14085,10,12688,1396,11055,3030,14085,0
2019/02,609,15/02/2019,5,SP 4 dal bivio SP22 (per SS 12) al bivio SP 26 (per Pavullo nel Frignano),3748,00,3511,237,2657,1091,3748,0
2019/02,609,16/02/2019,6,SP 4 dal bivio SP22 (per SS 12) al bivio SP 26 (per Pavullo nel Frignano),5911,10,5820,90,4912,999,0,5911
2019/02,609,17/02/2019,7,SP 4 dal bivio SP22 (per SS 12) al bivio SP 26 (per Pavullo nel Frignano),7639,00,7573,66,6626,1013,0,7639
2019/02,609,18/02/2019,1,SP 4 dal bivio SP22 (per SS 12) al bivio SP 26 (per Pavullo nel Frignano),3896,00,3534,362,3157,739,3896,0
2019/02,609,19/02/2019,2,SP 4 dal bivio SP22 (per SS 12) al bivio SP 26 (per Pavullo nel Frignano),3761,00,3492,269,3051,710,3761,0
2019/02,609,20/02/2019,3,SP 4 dal bivio SP22 (per SS 12) al bivio SP 26 (per Pavullo nel Frignano),4094,00,3752,342,3334,760,4094,0
2019/02,609,21/02/2019,4,SP 4 dal bivio SP22 (per SS 12) al bivio SP 26 (per Pavullo nel Frignano),4205,00,3825,380,3439,766,4205,0
2019/02,609,23/02/2019,6,SP 4 dal bivio SP22 (per SS 12) al bivio SP 26 (per Pavullo nel Frignano),5264,00,5149,115,4206,1058,0,5264
2019/02,609,24/02/2019,7,SP 4 dal bivio SP22 (per SS 12) al bivio SP 26 (per Pavullo nel Frignano),6028,00,5984,44,4996,1032,0,6028
2019/02,609,25/02/2019,1,SP 4 dal bivio SP22 (per SS 12) al bivio SP 26 (per Pavullo nel Frignano),3124,00,2818,306,2360,764,3124,0
2019/02,609,26/02/2019,2,SP 4 dal bivio SP22 (per SS 12) al bivio SP 26 (per Pavullo nel Frignano),3736,00,3371,365,3010,726,3736,0
2019/02,609,27/02/2019,3,SP 4 dal bivio SP22 (per SS 12) al bivio SP 26 (per Pavullo nel Frignano),4220,00,3829,391,3400,820,4220,0
2019/02,609,28/02/2019,4,SP 4 dal bivio SP22 (per SS 12) al bivio SP 26 (per Pavullo nel Frignano),4190,00,3732,458,3356,834,4190,0
2019/02,610,15/02/2019,5,SP 11 da Soragna a Roncole Verdi,3813,00,3538,275,2947,866,3813,0
2019/02,610,16/02/2019,6,SP 11 da Soragna a Roncole Verdi,3172,00,3068,104,2298,874,0,3172
2019/02,610,17/02/2019,7,SP 11 da Soragna a Roncole Verdi,2915,10,2883,31,2295,620,0,2915
2019/02,610,18/02/2019,1,SP 11 da Soragna a Roncole Verdi,3689,00,3389,300,2953,736,3689,0
2019/02,610,19/02/2019,2,SP 11 da Soragna a Roncole Verdi,3769,10,3473,295,3013,756,3769,0
2019/02,610,20/02/2019,3,SP 11 da Soragna a Roncole Verdi,4185,10,3785,399,3436,749,4185,0
2019/02,610,21/02/2019,4,SP 11 da Soragna a Roncole Verdi,3660,00,3338,322,2876,784,3660,0
2019/02,610,22/02/2019,5,SP 11 da Soragna a Roncole Verdi,3978,20,3595,381,3085,893,3978,0
2019/02,610,23/02/2019,6,SP 11 da Soragna a Roncole Verdi,3144,00,3045,99,2298,846,0,3144
2019/02,610,24/02/2019,7,SP 11 da Soragna a Roncole Verdi,3062,00,3012,50,2326,736,0,3062
2019/02,610,25/02/2019,1,SP 11 da Soragna a Roncole Verdi,3621,00,3294,327,2907,714,3621,0
2019/02,610,26/02/2019,2,SP 11 da Soragna a Roncole Verdi,3616,00,3328,288,2924,692,3616,0
2019/02,610,27/02/2019,3,SP 11 da Soragna a Roncole Verdi,3655,10,3318,336,2882,773,3655,0
2019/02,610,28/02/2019,4,SP 11 da Soragna a Roncole Verdi,3655,00,3362,293,2924,731,3655,0
2019/02,611,15/02/2019,5,SP 357R da Fornovo di Taro al bivio SP 93 per Fidenza,,,,,,,,
2019/02,611,16/02/2019,6,SP 357R da Fornovo di Taro al bivio SP 93 per Fidenza,,,,,,,,
2019/02,611,17/02/2019,7,SP 357R da Fornovo di Taro al bivio SP 93 per Fidenza,,,,,,,,
2019/02,611,18/02/2019,1,SP 357R da Fornovo di Taro al bivio SP 93 per Fidenza,,,,,,,,
2019/02,611,19/02/2019,2,SP 357R da Fornovo di Taro al bivio SP 93 per Fidenza,,,,,,,,
2019/02,611,20/02/2019,3,SP 357R da Fornovo di Taro al bivio SP 93 per Fidenza,,,,,,,,
2019/02,611,21/02/2019,4,SP 357R da Fornovo di Taro al bivio SP 93 per Fidenza,,,,,,,,
2019/02,611,22/02/2019,5,SP 357R da Fornovo di Taro al bivio SP 93 per Fidenza,,,,,,,,
2019/02,611,23/02/2019,6,SP 357R da Fornovo di Taro al bivio SP 93 per Fidenza,,,,,,,,
2019/02,611,24/02/2019,7,SP 357R da Fornovo di Taro al bivio SP 93 per Fidenza,,,,,,,,
2019/02,611,25/02/2019,1,SP 357R da Fornovo di Taro al bivio SP 93 per Fidenza,,,,,,,,
2019/02,611,26/02/2019,2,SP 357R da Fornovo di Taro al bivio SP 93 per Fidenza,,,,,,,,
2019/02,611,27/02/2019,3,SP 357R da Fornovo di Taro al bivio SP 93 per Fidenza,,,,,,,,
2019/02,611,28/02/2019,4,SP 357R da Fornovo di Taro al bivio SP 93 per Fidenza,,,,,,,,
2019/02,612,15/02/2019,5,SP 665R dalla località Pilastro a Langhirano,17848,00,16804,1044,14134,3714,17848,0
2019/02,612,16/02/2019,6,SP 665R dalla località Pilastro a Langhirano,15298,10,15078,219,11427,3871,0,15298
2019/02,612,17/02/2019,7,SP 665R dalla località Pilastro a Langhirano,13658,10,13579,78,10642,3016,0,13658
2019/02,612,18/02/2019,1,SP 665R dalla località Pilastro a Langhirano,17167,00,16150,1017,14128,3039,17167,0
2019/02,612,19/02/2019,2,SP 665R dalla località Pilastro a Langhirano,17512,10,16499,1012,14228,3284,17512,0
2019/02,612,20/02/2019,3,SP 665R dalla località Pilastro a Langhirano,17439,00,16291,1148,14151,3288,17439,0
2019/02,612,21/02/2019,4,SP 665R dalla località Pilastro a Langhirano,17534,10,16417,1116,14113,3421,17534,0
2019/02,612,22/02/2019,5,SP 665R dalla località Pilastro a Langhirano,18153,00,16993,1160,14416,3737,18153,0
2019/02,612,23/02/2019,6,SP 665R dalla località Pilastro a Langhirano,14624,10,14362,261,11056,3568,0,14624
2019/02,612,24/02/2019,7,SP 665R dalla località Pilastro a Langhirano,12536,10,12482,53,9619,2917,0,12536
2019/02,612,25/02/2019,1,SP 665R dalla località Pilastro a Langhirano,16779,30,15753,1023,13721,3058,16779,0
2019/02,612,26/02/2019,2,SP 665R dalla località Pilastro a Langhirano,17289,00,16224,1065,14004,3285,17289,0
2019/02,612,27/02/2019,3,SP 665R dalla località Pilastro a Langhirano,17001,00,15896,1105,13558,3443,17001,0
2019/02,612,28/02/2019,4,SP 665R dalla località Pilastro a Langhirano,17786,20,16720,1064,14224,3562,17786,0
2019/02,613,15/02/2019,5,SP 16 dalla località Basilicanova al bivio SP 32 centro abitato Mamiano,6974,00,6686,288,5254,1720,6974,0
2019/02,613,16/02/2019,6,SP 16 dalla località Basilicanova al bivio SP 32 centro abitato Mamiano,5979,00,5838,141,4328,1651,0,5979
2019/02,613,17/02/2019,7,SP 16 dalla località Basilicanova al bivio SP 32 centro abitato Mamiano,4676,00,4635,41,3386,1290,0,4676
2019/02,613,18/02/2019,1,SP 16 dalla località Basilicanova al bivio SP 32 centro abitato Mamiano,6522,10,6261,260,5244,1278,6522,0
2019/02,613,19/02/2019,2,SP 16 dalla località Basilicanova al bivio SP 32 centro abitato Mamiano,6631,00,6395,236,5252,1379,6631,0
2019/02,613,20/02/2019,3,SP 16 dalla località Basilicanova al bivio SP 32 centro abitato Mamiano,6828,00,6524,304,5408,1420,6828,0
2019/02,613,21/02/2019,4,SP 16 dalla località Basilicanova al bivio SP 32 centro abitato Mamiano,6696,00,6401,295,5272,1424,6696,0
2019/02,613,22/02/2019,5,SP 16 dalla località Basilicanova al bivio SP 32 centro abitato Mamiano,7074,10,6778,295,5402,1672,7074,0
2019/02,613,23/02/2019,6,SP 16 dalla località Basilicanova al bivio SP 32 centro abitato Mamiano,5943,00,5806,137,4333,1610,0,5943
2019/02,613,24/02/2019,7,SP 16 dalla località Basilicanova al bivio SP 32 centro abitato Mamiano,4557,00,4517,40,3201,1356,0,4557
2019/02,613,25/02/2019,1,SP 16 dalla località Basilicanova al bivio SP 32 centro abitato Mamiano,6678,00,6415,263,5405,1273,6678,0
2019/02,613,26/02/2019,2,SP 16 dalla località Basilicanova al bivio SP 32 centro abitato Mamiano,6806,00,6523,283,5423,1383,6806,0
2019/02,613,27/02/2019,3,SP 16 dalla località Basilicanova al bivio SP 32 centro abitato Mamiano,6748,00,6455,293,5331,1417,6748,0
2019/02,613,28/02/2019,4,SP 16 dalla località Basilicanova al bivio SP 32 centro abitato Mamiano,7071,00,6792,279,5531,1540,7071,0
2019/02,614,15/02/2019,5,SP 587R dal bivio SP 10R alla A 21Dir,7304,10,6722,581,5705,1599,7304,0
2019/02,614,16/02/2019,6,SP 587R dal bivio SP 10R alla A 21Dir,5649,00,5453,196,4154,1495,0,5649
2019/02,614,17/02/2019,7,SP 587R dal bivio SP 10R alla A 21Dir,4588,00,4543,45,3427,1161,0,4588
2019/02,614,18/02/2019,1,SP 587R dal bivio SP 10R alla A 21Dir,6820,00,6269,551,5565,1255,6820,0
2019/02,614,19/02/2019,2,SP 587R dal bivio SP 10R alla A 21Dir,6899,00,6326,573,5514,1385,6899,0
2019/02,614,20/02/2019,3,SP 587R dal bivio SP 10R alla A 21Dir,7309,20,6752,555,5989,1320,7309,0
2019/02,614,21/02/2019,4,SP 587R dal bivio SP 10R alla A 21Dir,6967,00,6335,632,5605,1362,6967,0
2019/02,614,22/02/2019,5,SP 587R dal bivio SP 10R alla A 21Dir,7169,00,6589,580,5560,1609,7169,0
2019/02,614,23/02/2019,6,SP 587R dal bivio SP 10R alla A 21Dir,5399,10,5174,224,3977,1422,0,5399
2019/02,614,24/02/2019,7,SP 587R dal bivio SP 10R alla A 21Dir,5080,00,5030,50,3914,1166,0,5080
2019/02,614,25/02/2019,1,SP 587R dal bivio SP 10R alla A 21Dir,6876,10,6325,550,5563,1313,6876,0
2019/02,614,26/02/2019,2,SP 587R dal bivio SP 10R alla A 21Dir,6864,00,6326,538,5504,1360,6864,0
2019/02,614,27/02/2019,3,SP 587R dal bivio SP 10R alla A 21Dir,6940,10,6361,578,5541,1399,6940,0
2019/02,614,28/02/2019,4,SP 587R dal bivio SP 10R alla A 21Dir,7141,00,6629,512,5673,1468,7141,0
2019/02,615,15/02/2019,5,Piazzale Milano (ex SS 9) c/o ponte fiume Po,28056,110,27440,605,20784,7272,28056,0
2019/02,615,16/02/2019,6,Piazzale Milano (ex SS 9) c/o ponte fiume Po,27761,40,27452,305,20060,7701,0,27761
2019/02,615,17/02/2019,7,Piazzale Milano (ex SS 9) c/o ponte fiume Po,22868,10,22764,103,16393,6475,0,22868
2019/02,615,18/02/2019,1,Piazzale Milano (ex SS 9) c/o ponte fiume Po,25494,170,24926,551,19510,5984,25494,0
2019/02,615,19/02/2019,2,Piazzale Milano (ex SS 9) c/o ponte fiume Po,26048,90,25479,560,20095,5953,26048,0
2019/02,615,20/02/2019,3,Piazzale Milano (ex SS 9) c/o ponte fiume Po,26077,120,25526,539,19864,6213,26077,0
2019/02,615,21/02/2019,4,Piazzale Milano (ex SS 9) c/o ponte fiume Po,27075,130,26348,714,20697,6378,27075,0
2019/02,615,22/02/2019,5,Piazzale Milano (ex SS 9) c/o ponte fiume Po,28013,200,27391,602,20784,7229,28013,0
2019/02,615,23/02/2019,6,Piazzale Milano (ex SS 9) c/o ponte fiume Po,27688,80,27341,339,20193,7495,0,27688
2019/02,615,24/02/2019,7,Piazzale Milano (ex SS 9) c/o ponte fiume Po,23263,20,23144,117,16893,6370,0,23263
2019/02,615,25/02/2019,1,Piazzale Milano (ex SS 9) c/o ponte fiume Po,25531,180,24972,541,19346,6185,25531,0
2019/02,615,26/02/2019,2,Piazzale Milano (ex SS 9) c/o ponte fiume Po,25752,130,25211,528,19770,5982,25752,0
2019/02,615,27/02/2019,3,Piazzale Milano (ex SS 9) c/o ponte fiume Po,26534,180,25918,598,19992,6542,26534,0
2019/02,615,28/02/2019,4,Piazzale Milano (ex SS 9) c/o ponte fiume Po,26284,200,25705,559,19761,6523,26284,0
2019/02,616,15/02/2019,5,SP 588R dal casello A 21 di Castelvetro Piacentino a Villanova d'Arda,4231,00,3933,298,3308,923,4231,0
2019/02,616,16/02/2019,6,SP 588R dal casello A 21 di Castelvetro Piacentino a Villanova d'Arda,3976,00,3889,87,2960,1016,0,3976
2019/02,616,17/02/2019,7,SP 588R dal casello A 21 di Castelvetro Piacentino a Villanova d'Arda,3694,00,3650,44,2865,829,0,3694
2019/02,616,18/02/2019,1,SP 588R dal casello A 21 di Castelvetro Piacentino a Villanova d'Arda,3809,00,3526,283,3103,706,3809,0
2019/02,616,19/02/2019,2,SP 588R dal casello A 21 di Castelvetro Piacentino a Villanova d'Arda,3908,00,3573,335,3182,726,3908,0
2019/02,616,20/02/2019,3,SP 588R dal casello A 21 di Castelvetro Piacentino a Villanova d'Arda,4088,00,3732,356,3318,770,4088,0
2019/02,616,21/02/2019,4,SP 588R dal casello A 21 di Castelvetro Piacentino a Villanova d'Arda,4081,00,3739,342,3347,734,4081,0
2019/02,616,22/02/2019,5,SP 588R dal casello A 21 di Castelvetro Piacentino a Villanova d'Arda,4336,00,4030,306,3404,932,4336,0
2019/02,616,23/02/2019,6,SP 588R dal casello A 21 di Castelvetro Piacentino a Villanova d'Arda,3937,00,3880,57,2876,1061,0,3937
2019/02,616,24/02/2019,7,SP 588R dal casello A 21 di Castelvetro Piacentino a Villanova d'Arda,3654,00,3631,23,2781,873,0,3654
2019/02,616,25/02/2019,1,SP 588R dal casello A 21 di Castelvetro Piacentino a Villanova d'Arda,3841,00,3553,288,3166,675,3841,0
2019/02,616,26/02/2019,2,SP 588R dal casello A 21 di Castelvetro Piacentino a Villanova d'Arda,3988,00,3640,348,3252,736,3988,0
2019/02,616,27/02/2019,3,SP 588R dal casello A 21 di Castelvetro Piacentino a Villanova d'Arda,4062,00,3739,323,3339,723,4062,0
2019/02,616,28/02/2019,4,SP 588R dal casello A 21 di Castelvetro Piacentino a Villanova d'Arda,4201,00,3878,323,3370,831,4201,0
2019/02,617,15/02/2019,5,SP 7 dalla intersezione tangenziale sud/ovest di Piacenza a San Nicolò,8098,00,7647,451,6446,1652,8098,0
2019/02,617,16/02/2019,6,SP 7 dalla intersezione tangenziale sud/ovest di Piacenza a San Nicolò,7293,00,7199,94,5482,1811,0,7293
2019/02,617,17/02/2019,7,SP 7 dalla intersezione tangenziale sud/ovest di Piacenza a San Nicolò,5271,10,5254,16,4091,1180,0,5271
2019/02,617,18/02/2019,1,SP 7 dalla intersezione tangenziale sud/ovest di Piacenza a San Nicolò,7696,00,7334,362,6350,1346,7696,0
2019/02,617,19/02/2019,2,SP 7 dalla intersezione tangenziale sud/ovest di Piacenza a San Nicolò,7480,00,7166,314,6067,1413,7480,0
2019/02,617,20/02/2019,3,SP 7 dalla intersezione tangenziale sud/ovest di Piacenza a San Nicolò,7520,00,7183,337,6101,1419,7520,0
2019/02,617,21/02/2019,4,SP 7 dalla intersezione tangenziale sud/ovest di Piacenza a San Nicolò,7633,00,7211,422,6206,1427,7633,0
2019/02,617,22/02/2019,5,SP 7 dalla intersezione tangenziale sud/ovest di Piacenza a San Nicolò,8095,00,7632,463,6380,1715,8095,0
2019/02,617,23/02/2019,6,SP 7 dalla intersezione tangenziale sud/ovest di Piacenza a San Nicolò,7346,00,7217,129,5534,1812,0,7346
2019/02,617,24/02/2019,7,SP 7 dalla intersezione tangenziale sud/ovest di Piacenza a San Nicolò,5482,00,5468,14,4181,1301,0,5482
2019/02,617,25/02/2019,1,SP 7 dalla intersezione tangenziale sud/ovest di Piacenza a San Nicolò,7632,00,7150,482,6292,1340,7632,0
2019/02,617,26/02/2019,2,SP 7 dalla intersezione tangenziale sud/ovest di Piacenza a San Nicolò,7753,00,7307,446,6396,1357,7753,0
2019/02,617,27/02/2019,3,SP 7 dalla intersezione tangenziale sud/ovest di Piacenza a San Nicolò,7712,00,7323,389,6258,1454,7712,0
2019/02,617,28/02/2019,4,SP 7 dalla intersezione tangenziale sud/ovest di Piacenza a San Nicolò,7842,10,7435,406,6337,1505,7842,0
2019/02,618,15/02/2019,5,SP 253R fra Bagnacavallo (A14 Dir) e Godo (bivio SP 302R),7917,10,7339,577,6177,1740,7917,0
2019/02,618,16/02/2019,6,SP 253R fra Bagnacavallo (A14 Dir) e Godo (bivio SP 302R),6381,40,6247,130,4857,1524,0,6381
2019/02,618,17/02/2019,7,SP 253R fra Bagnacavallo (A14 Dir) e Godo (bivio SP 302R),4878,00,4840,38,3661,1217,0,4878
2019/02,618,18/02/2019,1,SP 253R fra Bagnacavallo (A14 Dir) e Godo (bivio SP 302R),7362,10,6838,523,5975,1387,7362,0
2019/02,618,19/02/2019,2,SP 253R fra Bagnacavallo (A14 Dir) e Godo (bivio SP 302R),7513,00,6947,566,6095,1418,7513,0
2019/02,618,20/02/2019,3,SP 253R fra Bagnacavallo (A14 Dir) e Godo (bivio SP 302R),7469,10,6941,527,5970,1499,7469,0
2019/02,618,21/02/2019,4,SP 253R fra Bagnacavallo (A14 Dir) e Godo (bivio SP 302R),7566,00,6998,568,6027,1539,7566,0
2019/02,618,22/02/2019,5,SP 253R fra Bagnacavallo (A14 Dir) e Godo (bivio SP 302R),7722,10,7190,531,6012,1710,7722,0
2019/02,618,23/02/2019,6,SP 253R fra Bagnacavallo (A14 Dir) e Godo (bivio SP 302R),6377,00,6239,138,4761,1616,0,6377
2019/02,618,24/02/2019,7,SP 253R fra Bagnacavallo (A14 Dir) e Godo (bivio SP 302R),4571,00,4536,35,3467,1104,0,4571
2019/02,618,25/02/2019,1,SP 253R fra Bagnacavallo (A14 Dir) e Godo (bivio SP 302R),7236,10,6731,504,5854,1382,7236,0
2019/02,618,26/02/2019,2,SP 253R fra Bagnacavallo (A14 Dir) e Godo (bivio SP 302R),7563,00,7041,522,6100,1463,7563,0
2019/02,618,27/02/2019,3,SP 253R fra Bagnacavallo (A14 Dir) e Godo (bivio SP 302R),7644,00,7124,520,6042,1602,7644,0
2019/02,618,28/02/2019,4,SP 253R fra Bagnacavallo (A14 Dir) e Godo (bivio SP 302R),7582,00,7134,448,6017,1565,7582,0
2019/02,619,15/02/2019,5,SP 8 da Bagnacavallo al bivio SS 16,3163,10,2996,166,2401,762,3163,0
2019/02,619,16/02/2019,6,SP 8 da Bagnacavallo al bivio SS 16,2685,00,2637,48,1978,707,0,2685
2019/02,619,17/02/2019,7,SP 8 da Bagnacavallo al bivio SS 16,2374,10,2361,12,1759,615,0,2374
2019/02,619,18/02/2019,1,SP 8 da Bagnacavallo al bivio SS 16,3254,00,3070,184,2604,650,3254,0
2019/02,619,19/02/2019,2,SP 8 da Bagnacavallo al bivio SS 16,3248,00,3058,190,2580,668,3248,0
2019/02,619,20/02/2019,3,SP 8 da Bagnacavallo al bivio SS 16,3340,10,3122,217,2650,690,3340,0
2019/02,619,21/02/2019,4,SP 8 da Bagnacavallo al bivio SS 16,3408,00,3177,231,2665,743,3408,0
2019/02,619,22/02/2019,5,SP 8 da Bagnacavallo al bivio SS 16,3281,00,3093,188,2552,729,3281,0
2019/02,619,23/02/2019,6,SP 8 da Bagnacavallo al bivio SS 16,2705,10,2655,49,1975,730,0,2705
2019/02,619,24/02/2019,7,SP 8 da Bagnacavallo al bivio SS 16,2579,00,2567,12,1963,616,0,2579
2019/02,619,25/02/2019,1,SP 8 da Bagnacavallo al bivio SS 16,3253,1710,2878,204,2601,652,3253,0
2019/02,619,26/02/2019,2,SP 8 da Bagnacavallo al bivio SS 16,3207,230,2957,227,2544,663,3207,0
2019/02,619,27/02/2019,3,SP 8 da Bagnacavallo al bivio SS 16,3251,1000,2927,224,2574,677,3251,0
2019/02,619,28/02/2019,4,SP 8 da Bagnacavallo al bivio SS 16,,,,,,,,
2019/02,620,15/02/2019,5,SP 113 sulla variante di San Martino in Rio/Correggio c/o le località Prato/Gazzata,8622,00,7503,1119,6725,1897,8622,0
2019/02,620,16/02/2019,6,SP 113 sulla variante di San Martino in Rio/Correggio c/o le località Prato/Gazzata,6060,00,5876,184,4238,1822,0,6060
2019/02,620,17/02/2019,7,SP 113 sulla variante di San Martino in Rio/Correggio c/o le località Prato/Gazzata,5104,00,5046,58,3593,1511,0,5104
2019/02,620,18/02/2019,1,SP 113 sulla variante di San Martino in Rio/Correggio c/o le località Prato/Gazzata,8296,00,7180,1116,6696,1600,8296,0
2019/02,620,19/02/2019,2,SP 113 sulla variante di San Martino in Rio/Correggio c/o le località Prato/Gazzata,8314,00,7206,1108,6665,1649,8314,0
2019/02,620,20/02/2019,3,SP 113 sulla variante di San Martino in Rio/Correggio c/o le località Prato/Gazzata,8424,00,7364,1060,6737,1687,8424,0
2019/02,620,21/02/2019,4,SP 113 sulla variante di San Martino in Rio/Correggio c/o le località Prato/Gazzata,8475,00,7420,1055,6716,1759,8475,0
2019/02,620,22/02/2019,5,SP 113 sulla variante di San Martino in Rio/Correggio c/o le località Prato/Gazzata,7576,10,6710,865,5683,1893,7576,0
2019/02,620,23/02/2019,6,SP 113 sulla variante di San Martino in Rio/Correggio c/o le località Prato/Gazzata,5850,00,5659,191,4148,1702,0,5850
2019/02,620,24/02/2019,7,SP 113 sulla variante di San Martino in Rio/Correggio c/o le località Prato/Gazzata,5088,00,5035,53,3532,1556,0,5088
2019/02,620,25/02/2019,1,SP 113 sulla variante di San Martino in Rio/Correggio c/o le località Prato/Gazzata,8333,00,7242,1091,6724,1609,8333,0
2019/02,620,26/02/2019,2,SP 113 sulla variante di San Martino in Rio/Correggio c/o le località Prato/Gazzata,8644,00,7466,1178,6963,1681,8644,0
2019/02,620,27/02/2019,3,SP 113 sulla variante di San Martino in Rio/Correggio c/o le località Prato/Gazzata,8639,00,7544,1095,6915,1724,8639,0
2019/02,620,28/02/2019,4,SP 113 sulla variante di San Martino in Rio/Correggio c/o le località Prato/Gazzata,8745,00,7573,1172,6911,1834,8745,0
2019/02,621,15/02/2019,5,SP 513R a nord di Vetto,2098,00,1980,118,1602,496,2098,0
2019/02,621,16/02/2019,6,SP 513R a nord di Vetto,2117,00,2064,53,1699,418,0,2117
2019/02,621,17/02/2019,7,SP 513R a nord di Vetto,2523,00,2512,11,2097,426,0,2523
2019/02,621,18/02/2019,1,SP 513R a nord di Vetto,2029,00,1897,132,1560,469,2029,0
2019/02,621,19/02/2019,2,SP 513R a nord di Vetto,1992,00,1871,121,1547,445,1992,0
2019/02,621,20/02/2019,3,SP 513R a nord di Vetto,2044,00,1898,146,1603,441,2044,0
2019/02,621,21/02/2019,4,SP 513R a nord di Vetto,2033,10,1900,132,1599,434,2033,0
2019/02,621,22/02/2019,5,SP 513R a nord di Vetto,2167,00,2037,130,1672,495,2167,0
2019/02,621,23/02/2019,6,SP 513R a nord di Vetto,2149,00,2099,50,1772,377,0,2149
2019/02,621,24/02/2019,7,SP 513R a nord di Vetto,2320,00,2310,10,1924,396,0,2320
2019/02,621,25/02/2019,1,SP 513R a nord di Vetto,2103,00,1942,161,1652,451,2103,0
2019/02,621,26/02/2019,2,SP 513R a nord di Vetto,2049,00,1921,128,1632,417,2049,0
2019/02,621,27/02/2019,3,SP 513R a nord di Vetto,2032,00,1914,118,1602,430,2032,0
2019/02,621,28/02/2019,4,SP 513R a nord di Vetto,2029,00,1904,125,1575,454,2029,0
2019/02,622,15/02/2019,5,SP 468R tra Correggio e il confine provinciale,,,,,,,,
2019/02,622,16/02/2019,6,SP 468R tra Correggio e il confine provinciale,,,,,,,,
2019/02,622,17/02/2019,7,SP 468R tra Correggio e il confine provinciale,,,,,,,,
2019/02,622,18/02/2019,1,SP 468R tra Correggio e il confine provinciale,,,,,,,,
2019/02,622,19/02/2019,2,SP 468R tra Correggio e il confine provinciale,,,,,,,,
2019/02,622,20/02/2019,3,SP 468R tra Correggio e il confine provinciale,,,,,,,,
2019/02,622,21/02/2019,4,SP 468R tra Correggio e il confine provinciale,,,,,,,,
2019/02,622,22/02/2019,5,SP 468R tra Correggio e il confine provinciale,,,,,,,,
2019/02,622,23/02/2019,6,SP 468R tra Correggio e il confine provinciale,,,,,,,,
2019/02,622,24/02/2019,7,SP 468R tra Correggio e il confine provinciale,,,,,,,,
2019/02,622,25/02/2019,1,SP 468R tra Correggio e il confine provinciale,,,,,,,,
2019/02,622,26/02/2019,2,SP 468R tra Correggio e il confine provinciale,,,,,,,,
2019/02,622,27/02/2019,3,SP 468R tra Correggio e il confine provinciale,,,,,,,,
2019/02,622,28/02/2019,4,SP 468R tra Correggio e il confine provinciale,,,,,,,,
2019/02,623,15/02/2019,5,SP 30 tra Campagnola Emilia e il confine provinciale,16089,00,14890,1199,12450,3639,16089,0
2019/02,623,16/02/2019,6,SP 30 tra Campagnola Emilia e il confine provinciale,13316,00,13037,279,9464,3852,0,13316
2019/02,623,17/02/2019,7,SP 30 tra Campagnola Emilia e il confine provinciale,10121,00,10053,68,7045,3076,0,10121
2019/02,623,18/02/2019,1,SP 30 tra Campagnola Emilia e il confine provinciale,14683,00,13420,1263,11787,2896,14683,0
2019/02,623,19/02/2019,2,SP 30 tra Campagnola Emilia e il confine provinciale,14722,00,13657,1065,11748,2974,14722,0
2019/02,623,20/02/2019,3,SP 30 tra Campagnola Emilia e il confine provinciale,15372,00,14168,1204,12149,3223,15372,0
2019/02,623,21/02/2019,4,SP 30 tra Campagnola Emilia e il confine provinciale,15754,20,14508,1244,12544,3210,15754,0
2019/02,623,22/02/2019,5,SP 30 tra Campagnola Emilia e il confine provinciale,15757,10,14609,1147,12197,3560,15757,0
2019/02,623,23/02/2019,6,SP 30 tra Campagnola Emilia e il confine provinciale,13217,00,12964,253,9334,3883,0,13217
2019/02,623,24/02/2019,7,SP 30 tra Campagnola Emilia e il confine provinciale,9860,00,9806,54,7016,2844,0,9860
2019/02,623,25/02/2019,1,SP 30 tra Campagnola Emilia e il confine provinciale,14824,40,13580,1240,11830,2994,14824,0
2019/02,623,26/02/2019,2,SP 30 tra Campagnola Emilia e il confine provinciale,15317,20,14072,1243,12253,3064,15317,0
2019/02,623,27/02/2019,3,SP 30 tra Campagnola Emilia e il confine provinciale,15525,30,14266,1256,12240,3285,15525,0
2019/02,623,28/02/2019,4,SP 30 tra Campagnola Emilia e il confine provinciale,15441,00,14292,1149,12260,3181,15441,0
2019/02,624,15/02/2019,5,SP 23 tra Rivalta e la variante di Montecavolo,11851,00,11479,372,9029,2822,11851,0
2019/02,624,16/02/2019,6,SP 23 tra Rivalta e la variante di Montecavolo,10892,00,10799,93,7999,2893,0,10892
2019/02,624,17/02/2019,7,SP 23 tra Rivalta e la variante di Montecavolo,8610,00,8593,17,6320,2290,0,8610
2019/02,624,18/02/2019,1,SP 23 tra Rivalta e la variante di Montecavolo,10929,10,10560,368,8542,2387,10929,0
2019/02,624,19/02/2019,2,SP 23 tra Rivalta e la variante di Montecavolo,11208,00,10841,367,8711,2497,11208,0
2019/02,624,20/02/2019,3,SP 23 tra Rivalta e la variante di Montecavolo,11439,00,11073,366,8920,2519,11439,0
2019/02,624,21/02/2019,4,SP 23 tra Rivalta e la variante di Montecavolo,11476,00,11118,358,8878,2598,11476,0
2019/02,624,22/02/2019,5,SP 23 tra Rivalta e la variante di Montecavolo,11743,00,11356,387,8931,2812,11743,0
2019/02,624,23/02/2019,6,SP 23 tra Rivalta e la variante di Montecavolo,11435,00,11320,115,8376,3059,0,11435
2019/02,624,24/02/2019,7,SP 23 tra Rivalta e la variante di Montecavolo,8761,00,8734,27,6542,2219,0,8761
2019/02,624,25/02/2019,1,SP 23 tra Rivalta e la variante di Montecavolo,10988,00,10619,369,8582,2406,10988,0
2019/02,624,26/02/2019,2,SP 23 tra Rivalta e la variante di Montecavolo,10867,00,10538,329,8435,2432,10867,0
2019/02,624,27/02/2019,3,SP 23 tra Rivalta e la variante di Montecavolo,11879,00,11529,350,8981,2898,11879,0
2019/02,624,28/02/2019,4,SP 23 tra Rivalta e la variante di Montecavolo,11563,00,11174,389,8911,2652,11563,0
2019/02,625,15/02/2019,5,SP 14 da Poggio Berni (bivio SP 73) a Sant'Arcangelo di Romagna,,,,,,,,
2019/02,625,16/02/2019,6,SP 14 da Poggio Berni (bivio SP 73) a Sant'Arcangelo di Romagna,,,,,,,,
2019/02,625,17/02/2019,7,SP 14 da Poggio Berni (bivio SP 73) a Sant'Arcangelo di Romagna,,,,,,,,
2019/02,625,18/02/2019,1,SP 14 da Poggio Berni (bivio SP 73) a Sant'Arcangelo di Romagna,,,,,,,,
2019/02,625,19/02/2019,2,SP 14 da Poggio Berni (bivio SP 73) a Sant'Arcangelo di Romagna,,,,,,,,
2019/02,625,20/02/2019,3,SP 14 da Poggio Berni (bivio SP 73) a Sant'Arcangelo di Romagna,,,,,,,,
2019/02,625,21/02/2019,4,SP 14 da Poggio Berni (bivio SP 73) a Sant'Arcangelo di Romagna,,,,,,,,
2019/02,625,22/02/2019,5,SP 14 da Poggio Berni (bivio SP 73) a Sant'Arcangelo di Romagna,,,,,,,,
2019/02,625,23/02/2019,6,SP 14 da Poggio Berni (bivio SP 73) a Sant'Arcangelo di Romagna,,,,,,,,
2019/02,625,24/02/2019,7,SP 14 da Poggio Berni (bivio SP 73) a Sant'Arcangelo di Romagna,,,,,,,,
2019/02,625,25/02/2019,1,SP 14 da Poggio Berni (bivio SP 73) a Sant'Arcangelo di Romagna,,,,,,,,
2019/02,625,26/02/2019,2,SP 14 da Poggio Berni (bivio SP 73) a Sant'Arcangelo di Romagna,,,,,,,,
2019/02,625,27/02/2019,3,SP 14 da Poggio Berni (bivio SP 73) a Sant'Arcangelo di Romagna,,,,,,,,
2019/02,625,28/02/2019,4,SP 14 da Poggio Berni (bivio SP 73) a Sant'Arcangelo di Romagna,,,,,,,,
2019/02,626,15/02/2019,5,SP 18 da San Clemente al bivio SP 132 (località Osteria Nuova),8346,00,7949,397,6595,1751,8346,0
2019/02,626,16/02/2019,6,SP 18 da San Clemente al bivio SP 132 (località Osteria Nuova),7584,00,7470,114,5689,1895,0,7584
2019/02,626,17/02/2019,7,SP 18 da San Clemente al bivio SP 132 (località Osteria Nuova),6119,10,6106,12,4712,1407,0,6119
2019/02,626,18/02/2019,1,SP 18 da San Clemente al bivio SP 132 (località Osteria Nuova),7767,00,7379,388,6331,1436,7767,0
2019/02,626,19/02/2019,2,SP 18 da San Clemente al bivio SP 132 (località Osteria Nuova),7818,20,7443,373,6300,1518,7818,0
2019/02,626,20/02/2019,3,SP 18 da San Clemente al bivio SP 132 (località Osteria Nuova),7719,00,7291,428,6245,1474,7719,0
2019/02,626,21/02/2019,4,SP 18 da San Clemente al bivio SP 132 (località Osteria Nuova),8473,00,8093,380,6875,1598,8473,0
2019/02,626,22/02/2019,5,SP 18 da San Clemente al bivio SP 132 (località Osteria Nuova),8503,10,8143,359,6723,1780,8503,0
2019/02,626,23/02/2019,6,SP 18 da San Clemente al bivio SP 132 (località Osteria Nuova),7651,00,7517,134,5813,1838,0,7651
2019/02,626,24/02/2019,7,SP 18 da San Clemente al bivio SP 132 (località Osteria Nuova),5935,00,5913,22,4504,1431,0,5935
2019/02,626,25/02/2019,1,SP 18 da San Clemente al bivio SP 132 (località Osteria Nuova),7604,00,7191,413,6238,1366,7604,0
2019/02,626,26/02/2019,2,SP 18 da San Clemente al bivio SP 132 (località Osteria Nuova),7777,10,7384,392,6308,1469,7777,0
2019/02,626,27/02/2019,3,SP 18 da San Clemente al bivio SP 132 (località Osteria Nuova),7754,00,7311,443,6246,1508,7754,0
2019/02,626,28/02/2019,4,SP 18 da San Clemente al bivio SP 132 (località Osteria Nuova),8663,10,8258,404,6954,1709,8663,0
2019/02,627,15/02/2019,5,SS 64 variante di Riola di Vergato,8464,00,8019,445,6609,1855,8464,0
2019/02,627,16/02/2019,6,SS 64 variante di Riola di Vergato,8370,00,8233,137,6603,1767,0,8370
2019/02,627,17/02/2019,7,SS 64 variante di Riola di Vergato,7364,00,7300,64,5801,1563,0,7364
2019/02,627,18/02/2019,1,SS 64 variante di Riola di Vergato,7942,00,7460,482,6452,1490,7942,0
2019/02,627,19/02/2019,2,SS 64 variante di Riola di Vergato,7910,00,7467,443,6350,1560,7910,0
2019/02,627,20/02/2019,3,SS 64 variante di Riola di Vergato,7945,20,7497,446,6411,1534,7945,0
2019/02,627,21/02/2019,4,SS 64 variante di Riola di Vergato,7977,00,7497,480,6358,1619,7977,0
2019/02,627,22/02/2019,5,SS 64 variante di Riola di Vergato,8560,00,8092,468,6660,1900,8560,0
2019/02,627,23/02/2019,6,SS 64 variante di Riola di Vergato,7849,00,7697,152,6134,1715,0,7849
2019/02,627,24/02/2019,7,SS 64 variante di Riola di Vergato,7368,10,7336,31,5789,1579,0,7368
2019/02,627,25/02/2019,1,SS 64 variante di Riola di Vergato,8101,00,7636,465,6562,1539,8101,0
2019/02,627,26/02/2019,2,SS 64 variante di Riola di Vergato,7615,20,7141,472,6135,1480,7615,0
2019/02,627,27/02/2019,3,SS 64 variante di Riola di Vergato,7982,20,7493,487,6390,1592,7982,0
2019/02,627,28/02/2019,4,SS 64 variante di Riola di Vergato,8022,10,7567,454,6330,1692,8022,0
2019/02,629,15/02/2019,5,SS 727 (tg Forli') tra intersezione SS 9 e l'intersezione SS 67,17386,00,16243,1143,13445,3941,17386,0
2019/02,629,16/02/2019,6,SS 727 (tg Forli') tra intersezione SS 9 e l'intersezione SS 67,12643,00,12348,295,9282,3361,0,12643
2019/02,629,17/02/2019,7,SS 727 (tg Forli') tra intersezione SS 9 e l'intersezione SS 67,10517,00,10451,66,7903,2614,0,10517
2019/02,629,18/02/2019,1,SS 727 (tg Forli') tra intersezione SS 9 e l'intersezione SS 67,16396,00,15284,1112,13091,3305,16396,0
2019/02,629,19/02/2019,2,SS 727 (tg Forli') tra intersezione SS 9 e l'intersezione SS 67,16443,10,15311,1131,13137,3306,16443,0
2019/02,629,20/02/2019,3,SS 727 (tg Forli') tra intersezione SS 9 e l'intersezione SS 67,16297,00,15142,1155,13092,3205,16297,0
2019/02,629,21/02/2019,4,SS 727 (tg Forli') tra intersezione SS 9 e l'intersezione SS 67,16624,00,15551,1073,13147,3477,16624,0
2019/02,629,22/02/2019,5,SS 727 (tg Forli') tra intersezione SS 9 e l'intersezione SS 67,17347,10,16158,1188,13522,3825,17347,0
2019/02,629,23/02/2019,6,SS 727 (tg Forli') tra intersezione SS 9 e l'intersezione SS 67,12171,00,11873,298,8896,3275,0,12171
2019/02,629,24/02/2019,7,SS 727 (tg Forli') tra intersezione SS 9 e l'intersezione SS 67,10619,00,10568,51,7963,2656,0,10619
2019/02,629,25/02/2019,1,SS 727 (tg Forli') tra intersezione SS 9 e l'intersezione SS 67,16157,00,15034,1123,12972,3185,16157,0
2019/02,629,26/02/2019,2,SS 727 (tg Forli') tra intersezione SS 9 e l'intersezione SS 67,16644,00,15469,1175,13292,3352,16644,0
2019/02,629,27/02/2019,3,SS 727 (tg Forli') tra intersezione SS 9 e l'intersezione SS 67,16803,00,15615,1188,13360,3443,16803,0
2019/02,629,28/02/2019,4,SS 727 (tg Forli') tra intersezione SS 9 e l'intersezione SS 67,16951,00,15822,1129,13432,3519,16951,0
2019/02,630,15/02/2019,5,SS 726 (tg Cesena) tra intersezione ex SS 71BIS e l'intersezione SP 304R,,,,,,,,
2019/02,630,16/02/2019,6,SS 726 (tg Cesena) tra intersezione ex SS 71BIS e l'intersezione SP 304R,,,,,,,,
2019/02,630,17/02/2019,7,SS 726 (tg Cesena) tra intersezione ex SS 71BIS e l'intersezione SP 304R,,,,,,,,
2019/02,630,18/02/2019,1,SS 726 (tg Cesena) tra intersezione ex SS 71BIS e l'intersezione SP 304R,,,,,,,,
2019/02,630,19/02/2019,2,SS 726 (tg Cesena) tra intersezione ex SS 71BIS e l'intersezione SP 304R,,,,,,,,
2019/02,630,20/02/2019,3,SS 726 (tg Cesena) tra intersezione ex SS 71BIS e l'intersezione SP 304R,,,,,,,,
2019/02,630,21/02/2019,4,SS 726 (tg Cesena) tra intersezione ex SS 71BIS e l'intersezione SP 304R,,,,,,,,
2019/02,630,22/02/2019,5,SS 726 (tg Cesena) tra intersezione ex SS 71BIS e l'intersezione SP 304R,,,,,,,,
2019/02,630,23/02/2019,6,SS 726 (tg Cesena) tra intersezione ex SS 71BIS e l'intersezione SP 304R,,,,,,,,
2019/02,630,24/02/2019,7,SS 726 (tg Cesena) tra intersezione ex SS 71BIS e l'intersezione SP 304R,,,,,,,,
2019/02,630,25/02/2019,1,SS 726 (tg Cesena) tra intersezione ex SS 71BIS e l'intersezione SP 304R,,,,,,,,
2019/02,630,26/02/2019,2,SS 726 (tg Cesena) tra intersezione ex SS 71BIS e l'intersezione SP 304R,,,,,,,,
2019/02,630,27/02/2019,3,SS 726 (tg Cesena) tra intersezione ex SS 71BIS e l'intersezione SP 304R,,,,,,,,
2019/02,630,28/02/2019,4,SS 726 (tg Cesena) tra intersezione ex SS 71BIS e l'intersezione SP 304R,,,,,,,,
2019/02,631,15/02/2019,5,SS 3Bis/E 45 tra Sarsina e San Piero in Bagno,,,,,,,,
2019/02,631,16/02/2019,6,SS 3Bis/E 45 tra Sarsina e San Piero in Bagno,,,,,,,,
2019/02,631,17/02/2019,7,SS 3Bis/E 45 tra Sarsina e San Piero in Bagno,,,,,,,,
2019/02,631,18/02/2019,1,SS 3Bis/E 45 tra Sarsina e San Piero in Bagno,,,,,,,,
2019/02,631,19/02/2019,2,SS 3Bis/E 45 tra Sarsina e San Piero in Bagno,,,,,,,,
2019/02,631,20/02/2019,3,SS 3Bis/E 45 tra Sarsina e San Piero in Bagno,,,,,,,,
2019/02,631,21/02/2019,4,SS 3Bis/E 45 tra Sarsina e San Piero in Bagno,,,,,,,,
2019/02,631,22/02/2019,5,SS 3Bis/E 45 tra Sarsina e San Piero in Bagno,,,,,,,,
2019/02,631,23/02/2019,6,SS 3Bis/E 45 tra Sarsina e San Piero in Bagno,,,,,,,,
2019/02,631,24/02/2019,7,SS 3Bis/E 45 tra Sarsina e San Piero in Bagno,,,,,,,,
2019/02,631,25/02/2019,1,SS 3Bis/E 45 tra Sarsina e San Piero in Bagno,,,,,,,,
2019/02,631,26/02/2019,2,SS 3Bis/E 45 tra Sarsina e San Piero in Bagno,,,,,,,,
2019/02,631,27/02/2019,3,SS 3Bis/E 45 tra Sarsina e San Piero in Bagno,,,,,,,,
2019/02,631,28/02/2019,4,SS 3Bis/E 45 tra Sarsina e San Piero in Bagno,,,,,,,,
2019/02,632,28/02/2019,4,SS 724Dir/tangenziale complanare sud alla A 1 in direzione Reggio Emilia - tra intersezione Modena/Sassuolo e intersezione SS 12,8099,00,7718,381,6448,1651,8099,0
2019/02,633,15/02/2019,5,SS 724Dir/tangenziale complanare sud alla A 1 in direzione Bologna - tra intersezione Modena/Sassuolo e intersezione SS12,8034,00,7544,490,6060,1974,8034,0
2019/02,633,16/02/2019,6,SS 724Dir/tangenziale complanare sud alla A 1 in direzione Bologna - tra intersezione Modena/Sassuolo e intersezione SS12,6382,00,6272,110,4476,1906,0,6382
2019/02,633,17/02/2019,7,SS 724Dir/tangenziale complanare sud alla A 1 in direzione Bologna - tra intersezione Modena/Sassuolo e intersezione SS12,5170,00,5138,32,3545,1625,0,5170
2019/02,633,18/02/2019,1,SS 724Dir/tangenziale complanare sud alla A 1 in direzione Bologna - tra intersezione Modena/Sassuolo e intersezione SS12,7575,00,7135,440,5892,1683,7575,0
2019/02,633,19/02/2019,2,SS 724Dir/tangenziale complanare sud alla A 1 in direzione Bologna - tra intersezione Modena/Sassuolo e intersezione SS12,7823,00,7282,541,5993,1830,7823,0
2019/02,633,20/02/2019,3,SS 724Dir/tangenziale complanare sud alla A 1 in direzione Bologna - tra intersezione Modena/Sassuolo e intersezione SS12,7936,10,7380,555,6122,1814,7936,0
2019/02,633,21/02/2019,4,SS 724Dir/tangenziale complanare sud alla A 1 in direzione Bologna - tra intersezione Modena/Sassuolo e intersezione SS12,8175,10,7626,548,6203,1972,8175,0
2019/02,633,22/02/2019,5,SS 724Dir/tangenziale complanare sud alla A 1 in direzione Bologna - tra intersezione Modena/Sassuolo e intersezione SS12,8094,00,7539,555,6163,1931,8094,0
2019/02,633,23/02/2019,6,SS 724Dir/tangenziale complanare sud alla A 1 in direzione Bologna - tra intersezione Modena/Sassuolo e intersezione SS12,6518,00,6398,120,4493,2025,0,6518
2019/02,633,24/02/2019,7,SS 724Dir/tangenziale complanare sud alla A 1 in direzione Bologna - tra intersezione Modena/Sassuolo e intersezione SS12,5080,00,5034,46,3500,1580,0,5080
2019/02,633,25/02/2019,1,SS 724Dir/tangenziale complanare sud alla A 1 in direzione Bologna - tra intersezione Modena/Sassuolo e intersezione SS12,7866,00,7324,542,6046,1820,7866,0
2019/02,633,26/02/2019,2,SS 724Dir/tangenziale complanare sud alla A 1 in direzione Bologna - tra intersezione Modena/Sassuolo e intersezione SS12,7941,10,7375,565,6129,1812,7941,0
2019/02,633,27/02/2019,3,SS 724Dir/tangenziale complanare sud alla A 1 in direzione Bologna - tra intersezione Modena/Sassuolo e intersezione SS12,8093,20,7513,578,6182,1911,8093,0
2019/02,633,28/02/2019,4,SS 724Dir/tangenziale complanare sud alla A 1 in direzione Bologna - tra intersezione Modena/Sassuolo e intersezione SS12,8111,00,7613,498,6132,1979,8111,0
2019/02,634,15/02/2019,5,SS 12 tra Pavullo e intersezione SP 31,,,,,,,,
2019/02,634,16/02/2019,6,SS 12 tra Pavullo e intersezione SP 31,,,,,,,,
2019/02,634,17/02/2019,7,SS 12 tra Pavullo e intersezione SP 31,,,,,,,,
2019/02,634,18/02/2019,1,SS 12 tra Pavullo e intersezione SP 31,,,,,,,,
2019/02,634,19/02/2019,2,SS 12 tra Pavullo e intersezione SP 31,,,,,,,,
2019/02,634,20/02/2019,3,SS 12 tra Pavullo e intersezione SP 31,,,,,,,,
2019/02,634,21/02/2019,4,SS 12 tra Pavullo e intersezione SP 31,,,,,,,,
2019/02,634,22/02/2019,5,SS 12 tra Pavullo e intersezione SP 31,,,,,,,,
2019/02,634,23/02/2019,6,SS 12 tra Pavullo e intersezione SP 31,,,,,,,,
2019/02,634,24/02/2019,7,SS 12 tra Pavullo e intersezione SP 31,,,,,,,,
2019/02,634,25/02/2019,1,SS 12 tra Pavullo e intersezione SP 31,,,,,,,,
2019/02,634,26/02/2019,2,SS 12 tra Pavullo e intersezione SP 31,,,,,,,,
2019/02,634,27/02/2019,3,SS 12 tra Pavullo e intersezione SP 31,,,,,,,,
2019/02,634,28/02/2019,4,SS 12 tra Pavullo e intersezione SP 31,,,,,,,,
2019/02,635,15/02/2019,5,SS 725 (tg sud Piacenza) tra intersezione SS 45 e l'intersezione SP 6,47203,20,44129,3072,37308,9895,47203,0
2019/02,635,16/02/2019,6,SS 725 (tg sud Piacenza) tra intersezione SS 45 e l'intersezione SP 6,38879,00,37941,938,29814,9065,0,38879
2019/02,635,17/02/2019,7,SS 725 (tg sud Piacenza) tra intersezione SS 45 e l'intersezione SP 6,32254,00,32038,216,24399,7855,0,32254
2019/02,635,18/02/2019,1,SS 725 (tg sud Piacenza) tra intersezione SS 45 e l'intersezione SP 6,44219,20,41145,3072,35770,8449,44219,0
2019/02,635,19/02/2019,2,SS 725 (tg sud Piacenza) tra intersezione SS 45 e l'intersezione SP 6,44896,00,41897,2999,36360,8536,44896,0
2019/02,635,20/02/2019,3,SS 725 (tg sud Piacenza) tra intersezione SS 45 e l'intersezione SP 6,45273,00,42135,3138,36620,8653,45273,0
2019/02,635,21/02/2019,4,SS 725 (tg sud Piacenza) tra intersezione SS 45 e l'intersezione SP 6,45117,10,41974,3142,36395,8722,45117,0
2019/02,635,22/02/2019,5,SS 725 (tg sud Piacenza) tra intersezione SS 45 e l'intersezione SP 6,47829,10,44594,3234,37677,10152,47829,0
2019/02,635,23/02/2019,6,SS 725 (tg sud Piacenza) tra intersezione SS 45 e l'intersezione SP 6,39855,00,38964,891,30585,9270,0,39855
2019/02,635,24/02/2019,7,SS 725 (tg sud Piacenza) tra intersezione SS 45 e l'intersezione SP 6,31293,00,31068,225,23818,7475,0,31293
2019/02,635,25/02/2019,1,SS 725 (tg sud Piacenza) tra intersezione SS 45 e l'intersezione SP 6,44180,00,41193,2987,35767,8413,44180,0
2019/02,635,26/02/2019,2,SS 725 (tg sud Piacenza) tra intersezione SS 45 e l'intersezione SP 6,44866,00,41668,3198,36269,8597,44866,0
2019/02,635,27/02/2019,3,SS 725 (tg sud Piacenza) tra intersezione SS 45 e l'intersezione SP 6,45959,00,42572,3387,36988,8971,45959,0
2019/02,635,28/02/2019,4,SS 725 (tg sud Piacenza) tra intersezione SS 45 e l'intersezione SP 6,46050,30,42775,3272,36773,9277,46050,0
2019/02,636,15/02/2019,5,SS 9Var tra la tangenziale nord di Parma (intersezione SP 343R) e l'intersezione SP 62R,58187,40,54929,3254,45111,13076,58187,0
2019/02,636,16/02/2019,6,SS 9Var tra la tangenziale nord di Parma (intersezione SP 343R) e l'intersezione SP 62R,49487,60,48599,882,36461,13026,0,49487
2019/02,636,17/02/2019,7,SS 9Var tra la tangenziale nord di Parma (intersezione SP 343R) e l'intersezione SP 62R,39670,00,39369,301,28783,10887,0,39670
2019/02,636,18/02/2019,1,SS 9Var tra la tangenziale nord di Parma (intersezione SP 343R) e l'intersezione SP 62R,54189,50,50812,3372,43605,10584,54189,0
2019/02,636,19/02/2019,2,SS 9Var tra la tangenziale nord di Parma (intersezione SP 343R) e l'intersezione SP 62R,55253,90,51732,3512,44107,11146,55253,0
2019/02,636,20/02/2019,3,SS 9Var tra la tangenziale nord di Parma (intersezione SP 343R) e l'intersezione SP 62R,56341,30,52849,3489,44812,11529,56341,0
2019/02,636,21/02/2019,4,SS 9Var tra la tangenziale nord di Parma (intersezione SP 343R) e l'intersezione SP 62R,56195,50,52824,3366,44522,11673,56195,0
2019/02,636,22/02/2019,5,SS 9Var tra la tangenziale nord di Parma (intersezione SP 343R) e l'intersezione SP 62R,58859,50,55451,3403,45601,13258,58859,0
2019/02,636,23/02/2019,6,SS 9Var tra la tangenziale nord di Parma (intersezione SP 343R) e l'intersezione SP 62R,50032,60,49130,896,36616,13416,0,50032
2019/02,636,24/02/2019,7,SS 9Var tra la tangenziale nord di Parma (intersezione SP 343R) e l'intersezione SP 62R,41293,20,40973,318,29221,12072,0,41293
2019/02,636,25/02/2019,1,SS 9Var tra la tangenziale nord di Parma (intersezione SP 343R) e l'intersezione SP 62R,54365,30,51035,3327,43573,10792,54365,0
2019/02,636,26/02/2019,2,SS 9Var tra la tangenziale nord di Parma (intersezione SP 343R) e l'intersezione SP 62R,55381,70,51964,3410,44117,11264,55381,0
2019/02,636,27/02/2019,3,SS 9Var tra la tangenziale nord di Parma (intersezione SP 343R) e l'intersezione SP 62R,56882,60,53270,3606,44909,11973,56882,0
2019/02,636,28/02/2019,4,SS 9Var tra la tangenziale nord di Parma (intersezione SP 343R) e l'intersezione SP 62R,57185,120,53719,3454,44899,12286,57185,0
2019/02,637,15/02/2019,5,SS 62 tra Fornovo di Taro e Collecchio,14520,10,13693,826,11236,3284,14520,0
2019/02,637,16/02/2019,6,SS 62 tra Fornovo di Taro e Collecchio,12216,00,11953,263,9280,2936,0,12216
2019/02,637,17/02/2019,7,SS 62 tra Fornovo di Taro e Collecchio,11451,00,11379,72,8366,3085,0,11451
2019/02,637,18/02/2019,1,SS 62 tra Fornovo di Taro e Collecchio,13248,00,12375,873,10552,2696,13248,0
2019/02,637,19/02/2019,2,SS 62 tra Fornovo di Taro e Collecchio,14148,00,13268,880,11163,2985,14148,0
2019/02,637,20/02/2019,3,SS 62 tra Fornovo di Taro e Collecchio,14048,40,13154,890,11114,2934,14048,0
2019/02,637,21/02/2019,4,SS 62 tra Fornovo di Taro e Collecchio,14079,00,13243,836,11039,3040,14079,0
2019/02,637,22/02/2019,5,SS 62 tra Fornovo di Taro e Collecchio,14862,00,14064,798,11437,3425,14862,0
2019/02,637,23/02/2019,6,SS 62 tra Fornovo di Taro e Collecchio,12503,00,12243,260,9485,3018,0,12503
2019/02,637,24/02/2019,7,SS 62 tra Fornovo di Taro e Collecchio,10706,00,10620,86,7753,2953,0,10706
2019/02,637,25/02/2019,1,SS 62 tra Fornovo di Taro e Collecchio,13571,00,12697,874,10765,2806,13571,0
2019/02,637,26/02/2019,2,SS 62 tra Fornovo di Taro e Collecchio,14176,00,13289,887,11317,2859,14176,0
2019/02,637,27/02/2019,3,SS 62 tra Fornovo di Taro e Collecchio,14700,10,13748,951,11485,3215,14700,0
2019/02,637,28/02/2019,4,SS 62 tra Fornovo di Taro e Collecchio,14058,10,13235,822,10923,3135,14058,0
2019/02,638,15/02/2019,5,SS 9 tra la tangenziale nord di Reggio Emilia e Sant'Ilario d'Enza,20555,00,18805,1750,14734,5821,20555,0
2019/02,638,16/02/2019,6,SS 9 tra la tangenziale nord di Reggio Emilia e Sant'Ilario d'Enza,18524,00,18038,486,12380,6144,0,18524
2019/02,638,17/02/2019,7,SS 9 tra la tangenziale nord di Reggio Emilia e Sant'Ilario d'Enza,16750,00,16573,177,11445,5305,0,16750
2019/02,638,18/02/2019,1,SS 9 tra la tangenziale nord di Reggio Emilia e Sant'Ilario d'Enza,18711,00,17135,1576,14136,4575,18711,0
2019/02,638,19/02/2019,2,SS 9 tra la tangenziale nord di Reggio Emilia e Sant'Ilario d'Enza,19497,00,17789,1708,14688,4809,19497,0
2019/02,638,20/02/2019,3,SS 9 tra la tangenziale nord di Reggio Emilia e Sant'Ilario d'Enza,19328,10,17651,1676,14336,4992,19328,0
2019/02,638,21/02/2019,4,SS 9 tra la tangenziale nord di Reggio Emilia e Sant'Ilario d'Enza,19151,00,17442,1709,14015,5136,19151,0
2019/02,638,22/02/2019,5,SS 9 tra la tangenziale nord di Reggio Emilia e Sant'Ilario d'Enza,20709,10,18931,1777,14795,5914,20709,0
2019/02,638,23/02/2019,6,SS 9 tra la tangenziale nord di Reggio Emilia e Sant'Ilario d'Enza,18656,00,18172,484,12425,6231,0,18656
2019/02,638,24/02/2019,7,SS 9 tra la tangenziale nord di Reggio Emilia e Sant'Ilario d'Enza,15972,00,15805,167,10689,5283,0,15972
2019/02,638,25/02/2019,1,SS 9 tra la tangenziale nord di Reggio Emilia e Sant'Ilario d'Enza,18617,50,16978,1634,14103,4514,18617,0
2019/02,638,26/02/2019,2,SS 9 tra la tangenziale nord di Reggio Emilia e Sant'Ilario d'Enza,19623,00,17806,1817,14823,4800,19623,0
2019/02,638,27/02/2019,3,SS 9 tra la tangenziale nord di Reggio Emilia e Sant'Ilario d'Enza,19803,00,18074,1729,14583,5220,19803,0
2019/02,638,28/02/2019,4,SS 9 tra la tangenziale nord di Reggio Emilia e Sant'Ilario d'Enza,19995,00,18251,1744,14621,5374,19995,0
2019/02,639,15/02/2019,5,SS 63 località Casina (variante abitato),7121,00,6806,315,5424,1697,7121,0
2019/02,639,16/02/2019,6,SS 63 località Casina (variante abitato),6597,00,6476,121,5009,1588,0,6597
2019/02,639,17/02/2019,7,SS 63 località Casina (variante abitato),6685,00,6625,60,5148,1537,0,6685
2019/02,639,18/02/2019,1,SS 63 località Casina (variante abitato),6479,00,6143,336,5053,1426,6479,0
2019/02,639,19/02/2019,2,SS 63 località Casina (variante abitato),6325,10,6055,269,4905,1420,6325,0
2019/02,639,20/02/2019,3,SS 63 località Casina (variante abitato),6759,10,6426,332,5273,1486,6759,0
2019/02,639,21/02/2019,4,SS 63 località Casina (variante abitato),6620,10,6295,324,5113,1507,6620,0
2019/02,639,22/02/2019,5,SS 63 località Casina (variante abitato),6971,00,6656,315,5304,1667,6971,0
2019/02,639,23/02/2019,6,SS 63 località Casina (variante abitato),6565,00,6418,147,4968,1597,0,6565
2019/02,639,24/02/2019,7,SS 63 località Casina (variante abitato),6115,00,6064,51,4671,1444,0,6115
2019/02,639,25/02/2019,1,SS 63 località Casina (variante abitato),6409,10,6050,358,5022,1387,6409,0
2019/02,639,26/02/2019,2,SS 63 località Casina (variante abitato),6412,10,6077,334,4897,1515,6412,0
2019/02,639,27/02/2019,3,SS 63 località Casina (variante abitato),6946,00,6640,306,5261,1685,6946,0
2019/02,639,28/02/2019,4,SS 63 località Casina (variante abitato),6844,10,6519,324,5268,1576,6844,0
2019/02,651,15/02/2019,5,SS 9 da Imola a Castelbolognese (al confine provinciale),17303,00,16534,769,12580,4723,17303,0
2019/02,651,16/02/2019,6,SS 9 da Imola a Castelbolognese (al confine provinciale),15724,00,15513,211,10616,5108,0,15724
2019/02,651,17/02/2019,7,SS 9 da Imola a Castelbolognese (al confine provinciale),13886,00,13817,69,9888,3998,0,13886
2019/02,651,18/02/2019,1,SS 9 da Imola a Castelbolognese (al confine provinciale),16246,00,15351,895,12593,3653,16246,0
2019/02,651,19/02/2019,2,SS 9 da Imola a Castelbolognese (al confine provinciale),16496,00,15597,899,12558,3938,16496,0
2019/02,651,20/02/2019,3,SS 9 da Imola a Castelbolognese (al confine provinciale),16813,00,16009,804,12789,4024,16813,0
2019/02,651,21/02/2019,4,SS 9 da Imola a Castelbolognese (al confine provinciale),16140,00,15366,774,12491,3649,16140,0
2019/02,651,22/02/2019,5,SS 9 da Imola a Castelbolognese (al confine provinciale),17529,00,16765,764,12898,4631,17529,0
2019/02,651,23/02/2019,6,SS 9 da Imola a Castelbolognese (al confine provinciale),16472,00,16250,222,11225,5247,0,16472
2019/02,651,24/02/2019,7,SS 9 da Imola a Castelbolognese (al confine provinciale),13942,00,13887,55,9976,3966,0,13942
2019/02,651,25/02/2019,1,SS 9 da Imola a Castelbolognese (al confine provinciale),15916,00,15165,751,12231,3685,15916,0
2019/02,651,26/02/2019,2,SS 9 da Imola a Castelbolognese (al confine provinciale),16869,00,15950,919,12829,4040,16869,0
2019/02,651,27/02/2019,3,SS 9 da Imola a Castelbolognese (al confine provinciale),16810,00,15989,821,12581,4229,16810,0
2019/02,651,28/02/2019,4,SS 9 da Imola a Castelbolognese (al confine provinciale),16958,00,16170,788,12838,4120,16958,0
2019/02,652,15/02/2019,5,SS 16 dal bivio SP 610R ad Argenta,12824,00,11536,1288,9993,2831,12824,0
2019/02,652,16/02/2019,6,SS 16 dal bivio SP 610R ad Argenta,10382,00,10095,287,7768,2614,0,10382
2019/02,652,17/02/2019,7,SS 16 dal bivio SP 610R ad Argenta,9538,00,9457,81,7122,2416,0,9538
2019/02,652,18/02/2019,1,SS 16 dal bivio SP 610R ad Argenta,12055,00,10802,1253,9664,2391,12055,0
2019/02,652,19/02/2019,2,SS 16 dal bivio SP 610R ad Argenta,11953,00,10567,1386,9730,2223,11953,0
2019/02,652,20/02/2019,3,SS 16 dal bivio SP 610R ad Argenta,12066,00,10679,1387,9715,2351,12066,0
2019/02,652,21/02/2019,4,SS 16 dal bivio SP 610R ad Argenta,12468,00,11096,1372,9949,2519,12468,0
2019/02,652,22/02/2019,5,SS 16 dal bivio SP 610R ad Argenta,13127,00,11788,1339,10325,2802,13127,0
2019/02,652,23/02/2019,6,SS 16 dal bivio SP 610R ad Argenta,10747,00,10462,285,8139,2608,0,10747
2019/02,652,24/02/2019,7,SS 16 dal bivio SP 610R ad Argenta,9499,00,9388,111,7069,2430,0,9499
2019/02,652,25/02/2019,1,SS 16 dal bivio SP 610R ad Argenta,11923,00,10630,1293,9581,2342,11923,0
2019/02,652,26/02/2019,2,SS 16 dal bivio SP 610R ad Argenta,12262,00,10867,1395,9783,2479,12262,0
2019/02,652,27/02/2019,3,SS 16 dal bivio SP 610R ad Argenta,12364,00,10980,1384,9930,2434,12364,0
2019/02,652,28/02/2019,4,SS 16 dal bivio SP 610R ad Argenta,12567,00,11265,1302,9992,2575,12567,0
2019/02,653,15/02/2019,5,SP 254R dal ponte sul fiume Savio alla SS 16,7552,00,7412,140,5864,1688,7552,0
2019/02,653,18/02/2019,1,SP 254R dal ponte sul fiume Savio alla SS 16,6630,00,6458,172,5652,978,6630,0
2019/02,653,21/02/2019,4,SP 254R dal ponte sul fiume Savio alla SS 16,6816,00,6693,123,5628,1188,6816,0
2019/02,653,22/02/2019,5,SP 254R dal ponte sul fiume Savio alla SS 16,7245,00,7106,139,5713,1532,7245,0
2019/02,653,23/02/2019,6,SP 254R dal ponte sul fiume Savio alla SS 16,7990,00,7951,39,5987,2003,0,7990
2019/02,653,25/02/2019,1,SP 254R dal ponte sul fiume Savio alla SS 16,7675,00,7499,176,6338,1337,7675,0
2019/02,653,26/02/2019,2,SP 254R dal ponte sul fiume Savio alla SS 16,7939,00,7754,185,6522,1417,7939,0
2019/02,653,27/02/2019,3,SP 254R dal ponte sul fiume Savio alla SS 16,8214,00,7976,238,6775,1439,8214,0
2019/02,653,28/02/2019,4,SP 254R dal ponte sul fiume Savio alla SS 16,8452,00,8213,239,6867,1585,8452,0
2019/02,654,15/02/2019,5,SP 7IBisR dal bivio SSPP 32/33ter alla SS 16,12497,00,12081,416,9596,2901,12497,0
2019/02,654,16/02/2019,6,SP 7IBisR dal bivio SSPP 32/33ter alla SS 16,12560,00,12396,164,8867,3693,0,12560
2019/02,654,17/02/2019,7,SP 7IBisR dal bivio SSPP 32/33ter alla SS 16,14335,00,14285,50,10998,3337,0,14335
2019/02,654,18/02/2019,1,SP 7IBisR dal bivio SSPP 32/33ter alla SS 16,11345,00,10857,488,9263,2082,11345,0
2019/02,654,19/02/2019,2,SP 7IBisR dal bivio SSPP 32/33ter alla SS 16,11538,00,11011,527,9421,2117,11538,0
2019/02,654,20/02/2019,3,SP 7IBisR dal bivio SSPP 32/33ter alla SS 16,11795,00,11291,504,9606,2189,11795,0
2019/02,654,21/02/2019,4,SP 7IBisR dal bivio SSPP 32/33ter alla SS 16,11802,00,11297,505,9575,2227,11802,0
2019/02,654,22/02/2019,5,SP 7IBisR dal bivio SSPP 32/33ter alla SS 16,12403,00,11951,452,9587,2816,12403,0
2019/02,654,23/02/2019,6,SP 7IBisR dal bivio SSPP 32/33ter alla SS 16,11317,00,11185,132,8129,3188,0,11317
2019/02,654,24/02/2019,7,SP 7IBisR dal bivio SSPP 32/33ter alla SS 16,10741,00,10713,28,8209,2532,0,10741
2019/02,654,25/02/2019,1,SP 7IBisR dal bivio SSPP 32/33ter alla SS 16,10949,00,10510,439,8904,2045,10949,0
2019/02,654,26/02/2019,2,SP 7IBisR dal bivio SSPP 32/33ter alla SS 16,11429,00,10928,501,9305,2124,11429,0
2019/02,654,27/02/2019,3,SP 7IBisR dal bivio SSPP 32/33ter alla SS 16,11990,00,11554,436,9676,2314,11990,0
2019/02,654,28/02/2019,4,SP 7IBisR dal bivio SSPP 32/33ter alla SS 16,12021,00,11560,461,9595,2426,12021,0
2019/02,655,15/02/2019,5,SP 253R dal bivio SP 302R allo svincolo A 14dir a Fornace Zarattini,18189,00,17239,950,14171,4018,18189,0
2019/02,655,16/02/2019,6,SP 253R dal bivio SP 302R allo svincolo A 14dir a Fornace Zarattini,15163,00,14907,256,11152,4011,0,15163
2019/02,655,17/02/2019,7,SP 253R dal bivio SP 302R allo svincolo A 14dir a Fornace Zarattini,12205,00,12133,72,9349,2856,0,12205
2019/02,655,18/02/2019,1,SP 253R dal bivio SP 302R allo svincolo A 14dir a Fornace Zarattini,17472,00,16651,821,14250,3222,17472,0
2019/02,655,19/02/2019,2,SP 253R dal bivio SP 302R allo svincolo A 14dir a Fornace Zarattini,17887,00,17000,887,14335,3552,17887,0
2019/02,655,20/02/2019,3,SP 253R dal bivio SP 302R allo svincolo A 14dir a Fornace Zarattini,17910,00,17045,865,14317,3593,17910,0
2019/02,655,21/02/2019,4,SP 253R dal bivio SP 302R allo svincolo A 14dir a Fornace Zarattini,16402,00,15576,826,12788,3614,16402,0
2019/02,655,22/02/2019,5,SP 253R dal bivio SP 302R allo svincolo A 14dir a Fornace Zarattini,17850,00,16990,860,13999,3851,17850,0
2019/02,655,23/02/2019,6,SP 253R dal bivio SP 302R allo svincolo A 14dir a Fornace Zarattini,14741,00,14513,228,10714,4027,0,14741
2019/02,655,24/02/2019,7,SP 253R dal bivio SP 302R allo svincolo A 14dir a Fornace Zarattini,11452,00,11388,64,8612,2840,0,11452
2019/02,655,25/02/2019,1,SP 253R dal bivio SP 302R allo svincolo A 14dir a Fornace Zarattini,17556,00,16647,909,14131,3425,17556,0
2019/02,655,26/02/2019,2,SP 253R dal bivio SP 302R allo svincolo A 14dir a Fornace Zarattini,17482,00,16493,989,13962,3520,17482,0
2019/02,655,27/02/2019,3,SP 253R dal bivio SP 302R allo svincolo A 14dir a Fornace Zarattini,16960,00,16083,877,13155,3805,16960,0
2019/02,655,28/02/2019,4,SP 253R dal bivio SP 302R allo svincolo A 14dir a Fornace Zarattini,18260,00,17369,891,14499,3761,18260,0
2019/02,660,15/02/2019,5,SP 25 tra intersezione con SS 64 e confine provinciale,,,,,,,,
2019/02,660,16/02/2019,6,SP 25 tra intersezione con SS 64 e confine provinciale,,,,,,,,
2019/02,660,17/02/2019,7,SP 25 tra intersezione con SS 64 e confine provinciale,,,,,,,,
2019/02,660,18/02/2019,1,SP 25 tra intersezione con SS 64 e confine provinciale,,,,,,,,
2019/02,660,19/02/2019,2,SP 25 tra intersezione con SS 64 e confine provinciale,,,,,,,,
2019/02,660,20/02/2019,3,SP 25 tra intersezione con SS 64 e confine provinciale,,,,,,,,
2019/02,660,21/02/2019,4,SP 25 tra intersezione con SS 64 e confine provinciale,,,,,,,,
2019/02,660,22/02/2019,5,SP 25 tra intersezione con SS 64 e confine provinciale,,,,,,,,
2019/02,660,23/02/2019,6,SP 25 tra intersezione con SS 64 e confine provinciale,,,,,,,,
2019/02,660,24/02/2019,7,SP 25 tra intersezione con SS 64 e confine provinciale,,,,,,,,
2019/02,660,25/02/2019,1,SP 25 tra intersezione con SS 64 e confine provinciale,,,,,,,,
2019/02,660,26/02/2019,2,SP 25 tra intersezione con SS 64 e confine provinciale,,,,,,,,
2019/02,660,27/02/2019,3,SP 25 tra intersezione con SS 64 e confine provinciale,,,,,,,,
2019/02,660,28/02/2019,4,SP 25 tra intersezione con SS 64 e confine provinciale,,,,,,,,
2019/02,661,15/02/2019,5,SP 15 tra Tresigallo e Massa Fiscaglia,3467,00,3348,119,2683,784,3467,0
2019/02,661,16/02/2019,6,SP 15 tra Tresigallo e Massa Fiscaglia,3126,00,3081,45,2344,782,0,3126
2019/02,661,17/02/2019,7,SP 15 tra Tresigallo e Massa Fiscaglia,3400,00,3390,10,2673,727,0,3400
2019/02,661,18/02/2019,1,SP 15 tra Tresigallo e Massa Fiscaglia,3203,10,3133,69,2521,682,3203,0
2019/02,661,19/02/2019,2,SP 15 tra Tresigallo e Massa Fiscaglia,3351,10,3250,100,2699,652,3351,0
2019/02,661,20/02/2019,3,SP 15 tra Tresigallo e Massa Fiscaglia,3302,00,3203,99,2660,642,3302,0
2019/02,661,21/02/2019,4,SP 15 tra Tresigallo e Massa Fiscaglia,3363,00,3266,97,2690,673,3363,0
2019/02,661,22/02/2019,5,SP 15 tra Tresigallo e Massa Fiscaglia,3483,00,3373,110,2725,758,3483,0
2019/02,661,23/02/2019,6,SP 15 tra Tresigallo e Massa Fiscaglia,2784,00,2750,34,2082,702,0,2784
2019/02,661,24/02/2019,7,SP 15 tra Tresigallo e Massa Fiscaglia,3179,00,3162,17,2528,651,0,3179
2019/02,661,25/02/2019,1,SP 15 tra Tresigallo e Massa Fiscaglia,3252,10,3168,83,2582,670,3252,0
2019/02,661,26/02/2019,2,SP 15 tra Tresigallo e Massa Fiscaglia,3456,00,3353,103,2794,662,3456,0
2019/02,661,27/02/2019,3,SP 15 tra Tresigallo e Massa Fiscaglia,3420,10,3278,141,2728,692,3420,0
2019/02,661,28/02/2019,4,SP 15 tra Tresigallo e Massa Fiscaglia,3520,00,3431,89,2810,710,3520,0
2019/02,662,15/02/2019,5,SP 2 tra intersezione SP 14 e Copparo,13725,10,13150,574,10865,2860,13725,0
2019/02,662,16/02/2019,6,SP 2 tra intersezione SP 14 e Copparo,10960,00,10803,157,8230,2730,0,10960
2019/02,662,17/02/2019,7,SP 2 tra intersezione SP 14 e Copparo,8529,00,8488,41,6096,2433,0,8529
2019/02,662,18/02/2019,1,SP 2 tra intersezione SP 14 e Copparo,13257,30,12712,542,10794,2463,13257,0
2019/02,662,19/02/2019,2,SP 2 tra intersezione SP 14 e Copparo,13466,10,12889,576,10852,2614,13466,0
2019/02,662,20/02/2019,3,SP 2 tra intersezione SP 14 e Copparo,13517,00,12886,631,10869,2648,13517,0
2019/02,662,21/02/2019,4,SP 2 tra intersezione SP 14 e Copparo,13210,00,12648,562,10471,2739,13210,0
2019/02,662,22/02/2019,5,SP 2 tra intersezione SP 14 e Copparo,13884,00,13279,605,10979,2905,13884,0
2019/02,662,23/02/2019,6,SP 2 tra intersezione SP 14 e Copparo,11031,00,10852,179,8291,2740,0,11031
2019/02,662,24/02/2019,7,SP 2 tra intersezione SP 14 e Copparo,8455,00,8417,38,6102,2353,0,8455
2019/02,662,25/02/2019,1,SP 2 tra intersezione SP 14 e Copparo,13241,00,12657,584,10767,2474,13241,0
2019/02,662,26/02/2019,2,SP 2 tra intersezione SP 14 e Copparo,13331,20,12715,614,10767,2564,13331,0
2019/02,662,27/02/2019,3,SP 2 tra intersezione SP 14 e Copparo,13674,20,13031,641,10952,2722,13674,0
2019/02,662,28/02/2019,4,SP 2 tra intersezione SP 14 e Copparo,13491,00,12892,599,10685,2806,13491,0
2019/02,663,15/02/2019,5,SP 60 tra intersezione SP 68 e SP62,3263,00,2725,538,2512,751,3263,0
2019/02,663,16/02/2019,6,SP 60 tra intersezione SP 68 e SP62,2758,00,2633,125,2084,674,0,2758
2019/02,663,17/02/2019,7,SP 60 tra intersezione SP 68 e SP62,3334,00,3302,32,2683,651,0,3334
2019/02,663,18/02/2019,1,SP 60 tra intersezione SP 68 e SP62,2935,00,2471,464,2310,625,2935,0
2019/02,663,19/02/2019,2,SP 60 tra intersezione SP 68 e SP62,3034,00,2572,462,2438,596,3034,0
2019/02,663,20/02/2019,3,SP 60 tra intersezione SP 68 e SP62,3080,00,2587,493,2467,613,3080,0
2019/02,663,21/02/2019,4,SP 60 tra intersezione SP 68 e SP62,3058,00,2573,485,2449,609,3058,0
2019/02,663,22/02/2019,5,SP 60 tra intersezione SP 68 e SP62,3121,10,2694,426,2459,662,3121,0
2019/02,663,23/02/2019,6,SP 60 tra intersezione SP 68 e SP62,2708,00,2543,165,2042,666,0,2708
2019/02,663,24/02/2019,7,SP 60 tra intersezione SP 68 e SP62,3102,00,3065,37,2469,633,0,3102
2019/02,663,25/02/2019,1,SP 60 tra intersezione SP 68 e SP62,3138,00,2653,485,2486,652,3138,0
2019/02,663,26/02/2019,2,SP 60 tra intersezione SP 68 e SP62,3102,00,2631,471,2482,620,3102,0
2019/02,663,27/02/2019,3,SP 60 tra intersezione SP 68 e SP62,3425,00,2841,584,2715,710,3425,0
2019/02,663,28/02/2019,4,SP 60 tra intersezione SP 68 e SP62,3268,00,2788,480,2623,645,3268,0
2019/02,665,15/02/2019,5,SP 1 tra intersezione SP7 a Piacenza,12595,10,11926,668,9816,2779,12595,0
2019/02,665,16/02/2019,6,SP 1 tra intersezione SP7 a Piacenza,9794,00,9651,143,7187,2607,0,9794
2019/02,665,17/02/2019,7,SP 1 tra intersezione SP7 a Piacenza,7416,10,7374,41,5332,2084,0,7416
2019/02,665,18/02/2019,1,SP 1 tra intersezione SP7 a Piacenza,11616,00,11003,613,9341,2275,11616,0
2019/02,665,19/02/2019,2,SP 1 tra intersezione SP7 a Piacenza,12042,10,11337,704,9690,2352,12042,0
2019/02,665,20/02/2019,3,SP 1 tra intersezione SP7 a Piacenza,11965,10,11298,666,9593,2372,11965,0
2019/02,665,21/02/2019,4,SP 1 tra intersezione SP7 a Piacenza,12130,00,11453,677,9664,2466,12130,0
2019/02,665,22/02/2019,5,SP 1 tra intersezione SP7 a Piacenza,12488,00,11811,677,9787,2701,12488,0
2019/02,665,23/02/2019,6,SP 1 tra intersezione SP7 a Piacenza,9802,00,9652,150,7240,2562,0,9802
2019/02,665,24/02/2019,7,SP 1 tra intersezione SP7 a Piacenza,7496,00,7456,40,5477,2019,0,7496
2019/02,665,25/02/2019,1,SP 1 tra intersezione SP7 a Piacenza,11608,00,10985,623,9361,2247,11608,0
2019/02,665,26/02/2019,2,SP 1 tra intersezione SP7 a Piacenza,12143,10,11451,691,9908,2235,12143,0
2019/02,665,27/02/2019,3,SP 1 tra intersezione SP7 a Piacenza,12157,00,11408,749,9799,2358,12157,0
2019/02,665,28/02/2019,4,SP 1 tra intersezione SP7 a Piacenza,12320,00,11651,669,9707,2613,12320,0
2019/02,666,15/02/2019,5,SP 3 tra via Monda e via Caminate,8227,00,7687,540,6415,1812,8227,0
2019/02,666,16/02/2019,6,SP 3 tra via Monda e via Caminate,6761,00,6636,125,5008,1753,0,6761
2019/02,666,17/02/2019,7,SP 3 tra via Monda e via Caminate,7542,00,7517,25,5770,1772,0,7542
2019/02,666,18/02/2019,1,SP 3 tra via Monda e via Caminate,7736,10,7238,497,6295,1441,7736,0
2019/02,666,19/02/2019,2,SP 3 tra via Monda e via Caminate,7654,00,7176,478,6173,1481,7654,0
2019/02,666,20/02/2019,3,SP 3 tra via Monda e via Caminate,7608,00,7178,430,6085,1523,7608,0
2019/02,666,21/02/2019,4,SP 3 tra via Monda e via Caminate,7828,00,7354,474,6299,1529,7828,0
2019/02,666,22/02/2019,5,SP 3 tra via Monda e via Caminate,8057,00,7597,460,6383,1674,8057,0
2019/02,666,23/02/2019,6,SP 3 tra via Monda e via Caminate,6288,10,6195,92,4655,1633,0,6288
2019/02,666,24/02/2019,7,SP 3 tra via Monda e via Caminate,5411,00,5388,23,4061,1350,0,5411
2019/02,666,25/02/2019,1,SP 3 tra via Monda e via Caminate,7677,00,7219,458,6170,1507,7677,0
2019/02,666,26/02/2019,2,SP 3 tra via Monda e via Caminate,7639,00,7186,453,6088,1551,7639,0
2019/02,666,27/02/2019,3,SP 3 tra via Monda e via Caminate,7913,00,7475,438,6217,1696,7913,0
2019/02,666,28/02/2019,4,SP 3 tra via Monda e via Caminate,8068,10,7624,443,6395,1673,8068,0
2019/02,670,15/02/2019,5,SP 114 dalla rotatoria SP 114/viale Parisoli alla rotatoria SP467,17542,00,16741,801,13942,3600,17542,0
2019/02,670,16/02/2019,6,SP 114 dalla rotatoria SP 114/viale Parisoli alla rotatoria SP467,13367,20,13229,136,9903,3464,0,13367
2019/02,670,17/02/2019,7,SP 114 dalla rotatoria SP 114/viale Parisoli alla rotatoria SP467,9801,00,9745,56,7087,2714,0,9801
2019/02,670,18/02/2019,1,SP 114 dalla rotatoria SP 114/viale Parisoli alla rotatoria SP467,16524,00,15752,772,13573,2951,16524,0
2019/02,670,19/02/2019,2,SP 114 dalla rotatoria SP 114/viale Parisoli alla rotatoria SP467,16920,00,16075,845,13758,3162,16920,0
2019/02,670,20/02/2019,3,SP 114 dalla rotatoria SP 114/viale Parisoli alla rotatoria SP467,17187,00,16411,776,13977,3210,17187,0
2019/02,670,21/02/2019,4,SP 114 dalla rotatoria SP 114/viale Parisoli alla rotatoria SP467,17426,00,16569,857,13851,3575,17426,0
2019/02,670,22/02/2019,5,SP 114 dalla rotatoria SP 114/viale Parisoli alla rotatoria SP467,17700,00,16896,804,14113,3587,17700,0
2019/02,670,23/02/2019,6,SP 114 dalla rotatoria SP 114/viale Parisoli alla rotatoria SP467,13613,00,13445,168,9934,3679,0,13613
2019/02,670,24/02/2019,7,SP 114 dalla rotatoria SP 114/viale Parisoli alla rotatoria SP467,9534,10,9491,42,6854,2680,0,9534
2019/02,670,25/02/2019,1,SP 114 dalla rotatoria SP 114/viale Parisoli alla rotatoria SP467,16639,00,15863,776,13561,3078,16639,0
2019/02,670,26/02/2019,2,SP 114 dalla rotatoria SP 114/viale Parisoli alla rotatoria SP467,17129,00,16292,837,13967,3162,17129,0
2019/02,670,27/02/2019,3,SP 114 dalla rotatoria SP 114/viale Parisoli alla rotatoria SP467,17908,00,17017,891,14382,3526,17908,0
2019/02,670,28/02/2019,4,SP 114 dalla rotatoria SP 114/viale Parisoli alla rotatoria SP467,17458,10,16555,902,13889,3569,17458,0
2019/02,6,01/02/2019,5,SS 12 tra Fiumalbo e Abetone,1682,00,1641,41,1333,349,1682,0
2019/02,6,02/02/2019,6,SS 12 tra Fiumalbo e Abetone,2334,00,2303,31,1876,458,0,2334
2019/02,6,03/02/2019,7,SS 12 tra Fiumalbo e Abetone,2284,00,2267,17,1930,354,0,2284
2019/02,6,04/02/2019,1,SS 12 tra Fiumalbo e Abetone,1379,00,1322,57,1158,221,1379,0
2019/02,6,05/02/2019,2,SS 12 tra Fiumalbo e Abetone,1519,00,1490,29,1310,209,1519,0
2019/02,6,06/02/2019,3,SS 12 tra Fiumalbo e Abetone,1626,00,1583,43,1411,215,1626,0
2019/02,6,07/02/2019,4,SS 12 tra Fiumalbo e Abetone,1720,10,1678,41,1486,234,1720,0
2019/02,6,08/02/2019,5,SS 12 tra Fiumalbo e Abetone,2374,00,2322,52,1749,625,2374,0
2019/02,6,09/02/2019,6,SS 12 tra Fiumalbo e Abetone,3102,00,3083,19,2520,582,0,3102
2019/02,6,10/02/2019,7,SS 12 tra Fiumalbo e Abetone,2730,10,2724,5,2369,361,0,2730
2019/02,6,11/02/2019,1,SS 12 tra Fiumalbo e Abetone,1566,10,1523,42,1362,204,1566,0
2019/02,6,12/02/2019,2,SS 12 tra Fiumalbo e Abetone,1655,00,1602,53,1431,224,1655,0
2019/02,6,13/02/2019,3,SS 12 tra Fiumalbo e Abetone,1759,00,1721,38,1541,218,1759,0
2019/02,6,14/02/2019,4,SS 12 tra Fiumalbo e Abetone,1847,00,1800,47,1546,301,1847,0
2019/03,6,01/03/2019,5,SS 12 tra Fiumalbo e Abetone,2382,00,2322,60,1729,653,2382,0
2019/03,6,02/03/2019,6,SS 12 tra Fiumalbo e Abetone,3398,00,3373,25,2601,797,0,3398
2019/03,6,03/03/2019,7,SS 12 tra Fiumalbo e Abetone,3108,00,3105,3,2651,457,0,3108
2019/03,6,04/03/2019,1,SS 12 tra Fiumalbo e Abetone,1655,00,1629,26,1391,264,1655,0
2019/03,6,05/03/2019,2,SS 12 tra Fiumalbo e Abetone,1550,00,1511,39,1280,270,1550,0
2019/03,6,06/03/2019,3,SS 12 tra Fiumalbo e Abetone,1494,00,1459,35,1254,240,1494,0
2019/03,6,07/03/2019,4,SS 12 tra Fiumalbo e Abetone,1439,00,1391,48,1193,246,1439,0
2019/03,6,08/03/2019,5,SS 12 tra Fiumalbo e Abetone,1935,00,1895,40,1469,466,1935,0
2019/03,6,09/03/2019,6,SS 12 tra Fiumalbo e Abetone,2694,00,2665,29,2110,584,0,2694
2019/03,6,10/03/2019,7,SS 12 tra Fiumalbo e Abetone,2291,00,2283,8,1963,328,0,2291
2019/03,6,11/03/2019,1,SS 12 tra Fiumalbo e Abetone,1332,20,1282,48,1144,188,1332,0
2019/03,6,12/03/2019,2,SS 12 tra Fiumalbo e Abetone,1392,00,1350,42,1205,187,1392,0
2019/03,6,13/03/2019,3,SS 12 tra Fiumalbo e Abetone,1267,00,1227,40,1072,195,1267,0
2019/03,6,14/03/2019,4,SS 12 tra Fiumalbo e Abetone,1397,00,1343,54,1154,243,1397,0
2019/03,7,01/03/2019,5,SS 64 tra Porretta Terme e Sambuca Pistoiese,7412,10,7201,210,5958,1454,7412,0
2019/03,7,02/03/2019,6,SS 64 tra Porretta Terme e Sambuca Pistoiese,7705,00,7604,101,6286,1419,0,7705
2019/03,7,03/03/2019,7,SS 64 tra Porretta Terme e Sambuca Pistoiese,6544,00,6508,36,5295,1249,0,6544
2019/03,7,04/03/2019,1,SS 64 tra Porretta Terme e Sambuca Pistoiese,6640,10,6435,204,5543,1097,6640,0
2019/03,7,05/03/2019,2,SS 64 tra Porretta Terme e Sambuca Pistoiese,6576,10,6387,188,5426,1150,6576,0
2019/03,7,06/03/2019,3,SS 64 tra Porretta Terme e Sambuca Pistoiese,6695,20,6450,243,5521,1174,6695,0
2019/03,7,07/03/2019,4,SS 64 tra Porretta Terme e Sambuca Pistoiese,6292,00,6098,194,5111,1181,6292,0
2019/03,7,08/03/2019,5,SS 64 tra Porretta Terme e Sambuca Pistoiese,7522,10,7315,206,6044,1478,7522,0
2019/03,7,09/03/2019,6,SS 64 tra Porretta Terme e Sambuca Pistoiese,7633,00,7529,104,6180,1453,0,7633
2019/03,7,10/03/2019,7,SS 64 tra Porretta Terme e Sambuca Pistoiese,5865,00,5830,35,4786,1079,0,5865
2019/03,7,11/03/2019,1,SS 64 tra Porretta Terme e Sambuca Pistoiese,6376,00,6181,195,5269,1107,6376,0
2019/03,7,12/03/2019,2,SS 64 tra Porretta Terme e Sambuca Pistoiese,6625,20,6436,187,5386,1239,6625,0
2019/03,7,13/03/2019,3,SS 64 tra Porretta Terme e Sambuca Pistoiese,6631,20,6401,228,5423,1208,6631,0
2019/03,7,14/03/2019,4,SS 64 tra Porretta Terme e Sambuca Pistoiese,6502,00,6272,230,5262,1240,6502,0
2019/03,9,01/03/2019,5,SS 67 tra Rocca San Casciano e Portico San Benedetto,1261,00,1158,103,1032,229,1261,0
2019/03,9,02/03/2019,6,SS 67 tra Rocca San Casciano e Portico San Benedetto,1323,00,1298,25,1069,254,0,1323
2019/03,9,03/03/2019,7,SS 67 tra Rocca San Casciano e Portico San Benedetto,1360,00,1357,3,1118,242,0,1360
2019/03,9,04/03/2019,1,SS 67 tra Rocca San Casciano e Portico San Benedetto,1148,00,1071,77,944,204,1148,0
2019/03,9,05/03/2019,2,SS 67 tra Rocca San Casciano e Portico San Benedetto,1289,00,1214,75,1083,206,1289,0
2019/03,9,06/03/2019,3,SS 67 tra Rocca San Casciano e Portico San Benedetto,1191,10,1108,82,989,202,1191,0
2019/03,9,07/03/2019,4,SS 67 tra Rocca San Casciano e Portico San Benedetto,1240,00,1147,93,1031,209,1240,0
2019/03,9,08/03/2019,5,SS 67 tra Rocca San Casciano e Portico San Benedetto,1260,00,1174,86,1003,257,1260,0
2019/03,9,09/03/2019,6,SS 67 tra Rocca San Casciano e Portico San Benedetto,1217,00,1191,26,953,264,0,1217
2019/03,9,10/03/2019,7,SS 67 tra Rocca San Casciano e Portico San Benedetto,1263,00,1262,1,1094,169,0,1263
2019/03,9,11/03/2019,1,SS 67 tra Rocca San Casciano e Portico San Benedetto,1072,00,1007,65,874,198,1072,0
2019/03,9,12/03/2019,2,SS 67 tra Rocca San Casciano e Portico San Benedetto,1176,00,1098,78,977,199,1176,0
2019/03,9,13/03/2019,3,SS 67 tra Rocca San Casciano e Portico San Benedetto,1232,00,1156,76,1011,221,1232,0
2019/03,9,14/03/2019,4,SS 67 tra Rocca San Casciano e Portico San Benedetto,1166,00,1079,87,977,189,1166,0
2019/03,12,01/03/2019,5,SS 16 al Confine regionale (Marche),17521,00,16866,655,13459,4062,17521,0
2019/03,12,02/03/2019,6,SS 16 al Confine regionale (Marche),17174,10,16931,242,12308,4866,0,17174
2019/03,12,03/03/2019,7,SS 16 al Confine regionale (Marche),15785,00,15709,76,11371,4414,0,15785
2019/03,12,04/03/2019,1,SS 16 al Confine regionale (Marche),16506,00,15830,676,13231,3275,16506,0
2019/03,12,05/03/2019,2,SS 16 al Confine regionale (Marche),16690,20,15956,732,13295,3395,16690,0
2019/03,12,06/03/2019,3,SS 16 al Confine regionale (Marche),16637,20,15909,726,13257,3380,16637,0
2019/03,12,07/03/2019,4,SS 16 al Confine regionale (Marche),17186,10,16466,719,13517,3669,17186,0
2019/03,12,08/03/2019,5,SS 16 al Confine regionale (Marche),18239,10,17530,708,13790,4449,18239,0
2019/03,12,09/03/2019,6,SS 16 al Confine regionale (Marche),16972,20,16741,229,12097,4875,0,16972
2019/03,12,10/03/2019,7,SS 16 al Confine regionale (Marche),15140,00,15060,80,11107,4033,0,15140
2019/03,12,11/03/2019,1,SS 16 al Confine regionale (Marche),15795,00,15154,641,12631,3164,15795,0
2019/03,12,12/03/2019,2,SS 16 al Confine regionale (Marche),16756,00,16075,681,13279,3477,16756,0
2019/03,12,13/03/2019,3,SS 16 al Confine regionale (Marche),16205,10,15533,671,12730,3475,16205,0
2019/03,12,14/03/2019,4,SS 16 al Confine regionale (Marche),17349,00,16654,695,13604,3745,17349,0
2019/03,16,01/03/2019,5,SP 69 in località Pilastri al Confine regionale,1560,00,1423,137,1245,315,1560,0
2019/03,16,02/03/2019,6,SP 69 in località Pilastri al Confine regionale,1346,00,1305,41,1009,337,0,1346
2019/03,16,03/03/2019,7,SP 69 in località Pilastri al Confine regionale,1272,00,1256,16,929,343,0,1272
2019/03,16,04/03/2019,1,SP 69 in località Pilastri al Confine regionale,1467,10,1320,146,1203,264,1467,0
2019/03,16,05/03/2019,2,SP 69 in località Pilastri al Confine regionale,1595,00,1443,152,1302,293,1595,0
2019/03,16,06/03/2019,3,SP 69 in località Pilastri al Confine regionale,1573,00,1419,154,1257,316,1573,0
2019/03,16,07/03/2019,4,SP 69 in località Pilastri al Confine regionale,1525,00,1354,171,1250,275,1525,0
2019/03,16,08/03/2019,5,SP 69 in località Pilastri al Confine regionale,1679,00,1535,144,1323,356,1679,0
2019/03,16,09/03/2019,6,SP 69 in località Pilastri al Confine regionale,1325,00,1276,49,954,371,0,1325
2019/03,16,10/03/2019,7,SP 69 in località Pilastri al Confine regionale,1412,00,1396,16,1002,410,0,1412
2019/03,16,11/03/2019,1,SP 69 in località Pilastri al Confine regionale,1490,00,1337,153,1182,308,1490,0
2019/03,16,12/03/2019,2,SP 69 in località Pilastri al Confine regionale,1539,00,1391,148,1259,280,1539,0
2019/03,16,13/03/2019,3,SP 69 in località Pilastri al Confine regionale,1605,00,1445,160,1277,328,1605,0
2019/03,16,14/03/2019,4,SP 69 in località Pilastri al Confine regionale,1540,20,1360,178,1258,282,1540,0
2019/03,17,01/03/2019,5,SS 12 al Confine regionale (Lombardia),11472,10,10287,1184,8822,2650,11472,0
2019/03,17,02/03/2019,6,SS 12 al Confine regionale (Lombardia),9632,00,9422,210,6924,2708,0,9632
2019/03,17,03/03/2019,7,SS 12 al Confine regionale (Lombardia),7252,00,7196,56,5199,2053,0,7252
2019/03,17,04/03/2019,1,SS 12 al Confine regionale (Lombardia),10595,00,9596,999,8414,2181,10595,0
2019/03,17,05/03/2019,2,SS 12 al Confine regionale (Lombardia),10624,00,9487,1137,8363,2261,10624,0
2019/03,17,06/03/2019,3,SS 12 al Confine regionale (Lombardia),10757,00,9619,1138,8424,2333,10757,0
2019/03,17,07/03/2019,4,SS 12 al Confine regionale (Lombardia),10888,10,9741,1146,8459,2429,10888,0
2019/03,17,08/03/2019,5,SS 12 al Confine regionale (Lombardia),11746,10,10656,1089,8870,2876,11746,0
2019/03,17,09/03/2019,6,SS 12 al Confine regionale (Lombardia),9463,00,9270,193,6875,2588,0,9463
2019/03,17,10/03/2019,7,SS 12 al Confine regionale (Lombardia),8365,00,8308,57,6251,2114,0,8365
2019/03,17,11/03/2019,1,SS 12 al Confine regionale (Lombardia),10801,00,9686,1115,8637,2164,10801,0
2019/03,17,12/03/2019,2,SS 12 al Confine regionale (Lombardia),10726,00,9612,1114,8340,2386,10726,0
2019/03,17,13/03/2019,3,SS 12 al Confine regionale (Lombardia),10753,10,9556,1196,8468,2285,10753,0
2019/03,17,14/03/2019,4,SS 12 al Confine regionale (Lombardia),11004,00,9913,1091,8659,2345,11004,0
2019/03,19,01/03/2019,5,SP 343R tra Colorno e Casalmaggiore,1026,00,926,100,852,174,1026,0
2019/03,19,02/03/2019,6,SP 343R tra Colorno e Casalmaggiore,747,00,729,18,629,118,0,747
2019/03,19,03/03/2019,7,SP 343R tra Colorno e Casalmaggiore,607,00,602,5,506,101,0,607
2019/03,19,04/03/2019,1,SP 343R tra Colorno e Casalmaggiore,1038,00,945,93,888,150,1038,0
2019/03,19,05/03/2019,2,SP 343R tra Colorno e Casalmaggiore,943,00,851,92,793,150,943,0
2019/03,19,06/03/2019,3,SP 343R tra Colorno e Casalmaggiore,931,00,858,73,785,146,931,0
2019/03,19,07/03/2019,4,SP 343R tra Colorno e Casalmaggiore,1011,00,925,86,843,168,1011,0
2019/03,19,08/03/2019,5,SP 343R tra Colorno e Casalmaggiore,1034,00,935,99,856,178,1034,0
2019/03,19,09/03/2019,6,SP 343R tra Colorno e Casalmaggiore,787,00,776,11,653,134,0,787
2019/03,19,10/03/2019,7,SP 343R tra Colorno e Casalmaggiore,624,00,621,3,535,89,0,624
2019/03,19,11/03/2019,1,SP 343R tra Colorno e Casalmaggiore,975,00,889,86,821,154,975,0
2019/03,19,12/03/2019,2,SP 343R tra Colorno e Casalmaggiore,920,00,805,115,771,149,920,0
2019/03,19,13/03/2019,3,SP 343R tra Colorno e Casalmaggiore,983,00,874,109,830,153,983,0
2019/03,19,14/03/2019,4,SP 343R tra Colorno e Casalmaggiore,1000,00,902,98,836,164,1000,0
2019/03,25,01/03/2019,5,SS 9 tra San Prospero (Case Crostolo) e Sant'Ilario d'Enza,33218,30,30884,2331,24100,9118,33218,0
2019/03,25,02/03/2019,6,SS 9 tra San Prospero (Case Crostolo) e Sant'Ilario d'Enza,31225,10,30605,619,21439,9786,0,31225
2019/03,25,03/03/2019,7,SS 9 tra San Prospero (Case Crostolo) e Sant'Ilario d'Enza,25961,20,25793,166,17864,8097,0,25961
2019/03,25,04/03/2019,1,SS 9 tra San Prospero (Case Crostolo) e Sant'Ilario d'Enza,30842,20,28527,2313,23087,7755,30842,0
2019/03,25,05/03/2019,2,SS 9 tra San Prospero (Case Crostolo) e Sant'Ilario d'Enza,30544,30,28208,2333,22998,7546,30544,0
2019/03,25,06/03/2019,3,SS 9 tra San Prospero (Case Crostolo) e Sant'Ilario d'Enza,30770,60,28460,2304,23015,7755,30770,0
2019/03,25,07/03/2019,4,SS 9 tra San Prospero (Case Crostolo) e Sant'Ilario d'Enza,31553,30,29318,2232,23430,8123,31553,0
2019/03,25,08/03/2019,5,SS 9 tra San Prospero (Case Crostolo) e Sant'Ilario d'Enza,33249,70,31134,2108,23798,9451,33249,0
2019/03,25,09/03/2019,6,SS 9 tra San Prospero (Case Crostolo) e Sant'Ilario d'Enza,32296,00,31622,674,21022,11274,0,32296
2019/03,25,10/03/2019,7,SS 9 tra San Prospero (Case Crostolo) e Sant'Ilario d'Enza,27624,50,27432,187,18344,9280,0,27624
2019/03,25,11/03/2019,1,SS 9 tra San Prospero (Case Crostolo) e Sant'Ilario d'Enza,29915,70,27633,2275,22775,7140,29915,0
2019/03,25,12/03/2019,2,SS 9 tra San Prospero (Case Crostolo) e Sant'Ilario d'Enza,30616,80,28212,2396,23064,7552,30616,0
2019/03,25,13/03/2019,3,SS 9 tra San Prospero (Case Crostolo) e Sant'Ilario d'Enza,30086,50,27937,2144,22436,7650,30086,0
2019/03,25,14/03/2019,4,SS 9 tra San Prospero (Case Crostolo) e Sant'Ilario d'Enza,31236,50,28963,2268,23231,8005,31236,0
2019/03,29,01/03/2019,5,SS 9 tra Modena e Rubiera,26080,30,23716,2361,18976,7104,26080,0
2019/03,29,02/03/2019,6,SS 9 tra Modena e Rubiera,25239,10,24825,413,17114,8125,0,25239
2019/03,29,03/03/2019,7,SS 9 tra Modena e Rubiera,23505,10,23349,155,16404,7101,0,23505
2019/03,29,04/03/2019,1,SS 9 tra Modena e Rubiera,23901,40,21485,2412,18164,5737,23901,0
2019/03,29,05/03/2019,2,SS 9 tra Modena e Rubiera,25003,20,22335,2666,18974,6029,25003,0
2019/03,29,06/03/2019,3,SS 9 tra Modena e Rubiera,24768,40,22207,2557,18501,6267,24768,0
2019/03,29,07/03/2019,4,SS 9 tra Modena e Rubiera,25254,20,22637,2615,18821,6433,25254,0
2019/03,29,08/03/2019,5,SS 9 tra Modena e Rubiera,27001,30,24506,2492,19542,7459,27001,0
2019/03,29,09/03/2019,6,SS 9 tra Modena e Rubiera,24767,10,24246,520,16500,8267,0,24767
2019/03,29,10/03/2019,7,SS 9 tra Modena e Rubiera,22864,00,22731,133,15692,7172,0,22864
2019/03,29,11/03/2019,1,SS 9 tra Modena e Rubiera,24318,30,21874,2441,18690,5628,24318,0
2019/03,29,12/03/2019,2,SS 9 tra Modena e Rubiera,24941,00,22367,2574,18835,6106,24941,0
2019/03,29,13/03/2019,3,SS 9 tra Modena e Rubiera,25235,20,22636,2597,18973,6262,25235,0
2019/03,29,14/03/2019,4,SS 9 tra Modena e Rubiera,25727,60,23070,2651,19318,6409,25727,0
2019/03,52,01/03/2019,5,SP 253 tra Sesto Imolese e Medicina,6529,00,5850,679,5009,1520,6529,0
2019/03,52,02/03/2019,6,SP 253 tra Sesto Imolese e Medicina,5173,00,5029,144,3766,1407,0,5173
2019/03,52,03/03/2019,7,SP 253 tra Sesto Imolese e Medicina,5262,00,5205,57,3990,1272,0,5262
2019/03,52,04/03/2019,1,SP 253 tra Sesto Imolese e Medicina,6243,00,5620,623,4876,1367,6243,0
2019/03,52,05/03/2019,2,SP 253 tra Sesto Imolese e Medicina,6209,00,5538,671,4798,1411,6209,0
2019/03,52,06/03/2019,3,SP 253 tra Sesto Imolese e Medicina,6303,00,5655,648,4860,1443,6303,0
2019/03,52,07/03/2019,4,SP 253 tra Sesto Imolese e Medicina,6441,00,5759,682,5023,1418,6441,0
2019/03,52,08/03/2019,5,SP 253 tra Sesto Imolese e Medicina,6832,00,6157,675,5181,1651,6832,0
2019/03,52,09/03/2019,6,SP 253 tra Sesto Imolese e Medicina,5229,10,5077,151,3789,1440,0,5229
2019/03,52,10/03/2019,7,SP 253 tra Sesto Imolese e Medicina,4536,00,4491,45,3412,1124,0,4536
2019/03,52,11/03/2019,1,SP 253 tra Sesto Imolese e Medicina,6279,00,5645,634,4931,1348,6279,0
2019/03,52,12/03/2019,2,SP 253 tra Sesto Imolese e Medicina,6471,00,5806,665,5089,1382,6471,0
2019/03,52,13/03/2019,3,SP 253 tra Sesto Imolese e Medicina,6545,00,5887,658,5052,1493,6545,0
2019/03,52,14/03/2019,4,SP 253 tra Sesto Imolese e Medicina,6511,00,5803,708,5042,1469,6511,0
2019/03,53,01/03/2019,5,SS 309 a San Giuseppe di Comacchio,10446,00,7204,3242,7893,2553,10446,0
2019/03,53,02/03/2019,6,SS 309 a San Giuseppe di Comacchio,8872,00,7987,885,6607,2265,0,8872
2019/03,53,03/03/2019,7,SS 309 a San Giuseppe di Comacchio,10895,00,10537,358,8498,2397,0,10895
2019/03,53,04/03/2019,1,SS 309 a San Giuseppe di Comacchio,9769,00,6468,3301,7561,2208,9769,0
2019/03,53,05/03/2019,2,SS 309 a San Giuseppe di Comacchio,10228,00,6339,3889,7980,2248,10228,0
2019/03,53,06/03/2019,3,SS 309 a San Giuseppe di Comacchio,10308,00,6494,3814,8001,2307,10308,0
2019/03,53,07/03/2019,4,SS 309 a San Giuseppe di Comacchio,10079,10,6279,3799,7808,2271,10079,0
2019/03,53,08/03/2019,5,SS 309 a San Giuseppe di Comacchio,10796,00,7438,3358,8101,2695,10796,0
2019/03,53,09/03/2019,6,SS 309 a San Giuseppe di Comacchio,8731,10,7806,924,6310,2421,0,8731
2019/03,53,10/03/2019,7,SS 309 a San Giuseppe di Comacchio,10033,00,9697,336,7635,2398,0,10033
2019/03,53,11/03/2019,1,SS 309 a San Giuseppe di Comacchio,9660,10,6211,3448,7459,2201,9660,0
2019/03,53,12/03/2019,2,SS 309 a San Giuseppe di Comacchio,10342,20,6431,3909,8129,2213,10342,0
2019/03,53,13/03/2019,3,SS 309 a San Giuseppe di Comacchio,10150,20,6245,3903,7862,2288,10150,0
2019/03,53,14/03/2019,4,SS 309 a San Giuseppe di Comacchio,10217,00,6428,3789,7919,2298,10217,0
2019/03,95,01/03/2019,5,SP 10R tra Castel San Giovanni e Sarmato,,,,,,,,
2019/03,95,02/03/2019,6,SP 10R tra Castel San Giovanni e Sarmato,,,,,,,,
2019/03,95,03/03/2019,7,SP 10R tra Castel San Giovanni e Sarmato,,,,,,,,
2019/03,95,04/03/2019,1,SP 10R tra Castel San Giovanni e Sarmato,,,,,,,,
2019/03,95,05/03/2019,2,SP 10R tra Castel San Giovanni e Sarmato,,,,,,,,
2019/03,95,06/03/2019,3,SP 10R tra Castel San Giovanni e Sarmato,,,,,,,,
2019/03,95,07/03/2019,4,SP 10R tra Castel San Giovanni e Sarmato,,,,,,,,
2019/03,95,08/03/2019,5,SP 10R tra Castel San Giovanni e Sarmato,,,,,,,,
2019/03,95,09/03/2019,6,SP 10R tra Castel San Giovanni e Sarmato,,,,,,,,
2019/03,95,10/03/2019,7,SP 10R tra Castel San Giovanni e Sarmato,,,,,,,,
2019/03,95,11/03/2019,1,SP 10R tra Castel San Giovanni e Sarmato,,,,,,,,
2019/03,95,12/03/2019,2,SP 10R tra Castel San Giovanni e Sarmato,,,,,,,,
2019/03,95,13/03/2019,3,SP 10R tra Castel San Giovanni e Sarmato,,,,,,,,
2019/03,95,14/03/2019,4,SP 10R tra Castel San Giovanni e Sarmato,,,,,,,,
2019/03,98,01/03/2019,5,SP 302R tra Brisighella e Marradi,3202,00,3093,109,2470,732,3202,0
2019/03,98,02/03/2019,6,SP 302R tra Brisighella e Marradi,3328,00,3260,68,2537,791,0,3328
2019/03,98,03/03/2019,7,SP 302R tra Brisighella e Marradi,3157,00,3153,4,2560,597,0,3157
2019/03,98,04/03/2019,1,SP 302R tra Brisighella e Marradi,3050,00,2944,106,2397,653,3050,0
2019/03,98,05/03/2019,2,SP 302R tra Brisighella e Marradi,2984,00,2878,106,2303,681,2984,0
2019/03,98,06/03/2019,3,SP 302R tra Brisighella e Marradi,3220,00,3078,142,2521,699,3220,0
2019/03,98,07/03/2019,4,SP 302R tra Brisighella e Marradi,3156,00,3019,137,2456,700,3156,0
2019/03,98,08/03/2019,5,SP 302R tra Brisighella e Marradi,3356,00,3223,133,2540,816,3356,0
2019/03,98,09/03/2019,6,SP 302R tra Brisighella e Marradi,3264,00,3230,34,2485,779,0,3264
2019/03,98,10/03/2019,7,SP 302R tra Brisighella e Marradi,3126,00,3107,19,2579,547,0,3126
2019/03,98,11/03/2019,1,SP 302R tra Brisighella e Marradi,3004,00,2880,124,2376,628,3004,0
2019/03,98,12/03/2019,2,SP 302R tra Brisighella e Marradi,3107,00,2986,121,2457,650,3107,0
2019/03,98,13/03/2019,3,SP 302R tra Brisighella e Marradi,3088,00,2955,133,2391,697,3088,0
2019/03,98,14/03/2019,4,SP 302R tra Brisighella e Marradi,3126,00,3001,125,2442,684,3126,0
2019/03,100,01/03/2019,5,SP 258R tra Villa Verucchio ed ex Confine regionale (località Dogana),15918,00,14750,1168,12457,3461,15918,0
2019/03,100,02/03/2019,6,SP 258R tra Villa Verucchio ed ex Confine regionale (località Dogana),14472,00,14140,332,11001,3471,0,14472
2019/03,100,03/03/2019,7,SP 258R tra Villa Verucchio ed ex Confine regionale (località Dogana),13311,00,13242,69,10372,2939,0,13311
2019/03,100,04/03/2019,1,SP 258R tra Villa Verucchio ed ex Confine regionale (località Dogana),14728,00,13566,1162,11809,2919,14728,0
2019/03,100,05/03/2019,2,SP 258R tra Villa Verucchio ed ex Confine regionale (località Dogana),15266,10,13896,1369,12232,3034,15266,0
2019/03,100,06/03/2019,3,SP 258R tra Villa Verucchio ed ex Confine regionale (località Dogana),15541,00,14227,1314,12408,3133,15541,0
2019/03,100,07/03/2019,4,SP 258R tra Villa Verucchio ed ex Confine regionale (località Dogana),15457,10,14030,1426,12295,3162,15457,0
2019/03,100,08/03/2019,5,SP 258R tra Villa Verucchio ed ex Confine regionale (località Dogana),16546,00,15123,1423,12850,3696,16546,0
2019/03,100,09/03/2019,6,SP 258R tra Villa Verucchio ed ex Confine regionale (località Dogana),14245,20,13845,398,10591,3654,0,14245
2019/03,100,10/03/2019,7,SP 258R tra Villa Verucchio ed ex Confine regionale (località Dogana),12851,00,12781,70,9883,2968,0,12851
2019/03,100,11/03/2019,1,SP 258R tra Villa Verucchio ed ex Confine regionale (località Dogana),14685,00,13362,1323,11916,2769,14685,0
2019/03,100,12/03/2019,2,SP 258R tra Villa Verucchio ed ex Confine regionale (località Dogana),15116,10,13809,1306,12167,2949,15116,0
2019/03,100,13/03/2019,3,SP 258R tra Villa Verucchio ed ex Confine regionale (località Dogana),15117,00,13664,1453,12192,2925,15117,0
2019/03,100,14/03/2019,4,SP 258R tra Villa Verucchio ed ex Confine regionale (località Dogana),15046,20,13606,1438,11955,3091,15046,0
2019/03,104,01/03/2019,5,SP 10 nuovo ponte sul Po tra innesto variante Zibello e confine regionale (Lombardia),4988,00,3702,1286,3906,1082,4988,0
2019/03,104,02/03/2019,6,SP 10 nuovo ponte sul Po tra innesto variante Zibello e confine regionale (Lombardia),4079,10,3870,208,3132,947,0,4079
2019/03,104,03/03/2019,7,SP 10 nuovo ponte sul Po tra innesto variante Zibello e confine regionale (Lombardia),4430,00,4354,76,3428,1002,0,4430
2019/03,104,04/03/2019,1,SP 10 nuovo ponte sul Po tra innesto variante Zibello e confine regionale (Lombardia),4590,00,3358,1232,3686,904,4590,0
2019/03,104,05/03/2019,2,SP 10 nuovo ponte sul Po tra innesto variante Zibello e confine regionale (Lombardia),4883,00,3490,1393,3951,932,4883,0
2019/03,104,06/03/2019,3,SP 10 nuovo ponte sul Po tra innesto variante Zibello e confine regionale (Lombardia),4638,00,3390,1248,3684,954,4638,0
2019/03,104,07/03/2019,4,SP 10 nuovo ponte sul Po tra innesto variante Zibello e confine regionale (Lombardia),4951,00,3576,1375,3987,964,4951,0
2019/03,104,08/03/2019,5,SP 10 nuovo ponte sul Po tra innesto variante Zibello e confine regionale (Lombardia),5132,00,3873,1259,3975,1157,5132,0
2019/03,104,09/03/2019,6,SP 10 nuovo ponte sul Po tra innesto variante Zibello e confine regionale (Lombardia),3789,10,3513,275,2845,944,0,3789
2019/03,104,10/03/2019,7,SP 10 nuovo ponte sul Po tra innesto variante Zibello e confine regionale (Lombardia),4204,00,4139,65,3232,972,0,4204
2019/03,104,11/03/2019,1,SP 10 nuovo ponte sul Po tra innesto variante Zibello e confine regionale (Lombardia),4838,00,3433,1405,3884,954,4838,0
2019/03,104,12/03/2019,2,SP 10 nuovo ponte sul Po tra innesto variante Zibello e confine regionale (Lombardia),4570,00,3267,1303,3661,909,4570,0
2019/03,104,13/03/2019,3,SP 10 nuovo ponte sul Po tra innesto variante Zibello e confine regionale (Lombardia),4629,00,3296,1333,3653,976,4629,0
2019/03,104,14/03/2019,4,SP 10 nuovo ponte sul Po tra innesto variante Zibello e confine regionale (Lombardia),4644,00,3371,1273,3735,909,4644,0
2019/03,107,01/03/2019,5,SP 85 tra Rubiera e bivio SP 13MO (c/o Campogalliano),9506,00,8523,983,7331,2175,9506,0
2019/03,107,02/03/2019,6,SP 85 tra Rubiera e bivio SP 13MO (c/o Campogalliano),8180,00,7973,207,6020,2160,0,8180
2019/03,107,03/03/2019,7,SP 85 tra Rubiera e bivio SP 13MO (c/o Campogalliano),7347,00,7295,52,5505,1842,0,7347
2019/03,107,04/03/2019,1,SP 85 tra Rubiera e bivio SP 13MO (c/o Campogalliano),8946,00,7943,1003,7089,1857,8946,0
2019/03,107,05/03/2019,2,SP 85 tra Rubiera e bivio SP 13MO (c/o Campogalliano),9160,00,8103,1057,7279,1881,9160,0
2019/03,107,06/03/2019,3,SP 85 tra Rubiera e bivio SP 13MO (c/o Campogalliano),9608,00,8484,1124,7411,2197,9608,0
2019/03,107,07/03/2019,4,SP 85 tra Rubiera e bivio SP 13MO (c/o Campogalliano),9425,00,8259,1166,7272,2153,9425,0
2019/03,107,08/03/2019,5,SP 85 tra Rubiera e bivio SP 13MO (c/o Campogalliano),10099,10,8989,1109,7739,2360,10099,0
2019/03,107,09/03/2019,6,SP 85 tra Rubiera e bivio SP 13MO (c/o Campogalliano),8412,00,8240,172,6075,2337,0,8412
2019/03,107,10/03/2019,7,SP 85 tra Rubiera e bivio SP 13MO (c/o Campogalliano),7113,00,7070,43,5273,1840,0,7113
2019/03,107,11/03/2019,1,SP 85 tra Rubiera e bivio SP 13MO (c/o Campogalliano),8960,00,7866,1094,7234,1726,8960,0
2019/03,107,12/03/2019,2,SP 85 tra Rubiera e bivio SP 13MO (c/o Campogalliano),9169,00,8173,996,7227,1942,9169,0
2019/03,107,13/03/2019,3,SP 85 tra Rubiera e bivio SP 13MO (c/o Campogalliano),9353,10,8265,1087,7323,2030,9353,0
2019/03,107,14/03/2019,4,SP 85 tra Rubiera e bivio SP 13MO (c/o Campogalliano),9533,00,8469,1064,7350,2183,9533,0
2019/03,108,01/03/2019,5,SP 412R tra Castel San Giovanni (Casello A 21) e ponte fiume Po,12820,170,12473,330,9599,3221,12820,0
2019/03,108,02/03/2019,6,SP 412R tra Castel San Giovanni (Casello A 21) e ponte fiume Po,11253,20,11158,93,8634,2619,0,11253
2019/03,108,03/03/2019,7,SP 412R tra Castel San Giovanni (Casello A 21) e ponte fiume Po,11371,00,11333,38,8863,2508,0,11371
2019/03,108,04/03/2019,1,SP 412R tra Castel San Giovanni (Casello A 21) e ponte fiume Po,11363,30,11024,336,8617,2746,11363,0
2019/03,108,05/03/2019,2,SP 412R tra Castel San Giovanni (Casello A 21) e ponte fiume Po,12151,160,11736,399,9065,3086,12151,0
2019/03,108,06/03/2019,3,SP 412R tra Castel San Giovanni (Casello A 21) e ponte fiume Po,12059,130,11635,411,9126,2933,12059,0
2019/03,108,07/03/2019,4,SP 412R tra Castel San Giovanni (Casello A 21) e ponte fiume Po,12281,180,11856,407,9237,3044,12281,0
2019/03,108,08/03/2019,5,SP 412R tra Castel San Giovanni (Casello A 21) e ponte fiume Po,13078,150,12734,329,9636,3442,13078,0
2019/03,108,09/03/2019,6,SP 412R tra Castel San Giovanni (Casello A 21) e ponte fiume Po,11661,20,11510,149,8813,2848,0,11661
2019/03,108,10/03/2019,7,SP 412R tra Castel San Giovanni (Casello A 21) e ponte fiume Po,11767,00,11727,40,9284,2483,0,11767
2019/03,108,11/03/2019,1,SP 412R tra Castel San Giovanni (Casello A 21) e ponte fiume Po,11838,30,11462,373,9100,2738,11838,0
2019/03,108,12/03/2019,2,SP 412R tra Castel San Giovanni (Casello A 21) e ponte fiume Po,12205,150,11781,409,9227,2978,12205,0
2019/03,108,13/03/2019,3,SP 412R tra Castel San Giovanni (Casello A 21) e ponte fiume Po,12285,120,11812,461,9211,3074,12285,0
2019/03,108,14/03/2019,4,SP 412R tra Castel San Giovanni (Casello A 21) e ponte fiume Po,12590,180,12116,456,9472,3118,12590,0
2019/03,112,01/03/2019,5,SP 111 tra Boretto e Viadana sul ponte Po,21940,10,19276,2663,16716,5224,21940,0
2019/03,112,02/03/2019,6,SP 111 tra Boretto e Viadana sul ponte Po,19084,10,18512,571,13938,5146,0,19084
2019/03,112,03/03/2019,7,SP 111 tra Boretto e Viadana sul ponte Po,16687,00,16526,161,12225,4462,0,16687
2019/03,112,04/03/2019,1,SP 111 tra Boretto e Viadana sul ponte Po,19778,30,17000,2775,15405,4373,19778,0
2019/03,112,05/03/2019,2,SP 111 tra Boretto e Viadana sul ponte Po,20580,10,17600,2979,15898,4682,20580,0
2019/03,112,06/03/2019,3,SP 111 tra Boretto e Viadana sul ponte Po,20754,30,17965,2786,15961,4793,20754,0
2019/03,112,07/03/2019,4,SP 111 tra Boretto e Viadana sul ponte Po,21179,40,18224,2951,16383,4796,21179,0
2019/03,112,08/03/2019,5,SP 111 tra Boretto e Viadana sul ponte Po,22512,50,19703,2804,16933,5579,22512,0
2019/03,112,09/03/2019,6,SP 111 tra Boretto e Viadana sul ponte Po,19508,00,18908,600,14273,5235,0,19508
2019/03,112,10/03/2019,7,SP 111 tra Boretto e Viadana sul ponte Po,16238,10,16050,187,11725,4513,0,16238
2019/03,112,11/03/2019,1,SP 111 tra Boretto e Viadana sul ponte Po,20117,20,17268,2847,15735,4382,20117,0
2019/03,112,12/03/2019,2,SP 111 tra Boretto e Viadana sul ponte Po,20605,40,17628,2973,15910,4695,20605,0
2019/03,112,13/03/2019,3,SP 111 tra Boretto e Viadana sul ponte Po,20812,20,17839,2971,15926,4886,20812,0
2019/03,112,14/03/2019,4,SP 111 tra Boretto e Viadana sul ponte Po,21014,100,18056,2948,16225,4789,21014,0
2019/03,115,01/03/2019,5,SP 68 ad Ariano Polesine al Confine regionale (Veneto),3009,00,2710,299,2303,706,3009,0
2019/03,115,02/03/2019,6,SP 68 ad Ariano Polesine al Confine regionale (Veneto),2613,00,2544,69,1969,644,0,2613
2019/03,115,03/03/2019,7,SP 68 ad Ariano Polesine al Confine regionale (Veneto),2777,00,2760,17,2085,692,0,2777
2019/03,115,04/03/2019,1,SP 68 ad Ariano Polesine al Confine regionale (Veneto),2683,00,2401,282,2132,551,2683,0
2019/03,115,05/03/2019,2,SP 68 ad Ariano Polesine al Confine regionale (Veneto),2647,00,2369,278,2113,534,2647,0
2019/03,115,06/03/2019,3,SP 68 ad Ariano Polesine al Confine regionale (Veneto),2607,10,2314,292,2047,560,2607,0
2019/03,115,07/03/2019,4,SP 68 ad Ariano Polesine al Confine regionale (Veneto),2818,00,2538,280,2214,604,2818,0
2019/03,115,08/03/2019,5,SP 68 ad Ariano Polesine al Confine regionale (Veneto),3025,00,2693,332,2306,719,3025,0
2019/03,115,09/03/2019,6,SP 68 ad Ariano Polesine al Confine regionale (Veneto),2718,10,2612,105,2014,704,0,2718
2019/03,115,10/03/2019,7,SP 68 ad Ariano Polesine al Confine regionale (Veneto),2436,00,2410,26,1747,689,0,2436
2019/03,115,11/03/2019,1,SP 68 ad Ariano Polesine al Confine regionale (Veneto),2867,00,2507,360,2324,543,2867,0
2019/03,115,12/03/2019,2,SP 68 ad Ariano Polesine al Confine regionale (Veneto),2701,10,2377,323,2144,557,2701,0
2019/03,115,13/03/2019,3,SP 68 ad Ariano Polesine al Confine regionale (Veneto),2740,00,2442,298,2144,596,2740,0
2019/03,115,14/03/2019,4,SP 68 ad Ariano Polesine al Confine regionale (Veneto),2774,00,2443,331,2174,600,2774,0
2019/03,116,01/03/2019,5,SP 138 tra SPiero in Bagno (E 45) e Bagno di Romagna,5582,00,5322,260,4466,1116,5582,0
2019/03,116,02/03/2019,6,SP 138 tra SPiero in Bagno (E 45) e Bagno di Romagna,5725,20,5616,107,4306,1419,0,5725
2019/03,116,03/03/2019,7,SP 138 tra SPiero in Bagno (E 45) e Bagno di Romagna,6580,00,6556,24,5074,1506,0,6580
2019/03,116,04/03/2019,1,SP 138 tra SPiero in Bagno (E 45) e Bagno di Romagna,5609,00,5336,273,4331,1278,5609,0
2019/03,116,05/03/2019,2,SP 138 tra SPiero in Bagno (E 45) e Bagno di Romagna,5605,00,5325,280,4366,1239,5605,0
2019/03,116,06/03/2019,3,SP 138 tra SPiero in Bagno (E 45) e Bagno di Romagna,5316,00,5055,261,4395,921,5316,0
2019/03,116,07/03/2019,4,SP 138 tra SPiero in Bagno (E 45) e Bagno di Romagna,5274,00,5034,240,4314,960,5274,0
2019/03,116,08/03/2019,5,SP 138 tra SPiero in Bagno (E 45) e Bagno di Romagna,6117,10,5845,271,4841,1276,6117,0
2019/03,116,09/03/2019,6,SP 138 tra SPiero in Bagno (E 45) e Bagno di Romagna,5701,00,5586,115,4540,1161,0,5701
2019/03,116,10/03/2019,7,SP 138 tra SPiero in Bagno (E 45) e Bagno di Romagna,5456,00,5425,31,4494,962,0,5456
2019/03,116,11/03/2019,1,SP 138 tra SPiero in Bagno (E 45) e Bagno di Romagna,4948,40,4757,187,4182,766,4948,0
2019/03,116,12/03/2019,2,SP 138 tra SPiero in Bagno (E 45) e Bagno di Romagna,4913,10,4743,169,3995,918,4913,0
2019/03,116,13/03/2019,3,SP 138 tra SPiero in Bagno (E 45) e Bagno di Romagna,5167,00,4994,173,4347,820,5167,0
2019/03,116,14/03/2019,4,SP 138 tra SPiero in Bagno (E 45) e Bagno di Romagna,5172,10,4955,216,4180,992,5172,0
2019/03,117,01/03/2019,5,SS 63 tra Collagna e Sassalbo (Passo del Cerreto),650,00,617,33,559,91,650,0
2019/03,117,02/03/2019,6,SS 63 tra Collagna e Sassalbo (Passo del Cerreto),874,00,859,15,772,102,0,874
2019/03,117,03/03/2019,7,SS 63 tra Collagna e Sassalbo (Passo del Cerreto),1247,00,1244,3,1048,199,0,1247
2019/03,117,04/03/2019,1,SS 63 tra Collagna e Sassalbo (Passo del Cerreto),429,00,395,34,371,58,429,0
2019/03,117,05/03/2019,2,SS 63 tra Collagna e Sassalbo (Passo del Cerreto),431,00,407,24,384,47,431,0
2019/03,117,06/03/2019,3,SS 63 tra Collagna e Sassalbo (Passo del Cerreto),492,00,460,32,436,56,492,0
2019/03,117,07/03/2019,4,SS 63 tra Collagna e Sassalbo (Passo del Cerreto),472,00,449,23,403,69,472,0
2019/03,117,08/03/2019,5,SS 63 tra Collagna e Sassalbo (Passo del Cerreto),566,00,535,31,485,81,566,0
2019/03,117,09/03/2019,6,SS 63 tra Collagna e Sassalbo (Passo del Cerreto),722,00,704,18,624,98,0,722
2019/03,117,10/03/2019,7,SS 63 tra Collagna e Sassalbo (Passo del Cerreto),769,00,768,1,672,97,0,769
2019/03,117,11/03/2019,1,SS 63 tra Collagna e Sassalbo (Passo del Cerreto),416,00,366,50,361,55,416,0
2019/03,117,12/03/2019,2,SS 63 tra Collagna e Sassalbo (Passo del Cerreto),447,00,417,30,391,56,447,0
2019/03,117,13/03/2019,3,SS 63 tra Collagna e Sassalbo (Passo del Cerreto),377,00,354,23,326,51,377,0
2019/03,117,14/03/2019,4,SS 63 tra Collagna e Sassalbo (Passo del Cerreto),431,00,409,22,374,57,431,0
2019/03,118,02/03/2019,6,SS 45 tra Ottone e Gorreto,483,00,472,11,360,123,0,483
2019/03,118,04/03/2019,1,SS 45 tra Ottone e Gorreto,434,00,411,23,372,62,434,0
2019/03,118,05/03/2019,2,SS 45 tra Ottone e Gorreto,328,00,304,24,266,62,328,0
2019/03,118,06/03/2019,3,SS 45 tra Ottone e Gorreto,350,00,334,16,281,69,350,0
2019/03,118,07/03/2019,4,SS 45 tra Ottone e Gorreto,359,00,344,15,293,66,359,0
2019/03,118,10/03/2019,7,SS 45 tra Ottone e Gorreto,447,00,444,3,352,95,0,447
2019/03,118,13/03/2019,3,SS 45 tra Ottone e Gorreto,366,10,346,19,294,72,366,0
2019/03,118,14/03/2019,4,SS 45 tra Ottone e Gorreto,362,00,346,16,285,77,362,0
2019/03,122,01/03/2019,5,SP 10R tra Piacenza (ponte fiume Trebbia) e San Nicolo',29434,70,28222,1205,21952,7482,29434,0
2019/03,122,02/03/2019,6,SP 10R tra Piacenza (ponte fiume Trebbia) e San Nicolo',25974,60,25636,332,18462,7512,0,25974
2019/03,123,01/03/2019,5,SP 28 tra Piacenza (Tangenziale Sud) e Gossolengo,18120,00,17637,483,14031,4089,18120,0
2019/03,123,02/03/2019,6,SP 28 tra Piacenza (Tangenziale Sud) e Gossolengo,16657,10,16457,199,12850,3807,0,16657
2019/03,123,03/03/2019,7,SP 28 tra Piacenza (Tangenziale Sud) e Gossolengo,13106,00,13058,48,10203,2903,0,13106
2019/03,123,04/03/2019,1,SP 28 tra Piacenza (Tangenziale Sud) e Gossolengo,16447,00,16017,430,13191,3256,16447,0
2019/03,123,05/03/2019,2,SP 28 tra Piacenza (Tangenziale Sud) e Gossolengo,17075,00,16598,477,13792,3283,17075,0
2019/03,123,06/03/2019,3,SP 28 tra Piacenza (Tangenziale Sud) e Gossolengo,17076,00,16589,487,13718,3358,17076,0
2019/03,123,07/03/2019,4,SP 28 tra Piacenza (Tangenziale Sud) e Gossolengo,16965,00,16504,461,13426,3539,16965,0
2019/03,123,08/03/2019,5,SP 28 tra Piacenza (Tangenziale Sud) e Gossolengo,18721,00,18260,461,14539,4182,18721,0
2019/03,123,09/03/2019,6,SP 28 tra Piacenza (Tangenziale Sud) e Gossolengo,17333,00,17121,212,13296,4037,0,17333
2019/03,123,10/03/2019,7,SP 28 tra Piacenza (Tangenziale Sud) e Gossolengo,12780,00,12733,47,9707,3073,0,12780
2019/03,123,11/03/2019,1,SP 28 tra Piacenza (Tangenziale Sud) e Gossolengo,16568,00,16078,490,13336,3232,16568,0
2019/03,123,12/03/2019,2,SP 28 tra Piacenza (Tangenziale Sud) e Gossolengo,17477,20,16999,476,13942,3535,17477,0
2019/03,123,13/03/2019,3,SP 28 tra Piacenza (Tangenziale Sud) e Gossolengo,17522,00,17020,502,13868,3654,17522,0
2019/03,123,14/03/2019,4,SP 28 tra Piacenza (Tangenziale Sud) e Gossolengo,17374,10,16866,507,13771,3603,17374,0
2019/03,124,01/03/2019,5,SS 45 tra Piacenza e Settima,18323,00,17458,865,13894,4429,18323,0
2019/03,124,02/03/2019,6,SS 45 tra Piacenza e Settima,16057,00,15807,250,11586,4471,0,16057
2019/03,124,03/03/2019,7,SS 45 tra Piacenza e Settima,15946,00,15896,50,12152,3794,0,15946
2019/03,124,04/03/2019,1,SS 45 tra Piacenza e Settima,16064,00,15185,879,12802,3262,16064,0
2019/03,124,05/03/2019,2,SS 45 tra Piacenza e Settima,17002,00,16106,896,13535,3467,17002,0
2019/03,124,06/03/2019,3,SS 45 tra Piacenza e Settima,17308,20,16464,842,13559,3749,17308,0
2019/03,124,07/03/2019,4,SS 45 tra Piacenza e Settima,17613,00,16679,934,13962,3651,17613,0
2019/03,124,08/03/2019,5,SS 45 tra Piacenza e Settima,17936,00,16979,957,13556,4380,17936,0
2019/03,124,09/03/2019,6,SS 45 tra Piacenza e Settima,17401,10,17140,260,12581,4820,0,17401
2019/03,124,10/03/2019,7,SS 45 tra Piacenza e Settima,15670,10,15619,50,11867,3803,0,15670
2019/03,124,11/03/2019,1,SS 45 tra Piacenza e Settima,15855,10,15013,841,12664,3191,15855,0
2019/03,124,12/03/2019,2,SS 45 tra Piacenza e Settima,17241,00,16288,953,13662,3579,17241,0
2019/03,124,13/03/2019,3,SS 45 tra Piacenza e Settima,17381,00,16526,855,13461,3920,17381,0
2019/03,124,14/03/2019,4,SS 45 tra Piacenza e Settima,17502,00,16626,876,13658,3844,17502,0
2019/03,125,01/03/2019,5,SP 654R tra Piacenza (Tangenziale Sud) e Turro,25361,20,24270,1089,20064,5297,25361,0
2019/03,125,02/03/2019,6,SP 654R tra Piacenza (Tangenziale Sud) e Turro,19460,00,19166,294,14903,4557,0,19460
2019/03,125,03/03/2019,7,SP 654R tra Piacenza (Tangenziale Sud) e Turro,15179,00,15089,90,11789,3390,0,15179
2019/03,125,04/03/2019,1,SP 654R tra Piacenza (Tangenziale Sud) e Turro,24170,00,22930,1240,19881,4289,24170,0
2019/03,125,05/03/2019,2,SP 654R tra Piacenza (Tangenziale Sud) e Turro,24149,20,22992,1155,19490,4659,24149,0
2019/03,125,06/03/2019,3,SP 654R tra Piacenza (Tangenziale Sud) e Turro,24162,10,23065,1096,19473,4689,24162,0
2019/03,125,07/03/2019,4,SP 654R tra Piacenza (Tangenziale Sud) e Turro,24628,00,23378,1250,19763,4865,24628,0
2019/03,125,08/03/2019,5,SP 654R tra Piacenza (Tangenziale Sud) e Turro,26013,10,24797,1215,20426,5587,26013,0
2019/03,125,09/03/2019,6,SP 654R tra Piacenza (Tangenziale Sud) e Turro,20635,00,20293,342,15709,4926,0,20635
2019/03,125,10/03/2019,7,SP 654R tra Piacenza (Tangenziale Sud) e Turro,14735,00,14641,94,11110,3625,0,14735
2019/03,125,11/03/2019,1,SP 654R tra Piacenza (Tangenziale Sud) e Turro,23781,20,22669,1110,19466,4315,23781,0
2019/03,125,12/03/2019,2,SP 654R tra Piacenza (Tangenziale Sud) e Turro,24495,10,23210,1284,19836,4659,24495,0
2019/03,125,13/03/2019,3,SP 654R tra Piacenza (Tangenziale Sud) e Turro,24273,10,23122,1150,19420,4853,24273,0
2019/03,125,14/03/2019,4,SP 654R tra Piacenza (Tangenziale Sud) e Turro,24151,10,23004,1146,19496,4655,24151,0
2019/03,126,01/03/2019,5,SP 6 tra Piacenza (Tangenziale Sud) e bivio SP 42/ponte fiume Nure in località San Giorgio Piacentino,17435,00,16803,632,13188,4247,17435,0
2019/03,126,02/03/2019,6,SP 6 tra Piacenza (Tangenziale Sud) e bivio SP 42/ponte fiume Nure in località San Giorgio Piacentino,15602,10,15344,257,11495,4107,0,15602
2019/03,126,03/03/2019,7,SP 6 tra Piacenza (Tangenziale Sud) e bivio SP 42/ponte fiume Nure in località San Giorgio Piacentino,12519,00,12447,72,9544,2975,0,12519
2019/03,126,04/03/2019,1,SP 6 tra Piacenza (Tangenziale Sud) e bivio SP 42/ponte fiume Nure in località San Giorgio Piacentino,15721,00,15035,686,12612,3109,15721,0
2019/03,126,05/03/2019,2,SP 6 tra Piacenza (Tangenziale Sud) e bivio SP 42/ponte fiume Nure in località San Giorgio Piacentino,16146,00,15401,745,12721,3425,16146,0
2019/03,126,06/03/2019,3,SP 6 tra Piacenza (Tangenziale Sud) e bivio SP 42/ponte fiume Nure in località San Giorgio Piacentino,16129,10,15482,646,12583,3546,16129,0
2019/03,126,07/03/2019,4,SP 6 tra Piacenza (Tangenziale Sud) e bivio SP 42/ponte fiume Nure in località San Giorgio Piacentino,16505,00,15824,681,12995,3510,16505,0
2019/03,126,08/03/2019,5,SP 6 tra Piacenza (Tangenziale Sud) e bivio SP 42/ponte fiume Nure in località San Giorgio Piacentino,17520,10,16859,660,13360,4160,17520,0
2019/03,126,09/03/2019,6,SP 6 tra Piacenza (Tangenziale Sud) e bivio SP 42/ponte fiume Nure in località San Giorgio Piacentino,15887,00,15632,255,11692,4195,0,15887
2019/03,126,10/03/2019,7,SP 6 tra Piacenza (Tangenziale Sud) e bivio SP 42/ponte fiume Nure in località San Giorgio Piacentino,12584,00,12535,49,9331,3253,0,12584
2019/03,126,11/03/2019,1,SP 6 tra Piacenza (Tangenziale Sud) e bivio SP 42/ponte fiume Nure in località San Giorgio Piacentino,15834,10,15177,656,12632,3202,15834,0
2019/03,126,12/03/2019,2,SP 6 tra Piacenza (Tangenziale Sud) e bivio SP 42/ponte fiume Nure in località San Giorgio Piacentino,16178,10,15504,673,12757,3421,16178,0
2019/03,126,13/03/2019,3,SP 6 tra Piacenza (Tangenziale Sud) e bivio SP 42/ponte fiume Nure in località San Giorgio Piacentino,16545,00,15849,696,12928,3617,16545,0
2019/03,126,14/03/2019,4,SP 6 tra Piacenza (Tangenziale Sud) e bivio SP 42/ponte fiume Nure in località San Giorgio Piacentino,16340,00,15709,631,12683,3657,16340,0
2019/03,127,01/03/2019,5,SS 9 tra Piacenza e Pontenure,26764,00,24845,1919,20418,6346,26764,0
2019/03,127,02/03/2019,6,SS 9 tra Piacenza e Pontenure,22977,20,22317,658,17098,5879,0,22977
2019/03,127,03/03/2019,7,SS 9 tra Piacenza e Pontenure,16463,10,16330,132,11718,4745,0,16463
2019/03,127,04/03/2019,1,SS 9 tra Piacenza e Pontenure,24598,20,22753,1843,19545,5053,24598,0
2019/03,127,05/03/2019,2,SS 9 tra Piacenza e Pontenure,24901,20,23028,1871,19595,5306,24901,0
2019/03,127,06/03/2019,3,SS 9 tra Piacenza e Pontenure,24999,00,23136,1863,19705,5294,24999,0
2019/03,127,07/03/2019,4,SS 9 tra Piacenza e Pontenure,25385,00,23469,1916,19877,5508,25385,0
2019/03,127,08/03/2019,5,SS 9 tra Piacenza e Pontenure,27184,10,25194,1989,20657,6527,27184,0
2019/03,127,09/03/2019,6,SS 9 tra Piacenza e Pontenure,21782,00,21175,607,15643,6139,0,21782
2019/03,127,10/03/2019,7,SS 9 tra Piacenza e Pontenure,17924,10,17789,134,13014,4910,0,17924
2019/03,127,11/03/2019,1,SS 9 tra Piacenza e Pontenure,25653,30,23512,2138,20584,5069,25653,0
2019/03,127,12/03/2019,2,SS 9 tra Piacenza e Pontenure,25056,00,23172,1884,19713,5343,25056,0
2019/03,127,13/03/2019,3,SS 9 tra Piacenza e Pontenure,25520,10,23603,1916,19793,5727,25520,0
2019/03,127,14/03/2019,4,SS 9 tra Piacenza e Pontenure,25540,20,23578,1960,20004,5536,25540,0
2019/03,128,01/03/2019,5,SP 10R tra Piacenza (Casello A 1/A 21) e il bivio SP 10R e SP 587R,19207,00,17304,1903,14341,4866,19207,0
2019/03,128,02/03/2019,6,SP 10R tra Piacenza (Casello A 1/A 21) e il bivio SP 10R e SP 587R,14607,00,14130,477,10344,4263,0,14607
2019/03,128,03/03/2019,7,SP 10R tra Piacenza (Casello A 1/A 21) e il bivio SP 10R e SP 587R,12513,00,12447,66,9300,3213,0,12513
2019/03,128,04/03/2019,1,SP 10R tra Piacenza (Casello A 1/A 21) e il bivio SP 10R e SP 587R,16680,00,14849,1831,13099,3581,16680,0
2019/03,128,05/03/2019,2,SP 10R tra Piacenza (Casello A 1/A 21) e il bivio SP 10R e SP 587R,17785,00,15847,1938,13673,4112,17785,0
2019/03,128,06/03/2019,3,SP 10R tra Piacenza (Casello A 1/A 21) e il bivio SP 10R e SP 587R,17301,00,15340,1961,13169,4132,17301,0
2019/03,128,07/03/2019,4,SP 10R tra Piacenza (Casello A 1/A 21) e il bivio SP 10R e SP 587R,18219,00,16119,2100,14121,4098,18219,0
2019/03,128,08/03/2019,5,SP 10R tra Piacenza (Casello A 1/A 21) e il bivio SP 10R e SP 587R,19003,00,17032,1971,14195,4808,19003,0
2019/03,128,09/03/2019,6,SP 10R tra Piacenza (Casello A 1/A 21) e il bivio SP 10R e SP 587R,14151,00,13727,424,9796,4355,0,14151
2019/03,128,10/03/2019,7,SP 10R tra Piacenza (Casello A 1/A 21) e il bivio SP 10R e SP 587R,10627,00,10567,60,7328,3299,0,10627
2019/03,128,11/03/2019,1,SP 10R tra Piacenza (Casello A 1/A 21) e il bivio SP 10R e SP 587R,18374,00,16084,2290,14632,3742,18374,0
2019/03,128,12/03/2019,2,SP 10R tra Piacenza (Casello A 1/A 21) e il bivio SP 10R e SP 587R,17708,00,15548,2160,13699,4009,17708,0
2019/03,128,13/03/2019,3,SP 10R tra Piacenza (Casello A 1/A 21) e il bivio SP 10R e SP 587R,16576,00,14529,2047,12772,3804,16576,0
2019/03,128,14/03/2019,4,SP 10R tra Piacenza (Casello A 1/A 21) e il bivio SP 10R e SP 587R,18119,00,16044,2075,13872,4247,18119,0
2019/03,129,01/03/2019,5,SS 9Var tra Parma e ponte fiume Taro (Tangenziale nord di Parma),,,,,,,,
2019/03,129,02/03/2019,6,SS 9Var tra Parma e ponte fiume Taro (Tangenziale nord di Parma),,,,,,,,
2019/03,129,03/03/2019,7,SS 9Var tra Parma e ponte fiume Taro (Tangenziale nord di Parma),,,,,,,,
2019/03,129,04/03/2019,1,SS 9Var tra Parma e ponte fiume Taro (Tangenziale nord di Parma),,,,,,,,
2019/03,129,05/03/2019,2,SS 9Var tra Parma e ponte fiume Taro (Tangenziale nord di Parma),,,,,,,,
2019/03,129,06/03/2019,3,SS 9Var tra Parma e ponte fiume Taro (Tangenziale nord di Parma),,,,,,,,
2019/03,129,07/03/2019,4,SS 9Var tra Parma e ponte fiume Taro (Tangenziale nord di Parma),,,,,,,,
2019/03,129,08/03/2019,5,SS 9Var tra Parma e ponte fiume Taro (Tangenziale nord di Parma),,,,,,,,
2019/03,129,09/03/2019,6,SS 9Var tra Parma e ponte fiume Taro (Tangenziale nord di Parma),,,,,,,,
2019/03,129,10/03/2019,7,SS 9Var tra Parma e ponte fiume Taro (Tangenziale nord di Parma),,,,,,,,
2019/03,129,11/03/2019,1,SS 9Var tra Parma e ponte fiume Taro (Tangenziale nord di Parma),,,,,,,,
2019/03,129,12/03/2019,2,SS 9Var tra Parma e ponte fiume Taro (Tangenziale nord di Parma),,,,,,,,
2019/03,129,13/03/2019,3,SS 9Var tra Parma e ponte fiume Taro (Tangenziale nord di Parma),,,,,,,,
2019/03,129,14/03/2019,4,SS 9Var tra Parma e ponte fiume Taro (Tangenziale nord di Parma),,,,,,,,
2019/03,130,01/03/2019,5,SS 62 tra Parma e Collecchio,23483,00,22200,1283,17928,5555,23483,0
2019/03,130,02/03/2019,6,SS 62 tra Parma e Collecchio,20424,00,20079,345,14915,5509,0,20424
2019/03,130,03/03/2019,7,SS 62 tra Parma e Collecchio,16473,00,16386,87,11597,4876,0,16473
2019/03,130,04/03/2019,1,SS 62 tra Parma e Collecchio,21855,00,20542,1313,17285,4570,21855,0
2019/03,130,05/03/2019,2,SS 62 tra Parma e Collecchio,22152,20,20803,1347,17220,4932,22152,0
2019/03,130,06/03/2019,3,SS 62 tra Parma e Collecchio,22546,00,21247,1299,17570,4976,22546,0
2019/03,130,07/03/2019,4,SS 62 tra Parma e Collecchio,22491,10,21141,1349,17410,5081,22491,0
2019/03,130,08/03/2019,5,SS 62 tra Parma e Collecchio,24064,10,22662,1401,18260,5804,24064,0
2019/03,130,09/03/2019,6,SS 62 tra Parma e Collecchio,20536,00,20203,333,14547,5989,0,20536
2019/03,130,10/03/2019,7,SS 62 tra Parma e Collecchio,16002,00,15895,107,11314,4688,0,16002
2019/03,130,11/03/2019,1,SS 62 tra Parma e Collecchio,21525,00,20278,1247,16889,4636,21525,0
2019/03,130,12/03/2019,2,SS 62 tra Parma e Collecchio,22836,00,21524,1312,17695,5141,22836,0
2019/03,130,13/03/2019,3,SS 62 tra Parma e Collecchio,22144,00,20847,1297,17125,5019,22144,0
2019/03,130,14/03/2019,4,SS 62 tra Parma e Collecchio,22561,00,21156,1405,17417,5144,22561,0
2019/03,131,01/03/2019,5,SP 665R tra Parma e Corcagnano,22943,20,21699,1242,17691,5252,22943,0
2019/03,131,02/03/2019,6,SP 665R tra Parma e Corcagnano,19973,10,19627,345,14659,5314,0,19973
2019/03,131,03/03/2019,7,SP 665R tra Parma e Corcagnano,16215,20,16124,89,11939,4276,0,16215
2019/03,131,04/03/2019,1,SP 665R tra Parma e Corcagnano,20901,20,19724,1175,16901,4000,20901,0
2019/03,131,05/03/2019,2,SP 665R tra Parma e Corcagnano,21287,00,20125,1162,16845,4442,21287,0
2019/03,131,06/03/2019,3,SP 665R tra Parma e Corcagnano,21296,20,20169,1125,16669,4627,21296,0
2019/03,131,07/03/2019,4,SP 665R tra Parma e Corcagnano,21636,20,20474,1160,16789,4847,21636,0
2019/03,131,08/03/2019,5,SP 665R tra Parma e Corcagnano,22591,50,21453,1133,17231,5360,22591,0
2019/03,131,09/03/2019,6,SP 665R tra Parma e Corcagnano,20227,20,19915,310,14691,5536,0,20227
2019/03,131,10/03/2019,7,SP 665R tra Parma e Corcagnano,15291,30,15189,99,11157,4134,0,15291
2019/03,131,11/03/2019,1,SP 665R tra Parma e Corcagnano,20683,10,19530,1152,16560,4123,20683,0
2019/03,131,12/03/2019,2,SP 665R tra Parma e Corcagnano,21374,20,20261,1111,16977,4397,21374,0
2019/03,131,13/03/2019,3,SP 665R tra Parma e Corcagnano,21095,10,19931,1163,16529,4566,21095,0
2019/03,131,14/03/2019,4,SP 665R tra Parma e Corcagnano,21582,40,20437,1141,16925,4657,21582,0
2019/03,132,01/03/2019,5,SP 513R tra Parma e Pilastrello,23690,10,22555,1134,18300,5390,23690,0
2019/03,132,02/03/2019,6,SP 513R tra Parma e Pilastrello,19752,00,19447,305,14648,5104,0,19752
2019/03,132,03/03/2019,7,SP 513R tra Parma e Pilastrello,16309,00,16224,85,12224,4085,0,16309
2019/03,132,04/03/2019,1,SP 513R tra Parma e Pilastrello,21958,10,20924,1033,17649,4309,21958,0
2019/03,132,05/03/2019,2,SP 513R tra Parma e Pilastrello,21989,00,20988,1001,17431,4558,21989,0
2019/03,132,06/03/2019,3,SP 513R tra Parma e Pilastrello,21938,10,20946,991,17252,4686,21938,0
2019/03,132,07/03/2019,4,SP 513R tra Parma e Pilastrello,21885,00,20938,947,17195,4690,21885,0
2019/03,132,08/03/2019,5,SP 513R tra Parma e Pilastrello,23031,20,22070,959,17600,5431,23031,0
2019/03,132,09/03/2019,6,SP 513R tra Parma e Pilastrello,19733,00,19449,284,14430,5303,0,19733
2019/03,132,10/03/2019,7,SP 513R tra Parma e Pilastrello,15574,00,15507,67,11671,3903,0,15574
2019/03,132,11/03/2019,1,SP 513R tra Parma e Pilastrello,21004,10,20073,930,17020,3984,21004,0
2019/03,132,12/03/2019,2,SP 513R tra Parma e Pilastrello,22177,10,21129,1047,17578,4599,22177,0
2019/03,132,13/03/2019,3,SP 513R tra Parma e Pilastrello,21789,10,20789,999,17141,4648,21789,0
2019/03,132,14/03/2019,4,SP 513R tra Parma e Pilastrello,21810,20,20832,976,17288,4522,21810,0
2019/03,133,01/03/2019,5,SP 62R tra Parma (viadotto A 1) e Sorbolo,20073,00,17947,2126,15020,5053,20073,0
2019/03,133,02/03/2019,6,SP 62R tra Parma (viadotto A 1) e Sorbolo,18197,00,17728,469,12987,5210,0,18197
2019/03,133,03/03/2019,7,SP 62R tra Parma (viadotto A 1) e Sorbolo,16418,10,16288,129,11637,4781,0,16418
2019/03,133,04/03/2019,1,SP 62R tra Parma (viadotto A 1) e Sorbolo,19122,10,16903,2218,14828,4294,19122,0
2019/03,133,05/03/2019,2,SP 62R tra Parma (viadotto A 1) e Sorbolo,19124,20,16801,2321,14643,4481,19124,0
2019/03,133,06/03/2019,3,SP 62R tra Parma (viadotto A 1) e Sorbolo,19266,10,16882,2383,14785,4481,19266,0
2019/03,133,07/03/2019,4,SP 62R tra Parma (viadotto A 1) e Sorbolo,19490,10,17135,2354,14810,4680,19490,0
2019/03,133,08/03/2019,5,SP 62R tra Parma (viadotto A 1) e Sorbolo,20673,00,18470,2203,15282,5391,20673,0
2019/03,133,09/03/2019,6,SP 62R tra Parma (viadotto A 1) e Sorbolo,18681,00,18208,473,13140,5541,0,18681
2019/03,133,10/03/2019,7,SP 62R tra Parma (viadotto A 1) e Sorbolo,16513,20,16370,141,11654,4859,0,16513
2019/03,133,11/03/2019,1,SP 62R tra Parma (viadotto A 1) e Sorbolo,18645,00,16351,2294,14479,4166,18645,0
2019/03,133,12/03/2019,2,SP 62R tra Parma (viadotto A 1) e Sorbolo,19517,20,17080,2435,15096,4421,19517,0
2019/03,133,13/03/2019,3,SP 62R tra Parma (viadotto A 1) e Sorbolo,18687,10,16470,2216,14126,4561,18687,0
2019/03,133,14/03/2019,4,SP 62R tra Parma (viadotto A 1) e Sorbolo,19494,00,17168,2326,14935,4559,19494,0
2019/03,134,01/03/2019,5,SP 343R tra Parma e San Polo,20804,00,18560,2244,15846,4958,20804,0
2019/03,134,02/03/2019,6,SP 343R tra Parma e San Polo,14738,10,14236,501,10614,4124,0,14738
2019/03,134,03/03/2019,7,SP 343R tra Parma e San Polo,11916,00,11790,126,8768,3148,0,11916
2019/03,134,04/03/2019,1,SP 343R tra Parma e San Polo,19878,00,17572,2306,15628,4250,19878,0
2019/03,134,05/03/2019,2,SP 343R tra Parma e San Polo,20372,00,17895,2477,15856,4516,20372,0
2019/03,134,06/03/2019,3,SP 343R tra Parma e San Polo,20265,00,17908,2357,15750,4515,20265,0
2019/03,134,07/03/2019,4,SP 343R tra Parma e San Polo,20039,10,17741,2297,15425,4614,20039,0
2019/03,134,08/03/2019,5,SP 343R tra Parma e San Polo,21150,00,18787,2363,16057,5093,21150,0
2019/03,134,09/03/2019,6,SP 343R tra Parma e San Polo,14891,10,14372,518,10430,4461,0,14891
2019/03,134,10/03/2019,7,SP 343R tra Parma e San Polo,11019,00,10846,173,7798,3221,0,11019
2019/03,134,11/03/2019,1,SP 343R tra Parma e San Polo,19181,10,16943,2237,15195,3986,19181,0
2019/03,134,12/03/2019,2,SP 343R tra Parma e San Polo,20726,00,18331,2395,16231,4495,20726,0
2019/03,134,13/03/2019,3,SP 343R tra Parma e San Polo,20696,00,18317,2379,16083,4613,20696,0
2019/03,134,14/03/2019,4,SP 343R tra Parma e San Polo,16701,00,14740,1961,12324,4377,16701,0
2019/03,135,01/03/2019,5,SP 10 tra Parma (Tangenziale) e Viarolo,,,,,,,,
2019/03,135,02/03/2019,6,SP 10 tra Parma (Tangenziale) e Viarolo,,,,,,,,
2019/03,135,03/03/2019,7,SP 10 tra Parma (Tangenziale) e Viarolo,,,,,,,,
2019/03,135,04/03/2019,1,SP 10 tra Parma (Tangenziale) e Viarolo,,,,,,,,
2019/03,135,05/03/2019,2,SP 10 tra Parma (Tangenziale) e Viarolo,,,,,,,,
2019/03,135,06/03/2019,3,SP 10 tra Parma (Tangenziale) e Viarolo,,,,,,,,
2019/03,135,07/03/2019,4,SP 10 tra Parma (Tangenziale) e Viarolo,,,,,,,,
2019/03,135,08/03/2019,5,SP 10 tra Parma (Tangenziale) e Viarolo,,,,,,,,
2019/03,135,09/03/2019,6,SP 10 tra Parma (Tangenziale) e Viarolo,,,,,,,,
2019/03,135,10/03/2019,7,SP 10 tra Parma (Tangenziale) e Viarolo,,,,,,,,
2019/03,135,11/03/2019,1,SP 10 tra Parma (Tangenziale) e Viarolo,,,,,,,,
2019/03,135,12/03/2019,2,SP 10 tra Parma (Tangenziale) e Viarolo,,,,,,,,
2019/03,135,13/03/2019,3,SP 10 tra Parma (Tangenziale) e Viarolo,,,,,,,,
2019/03,135,14/03/2019,4,SP 10 tra Parma (Tangenziale) e Viarolo,,,,,,,,
2019/03,137,01/03/2019,5,SP 28 tra Reggio Emilia (Tangenziale) e Cavriago,16662,10,16196,465,14148,2514,16662,0
2019/03,137,02/03/2019,6,SP 28 tra Reggio Emilia (Tangenziale) e Cavriago,15797,10,15643,153,12175,3622,0,15797
2019/03,137,03/03/2019,7,SP 28 tra Reggio Emilia (Tangenziale) e Cavriago,12932,10,12881,50,10279,2653,0,12932
2019/03,137,04/03/2019,1,SP 28 tra Reggio Emilia (Tangenziale) e Cavriago,21408,20,20804,602,17389,4019,21408,0
2019/03,137,05/03/2019,2,SP 28 tra Reggio Emilia (Tangenziale) e Cavriago,22100,20,21480,618,17593,4507,22100,0
2019/03,137,06/03/2019,3,SP 28 tra Reggio Emilia (Tangenziale) e Cavriago,22264,40,21627,633,17562,4702,22264,0
2019/03,137,07/03/2019,4,SP 28 tra Reggio Emilia (Tangenziale) e Cavriago,22153,40,21582,567,17398,4755,22153,0
2019/03,137,08/03/2019,5,SP 28 tra Reggio Emilia (Tangenziale) e Cavriago,20969,40,20415,550,17902,3067,20969,0
2019/03,137,09/03/2019,6,SP 28 tra Reggio Emilia (Tangenziale) e Cavriago,19247,00,19004,243,14059,5188,0,19247
2019/03,137,10/03/2019,7,SP 28 tra Reggio Emilia (Tangenziale) e Cavriago,11677,00,11615,62,7993,3684,0,11677
2019/03,137,11/03/2019,1,SP 28 tra Reggio Emilia (Tangenziale) e Cavriago,21379,40,20732,643,17119,4260,21379,0
2019/03,137,12/03/2019,2,SP 28 tra Reggio Emilia (Tangenziale) e Cavriago,19469,10,18884,584,15563,3906,19469,0
2019/03,137,13/03/2019,3,SP 28 tra Reggio Emilia (Tangenziale) e Cavriago,21911,10,21362,548,17224,4687,21911,0
2019/03,137,14/03/2019,4,SP 28 tra Reggio Emilia (Tangenziale) e Cavriago,17740,00,17257,483,13600,4140,17740,0
2019/03,138,01/03/2019,5,SS 63 tra Reggio Emilia e Puianello,12967,10,12535,431,9530,3437,12967,0
2019/03,138,02/03/2019,6,SS 63 tra Reggio Emilia e Puianello,13242,10,13073,168,9489,3753,0,13242
2019/03,138,03/03/2019,7,SS 63 tra Reggio Emilia e Puianello,11731,00,11686,45,8810,2921,0,11731
2019/03,138,04/03/2019,1,SS 63 tra Reggio Emilia e Puianello,11845,40,11416,425,9132,2713,11845,0
2019/03,138,05/03/2019,2,SS 63 tra Reggio Emilia e Puianello,12171,00,11732,439,9231,2940,12171,0
2019/03,138,06/03/2019,3,SS 63 tra Reggio Emilia e Puianello,12165,00,11759,406,9101,3064,12165,0
2019/03,138,07/03/2019,4,SS 63 tra Reggio Emilia e Puianello,12588,10,12106,481,9383,3205,12588,0
2019/03,138,08/03/2019,5,SS 63 tra Reggio Emilia e Puianello,13212,20,12799,411,9572,3640,13212,0
2019/03,138,09/03/2019,6,SS 63 tra Reggio Emilia e Puianello,13499,10,13308,190,9694,3805,0,13499
2019/03,138,10/03/2019,7,SS 63 tra Reggio Emilia e Puianello,11200,10,11147,52,8159,3041,0,11200
2019/03,138,11/03/2019,1,SS 63 tra Reggio Emilia e Puianello,12001,00,11563,438,9230,2771,12001,0
2019/03,138,12/03/2019,2,SS 63 tra Reggio Emilia e Puianello,12276,10,11846,429,9366,2910,12276,0
2019/03,138,13/03/2019,3,SS 63 tra Reggio Emilia e Puianello,12164,20,11742,420,9130,3034,12164,0
2019/03,138,14/03/2019,4,SS 63 tra Reggio Emilia e Puianello,12512,00,12024,488,9361,3151,12512,0
2019/03,139,01/03/2019,5,SP 467R tra Fogliano e località Pratissolo (c/o Scandiano),18954,00,18175,779,14702,4252,18954,0
2019/03,139,02/03/2019,6,SP 467R tra Fogliano e località Pratissolo (c/o Scandiano),15611,00,15447,164,11309,4302,0,15611
2019/03,139,03/03/2019,7,SP 467R tra Fogliano e località Pratissolo (c/o Scandiano),11136,00,11068,68,7842,3294,0,11136
2019/03,139,04/03/2019,1,SP 467R tra Fogliano e località Pratissolo (c/o Scandiano),18480,10,17695,784,14907,3573,18480,0
2019/03,139,05/03/2019,2,SP 467R tra Fogliano e località Pratissolo (c/o Scandiano),18170,00,17374,796,14444,3726,18170,0
2019/03,139,06/03/2019,3,SP 467R tra Fogliano e località Pratissolo (c/o Scandiano),18357,00,17548,809,14545,3812,18357,0
2019/03,139,07/03/2019,4,SP 467R tra Fogliano e località Pratissolo (c/o Scandiano),18154,00,17343,811,14280,3874,18154,0
2019/03,139,08/03/2019,5,SP 467R tra Fogliano e località Pratissolo (c/o Scandiano),18881,00,18113,768,14389,4492,18881,0
2019/03,139,09/03/2019,6,SP 467R tra Fogliano e località Pratissolo (c/o Scandiano),15788,00,15632,156,11162,4626,0,15788
2019/03,139,10/03/2019,7,SP 467R tra Fogliano e località Pratissolo (c/o Scandiano),11595,00,11534,61,8007,3588,0,11595
2019/03,139,11/03/2019,1,SP 467R tra Fogliano e località Pratissolo (c/o Scandiano),17734,00,17049,685,14177,3557,17734,0
2019/03,139,12/03/2019,2,SP 467R tra Fogliano e località Pratissolo (c/o Scandiano),18106,00,17293,813,14415,3691,18106,0
2019/03,139,13/03/2019,3,SP 467R tra Fogliano e località Pratissolo (c/o Scandiano),17571,00,16793,778,13695,3876,17571,0
2019/03,139,14/03/2019,4,SP 467R tra Fogliano e località Pratissolo (c/o Scandiano),17466,40,16664,798,13530,3936,17466,0
2019/03,140,01/03/2019,5,SS 9 tra Masone e Rubiera,27276,50,24421,2850,19666,7610,27276,0
2019/03,140,02/03/2019,6,SS 9 tra Masone e Rubiera,24636,00,24072,564,16018,8618,0,24636
2019/03,140,03/03/2019,7,SS 9 tra Masone e Rubiera,21340,00,21181,159,14252,7088,0,21340
2019/03,140,04/03/2019,1,SS 9 tra Masone e Rubiera,25148,00,22390,2758,18939,6209,25148,0
2019/03,140,05/03/2019,2,SS 9 tra Masone e Rubiera,26175,50,23224,2946,19628,6547,26175,0
2019/03,140,06/03/2019,3,SS 9 tra Masone e Rubiera,25281,80,22376,2897,18541,6740,25281,0
2019/03,140,07/03/2019,4,SS 9 tra Masone e Rubiera,26828,00,23800,3028,19722,7106,26828,0
2019/03,140,08/03/2019,5,SS 9 tra Masone e Rubiera,28273,00,25310,2963,20223,8050,28273,0
2019/03,140,09/03/2019,6,SS 9 tra Masone e Rubiera,25360,10,24650,709,16748,8612,0,25360
2019/03,140,10/03/2019,7,SS 9 tra Masone e Rubiera,23379,00,23213,166,15804,7575,0,23379
2019/03,140,11/03/2019,1,SS 9 tra Masone e Rubiera,25573,00,22772,2801,19333,6240,25573,0
2019/03,140,12/03/2019,2,SS 9 tra Masone e Rubiera,26354,30,23397,2954,19711,6643,26354,0
2019/03,140,13/03/2019,3,SS 9 tra Masone e Rubiera,26567,10,23529,3037,19716,6851,26567,0
2019/03,140,14/03/2019,4,SS 9 tra Masone e Rubiera,27004,00,23996,3008,20060,6944,27004,0
2019/03,143,01/03/2019,5,SP 63R tra Sesso e Cadelbosco di Sopra (bivio SP 358R),26989,00,25565,1424,20602,6387,26989,0
2019/03,143,02/03/2019,6,SP 63R tra Sesso e Cadelbosco di Sopra (bivio SP 358R),22581,00,22201,380,16214,6367,0,22581
2019/03,143,03/03/2019,7,SP 63R tra Sesso e Cadelbosco di Sopra (bivio SP 358R),19221,00,19121,100,13806,5415,0,19221
2019/03,143,04/03/2019,1,SP 63R tra Sesso e Cadelbosco di Sopra (bivio SP 358R),25210,00,23793,1417,20073,5137,25210,0
2019/03,143,05/03/2019,2,SP 63R tra Sesso e Cadelbosco di Sopra (bivio SP 358R),26073,10,24621,1451,20610,5463,26073,0
2019/03,143,06/03/2019,3,SP 63R tra Sesso e Cadelbosco di Sopra (bivio SP 358R),26565,00,25101,1464,20744,5821,26565,0
2019/03,143,07/03/2019,4,SP 63R tra Sesso e Cadelbosco di Sopra (bivio SP 358R),26409,20,24949,1458,20557,5852,26409,0
2019/03,143,08/03/2019,5,SP 63R tra Sesso e Cadelbosco di Sopra (bivio SP 358R),27205,00,25654,1551,20566,6639,27205,0
2019/03,143,09/03/2019,6,SP 63R tra Sesso e Cadelbosco di Sopra (bivio SP 358R),22723,00,22351,372,16059,6664,0,22723
2019/03,143,10/03/2019,7,SP 63R tra Sesso e Cadelbosco di Sopra (bivio SP 358R),17834,00,17751,83,12549,5285,0,17834
2019/03,143,11/03/2019,1,SP 63R tra Sesso e Cadelbosco di Sopra (bivio SP 358R),25394,00,23965,1429,20100,5294,25394,0
2019/03,143,12/03/2019,2,SP 63R tra Sesso e Cadelbosco di Sopra (bivio SP 358R),26012,30,24651,1358,20523,5489,26012,0
2019/03,143,13/03/2019,3,SP 63R tra Sesso e Cadelbosco di Sopra (bivio SP 358R),26275,00,24829,1446,20583,5692,26275,0
2019/03,143,14/03/2019,4,SP 63R tra Sesso e Cadelbosco di Sopra (bivio SP 358R),26073,00,24673,1400,20390,5683,26073,0
2019/03,146,01/03/2019,5,SS 12 tra Montale e Modena,22397,10,21083,1313,16926,5471,22397,0
2019/03,146,02/03/2019,6,SS 12 tra Montale e Modena,19304,00,18974,330,13643,5661,0,19304
2019/03,146,03/03/2019,7,SS 12 tra Montale e Modena,17410,00,17339,71,12643,4767,0,17410
2019/03,146,04/03/2019,1,SS 12 tra Montale e Modena,21139,20,19764,1373,16534,4605,21139,0
2019/03,146,05/03/2019,2,SS 12 tra Montale e Modena,21760,40,20423,1333,16804,4956,21760,0
2019/03,146,06/03/2019,3,SS 12 tra Montale e Modena,22287,30,20840,1444,17033,5254,22287,0
2019/03,146,07/03/2019,4,SS 12 tra Montale e Modena,22442,10,21077,1364,17177,5265,22442,0
2019/03,146,08/03/2019,5,SS 12 tra Montale e Modena,23333,30,21928,1402,17546,5787,23333,0
2019/03,146,09/03/2019,6,SS 12 tra Montale e Modena,19563,20,19195,366,13710,5853,0,19563
2019/03,146,10/03/2019,7,SS 12 tra Montale e Modena,17434,00,17333,101,12998,4436,0,17434
2019/03,146,11/03/2019,1,SS 12 tra Montale e Modena,21258,40,19895,1359,16626,4632,21258,0
2019/03,146,12/03/2019,2,SS 12 tra Montale e Modena,21405,50,20038,1362,16578,4827,21405,0
2019/03,146,13/03/2019,3,SS 12 tra Montale e Modena,21694,40,20339,1351,16557,5137,21694,0
2019/03,146,14/03/2019,4,SS 12 tra Montale e Modena,22251,10,20896,1354,17028,5223,22251,0
2019/03,147,01/03/2019,5,SP 623 tra Modena Sud/casello A 1 e Spilamberto,20514,00,17170,3344,15428,5086,20514,0
2019/03,147,02/03/2019,6,SP 623 tra Modena Sud/casello A 1 e Spilamberto,16267,00,15633,634,11411,4856,0,16267
2019/03,147,03/03/2019,7,SP 623 tra Modena Sud/casello A 1 e Spilamberto,14735,00,14553,182,10587,4148,0,14735
2019/03,147,04/03/2019,1,SP 623 tra Modena Sud/casello A 1 e Spilamberto,19164,20,15755,3407,14879,4285,19164,0
2019/03,147,05/03/2019,2,SP 623 tra Modena Sud/casello A 1 e Spilamberto,19436,00,15987,3449,14986,4450,19436,0
2019/03,147,08/03/2019,5,SP 623 tra Modena Sud/casello A 1 e Spilamberto,17518,00,14549,2969,12941,4577,17518,0
2019/03,147,09/03/2019,6,SP 623 tra Modena Sud/casello A 1 e Spilamberto,15551,00,14946,605,10480,5071,0,15551
2019/03,147,10/03/2019,7,SP 623 tra Modena Sud/casello A 1 e Spilamberto,14598,00,14445,153,10397,4201,0,14598
2019/03,147,11/03/2019,1,SP 623 tra Modena Sud/casello A 1 e Spilamberto,18891,00,15410,3481,14564,4327,18891,0
2019/03,147,12/03/2019,2,SP 623 tra Modena Sud/casello A 1 e Spilamberto,19168,10,15744,3423,14651,4517,19168,0
2019/03,147,13/03/2019,3,SP 623 tra Modena Sud/casello A 1 e Spilamberto,20174,00,16658,3516,15419,4755,20174,0
2019/03,147,14/03/2019,4,SP 623 tra Modena Sud/casello A 1 e Spilamberto,19933,10,16499,3433,15194,4739,19933,0
2019/03,148,01/03/2019,5,SS 9 tra Sant'Ambrogio e Castelfranco Emilia,29755,50,27947,1803,21590,8165,29755,0
2019/03,148,02/03/2019,6,SS 9 tra Sant'Ambrogio e Castelfranco Emilia,26512,00,26035,477,18253,8259,0,26512
2019/03,148,03/03/2019,7,SS 9 tra Sant'Ambrogio e Castelfranco Emilia,21502,20,21407,93,14730,6772,0,21502
2019/03,148,04/03/2019,1,SS 9 tra Sant'Ambrogio e Castelfranco Emilia,28319,10,26476,1842,21205,7114,28319,0
2019/03,148,05/03/2019,2,SS 9 tra Sant'Ambrogio e Castelfranco Emilia,28614,50,26664,1945,21131,7483,28614,0
2019/03,148,06/03/2019,3,SS 9 tra Sant'Ambrogio e Castelfranco Emilia,28953,10,26975,1977,21434,7519,28953,0
2019/03,148,07/03/2019,4,SS 9 tra Sant'Ambrogio e Castelfranco Emilia,29085,20,27147,1936,21350,7735,29085,0
2019/03,148,08/03/2019,5,SS 9 tra Sant'Ambrogio e Castelfranco Emilia,31065,20,29078,1985,22216,8849,31065,0
2019/03,148,09/03/2019,6,SS 9 tra Sant'Ambrogio e Castelfranco Emilia,26737,00,26236,501,18156,8581,0,26737
2019/03,148,10/03/2019,7,SS 9 tra Sant'Ambrogio e Castelfranco Emilia,21802,00,21650,152,14651,7151,0,21802
2019/03,148,11/03/2019,1,SS 9 tra Sant'Ambrogio e Castelfranco Emilia,28286,30,26449,1834,21255,7031,28286,0
2019/03,148,12/03/2019,2,SS 9 tra Sant'Ambrogio e Castelfranco Emilia,28307,30,26393,1911,21159,7148,28307,0
2019/03,148,13/03/2019,3,SS 9 tra Sant'Ambrogio e Castelfranco Emilia,28625,10,26787,1837,21064,7561,28625,0
2019/03,149,01/03/2019,5,SP 255 tra Modena e Navicello,38135,390,34793,3303,28767,9368,38135,0
2019/03,149,02/03/2019,6,SP 255 tra Modena e Navicello,30206,10,29581,624,21197,9009,0,30206
2019/03,149,03/03/2019,7,SP 255 tra Modena e Navicello,25549,90,25387,153,17801,7748,0,25549
2019/03,149,04/03/2019,1,SP 255 tra Modena e Navicello,35844,560,32673,3115,27875,7969,35844,0
2019/03,149,05/03/2019,2,SP 255 tra Modena e Navicello,36831,450,33574,3212,28428,8403,36831,0
2019/03,149,06/03/2019,3,SP 255 tra Modena e Navicello,36966,460,33735,3185,28274,8692,36966,0
2019/03,149,07/03/2019,4,SP 255 tra Modena e Navicello,37434,550,34065,3314,28593,8841,37434,0
2019/03,149,08/03/2019,5,SP 255 tra Modena e Navicello,38780,560,35521,3203,28987,9793,38780,0
2019/03,149,09/03/2019,6,SP 255 tra Modena e Navicello,29839,00,29194,645,20761,9078,0,29839
2019/03,149,10/03/2019,7,SP 255 tra Modena e Navicello,24543,20,24363,178,17138,7405,0,24543
2019/03,149,11/03/2019,1,SP 255 tra Modena e Navicello,35972,490,32832,3091,28090,7882,35972,0
2019/03,149,12/03/2019,2,SP 255 tra Modena e Navicello,36737,560,33409,3272,28304,8433,36737,0
2019/03,149,13/03/2019,3,SP 255 tra Modena e Navicello,36791,470,33413,3331,28104,8687,36791,0
2019/03,149,14/03/2019,4,SP 255 tra Modena e Navicello,37338,290,33966,3343,28570,8768,37338,0
2019/03,150,01/03/2019,5,SS 12 tra Modena e Bastiglia,25785,10,23730,2054,19366,6419,25785,0
2019/03,150,02/03/2019,6,SS 12 tra Modena e Bastiglia,20371,00,19973,398,13841,6530,0,20371
2019/03,150,03/03/2019,7,SS 12 tra Modena e Bastiglia,17015,00,16954,61,11738,5277,0,17015
2019/03,150,04/03/2019,1,SS 12 tra Modena e Bastiglia,24554,00,22554,2000,19402,5152,24554,0
2019/03,150,05/03/2019,2,SS 12 tra Modena e Bastiglia,25131,10,23065,2065,19697,5434,25131,0
2019/03,150,06/03/2019,3,SS 12 tra Modena e Bastiglia,25256,10,23100,2155,19602,5654,25256,0
2019/03,150,07/03/2019,4,SS 12 tra Modena e Bastiglia,25253,00,23084,2169,19550,5703,25253,0
2019/03,150,08/03/2019,5,SS 12 tra Modena e Bastiglia,26371,10,24427,1943,19691,6680,26371,0
2019/03,150,09/03/2019,6,SS 12 tra Modena e Bastiglia,20985,00,20593,392,14142,6843,0,20985
2019/03,150,10/03/2019,7,SS 12 tra Modena e Bastiglia,17122,00,17060,62,11653,5469,0,17122
2019/03,150,11/03/2019,1,SS 12 tra Modena e Bastiglia,24499,00,22384,2115,19207,5292,24499,0
2019/03,150,12/03/2019,2,SS 12 tra Modena e Bastiglia,24825,10,22741,2083,19358,5467,24825,0
2019/03,150,13/03/2019,3,SS 12 tra Modena e Bastiglia,25417,10,23276,2140,19775,5642,25417,0
2019/03,150,14/03/2019,4,SS 12 tra Modena e Bastiglia,25402,00,23182,2220,19658,5744,25402,0
2019/03,151,01/03/2019,5,SP 413 tra Modena e Ganaceto,16384,00,15581,803,11555,4829,16384,0
2019/03,151,02/03/2019,6,SP 413 tra Modena e Ganaceto,23462,00,23096,366,16227,7235,0,23462
2019/03,151,03/03/2019,7,SP 413 tra Modena e Ganaceto,18031,00,17949,82,12366,5665,0,18031
2019/03,151,04/03/2019,1,SP 413 tra Modena e Ganaceto,23446,00,21957,1489,18075,5371,23446,0
2019/03,151,05/03/2019,2,SP 413 tra Modena e Ganaceto,24194,00,22625,1569,18417,5777,24194,0
2019/03,151,06/03/2019,3,SP 413 tra Modena e Ganaceto,24368,10,22781,1586,18352,6016,24368,0
2019/03,151,07/03/2019,4,SP 413 tra Modena e Ganaceto,24827,00,23079,1748,18698,6129,24827,0
2019/03,151,08/03/2019,5,SP 413 tra Modena e Ganaceto,25570,30,23983,1584,18545,7025,25570,0
2019/03,151,09/03/2019,6,SP 413 tra Modena e Ganaceto,23023,00,22676,347,15678,7345,0,23023
2019/03,151,10/03/2019,7,SP 413 tra Modena e Ganaceto,17602,00,17518,84,11762,5840,0,17602
2019/03,151,11/03/2019,1,SP 413 tra Modena e Ganaceto,23469,00,21914,1555,17975,5494,23469,0
2019/03,151,12/03/2019,2,SP 413 tra Modena e Ganaceto,24012,00,22372,1640,18287,5725,24012,0
2019/03,151,13/03/2019,3,SP 413 tra Modena e Ganaceto,23683,10,22183,1499,17712,5971,23683,0
2019/03,151,14/03/2019,4,SP 413 tra Modena e Ganaceto,24617,10,23102,1514,18559,6058,24617,0
2019/03,152,01/03/2019,5,SP 569 tra Innesto tangenziale Bologna e uscita Zola Predosa (Gesso/Rivabella),66962,30,64062,2897,51607,15355,66962,0
2019/03,152,02/03/2019,6,SP 569 tra Innesto tangenziale Bologna e uscita Zola Predosa (Gesso/Rivabella),60408,10,59800,607,44090,16318,0,60408
2019/03,152,03/03/2019,7,SP 569 tra Innesto tangenziale Bologna e uscita Zola Predosa (Gesso/Rivabella),49537,00,49360,177,36120,13417,0,49537
2019/03,152,04/03/2019,1,SP 569 tra Innesto tangenziale Bologna e uscita Zola Predosa (Gesso/Rivabella),62807,30,60019,2785,49910,12897,62807,0
2019/03,152,05/03/2019,2,SP 569 tra Innesto tangenziale Bologna e uscita Zola Predosa (Gesso/Rivabella),65182,20,62148,3032,50970,14212,65182,0
2019/03,152,06/03/2019,3,SP 569 tra Innesto tangenziale Bologna e uscita Zola Predosa (Gesso/Rivabella),61753,00,59074,2679,47656,14097,61753,0
2019/03,152,07/03/2019,4,SP 569 tra Innesto tangenziale Bologna e uscita Zola Predosa (Gesso/Rivabella),62463,20,59787,2674,48004,14459,62463,0
2019/03,152,08/03/2019,5,SP 569 tra Innesto tangenziale Bologna e uscita Zola Predosa (Gesso/Rivabella),67869,30,65228,2638,51829,16040,67869,0
2019/03,152,09/03/2019,6,SP 569 tra Innesto tangenziale Bologna e uscita Zola Predosa (Gesso/Rivabella),59862,20,59340,520,44412,15450,0,59862
2019/03,152,10/03/2019,7,SP 569 tra Innesto tangenziale Bologna e uscita Zola Predosa (Gesso/Rivabella),50961,00,50762,199,38843,12118,0,50961
2019/03,152,11/03/2019,1,SP 569 tra Innesto tangenziale Bologna e uscita Zola Predosa (Gesso/Rivabella),61630,20,58972,2656,48744,12886,61630,0
2019/03,152,12/03/2019,2,SP 569 tra Innesto tangenziale Bologna e uscita Zola Predosa (Gesso/Rivabella),65140,40,62102,3034,50714,14426,65140,0
2019/03,152,13/03/2019,3,SP 569 tra Innesto tangenziale Bologna e uscita Zola Predosa (Gesso/Rivabella),66314,40,63221,3089,51459,14855,66314,0
2019/03,152,14/03/2019,4,SP 569 tra Innesto tangenziale Bologna e uscita Zola Predosa (Gesso/Rivabella),66328,30,63262,3063,51457,14871,66328,0
2019/03,153,01/03/2019,5,Via Porrettana (ex SS 64) tra Bologna e Pontecchio Marconi,12127,10,11874,252,9138,2989,12127,0
2019/03,153,02/03/2019,6,Via Porrettana (ex SS 64) tra Bologna e Pontecchio Marconi,11598,00,11472,126,8592,3006,0,11598
2019/03,153,03/03/2019,7,Via Porrettana (ex SS 64) tra Bologna e Pontecchio Marconi,9215,00,9192,23,6917,2298,0,9215
2019/03,153,04/03/2019,1,Via Porrettana (ex SS 64) tra Bologna e Pontecchio Marconi,11149,00,10893,256,8827,2322,11149,0
2019/03,153,05/03/2019,2,Via Porrettana (ex SS 64) tra Bologna e Pontecchio Marconi,11518,00,11255,263,8944,2574,11518,0
2019/03,153,06/03/2019,3,Via Porrettana (ex SS 64) tra Bologna e Pontecchio Marconi,11282,00,11000,282,8756,2526,11282,0
2019/03,153,07/03/2019,4,Via Porrettana (ex SS 64) tra Bologna e Pontecchio Marconi,11849,00,11589,260,9071,2778,11849,0
2019/03,153,08/03/2019,5,Via Porrettana (ex SS 64) tra Bologna e Pontecchio Marconi,12861,10,12634,226,9651,3210,12861,0
2019/03,153,09/03/2019,6,Via Porrettana (ex SS 64) tra Bologna e Pontecchio Marconi,11626,00,11511,115,8611,3015,0,11626
2019/03,153,10/03/2019,7,Via Porrettana (ex SS 64) tra Bologna e Pontecchio Marconi,9497,00,9466,31,7322,2175,0,9497
2019/03,153,11/03/2019,1,Via Porrettana (ex SS 64) tra Bologna e Pontecchio Marconi,11161,00,10903,258,8790,2371,11161,0
2019/03,153,12/03/2019,2,Via Porrettana (ex SS 64) tra Bologna e Pontecchio Marconi,11823,00,11575,248,9186,2637,11823,0
2019/03,153,13/03/2019,3,Via Porrettana (ex SS 64) tra Bologna e Pontecchio Marconi,11205,10,10936,268,8590,2615,11205,0
2019/03,153,14/03/2019,4,Via Porrettana (ex SS 64) tra Bologna e Pontecchio Marconi,11466,10,11209,256,8878,2588,11466,0
2019/03,154,01/03/2019,5,Tra Rastignano e Pian di Macina (SP85 Fondo Valle Savena),12740,00,12486,254,9927,2813,12740,0
2019/03,154,02/03/2019,6,Tra Rastignano e Pian di Macina (SP85 Fondo Valle Savena),10687,20,10622,63,8050,2637,0,10687
2019/03,154,03/03/2019,7,Tra Rastignano e Pian di Macina (SP85 Fondo Valle Savena),9641,00,9629,12,7463,2178,0,9641
2019/03,154,04/03/2019,1,Tra Rastignano e Pian di Macina (SP85 Fondo Valle Savena),11635,20,11382,251,9144,2491,11635,0
2019/03,154,05/03/2019,2,Tra Rastignano e Pian di Macina (SP85 Fondo Valle Savena),12071,00,11805,266,9449,2622,12071,0
2019/03,154,06/03/2019,3,Tra Rastignano e Pian di Macina (SP85 Fondo Valle Savena),12456,00,12183,273,9808,2648,12456,0
2019/03,154,07/03/2019,4,Tra Rastignano e Pian di Macina (SP85 Fondo Valle Savena),12350,10,12085,264,9667,2683,12350,0
2019/03,154,08/03/2019,5,Tra Rastignano e Pian di Macina (SP85 Fondo Valle Savena),13484,10,13210,273,10355,3129,13484,0
2019/03,154,09/03/2019,6,Tra Rastignano e Pian di Macina (SP85 Fondo Valle Savena),11045,10,10971,73,8377,2668,0,11045
2019/03,154,10/03/2019,7,Tra Rastignano e Pian di Macina (SP85 Fondo Valle Savena),9220,30,9199,18,7023,2197,0,9220
2019/03,154,11/03/2019,1,Tra Rastignano e Pian di Macina (SP85 Fondo Valle Savena),11532,30,11297,232,9319,2213,11532,0
2019/03,154,12/03/2019,2,Tra Rastignano e Pian di Macina (SP85 Fondo Valle Savena),12242,30,11925,314,9649,2593,12242,0
2019/03,154,13/03/2019,3,Tra Rastignano e Pian di Macina (SP85 Fondo Valle Savena),12369,30,12098,268,9708,2661,12369,0
2019/03,154,14/03/2019,4,Tra Rastignano e Pian di Macina (SP85 Fondo Valle Savena),12454,10,12178,275,9755,2699,12454,0
2019/03,155,01/03/2019,5,Via Emilia tra San Lazzaro e Idice,15634,100,15145,479,12045,3589,15634,0
2019/03,155,02/03/2019,6,Via Emilia tra San Lazzaro e Idice,14869,20,14580,287,11054,3815,0,14869
2019/03,155,03/03/2019,7,Via Emilia tra San Lazzaro e Idice,11431,00,11366,65,8307,3124,0,11431
2019/03,155,04/03/2019,1,Via Emilia tra San Lazzaro e Idice,14637,30,14130,504,11737,2900,14637,0
2019/03,155,05/03/2019,2,Via Emilia tra San Lazzaro e Idice,14866,00,14387,479,11770,3096,14866,0
2019/03,155,06/03/2019,3,Via Emilia tra San Lazzaro e Idice,15294,00,14785,509,12003,3291,15294,0
2019/03,155,07/03/2019,4,Via Emilia tra San Lazzaro e Idice,15299,00,14782,517,11899,3400,15299,0
2019/03,155,08/03/2019,5,Via Emilia tra San Lazzaro e Idice,16444,30,15994,447,12491,3953,16444,0
2019/03,155,09/03/2019,6,Via Emilia tra San Lazzaro e Idice,14524,10,14253,270,10658,3866,0,14524
2019/03,155,10/03/2019,7,Via Emilia tra San Lazzaro e Idice,10722,00,10664,58,7799,2923,0,10722
2019/03,155,11/03/2019,1,Via Emilia tra San Lazzaro e Idice,14390,40,13907,479,11489,2901,14390,0
2019/03,155,12/03/2019,2,Via Emilia tra San Lazzaro e Idice,15151,20,14668,481,11950,3201,15151,0
2019/03,155,13/03/2019,3,Via Emilia tra San Lazzaro e Idice,15239,00,14714,525,11881,3358,15239,0
2019/03,155,14/03/2019,4,Via Emilia tra San Lazzaro e Idice,15328,30,14774,551,11929,3399,15328,0
2019/03,156,01/03/2019,5,SP 253 tra la località Villanova e inizio variante Castenaso,22576,00,21839,737,17716,4860,22576,0
2019/03,156,02/03/2019,6,SP 253 tra la località Villanova e inizio variante Castenaso,19526,10,19361,164,14614,4912,0,19526
2019/03,156,03/03/2019,7,SP 253 tra la località Villanova e inizio variante Castenaso,14922,00,14869,53,11168,3754,0,14922
2019/03,156,04/03/2019,1,SP 253 tra la località Villanova e inizio variante Castenaso,21608,00,20798,810,17262,4346,21608,0
2019/03,156,05/03/2019,2,SP 253 tra la località Villanova e inizio variante Castenaso,21682,00,20869,813,17107,4575,21682,0
2019/03,156,06/03/2019,3,SP 253 tra la località Villanova e inizio variante Castenaso,21648,00,20882,766,17147,4501,21648,0
2019/03,156,07/03/2019,4,SP 253 tra la località Villanova e inizio variante Castenaso,21737,10,20987,749,16861,4876,21737,0
2019/03,156,08/03/2019,5,SP 253 tra la località Villanova e inizio variante Castenaso,23840,10,23072,767,18465,5375,23840,0
2019/03,156,09/03/2019,6,SP 253 tra la località Villanova e inizio variante Castenaso,19421,00,19260,161,14355,5066,0,19421
2019/03,156,10/03/2019,7,SP 253 tra la località Villanova e inizio variante Castenaso,14106,00,14059,47,10447,3659,0,14106
2019/03,156,11/03/2019,1,SP 253 tra la località Villanova e inizio variante Castenaso,21265,00,20511,754,17034,4231,21265,0
2019/03,156,12/03/2019,2,SP 253 tra la località Villanova e inizio variante Castenaso,21914,00,21091,823,17193,4721,21914,0
2019/03,156,13/03/2019,3,SP 253 tra la località Villanova e inizio variante Castenaso,21818,10,21109,708,17190,4628,21818,0
2019/03,156,14/03/2019,4,SP 253 tra la località Villanova e inizio variante Castenaso,21816,10,21084,731,17092,4724,21816,0
2019/03,157,01/03/2019,5,Via San Donato (ex SP 5) tra Granarolo dell'Emilia e Quarto Inferiore,12436,00,12138,298,9500,2936,12436,0
2019/03,157,02/03/2019,6,Via San Donato (ex SP 5) tra Granarolo dell'Emilia e Quarto Inferiore,10940,00,10816,124,8132,2808,0,10940
2019/03,157,03/03/2019,7,Via San Donato (ex SP 5) tra Granarolo dell'Emilia e Quarto Inferiore,8849,00,8792,57,6650,2199,0,8849
2019/03,157,04/03/2019,1,Via San Donato (ex SP 5) tra Granarolo dell'Emilia e Quarto Inferiore,11876,00,11549,327,9484,2392,11876,0
2019/03,157,05/03/2019,2,Via San Donato (ex SP 5) tra Granarolo dell'Emilia e Quarto Inferiore,11847,00,11547,300,9320,2527,11847,0
2019/03,157,06/03/2019,3,Via San Donato (ex SP 5) tra Granarolo dell'Emilia e Quarto Inferiore,12017,20,11733,282,9264,2753,12017,0
2019/03,157,07/03/2019,4,Via San Donato (ex SP 5) tra Granarolo dell'Emilia e Quarto Inferiore,12131,10,11851,279,9394,2737,12131,0
2019/03,157,08/03/2019,5,Via San Donato (ex SP 5) tra Granarolo dell'Emilia e Quarto Inferiore,13077,00,12819,258,9881,3196,13077,0
2019/03,157,09/03/2019,6,Via San Donato (ex SP 5) tra Granarolo dell'Emilia e Quarto Inferiore,11085,00,10954,131,8219,2866,0,11085
2019/03,157,10/03/2019,7,Via San Donato (ex SP 5) tra Granarolo dell'Emilia e Quarto Inferiore,8553,10,8521,31,6298,2255,0,8553
2019/03,157,11/03/2019,1,Via San Donato (ex SP 5) tra Granarolo dell'Emilia e Quarto Inferiore,11883,20,11565,316,9552,2331,11883,0
2019/03,157,12/03/2019,2,Via San Donato (ex SP 5) tra Granarolo dell'Emilia e Quarto Inferiore,12129,10,11861,267,9544,2585,12129,0
2019/03,157,13/03/2019,3,Via San Donato (ex SP 5) tra Granarolo dell'Emilia e Quarto Inferiore,12108,20,11849,257,9497,2611,12108,0
2019/03,157,14/03/2019,4,Via San Donato (ex SP 5) tra Granarolo dell'Emilia e Quarto Inferiore,12147,10,11840,306,9442,2705,12147,0
2019/03,158,01/03/2019,5,SS 64 tra Bologna e Lovoleto,12442,10,11719,722,9424,3018,12442,0
2019/03,158,02/03/2019,6,SS 64 tra Bologna e Lovoleto,9359,00,9174,185,6605,2754,0,9359
2019/03,158,03/03/2019,7,SS 64 tra Bologna e Lovoleto,7539,00,7467,72,5298,2241,0,7539
2019/03,158,04/03/2019,1,SS 64 tra Bologna e Lovoleto,12149,20,11435,712,9655,2494,12149,0
2019/03,158,05/03/2019,2,SS 64 tra Bologna e Lovoleto,11976,00,11213,763,9273,2703,11976,0
2019/03,158,06/03/2019,3,SS 64 tra Bologna e Lovoleto,12031,10,11285,745,9340,2691,12031,0
2019/03,158,07/03/2019,4,SS 64 tra Bologna e Lovoleto,12255,10,11507,747,9379,2876,12255,0
2019/03,158,08/03/2019,5,SS 64 tra Bologna e Lovoleto,12962,30,12166,793,9676,3286,12962,0
2019/03,158,09/03/2019,6,SS 64 tra Bologna e Lovoleto,9603,10,9415,187,6791,2812,0,9603
2019/03,158,10/03/2019,7,SS 64 tra Bologna e Lovoleto,7152,00,7094,58,5132,2020,0,7152
2019/03,158,11/03/2019,1,SS 64 tra Bologna e Lovoleto,11853,20,11190,661,9341,2512,11853,0
2019/03,158,12/03/2019,2,SS 64 tra Bologna e Lovoleto,12056,10,11302,753,9329,2727,12056,0
2019/03,158,13/03/2019,3,SS 64 tra Bologna e Lovoleto,11979,00,11229,750,9291,2688,11979,0
2019/03,158,14/03/2019,4,SS 64 tra Bologna e Lovoleto,12052,10,11338,713,9213,2839,12052,0
2019/03,160,01/03/2019,5,SP 18 tra Bargellino e Calderara di Reno (c/o Variante SP18),19038,00,17352,1686,14857,4181,19038,0
2019/03,160,02/03/2019,6,SP 18 tra Bargellino e Calderara di Reno (c/o Variante SP18),13305,00,12891,414,9668,3637,0,13305
2019/03,160,03/03/2019,7,SP 18 tra Bargellino e Calderara di Reno (c/o Variante SP18),9538,00,9472,66,6985,2553,0,9538
2019/03,160,04/03/2019,1,SP 18 tra Bargellino e Calderara di Reno (c/o Variante SP18),18035,00,16448,1587,14559,3476,18035,0
2019/03,160,05/03/2019,2,SP 18 tra Bargellino e Calderara di Reno (c/o Variante SP18),18744,40,16921,1819,14840,3904,18744,0
2019/03,160,06/03/2019,3,SP 18 tra Bargellino e Calderara di Reno (c/o Variante SP18),18622,10,16887,1734,14789,3833,18622,0
2019/03,160,07/03/2019,4,SP 18 tra Bargellino e Calderara di Reno (c/o Variante SP18),18684,10,16968,1715,14629,4055,18684,0
2019/03,160,08/03/2019,5,SP 18 tra Bargellino e Calderara di Reno (c/o Variante SP18),19778,00,17991,1787,15390,4388,19778,0
2019/03,160,09/03/2019,6,SP 18 tra Bargellino e Calderara di Reno (c/o Variante SP18),13017,00,12659,358,9497,3520,0,13017
2019/03,160,10/03/2019,7,SP 18 tra Bargellino e Calderara di Reno (c/o Variante SP18),9707,00,9628,79,7260,2447,0,9707
2019/03,160,11/03/2019,1,SP 18 tra Bargellino e Calderara di Reno (c/o Variante SP18),18268,10,16731,1536,14704,3564,18268,0
2019/03,160,12/03/2019,2,SP 18 tra Bargellino e Calderara di Reno (c/o Variante SP18),19104,00,17410,1694,15079,4025,19104,0
2019/03,160,13/03/2019,3,SP 18 tra Bargellino e Calderara di Reno (c/o Variante SP18),18665,20,16924,1739,14766,3899,18665,0
2019/03,160,14/03/2019,4,SP 18 tra Bargellino e Calderara di Reno (c/o Variante SP18),18932,10,17197,1734,14890,4042,18932,0
2019/03,161,01/03/2019,5,SP 568 da Tavernelle all'intersezione della SP3,20322,00,19254,1068,14898,5424,20322,0
2019/03,161,02/03/2019,6,SP 568 da Tavernelle all'intersezione della SP3,17099,00,16865,234,11831,5268,0,17099
2019/03,161,03/03/2019,7,SP 568 da Tavernelle all'intersezione della SP3,15498,00,15429,69,10862,4636,0,15498
2019/03,161,04/03/2019,1,SP 568 da Tavernelle all'intersezione della SP3,18675,00,17522,1153,14393,4282,18675,0
2019/03,161,05/03/2019,2,SP 568 da Tavernelle all'intersezione della SP3,19136,00,18025,1111,14600,4536,19136,0
2019/03,161,06/03/2019,3,SP 568 da Tavernelle all'intersezione della SP3,19322,00,18163,1159,14763,4559,19322,0
2019/03,161,07/03/2019,4,SP 568 da Tavernelle all'intersezione della SP3,19607,00,18516,1091,14660,4947,19607,0
2019/03,161,08/03/2019,5,SP 568 da Tavernelle all'intersezione della SP3,20864,00,19809,1055,15181,5683,20864,0
2019/03,161,09/03/2019,6,SP 568 da Tavernelle all'intersezione della SP3,17106,10,16854,251,11602,5504,0,17106
2019/03,161,10/03/2019,7,SP 568 da Tavernelle all'intersezione della SP3,14698,00,14637,61,10149,4549,0,14698
2019/03,161,11/03/2019,1,SP 568 da Tavernelle all'intersezione della SP3,18792,00,17707,1085,14451,4341,18792,0
2019/03,161,12/03/2019,2,SP 568 da Tavernelle all'intersezione della SP3,19065,10,17955,1109,14601,4464,19065,0
2019/03,161,13/03/2019,3,SP 568 da Tavernelle all'intersezione della SP3,19371,00,18269,1102,14723,4648,19371,0
2019/03,161,14/03/2019,4,SP 568 da Tavernelle all'intersezione della SP3,19451,20,18373,1076,14696,4755,19451,0
2019/03,162,01/03/2019,5,SS 9 località Cavazzona,18703,20,16932,1769,12854,5849,18703,0
2019/03,162,02/03/2019,6,SS 9 località Cavazzona,16357,00,15897,460,10602,5755,0,16357
2019/03,162,03/03/2019,7,SS 9 località Cavazzona,13992,10,13894,97,8980,5012,0,13992
2019/03,162,04/03/2019,1,SS 9 località Cavazzona,16967,00,15337,1630,12108,4859,16967,0
2019/03,162,05/03/2019,2,SS 9 località Cavazzona,17364,10,15624,1739,12340,5024,17364,0
2019/03,162,06/03/2019,3,SS 9 località Cavazzona,17878,20,16021,1855,12622,5256,17878,0
2019/03,162,07/03/2019,4,SS 9 località Cavazzona,18007,10,16243,1763,12498,5509,18007,0
2019/03,162,08/03/2019,5,SS 9 località Cavazzona,19572,20,17819,1751,13338,6234,19572,0
2019/03,162,09/03/2019,6,SS 9 località Cavazzona,16315,00,15916,399,10616,5699,0,16315
2019/03,162,10/03/2019,7,SS 9 località Cavazzona,14203,00,14043,160,8806,5397,0,14203
2019/03,162,11/03/2019,1,SS 9 località Cavazzona,17108,20,15428,1678,12319,4789,17108,0
2019/03,162,12/03/2019,2,SS 9 località Cavazzona,17629,20,15912,1715,12531,5098,17629,0
2019/03,162,13/03/2019,3,SS 9 località Cavazzona,17532,10,15755,1776,12373,5159,17532,0
2019/03,162,14/03/2019,4,SS 9 località Cavazzona,17944,00,16193,1751,12560,5384,17944,0
2019/03,170,01/03/2019,5,SS 67 tra Rovere e Forlì,10164,00,9611,553,7921,2243,10164,0
2019/03,170,02/03/2019,6,SS 67 tra Rovere e Forlì,8698,00,8522,176,6493,2205,0,8698
2019/03,170,03/03/2019,7,SS 67 tra Rovere e Forlì,7546,00,7495,51,5783,1763,0,7546
2019/03,170,04/03/2019,1,SS 67 tra Rovere e Forlì,9467,10,8997,469,7566,1901,9467,0
2019/03,170,05/03/2019,2,SS 67 tra Rovere e Forlì,9781,00,9231,550,7771,2010,9781,0
2019/03,170,06/03/2019,3,SS 67 tra Rovere e Forlì,9650,00,9186,464,7605,2045,9650,0
2019/03,170,07/03/2019,4,SS 67 tra Rovere e Forlì,9599,00,9126,473,7499,2100,9599,0
2019/03,170,08/03/2019,5,SS 67 tra Rovere e Forlì,10430,00,9930,500,8008,2422,10430,0
2019/03,170,09/03/2019,6,SS 67 tra Rovere e Forlì,9042,10,8866,175,6645,2397,0,9042
2019/03,170,10/03/2019,7,SS 67 tra Rovere e Forlì,7050,00,7011,39,5273,1777,0,7050
2019/03,170,11/03/2019,1,SS 67 tra Rovere e Forlì,9312,00,8821,491,7505,1807,9312,0
2019/03,170,12/03/2019,2,SS 67 tra Rovere e Forlì,9753,00,9186,567,7745,2008,9753,0
2019/03,170,13/03/2019,3,SS 67 tra Rovere e Forlì,9599,00,9138,461,7507,2092,9599,0
2019/03,170,14/03/2019,4,SS 67 tra Rovere e Forlì,9586,00,9112,474,7514,2072,9586,0
2019/03,171,01/03/2019,5,SP 56 tra Forlì e bivio SS67 (Castrocaro Terme),7644,00,7407,237,5943,1701,7644,0
2019/03,171,02/03/2019,6,SP 56 tra Forlì e bivio SS67 (Castrocaro Terme),7010,00,6946,64,5190,1820,0,7010
2019/03,171,03/03/2019,7,SP 56 tra Forlì e bivio SS67 (Castrocaro Terme),5707,00,5690,17,4403,1304,0,5707
2019/03,171,04/03/2019,1,SP 56 tra Forlì e bivio SS67 (Castrocaro Terme),7173,00,6973,200,5674,1499,7173,0
2019/03,171,05/03/2019,2,SP 56 tra Forlì e bivio SS67 (Castrocaro Terme),7227,00,7041,186,5699,1528,7227,0
2019/03,171,06/03/2019,3,SP 56 tra Forlì e bivio SS67 (Castrocaro Terme),7127,00,6926,201,5634,1493,7127,0
2019/03,171,07/03/2019,4,SP 56 tra Forlì e bivio SS67 (Castrocaro Terme),7240,00,6993,247,5715,1525,7240,0
2019/03,171,08/03/2019,5,SP 56 tra Forlì e bivio SS67 (Castrocaro Terme),8173,10,7952,220,6215,1958,8173,0
2019/03,171,09/03/2019,6,SP 56 tra Forlì e bivio SS67 (Castrocaro Terme),7094,10,7031,62,5258,1836,0,7094
2019/03,171,10/03/2019,7,SP 56 tra Forlì e bivio SS67 (Castrocaro Terme),6015,00,5997,18,4655,1360,0,6015
2019/03,171,11/03/2019,1,SP 56 tra Forlì e bivio SS67 (Castrocaro Terme),6913,00,6710,203,5519,1394,6913,0
2019/03,171,12/03/2019,2,SP 56 tra Forlì e bivio SS67 (Castrocaro Terme),7243,00,7034,209,5786,1457,7243,0
2019/03,171,13/03/2019,3,SP 56 tra Forlì e bivio SS67 (Castrocaro Terme),7305,10,7074,230,5734,1571,7305,0
2019/03,171,14/03/2019,4,SP 56 tra Forlì e bivio SS67 (Castrocaro Terme),7149,00,6915,234,5605,1544,7149,0
2019/03,173,01/03/2019,5,SP 4 tra Ronco (SS9) e bivio SP 72 (Para),8296,20,7859,435,6459,1837,8296,0
2019/03,173,02/03/2019,6,SP 4 tra Ronco (SS9) e bivio SP 72 (Para),6667,10,6496,170,4966,1701,0,6667
2019/03,173,03/03/2019,7,SP 4 tra Ronco (SS9) e bivio SP 72 (Para),4959,00,4917,42,3781,1178,0,4959
2019/03,173,04/03/2019,1,SP 4 tra Ronco (SS9) e bivio SP 72 (Para),8165,20,7691,472,6670,1495,8165,0
2019/03,173,05/03/2019,2,SP 4 tra Ronco (SS9) e bivio SP 72 (Para),8226,20,7740,484,6675,1551,8226,0
2019/03,173,06/03/2019,3,SP 4 tra Ronco (SS9) e bivio SP 72 (Para),8083,00,7619,464,6496,1587,8083,0
2019/03,173,07/03/2019,4,SP 4 tra Ronco (SS9) e bivio SP 72 (Para),8306,10,7804,501,6612,1694,8306,0
2019/03,173,08/03/2019,5,SP 4 tra Ronco (SS9) e bivio SP 72 (Para),8625,00,8122,503,6678,1947,8625,0
2019/03,173,09/03/2019,6,SP 4 tra Ronco (SS9) e bivio SP 72 (Para),6658,10,6491,166,4916,1742,0,6658
2019/03,173,10/03/2019,7,SP 4 tra Ronco (SS9) e bivio SP 72 (Para),4983,00,4931,52,3807,1176,0,4983
2019/03,173,11/03/2019,1,SP 4 tra Ronco (SS9) e bivio SP 72 (Para),8144,00,7679,465,6629,1515,8144,0
2019/03,173,12/03/2019,2,SP 4 tra Ronco (SS9) e bivio SP 72 (Para),8136,10,7689,446,6543,1593,8136,0
2019/03,173,13/03/2019,3,SP 4 tra Ronco (SS9) e bivio SP 72 (Para),8339,00,7845,494,6611,1728,8339,0
2019/03,173,14/03/2019,4,SP 4 tra Ronco (SS9) e bivio SP 72 (Para),8244,00,7795,449,6547,1697,8244,0
2019/03,174,01/03/2019,5,SS 9 tra Ronco e Forlimpopoli,,,,,,,,
2019/03,174,02/03/2019,6,SS 9 tra Ronco e Forlimpopoli,,,,,,,,
2019/03,174,03/03/2019,7,SS 9 tra Ronco e Forlimpopoli,,,,,,,,
2019/03,174,04/03/2019,1,SS 9 tra Ronco e Forlimpopoli,,,,,,,,
2019/03,174,05/03/2019,2,SS 9 tra Ronco e Forlimpopoli,,,,,,,,
2019/03,174,06/03/2019,3,SS 9 tra Ronco e Forlimpopoli,,,,,,,,
2019/03,174,07/03/2019,4,SS 9 tra Ronco e Forlimpopoli,,,,,,,,
2019/03,174,08/03/2019,5,SS 9 tra Ronco e Forlimpopoli,,,,,,,,
2019/03,174,09/03/2019,6,SS 9 tra Ronco e Forlimpopoli,,,,,,,,
2019/03,174,10/03/2019,7,SS 9 tra Ronco e Forlimpopoli,,,,,,,,
2019/03,174,11/03/2019,1,SS 9 tra Ronco e Forlimpopoli,,,,,,,,
2019/03,174,12/03/2019,2,SS 9 tra Ronco e Forlimpopoli,,,,,,,,
2019/03,174,13/03/2019,3,SS 9 tra Ronco e Forlimpopoli,,,,,,,,
2019/03,174,14/03/2019,4,SS 9 tra Ronco e Forlimpopoli,,,,,,,,
2019/03,176,01/03/2019,5,SP 2 in località La Caserma al Confine Provinciale,9000,00,8290,710,7010,1990,9000,0
2019/03,176,02/03/2019,6,SP 2 in località La Caserma al Confine Provinciale,9388,00,9203,185,6945,2443,0,9388
2019/03,176,03/03/2019,7,SP 2 in località La Caserma al Confine Provinciale,12851,00,12817,34,10557,2294,0,12851
2019/03,176,04/03/2019,1,SP 2 in località La Caserma al Confine Provinciale,8196,00,7486,710,6638,1558,8196,0
2019/03,176,05/03/2019,2,SP 2 in località La Caserma al Confine Provinciale,8273,00,7590,683,6707,1566,8273,0
2019/03,176,06/03/2019,3,SP 2 in località La Caserma al Confine Provinciale,8673,00,7975,698,7048,1625,8673,0
2019/03,176,07/03/2019,4,SP 2 in località La Caserma al Confine Provinciale,8889,10,8188,700,7078,1811,8889,0
2019/03,176,08/03/2019,5,SP 2 in località La Caserma al Confine Provinciale,9443,10,8747,695,7149,2294,9443,0
2019/03,176,09/03/2019,6,SP 2 in località La Caserma al Confine Provinciale,9483,00,9325,158,6742,2741,0,9483
2019/03,176,10/03/2019,7,SP 2 in località La Caserma al Confine Provinciale,10748,00,10711,37,8569,2179,0,10748
2019/03,176,11/03/2019,1,SP 2 in località La Caserma al Confine Provinciale,8203,00,7540,663,6722,1481,8203,0
2019/03,176,12/03/2019,2,SP 2 in località La Caserma al Confine Provinciale,8389,00,7693,696,6727,1662,8389,0
2019/03,176,13/03/2019,3,SP 2 in località La Caserma al Confine Provinciale,8583,00,7846,737,6905,1678,8583,0
2019/03,176,14/03/2019,4,SP 2 in località La Caserma al Confine Provinciale,8982,00,8237,745,7216,1766,8982,0
2019/03,177,01/03/2019,5,NSA 313 - Prosecuzione tangenziale di Bologna complanare sud alla A 14 nel tratto San Lazzaro/Idice,17192,10,16347,844,12894,4298,17192,0
2019/03,177,02/03/2019,6,NSA 313 - Prosecuzione tangenziale di Bologna complanare sud alla A 14 nel tratto San Lazzaro/Idice,13493,00,13291,202,9309,4184,0,13493
2019/03,177,03/03/2019,7,NSA 313 - Prosecuzione tangenziale di Bologna complanare sud alla A 14 nel tratto San Lazzaro/Idice,11484,00,11450,34,7624,3860,0,11484
2019/03,177,04/03/2019,1,NSA 313 - Prosecuzione tangenziale di Bologna complanare sud alla A 14 nel tratto San Lazzaro/Idice,16635,00,15748,887,12852,3783,16635,0
2019/03,177,05/03/2019,2,NSA 313 - Prosecuzione tangenziale di Bologna complanare sud alla A 14 nel tratto San Lazzaro/Idice,17120,00,16252,868,13114,4006,17120,0
2019/03,177,06/03/2019,3,NSA 313 - Prosecuzione tangenziale di Bologna complanare sud alla A 14 nel tratto San Lazzaro/Idice,16867,10,16046,820,12750,4117,16867,0
2019/03,177,09/03/2019,6,NSA 313 - Prosecuzione tangenziale di Bologna complanare sud alla A 14 nel tratto San Lazzaro/Idice,13429,10,13253,175,9207,4222,0,13429
2019/03,177,10/03/2019,7,NSA 313 - Prosecuzione tangenziale di Bologna complanare sud alla A 14 nel tratto San Lazzaro/Idice,11309,00,11271,38,7753,3556,0,11309
2019/03,177,11/03/2019,1,NSA 313 - Prosecuzione tangenziale di Bologna complanare sud alla A 14 nel tratto San Lazzaro/Idice,16360,00,15543,817,12653,3707,16360,0
2019/03,177,12/03/2019,2,NSA 313 - Prosecuzione tangenziale di Bologna complanare sud alla A 14 nel tratto San Lazzaro/Idice,17285,00,16338,947,13229,4056,17285,0
2019/03,177,13/03/2019,3,NSA 313 - Prosecuzione tangenziale di Bologna complanare sud alla A 14 nel tratto San Lazzaro/Idice,17957,20,17026,929,12916,5041,17957,0
2019/03,177,14/03/2019,4,NSA 313 - Prosecuzione tangenziale di Bologna complanare sud alla A 14 nel tratto San Lazzaro/Idice,17106,00,16267,839,12816,4290,17106,0
2019/03,182,01/03/2019,5,SP 258R tra Rimini e A 14,17589,00,16925,664,13182,4407,17589,0
2019/03,182,02/03/2019,6,SP 258R tra Rimini e A 14,16165,20,15925,238,11486,4679,0,16165
2019/03,182,03/03/2019,7,SP 258R tra Rimini e A 14,14237,20,14188,47,10409,3828,0,14237
2019/03,182,04/03/2019,1,SP 258R tra Rimini e A 14,16716,20,16057,657,13086,3630,16716,0
2019/03,182,05/03/2019,2,SP 258R tra Rimini e A 14,16871,20,16196,673,13153,3718,16871,0
2019/03,182,06/03/2019,3,SP 258R tra Rimini e A 14,17174,20,16446,726,13389,3785,17174,0
2019/03,182,07/03/2019,4,SP 258R tra Rimini e A 14,17204,00,16528,676,13365,3839,17204,0
2019/03,182,08/03/2019,5,SP 258R tra Rimini e A 14,18241,00,17525,716,13633,4608,18241,0
2019/03,182,09/03/2019,6,SP 258R tra Rimini e A 14,16353,00,16105,248,11390,4963,0,16353
2019/03,182,10/03/2019,7,SP 258R tra Rimini e A 14,13901,00,13832,69,10083,3818,0,13901
2019/03,182,11/03/2019,1,SP 258R tra Rimini e A 14,16579,00,15847,732,12988,3591,16579,0
2019/03,182,12/03/2019,2,SP 258R tra Rimini e A 14,17071,20,16365,704,13173,3898,17071,0
2019/03,182,13/03/2019,3,SP 258R tra Rimini e A 14,17019,20,16337,680,13157,3862,17019,0
2019/03,182,14/03/2019,4,SP 258R tra Rimini e A 14,17478,00,16768,710,13423,4055,17478,0
2019/03,186,01/03/2019,5,SS 16 tra Rimini e Igea Marina-Viserba,28996,00,27658,1338,22090,6906,28996,0
2019/03,186,02/03/2019,6,SS 16 tra Rimini e Igea Marina-Viserba,27236,10,26805,430,19514,7722,0,27236
2019/03,186,03/03/2019,7,SS 16 tra Rimini e Igea Marina-Viserba,25049,50,24887,157,18290,6759,0,25049
2019/03,186,04/03/2019,1,SS 16 tra Rimini e Igea Marina-Viserba,27972,10,26579,1392,21992,5980,27972,0
2019/03,186,05/03/2019,2,SS 16 tra Rimini e Igea Marina-Viserba,27989,00,26594,1395,21912,6077,27989,0
2019/03,186,06/03/2019,3,SS 16 tra Rimini e Igea Marina-Viserba,28489,10,27086,1402,22356,6133,28489,0
2019/03,186,07/03/2019,4,SS 16 tra Rimini e Igea Marina-Viserba,28539,00,27096,1443,21965,6574,28539,0
2019/03,186,08/03/2019,5,SS 16 tra Rimini e Igea Marina-Viserba,30159,00,28743,1416,22645,7514,30159,0
2019/03,186,09/03/2019,6,SS 16 tra Rimini e Igea Marina-Viserba,27987,10,27526,460,19868,8119,0,27987
2019/03,186,10/03/2019,7,SS 16 tra Rimini e Igea Marina-Viserba,25831,10,25670,160,18951,6880,0,25831
2019/03,186,11/03/2019,1,SS 16 tra Rimini e Igea Marina-Viserba,27854,10,26457,1396,21874,5980,27854,0
2019/03,186,12/03/2019,2,SS 16 tra Rimini e Igea Marina-Viserba,28690,20,27246,1442,22426,6264,28690,0
2019/03,186,13/03/2019,3,SS 16 tra Rimini e Igea Marina-Viserba,28880,40,27488,1388,22535,6345,28880,0
2019/03,186,14/03/2019,4,SS 16 tra Rimini e Igea Marina-Viserba,29653,00,28281,1372,23078,6575,29653,0
2019/03,188,01/03/2019,5,SS 9 tra Rimini e Santa Giustina,29223,30,28057,1163,22193,7030,29223,0
2019/03,188,02/03/2019,6,SS 9 tra Rimini e Santa Giustina,24791,10,24281,509,17643,7148,0,24791
2019/03,188,03/03/2019,7,SS 9 tra Rimini e Santa Giustina,20393,00,20244,149,14500,5893,0,20393
2019/03,188,04/03/2019,1,SS 9 tra Rimini e Santa Giustina,27564,10,26436,1127,21644,5920,27564,0
2019/03,188,05/03/2019,2,SS 9 tra Rimini e Santa Giustina,28097,30,26987,1107,22014,6083,28097,0
2019/03,188,06/03/2019,3,SS 9 tra Rimini e Santa Giustina,27854,10,26617,1236,21651,6203,27854,0
2019/03,188,07/03/2019,4,SS 9 tra Rimini e Santa Giustina,28221,20,27111,1108,21706,6515,28221,0
2019/03,188,08/03/2019,5,SS 9 tra Rimini e Santa Giustina,29516,20,28377,1137,22336,7180,29516,0
2019/03,188,09/03/2019,6,SS 9 tra Rimini e Santa Giustina,24051,00,23541,510,16988,7063,0,24051
2019/03,188,10/03/2019,7,SS 9 tra Rimini e Santa Giustina,19142,00,18998,144,13503,5639,0,19142
2019/03,188,11/03/2019,1,SS 9 tra Rimini e Santa Giustina,27533,00,26404,1129,21750,5783,27533,0
2019/03,188,12/03/2019,2,SS 9 tra Rimini e Santa Giustina,28118,00,26958,1160,21884,6234,28118,0
2019/03,188,13/03/2019,3,SS 9 tra Rimini e Santa Giustina,28654,00,27534,1120,22123,6531,28654,0
2019/03,188,14/03/2019,4,SS 9 tra Rimini e Santa Giustina,29100,10,27912,1187,22506,6594,29100,0
2019/03,215,01/03/2019,5,SP 3_1 tra accesso interporto Bologna e viadotto A 13,31516,10,24579,6936,23778,7738,31516,0
2019/03,215,02/03/2019,6,SP 3_1 tra accesso interporto Bologna e viadotto A 13,15676,10,13971,1704,10668,5008,0,15676
2019/03,215,03/03/2019,7,SP 3_1 tra accesso interporto Bologna e viadotto A 13,12905,00,12740,165,9506,3399,0,12905
2019/03,215,04/03/2019,1,SP 3_1 tra accesso interporto Bologna e viadotto A 13,30107,50,23862,6240,23830,6277,30107,0
2019/03,215,05/03/2019,2,SP 3_1 tra accesso interporto Bologna e viadotto A 13,31682,60,24045,7631,24127,7555,31682,0
2019/03,215,06/03/2019,3,SP 3_1 tra accesso interporto Bologna e viadotto A 13,31913,30,24422,7488,24082,7831,31913,0
2019/03,215,07/03/2019,4,SP 3_1 tra accesso interporto Bologna e viadotto A 13,31477,50,24006,7466,23663,7814,31477,0
2019/03,215,08/03/2019,5,SP 3_1 tra accesso interporto Bologna e viadotto A 13,31709,50,24952,6752,24249,7460,31709,0
2019/03,215,09/03/2019,6,SP 3_1 tra accesso interporto Bologna e viadotto A 13,15749,10,14627,1121,11087,4662,0,15749
2019/03,215,10/03/2019,7,SP 3_1 tra accesso interporto Bologna e viadotto A 13,12425,00,12058,367,8981,3444,0,12425
2019/03,215,11/03/2019,1,SP 3_1 tra accesso interporto Bologna e viadotto A 13,28052,100,21605,6437,21418,6634,28052,0
2019/03,215,12/03/2019,2,SP 3_1 tra accesso interporto Bologna e viadotto A 13,29230,30,22084,7143,21583,7647,29230,0
2019/03,215,13/03/2019,3,SP 3_1 tra accesso interporto Bologna e viadotto A 13,29163,50,22188,6970,21404,7759,29163,0
2019/03,215,14/03/2019,4,SP 3_1 tra accesso interporto Bologna e viadotto A 13,29764,50,22442,7317,21745,8019,29764,0
2019/03,218,01/03/2019,5,SP 10 tra Polesine e Roccabianca su variante Zibello,2507,10,2117,389,1946,561,2507,0
2019/03,218,02/03/2019,6,SP 10 tra Polesine e Roccabianca su variante Zibello,1983,00,1851,132,1482,501,0,1983
2019/03,218,03/03/2019,7,SP 10 tra Polesine e Roccabianca su variante Zibello,1732,00,1696,36,1337,395,0,1732
2019/03,218,04/03/2019,1,SP 10 tra Polesine e Roccabianca su variante Zibello,2409,00,2039,370,1958,451,2409,0
2019/03,218,05/03/2019,2,SP 10 tra Polesine e Roccabianca su variante Zibello,2535,00,2141,394,2009,526,2535,0
2019/03,218,06/03/2019,3,SP 10 tra Polesine e Roccabianca su variante Zibello,2487,00,2078,409,1993,494,2487,0
2019/03,218,07/03/2019,4,SP 10 tra Polesine e Roccabianca su variante Zibello,2508,00,2111,397,1961,547,2508,0
2019/03,218,08/03/2019,5,SP 10 tra Polesine e Roccabianca su variante Zibello,2636,00,2215,421,2026,610,2636,0
2019/03,218,09/03/2019,6,SP 10 tra Polesine e Roccabianca su variante Zibello,2084,10,1967,116,1501,583,0,2084
2019/03,218,10/03/2019,7,SP 10 tra Polesine e Roccabianca su variante Zibello,1851,00,1823,28,1457,394,0,1851
2019/03,218,11/03/2019,1,SP 10 tra Polesine e Roccabianca su variante Zibello,2401,00,2009,392,1949,452,2401,0
2019/03,218,12/03/2019,2,SP 10 tra Polesine e Roccabianca su variante Zibello,2551,00,2185,366,2033,518,2551,0
2019/03,218,13/03/2019,3,SP 10 tra Polesine e Roccabianca su variante Zibello,2503,00,2083,420,1977,526,2503,0
2019/03,218,14/03/2019,4,SP 10 tra Polesine e Roccabianca su variante Zibello,2544,00,2156,388,1989,555,2544,0
2019/03,219,01/03/2019,5,SS 9 tra Fiorenzuola d'Arda e Pontenure,17795,130,16287,1495,13826,3969,17795,0
2019/03,219,02/03/2019,6,SS 9 tra Fiorenzuola d'Arda e Pontenure,16104,70,15571,526,12054,4050,0,16104
2019/03,219,03/03/2019,7,SS 9 tra Fiorenzuola d'Arda e Pontenure,12634,20,12539,93,9227,3407,0,12634
2019/03,219,04/03/2019,1,SS 9 tra Fiorenzuola d'Arda e Pontenure,16588,80,15159,1421,13334,3254,16588,0
2019/03,219,05/03/2019,2,SS 9 tra Fiorenzuola d'Arda e Pontenure,16824,160,15334,1474,13457,3367,16824,0
2019/03,219,06/03/2019,3,SS 9 tra Fiorenzuola d'Arda e Pontenure,15741,70,14433,1301,13413,2328,15741,0
2019/03,220,01/03/2019,5,SS 9 tra Fiorenzuola d'Arda e Fidenza al confine provinciale,14616,940,12844,1678,11326,3290,14616,0
2019/03,220,02/03/2019,6,SS 9 tra Fiorenzuola d'Arda e Fidenza al confine provinciale,,,,,,,,
2019/03,220,03/03/2019,7,SS 9 tra Fiorenzuola d'Arda e Fidenza al confine provinciale,,,,,,,,
2019/03,220,04/03/2019,1,SS 9 tra Fiorenzuola d'Arda e Fidenza al confine provinciale,13607,00,11901,1706,10856,2751,13607,0
2019/03,220,05/03/2019,2,SS 9 tra Fiorenzuola d'Arda e Fidenza al confine provinciale,13947,00,12197,1750,11007,2940,13947,0
2019/03,220,06/03/2019,3,SS 9 tra Fiorenzuola d'Arda e Fidenza al confine provinciale,14158,00,12467,1691,11151,3007,14158,0
2019/03,220,07/03/2019,4,SS 9 tra Fiorenzuola d'Arda e Fidenza al confine provinciale,14438,00,12713,1725,11291,3147,14438,0
2019/03,220,08/03/2019,5,SS 9 tra Fiorenzuola d'Arda e Fidenza al confine provinciale,15033,6000,12753,1680,11482,3551,15033,0
2019/03,220,09/03/2019,6,SS 9 tra Fiorenzuola d'Arda e Fidenza al confine provinciale,,,,,,,,
2019/03,220,10/03/2019,7,SS 9 tra Fiorenzuola d'Arda e Fidenza al confine provinciale,,,,,,,,
2019/03,220,11/03/2019,1,SS 9 tra Fiorenzuola d'Arda e Fidenza al confine provinciale,,,,,,,,
2019/03,220,12/03/2019,2,SS 9 tra Fiorenzuola d'Arda e Fidenza al confine provinciale,,,,,,,,
2019/03,220,13/03/2019,3,SS 9 tra Fiorenzuola d'Arda e Fidenza al confine provinciale,14069,00,12310,1759,10964,3105,14069,0
2019/03,220,14/03/2019,4,SS 9 tra Fiorenzuola d'Arda e Fidenza al confine provinciale,14224,00,12509,1715,11283,2941,14224,0
2019/03,221,01/03/2019,5,SS 9 tra Fidenza e A 15,25787,10,22833,2953,19536,6251,25787,0
2019/03,221,02/03/2019,6,SS 9 tra Fidenza e A 15,21052,10,20341,710,15305,5747,0,21052
2019/03,221,03/03/2019,7,SS 9 tra Fidenza e A 15,17617,00,17456,161,12865,4752,0,17617
2019/03,221,04/03/2019,1,SS 9 tra Fidenza e A 15,24543,20,21669,2872,19201,5342,24543,0
2019/03,221,05/03/2019,2,SS 9 tra Fidenza e A 15,25213,00,22214,2999,19503,5710,25213,0
2019/03,221,06/03/2019,3,SS 9 tra Fidenza e A 15,24977,00,22012,2965,19163,5814,24977,0
2019/03,221,07/03/2019,4,SS 9 tra Fidenza e A 15,25397,00,22257,3140,19461,5936,25397,0
2019/03,221,08/03/2019,5,SS 9 tra Fidenza e A 15,26576,10,23553,3022,20017,6559,26576,0
2019/03,221,09/03/2019,6,SS 9 tra Fidenza e A 15,21830,10,21092,737,15438,6392,0,21830
2019/03,222,01/03/2019,5,SP 359R tra Fidenza e Salsomaggiore Terme,17150,70,16681,462,12794,4356,17150,0
2019/03,222,02/03/2019,6,SP 359R tra Fidenza e Salsomaggiore Terme,15606,00,15373,233,10967,4639,0,15606
2019/03,222,03/03/2019,7,SP 359R tra Fidenza e Salsomaggiore Terme,12125,20,12075,48,8504,3621,0,12125
2019/03,222,04/03/2019,1,SP 359R tra Fidenza e Salsomaggiore Terme,16071,70,15639,425,12489,3582,16071,0
2019/03,222,05/03/2019,2,SP 359R tra Fidenza e Salsomaggiore Terme,16438,100,15985,443,12704,3734,16438,0
2019/03,222,06/03/2019,3,SP 359R tra Fidenza e Salsomaggiore Terme,16262,110,15790,461,12381,3881,16262,0
2019/03,222,07/03/2019,4,SP 359R tra Fidenza e Salsomaggiore Terme,16438,50,15975,458,12487,3951,16438,0
2019/03,222,08/03/2019,5,SP 359R tra Fidenza e Salsomaggiore Terme,17613,80,17148,457,12992,4621,17613,0
2019/03,222,09/03/2019,6,SP 359R tra Fidenza e Salsomaggiore Terme,16421,50,16181,235,11324,5097,0,16421
2019/03,222,10/03/2019,7,SP 359R tra Fidenza e Salsomaggiore Terme,12297,00,12243,54,8577,3720,0,12297
2019/03,222,11/03/2019,1,SP 359R tra Fidenza e Salsomaggiore Terme,15863,120,15444,407,12386,3477,15863,0
2019/03,222,12/03/2019,2,SP 359R tra Fidenza e Salsomaggiore Terme,16412,80,15907,497,12634,3778,16412,0
2019/03,222,13/03/2019,3,SP 359R tra Fidenza e Salsomaggiore Terme,16312,100,15878,424,12464,3848,16312,0
2019/03,222,14/03/2019,4,SP 359R tra Fidenza e Salsomaggiore Terme,16890,100,16449,431,12917,3973,16890,0
2019/03,223,01/03/2019,5,SP 357R tra SS 9 e Noceto,10969,00,9696,1273,8541,2428,10969,0
2019/03,223,02/03/2019,6,SP 357R tra SS 9 e Noceto,8820,00,8509,311,6442,2378,0,8820
2019/03,223,03/03/2019,7,SP 357R tra SS 9 e Noceto,6867,00,6772,95,5020,1847,0,6867
2019/03,223,04/03/2019,1,SP 357R tra SS 9 e Noceto,10476,10,9261,1214,8334,2142,10476,0
2019/03,223,05/03/2019,2,SP 357R tra SS 9 e Noceto,10747,00,9474,1273,8347,2400,10747,0
2019/03,223,06/03/2019,3,SP 357R tra SS 9 e Noceto,10859,00,9511,1348,8529,2330,10859,0
2019/03,223,07/03/2019,4,SP 357R tra SS 9 e Noceto,10879,00,9583,1296,8551,2328,10879,0
2019/03,223,08/03/2019,5,SP 357R tra SS 9 e Noceto,11210,00,9966,1244,8565,2645,11210,0
2019/03,223,09/03/2019,6,SP 357R tra SS 9 e Noceto,9018,00,8705,313,6508,2510,0,9018
2019/03,223,10/03/2019,7,SP 357R tra SS 9 e Noceto,6932,00,6845,87,5091,1841,0,6932
2019/03,223,11/03/2019,1,SP 357R tra SS 9 e Noceto,10504,10,9235,1268,8360,2144,10504,0
2019/03,223,12/03/2019,2,SP 357R tra SS 9 e Noceto,11302,00,9972,1330,8984,2318,11302,0
2019/03,223,13/03/2019,3,SP 357R tra SS 9 e Noceto,11001,00,9703,1298,8604,2397,11001,0
2019/03,223,14/03/2019,4,SP 357R tra SS 9 e Noceto,10864,00,9576,1288,8525,2339,10864,0
2019/03,226,04/03/2019,1,SP 32 dal bivio SP 16 (per Langhirano) al bivio SP 665R,6097,00,5710,387,4803,1294,6097,0
2019/03,226,05/03/2019,2,SP 32 dal bivio SP 16 (per Langhirano) al bivio SP 665R,11680,00,10889,791,9333,2347,11680,0
2019/03,226,06/03/2019,3,SP 32 dal bivio SP 16 (per Langhirano) al bivio SP 665R,11887,10,11057,829,9540,2347,11887,0
2019/03,226,07/03/2019,4,SP 32 dal bivio SP 16 (per Langhirano) al bivio SP 665R,11856,10,10987,868,9388,2468,11856,0
2019/03,226,08/03/2019,5,SP 32 dal bivio SP 16 (per Langhirano) al bivio SP 665R,12158,00,11358,800,9392,2766,12158,0
2019/03,226,09/03/2019,6,SP 32 dal bivio SP 16 (per Langhirano) al bivio SP 665R,9711,00,9437,274,7198,2513,0,9711
2019/03,226,10/03/2019,7,SP 32 dal bivio SP 16 (per Langhirano) al bivio SP 665R,8277,00,8181,96,6418,1859,0,8277
2019/03,226,11/03/2019,1,SP 32 dal bivio SP 16 (per Langhirano) al bivio SP 665R,11304,10,10495,808,9171,2133,11304,0
2019/03,226,12/03/2019,2,SP 32 dal bivio SP 16 (per Langhirano) al bivio SP 665R,11893,00,11058,835,9531,2362,11893,0
2019/03,226,13/03/2019,3,SP 32 dal bivio SP 16 (per Langhirano) al bivio SP 665R,11759,10,10911,847,9315,2444,11759,0
2019/03,226,14/03/2019,4,SP 32 dal bivio SP 16 (per Langhirano) al bivio SP 665R,12132,00,11198,934,9719,2413,12132,0
2019/03,227,01/03/2019,5,SP 34 da Colorno al bivio SP 60 (al confine provinciale),6274,00,6075,199,4961,1313,6274,0
2019/03,227,02/03/2019,6,SP 34 da Colorno al bivio SP 60 (al confine provinciale),5288,00,5198,90,4115,1173,0,5288
2019/03,227,03/03/2019,7,SP 34 da Colorno al bivio SP 60 (al confine provinciale),3756,00,3734,22,2838,918,0,3756
2019/03,227,04/03/2019,1,SP 34 da Colorno al bivio SP 60 (al confine provinciale),5756,00,5539,217,4629,1127,5756,0
2019/03,227,05/03/2019,2,SP 34 da Colorno al bivio SP 60 (al confine provinciale),6193,00,5949,244,4968,1225,6193,0
2019/03,227,06/03/2019,3,SP 34 da Colorno al bivio SP 60 (al confine provinciale),6025,10,5794,230,4689,1336,6025,0
2019/03,227,07/03/2019,4,SP 34 da Colorno al bivio SP 60 (al confine provinciale),6048,00,5841,207,4769,1279,6048,0
2019/03,227,08/03/2019,5,SP 34 da Colorno al bivio SP 60 (al confine provinciale),6497,30,6302,192,5053,1444,6497,0
2019/03,227,09/03/2019,6,SP 34 da Colorno al bivio SP 60 (al confine provinciale),5191,00,5098,93,3970,1221,0,5191
2019/03,227,10/03/2019,7,SP 34 da Colorno al bivio SP 60 (al confine provinciale),3952,00,3935,17,3019,933,0,3952
2019/03,227,11/03/2019,1,SP 34 da Colorno al bivio SP 60 (al confine provinciale),5993,00,5782,211,4944,1049,5993,0
2019/03,227,12/03/2019,2,SP 34 da Colorno al bivio SP 60 (al confine provinciale),6151,00,5918,233,4935,1216,6151,0
2019/03,227,13/03/2019,3,SP 34 da Colorno al bivio SP 60 (al confine provinciale),6190,00,5957,233,4884,1306,6190,0
2019/03,227,14/03/2019,4,SP 34 da Colorno al bivio SP 60 (al confine provinciale),6166,00,5922,244,4903,1263,6166,0
2019/03,228,01/03/2019,5,SP 62R tra Brescello (bivio SP 41) e Sorbolo (bivio SP 20),12120,20,10206,1912,9426,2694,12120,0
2019/03,228,02/03/2019,6,SP 62R tra Brescello (bivio SP 41) e Sorbolo (bivio SP 20),9803,20,9431,370,7231,2572,0,9803
2019/03,228,03/03/2019,7,SP 62R tra Brescello (bivio SP 41) e Sorbolo (bivio SP 20),9855,30,9757,95,7045,2810,0,9855
2019/03,228,04/03/2019,1,SP 62R tra Brescello (bivio SP 41) e Sorbolo (bivio SP 20),11254,10,9297,1956,9008,2246,11254,0
2019/03,228,05/03/2019,2,SP 62R tra Brescello (bivio SP 41) e Sorbolo (bivio SP 20),11423,20,9337,2084,9091,2332,11423,0
2019/03,228,06/03/2019,3,SP 62R tra Brescello (bivio SP 41) e Sorbolo (bivio SP 20),11459,30,9415,2041,9119,2340,11459,0
2019/03,228,07/03/2019,4,SP 62R tra Brescello (bivio SP 41) e Sorbolo (bivio SP 20),11865,40,9737,2124,9409,2456,11865,0
2019/03,228,08/03/2019,5,SP 62R tra Brescello (bivio SP 41) e Sorbolo (bivio SP 20),12149,00,10203,1946,9354,2795,12149,0
2019/03,228,09/03/2019,6,SP 62R tra Brescello (bivio SP 41) e Sorbolo (bivio SP 20),10252,10,9861,390,7502,2750,0,10252
2019/03,228,10/03/2019,7,SP 62R tra Brescello (bivio SP 41) e Sorbolo (bivio SP 20),9671,00,9555,116,6753,2918,0,9671
2019/03,228,11/03/2019,1,SP 62R tra Brescello (bivio SP 41) e Sorbolo (bivio SP 20),11251,30,9204,2044,9031,2220,11251,0
2019/03,228,12/03/2019,2,SP 62R tra Brescello (bivio SP 41) e Sorbolo (bivio SP 20),11338,10,9246,2091,9067,2271,11338,0
2019/03,228,13/03/2019,3,SP 62R tra Brescello (bivio SP 41) e Sorbolo (bivio SP 20),11067,10,9104,1962,8689,2378,11067,0
2019/03,228,14/03/2019,4,SP 62R tra Brescello (bivio SP 41) e Sorbolo (bivio SP 20),11817,10,9770,2046,9458,2359,11817,0
2019/03,229,01/03/2019,5,SP 111 tra bivio SP 1 (a nord di Poviglio) e Boretto (innesto variante),,,,,,,,
2019/03,229,02/03/2019,6,SP 111 tra bivio SP 1 (a nord di Poviglio) e Boretto (innesto variante),,,,,,,,
2019/03,229,03/03/2019,7,SP 111 tra bivio SP 1 (a nord di Poviglio) e Boretto (innesto variante),,,,,,,,
2019/03,229,04/03/2019,1,SP 111 tra bivio SP 1 (a nord di Poviglio) e Boretto (innesto variante),,,,,,,,
2019/03,229,05/03/2019,2,SP 111 tra bivio SP 1 (a nord di Poviglio) e Boretto (innesto variante),,,,,,,,
2019/03,229,06/03/2019,3,SP 111 tra bivio SP 1 (a nord di Poviglio) e Boretto (innesto variante),,,,,,,,
2019/03,229,07/03/2019,4,SP 111 tra bivio SP 1 (a nord di Poviglio) e Boretto (innesto variante),,,,,,,,
2019/03,229,08/03/2019,5,SP 111 tra bivio SP 1 (a nord di Poviglio) e Boretto (innesto variante),,,,,,,,
2019/03,229,09/03/2019,6,SP 111 tra bivio SP 1 (a nord di Poviglio) e Boretto (innesto variante),,,,,,,,
2019/03,229,10/03/2019,7,SP 111 tra bivio SP 1 (a nord di Poviglio) e Boretto (innesto variante),,,,,,,,
2019/03,229,11/03/2019,1,SP 111 tra bivio SP 1 (a nord di Poviglio) e Boretto (innesto variante),,,,,,,,
2019/03,229,12/03/2019,2,SP 111 tra bivio SP 1 (a nord di Poviglio) e Boretto (innesto variante),,,,,,,,
2019/03,229,13/03/2019,3,SP 111 tra bivio SP 1 (a nord di Poviglio) e Boretto (innesto variante),,,,,,,,
2019/03,229,14/03/2019,4,SP 111 tra bivio SP 1 (a nord di Poviglio) e Boretto (innesto variante),,,,,,,,
2019/03,230,01/03/2019,5,SP 62RVar Cispadana da Boretto (bivio Variante SP 358R) a Gualtieri (bivio SP 63R),12232,00,9689,2543,9533,2699,12232,0
2019/03,230,02/03/2019,6,SP 62RVar Cispadana da Boretto (bivio Variante SP 358R) a Gualtieri (bivio SP 63R),8662,00,8239,423,6353,2309,0,8662
2019/03,230,03/03/2019,7,SP 62RVar Cispadana da Boretto (bivio Variante SP 358R) a Gualtieri (bivio SP 63R),8950,00,8814,136,6414,2536,0,8950
2019/03,230,04/03/2019,1,SP 62RVar Cispadana da Boretto (bivio Variante SP 358R) a Gualtieri (bivio SP 63R),11291,00,8624,2667,9094,2197,11291,0
2019/03,230,05/03/2019,2,SP 62RVar Cispadana da Boretto (bivio Variante SP 358R) a Gualtieri (bivio SP 63R),11673,00,8810,2863,9345,2328,11673,0
2019/03,230,06/03/2019,3,SP 62RVar Cispadana da Boretto (bivio Variante SP 358R) a Gualtieri (bivio SP 63R),11598,00,8784,2814,9329,2269,11598,0
2019/03,230,07/03/2019,4,SP 62RVar Cispadana da Boretto (bivio Variante SP 358R) a Gualtieri (bivio SP 63R),11665,00,8941,2724,9304,2361,11665,0
2019/03,230,08/03/2019,5,SP 62RVar Cispadana da Boretto (bivio Variante SP 358R) a Gualtieri (bivio SP 63R),12129,00,9515,2614,9426,2703,12129,0
2019/03,230,09/03/2019,6,SP 62RVar Cispadana da Boretto (bivio Variante SP 358R) a Gualtieri (bivio SP 63R),8958,00,8544,414,6494,2464,0,8958
2019/03,230,10/03/2019,7,SP 62RVar Cispadana da Boretto (bivio Variante SP 358R) a Gualtieri (bivio SP 63R),8961,00,8808,153,6412,2549,0,8961
2019/03,230,11/03/2019,1,SP 62RVar Cispadana da Boretto (bivio Variante SP 358R) a Gualtieri (bivio SP 63R),11208,00,8591,2617,8924,2284,11208,0
2019/03,230,12/03/2019,2,SP 62RVar Cispadana da Boretto (bivio Variante SP 358R) a Gualtieri (bivio SP 63R),11620,10,8755,2864,9319,2301,11620,0
2019/03,230,13/03/2019,3,SP 62RVar Cispadana da Boretto (bivio Variante SP 358R) a Gualtieri (bivio SP 63R),11302,00,8589,2713,8926,2376,11302,0
2019/03,230,14/03/2019,4,SP 62RVar Cispadana da Boretto (bivio Variante SP 358R) a Gualtieri (bivio SP 63R),11561,00,8827,2734,9178,2383,11561,0
2019/03,231,01/03/2019,5,SP 63R tra la località Santa Vittoria (c/o bivio SP 81) e la Cispadana,7396,70,6876,513,5876,1520,7396,0
2019/03,231,02/03/2019,6,SP 63R tra la località Santa Vittoria (c/o bivio SP 81) e la Cispadana,6410,10,6273,136,4810,1600,0,6410
2019/03,231,03/03/2019,7,SP 63R tra la località Santa Vittoria (c/o bivio SP 81) e la Cispadana,5381,00,5361,20,4065,1316,0,5381
2019/03,231,04/03/2019,1,SP 63R tra la località Santa Vittoria (c/o bivio SP 81) e la Cispadana,6856,10,6389,466,5620,1236,6856,0
2019/03,231,05/03/2019,2,SP 63R tra la località Santa Vittoria (c/o bivio SP 81) e la Cispadana,7081,20,6567,512,5820,1261,7081,0
2019/03,231,06/03/2019,3,SP 63R tra la località Santa Vittoria (c/o bivio SP 81) e la Cispadana,7175,00,6689,486,5789,1386,7175,0
2019/03,231,07/03/2019,4,SP 63R tra la località Santa Vittoria (c/o bivio SP 81) e la Cispadana,7215,40,6718,493,5846,1369,7215,0
2019/03,231,08/03/2019,5,SP 63R tra la località Santa Vittoria (c/o bivio SP 81) e la Cispadana,7668,40,7169,495,6129,1539,7668,0
2019/03,231,09/03/2019,6,SP 63R tra la località Santa Vittoria (c/o bivio SP 81) e la Cispadana,6615,50,6465,145,5027,1588,0,6615
2019/03,231,10/03/2019,7,SP 63R tra la località Santa Vittoria (c/o bivio SP 81) e la Cispadana,5418,00,5395,23,4093,1325,0,5418
2019/03,231,11/03/2019,1,SP 63R tra la località Santa Vittoria (c/o bivio SP 81) e la Cispadana,7014,60,6540,468,5791,1223,7014,0
2019/03,231,12/03/2019,2,SP 63R tra la località Santa Vittoria (c/o bivio SP 81) e la Cispadana,7221,00,6684,537,5878,1343,7221,0
2019/03,231,13/03/2019,3,SP 63R tra la località Santa Vittoria (c/o bivio SP 81) e la Cispadana,7200,00,6709,491,5824,1376,7200,0
2019/03,231,14/03/2019,4,SP 63R tra la località Santa Vittoria (c/o bivio SP 81) e la Cispadana,7214,00,6684,530,5864,1350,7214,0
2019/03,236,01/03/2019,5,SP 468 tra Casumaro e Reno Centese,5670,00,5060,610,4462,1208,5670,0
2019/03,236,02/03/2019,6,SP 468 tra Casumaro e Reno Centese,4999,00,4874,125,3754,1245,0,4999
2019/03,236,03/03/2019,7,SP 468 tra Casumaro e Reno Centese,4493,10,4463,29,3346,1147,0,4493
2019/03,236,04/03/2019,1,SP 468 tra Casumaro e Reno Centese,5464,10,4831,632,4403,1061,5464,0
2019/03,236,05/03/2019,2,SP 468 tra Casumaro e Reno Centese,5464,00,4812,652,4434,1030,5464,0
2019/03,236,06/03/2019,3,SP 468 tra Casumaro e Reno Centese,5945,00,5270,675,4757,1188,5945,0
2019/03,236,07/03/2019,4,SP 468 tra Casumaro e Reno Centese,5712,00,5081,631,4519,1193,5712,0
2019/03,236,08/03/2019,5,SP 468 tra Casumaro e Reno Centese,6137,00,5453,684,4749,1388,6137,0
2019/03,236,09/03/2019,6,SP 468 tra Casumaro e Reno Centese,5019,00,4869,150,3740,1279,0,5019
2019/03,236,10/03/2019,7,SP 468 tra Casumaro e Reno Centese,4213,00,4178,35,3126,1087,0,4213
2019/03,236,11/03/2019,1,SP 468 tra Casumaro e Reno Centese,5504,00,4902,602,4375,1129,5504,0
2019/03,236,12/03/2019,2,SP 468 tra Casumaro e Reno Centese,5413,00,4806,607,4331,1082,5413,0
2019/03,236,13/03/2019,3,SP 468 tra Casumaro e Reno Centese,5589,00,4902,687,4521,1068,5589,0
2019/03,236,14/03/2019,4,SP 468 tra Casumaro e Reno Centese,5532,00,4914,618,4407,1125,5532,0
2019/03,237,01/03/2019,5,SP 23 tra Quattro Castella e la Variante di Montecavolo (c/o bivio SP 21),15713,10,14910,802,12233,3480,15713,0
2019/03,237,02/03/2019,6,SP 23 tra Quattro Castella e la Variante di Montecavolo (c/o bivio SP 21),13805,10,13630,174,10318,3487,0,13805
2019/03,237,03/03/2019,7,SP 23 tra Quattro Castella e la Variante di Montecavolo (c/o bivio SP 21),11844,00,11800,44,9015,2829,0,11844
2019/03,237,04/03/2019,1,SP 23 tra Quattro Castella e la Variante di Montecavolo (c/o bivio SP 21),14619,00,13849,770,11689,2930,14619,0
2019/03,237,05/03/2019,2,SP 23 tra Quattro Castella e la Variante di Montecavolo (c/o bivio SP 21),15228,00,14391,837,12077,3151,15228,0
2019/03,237,06/03/2019,3,SP 23 tra Quattro Castella e la Variante di Montecavolo (c/o bivio SP 21),15689,10,14864,824,12305,3384,15689,0
2019/03,237,07/03/2019,4,SP 23 tra Quattro Castella e la Variante di Montecavolo (c/o bivio SP 21),15439,00,14627,812,12165,3274,15439,0
2019/03,237,08/03/2019,5,SP 23 tra Quattro Castella e la Variante di Montecavolo (c/o bivio SP 21),16217,00,15463,754,12417,3800,16217,0
2019/03,237,09/03/2019,6,SP 23 tra Quattro Castella e la Variante di Montecavolo (c/o bivio SP 21),13642,00,13423,219,10142,3500,0,13642
2019/03,237,10/03/2019,7,SP 23 tra Quattro Castella e la Variante di Montecavolo (c/o bivio SP 21),11779,00,11734,45,9083,2696,0,11779
2019/03,237,11/03/2019,1,SP 23 tra Quattro Castella e la Variante di Montecavolo (c/o bivio SP 21),14874,00,14116,758,12001,2873,14874,0
2019/03,237,12/03/2019,2,SP 23 tra Quattro Castella e la Variante di Montecavolo (c/o bivio SP 21),14968,10,14201,766,11889,3079,14968,0
2019/03,237,13/03/2019,3,SP 23 tra Quattro Castella e la Variante di Montecavolo (c/o bivio SP 21),15280,00,14471,809,12063,3217,15280,0
2019/03,237,14/03/2019,4,SP 23 tra Quattro Castella e la Variante di Montecavolo (c/o bivio SP 21),15686,10,14865,820,12268,3418,15686,0
2019/03,238,01/03/2019,5,SP 37 fra Albinea e Scandiano (bivio SP 7),11873,00,11266,607,9229,2644,11873,0
2019/03,238,02/03/2019,6,SP 37 fra Albinea e Scandiano (bivio SP 7),9937,00,9796,141,7263,2674,0,9937
2019/03,238,03/03/2019,7,SP 37 fra Albinea e Scandiano (bivio SP 7),8411,00,8366,45,6406,2005,0,8411
2019/03,238,04/03/2019,1,SP 37 fra Albinea e Scandiano (bivio SP 7),11385,00,10792,593,9115,2270,11385,0
2019/03,238,05/03/2019,2,SP 37 fra Albinea e Scandiano (bivio SP 7),11677,00,11076,601,9227,2450,11677,0
2019/03,238,06/03/2019,3,SP 37 fra Albinea e Scandiano (bivio SP 7),11897,00,11314,583,9308,2589,11897,0
2019/03,238,07/03/2019,4,SP 37 fra Albinea e Scandiano (bivio SP 7),11854,00,11219,635,9319,2535,11854,0
2019/03,238,08/03/2019,5,SP 37 fra Albinea e Scandiano (bivio SP 7),12185,00,11643,542,9501,2684,12185,0
2019/03,238,09/03/2019,6,SP 37 fra Albinea e Scandiano (bivio SP 7),9956,10,9782,173,7334,2622,0,9956
2019/03,238,10/03/2019,7,SP 37 fra Albinea e Scandiano (bivio SP 7),8680,10,8643,36,6721,1959,0,8680
2019/03,238,11/03/2019,1,SP 37 fra Albinea e Scandiano (bivio SP 7),11345,00,10768,577,9189,2156,11345,0
2019/03,238,12/03/2019,2,SP 37 fra Albinea e Scandiano (bivio SP 7),11515,00,10891,624,9120,2395,11515,0
2019/03,238,13/03/2019,3,SP 37 fra Albinea e Scandiano (bivio SP 7),12324,00,11690,634,9596,2728,12324,0
2019/03,238,14/03/2019,4,SP 37 fra Albinea e Scandiano (bivio SP 7),12565,00,11928,637,9864,2701,12565,0
2019/03,239,01/03/2019,5,SP 486R fra Sassuolo e Castellarano,28637,10,25017,3619,22419,6218,28637,0
2019/03,239,02/03/2019,6,SP 486R fra Sassuolo e Castellarano,21680,00,21261,419,15908,5772,0,21680
2019/03,239,03/03/2019,7,SP 486R fra Sassuolo e Castellarano,18303,00,18197,106,13554,4749,0,18303
2019/03,239,04/03/2019,1,SP 486R fra Sassuolo e Castellarano,26831,00,23443,3388,21418,5413,26831,0
2019/03,239,05/03/2019,2,SP 486R fra Sassuolo e Castellarano,27643,20,24018,3623,22088,5555,27643,0
2019/03,239,06/03/2019,3,SP 486R fra Sassuolo e Castellarano,27825,20,23951,3872,22162,5663,27825,0
2019/03,239,07/03/2019,4,SP 486R fra Sassuolo e Castellarano,28244,20,24097,4145,22482,5762,28244,0
2019/03,239,08/03/2019,5,SP 486R fra Sassuolo e Castellarano,29380,10,25610,3769,22818,6562,29380,0
2019/03,239,09/03/2019,6,SP 486R fra Sassuolo e Castellarano,21558,10,21051,506,15652,5906,0,21558
2019/03,239,10/03/2019,7,SP 486R fra Sassuolo e Castellarano,17899,10,17770,128,13139,4760,0,17899
2019/03,239,11/03/2019,1,SP 486R fra Sassuolo e Castellarano,27192,00,23880,3312,21813,5379,27192,0
2019/03,239,12/03/2019,2,SP 486R fra Sassuolo e Castellarano,27403,30,23773,3627,21858,5545,27403,0
2019/03,239,13/03/2019,3,SP 486R fra Sassuolo e Castellarano,27544,10,23673,3870,21848,5696,27544,0
2019/03,239,14/03/2019,4,SP 486R fra Sassuolo e Castellarano,28132,20,24116,4014,22257,5875,28132,0
2019/03,242,01/03/2019,5,SS 12 tra Maranello e Pavullo nel Frignano,16421,00,15057,1364,12412,4009,16421,0
2019/03,242,02/03/2019,6,SS 12 tra Maranello e Pavullo nel Frignano,14983,20,14691,290,11058,3925,0,14983
2019/03,242,03/03/2019,7,SS 12 tra Maranello e Pavullo nel Frignano,16250,10,16191,58,12665,3585,0,16250
2019/03,242,04/03/2019,1,SS 12 tra Maranello e Pavullo nel Frignano,14944,10,13717,1226,11563,3381,14944,0
2019/03,242,05/03/2019,2,SS 12 tra Maranello e Pavullo nel Frignano,15307,00,13846,1461,11927,3380,15307,0
2019/03,242,06/03/2019,3,SS 12 tra Maranello e Pavullo nel Frignano,15859,10,14472,1386,12120,3739,15859,0
2019/03,242,07/03/2019,4,SS 12 tra Maranello e Pavullo nel Frignano,15772,00,14291,1481,12067,3705,15772,0
2019/03,242,08/03/2019,5,SS 12 tra Maranello e Pavullo nel Frignano,16656,10,15272,1383,12475,4181,16656,0
2019/03,242,09/03/2019,6,SS 12 tra Maranello e Pavullo nel Frignano,15604,00,15297,307,11334,4270,0,15604
2019/03,242,10/03/2019,7,SS 12 tra Maranello e Pavullo nel Frignano,14931,00,14854,77,11599,3332,0,14931
2019/03,242,11/03/2019,1,SS 12 tra Maranello e Pavullo nel Frignano,14886,00,13614,1272,11681,3205,14886,0
2019/03,242,12/03/2019,2,SS 12 tra Maranello e Pavullo nel Frignano,15211,10,13834,1376,11770,3441,15211,0
2019/03,242,13/03/2019,3,SS 12 tra Maranello e Pavullo nel Frignano,15612,20,14291,1319,11987,3625,15612,0
2019/03,242,14/03/2019,4,SS 12 tra Maranello e Pavullo nel Frignano,15744,00,14272,1472,12170,3574,15744,0
2019/03,243,01/03/2019,5,SP 27 tra Ponte Samoggia e Muffa,11723,10,10800,922,9131,2592,11723,0
2019/03,243,02/03/2019,6,SP 27 tra Ponte Samoggia e Muffa,9160,00,8939,221,6982,2178,0,9160
2019/03,243,03/03/2019,7,SP 27 tra Ponte Samoggia e Muffa,6965,00,6916,49,5252,1713,0,6965
2019/03,243,04/03/2019,1,SP 27 tra Ponte Samoggia e Muffa,10847,00,9956,891,8799,2048,10847,0
2019/03,243,05/03/2019,2,SP 27 tra Ponte Samoggia e Muffa,11294,20,10376,916,9048,2246,11294,0
2019/03,243,06/03/2019,3,SP 27 tra Ponte Samoggia e Muffa,12747,00,11658,1089,10200,2547,12747,0
2019/03,243,07/03/2019,4,SP 27 tra Ponte Samoggia e Muffa,13650,20,12576,1072,11023,2627,13650,0
2019/03,243,08/03/2019,5,SP 27 tra Ponte Samoggia e Muffa,13657,20,12625,1030,10712,2945,13657,0
2019/03,243,09/03/2019,6,SP 27 tra Ponte Samoggia e Muffa,9899,00,9695,204,7452,2447,0,9899
2019/03,243,10/03/2019,7,SP 27 tra Ponte Samoggia e Muffa,7548,00,7488,60,5765,1783,0,7548
2019/03,243,11/03/2019,1,SP 27 tra Ponte Samoggia e Muffa,12086,00,11153,933,9814,2272,12086,0
2019/03,243,12/03/2019,2,SP 27 tra Ponte Samoggia e Muffa,11275,00,10538,737,8859,2416,11275,0
2019/03,243,13/03/2019,3,SP 27 tra Ponte Samoggia e Muffa,11039,00,10334,705,8642,2397,11039,0
2019/03,243,14/03/2019,4,SP 27 tra Ponte Samoggia e Muffa,11354,10,10618,735,8878,2476,11354,0
2019/03,244,01/03/2019,5,SP 569 tra Pragatto e innesto variante Ponte Ronca,29131,20,27301,1828,22061,7070,29131,0
2019/03,244,02/03/2019,6,SP 569 tra Pragatto e innesto variante Ponte Ronca,27463,10,27109,353,20534,6929,0,27463
2019/03,244,03/03/2019,7,SP 569 tra Pragatto e innesto variante Ponte Ronca,22827,00,22745,82,17027,5800,0,22827
2019/03,244,04/03/2019,1,SP 569 tra Pragatto e innesto variante Ponte Ronca,27266,10,25372,1893,21471,5795,27266,0
2019/03,244,05/03/2019,2,SP 569 tra Pragatto e innesto variante Ponte Ronca,28365,10,26446,1918,21960,6405,28365,0
2019/03,244,06/03/2019,3,SP 569 tra Pragatto e innesto variante Ponte Ronca,26076,100,24430,1636,19813,6263,26076,0
2019/03,244,07/03/2019,4,SP 569 tra Pragatto e innesto variante Ponte Ronca,22953,140,21515,1424,16879,6074,22953,0
2019/03,244,08/03/2019,5,SP 569 tra Pragatto e innesto variante Ponte Ronca,26576,10,24983,1592,19351,7225,26576,0
2019/03,244,09/03/2019,6,SP 569 tra Pragatto e innesto variante Ponte Ronca,26002,10,25661,340,19161,6841,0,26002
2019/03,244,10/03/2019,7,SP 569 tra Pragatto e innesto variante Ponte Ronca,22169,20,22035,132,16799,5370,0,22169
2019/03,244,11/03/2019,1,SP 569 tra Pragatto e innesto variante Ponte Ronca,23986,50,22334,1647,18293,5693,23986,0
2019/03,244,12/03/2019,2,SP 569 tra Pragatto e innesto variante Ponte Ronca,12483,40,11678,801,8918,3565,12483,0
2019/03,244,13/03/2019,3,SP 569 tra Pragatto e innesto variante Ponte Ronca,10503,00,9906,597,8219,2284,10503,0
2019/03,244,14/03/2019,4,SP 569 tra Pragatto e innesto variante Ponte Ronca,10068,00,9535,533,7907,2161,10068,0
2019/03,245,01/03/2019,5,SP 569 da intersezione Pedemontana a Savignano sul Panaro,8051,00,7555,496,5986,2065,8051,0
2019/03,245,02/03/2019,6,SP 569 da intersezione Pedemontana a Savignano sul Panaro,8345,00,8189,156,6284,2061,0,8345
2019/03,245,03/03/2019,7,SP 569 da intersezione Pedemontana a Savignano sul Panaro,7151,00,7099,52,5434,1717,0,7151
2019/03,245,04/03/2019,1,SP 569 da intersezione Pedemontana a Savignano sul Panaro,7175,10,6673,501,5608,1567,7175,0
2019/03,245,05/03/2019,2,SP 569 da intersezione Pedemontana a Savignano sul Panaro,7483,00,6912,571,5724,1759,7483,0
2019/03,245,06/03/2019,3,SP 569 da intersezione Pedemontana a Savignano sul Panaro,8955,00,8332,623,6857,2098,8955,0
2019/03,245,07/03/2019,4,SP 569 da intersezione Pedemontana a Savignano sul Panaro,8209,00,7684,525,6305,1904,8209,0
2019/03,245,08/03/2019,5,SP 569 da intersezione Pedemontana a Savignano sul Panaro,8280,00,7807,473,6107,2173,8280,0
2019/03,245,09/03/2019,6,SP 569 da intersezione Pedemontana a Savignano sul Panaro,8256,10,8091,164,6130,2126,0,8256
2019/03,245,10/03/2019,7,SP 569 da intersezione Pedemontana a Savignano sul Panaro,6891,10,6829,61,5204,1687,0,6891
2019/03,245,11/03/2019,1,SP 569 da intersezione Pedemontana a Savignano sul Panaro,6874,10,6463,410,5382,1492,6874,0
2019/03,245,12/03/2019,2,SP 569 da intersezione Pedemontana a Savignano sul Panaro,7305,00,6847,458,5569,1736,7305,0
2019/03,245,13/03/2019,3,SP 569 da intersezione Pedemontana a Savignano sul Panaro,7123,00,6675,448,5413,1710,7123,0
2019/03,245,14/03/2019,4,SP 569 da intersezione Pedemontana a Savignano sul Panaro,7412,00,6932,480,5663,1749,7412,0
2019/03,246,01/03/2019,5,SP 255 da Decima a San Giovanni in Persiceto,15555,00,14533,1022,11742,3813,15555,0
2019/03,246,02/03/2019,6,SP 255 da Decima a San Giovanni in Persiceto,12098,00,11882,216,8684,3414,0,12098
2019/03,246,03/03/2019,7,SP 255 da Decima a San Giovanni in Persiceto,10740,00,10668,72,7793,2947,0,10740
2019/03,246,04/03/2019,1,SP 255 da Decima a San Giovanni in Persiceto,14472,00,13429,1043,11337,3135,14472,0
2019/03,246,05/03/2019,2,SP 255 da Decima a San Giovanni in Persiceto,14949,00,13838,1111,11649,3300,14949,0
2019/03,246,06/03/2019,3,SP 255 da Decima a San Giovanni in Persiceto,15256,00,14170,1086,11694,3562,15256,0
2019/03,247,01/03/2019,5,SP 255 fra Nonantola e Sant'Agata Bolognese,11177,00,9654,1523,8529,2648,11177,0
2019/03,247,02/03/2019,6,SP 255 fra Nonantola e Sant'Agata Bolognese,7613,00,7380,233,5323,2290,0,7613
2019/03,247,03/03/2019,7,SP 255 fra Nonantola e Sant'Agata Bolognese,7827,00,7760,67,5604,2223,0,7827
2019/03,247,04/03/2019,1,SP 255 fra Nonantola e Sant'Agata Bolognese,10154,10,8758,1395,7946,2208,10154,0
2019/03,247,05/03/2019,2,SP 255 fra Nonantola e Sant'Agata Bolognese,10344,00,8920,1424,8062,2282,10344,0
2019/03,247,06/03/2019,3,SP 255 fra Nonantola e Sant'Agata Bolognese,10854,00,9254,1600,8349,2505,10854,0
2019/03,247,07/03/2019,4,SP 255 fra Nonantola e Sant'Agata Bolognese,10863,10,9315,1547,8269,2594,10863,0
2019/03,247,08/03/2019,5,SP 255 fra Nonantola e Sant'Agata Bolognese,11211,00,9767,1444,8451,2760,11211,0
2019/03,247,09/03/2019,6,SP 255 fra Nonantola e Sant'Agata Bolognese,7625,00,7413,212,5133,2492,0,7625
2019/03,247,10/03/2019,7,SP 255 fra Nonantola e Sant'Agata Bolognese,7505,00,7419,86,5122,2383,0,7505
2019/03,247,11/03/2019,1,SP 255 fra Nonantola e Sant'Agata Bolognese,10336,10,8854,1481,8075,2261,10336,0
2019/03,247,12/03/2019,2,SP 255 fra Nonantola e Sant'Agata Bolognese,10501,00,9006,1495,8204,2297,10501,0
2019/03,247,13/03/2019,3,SP 255 fra Nonantola e Sant'Agata Bolognese,10629,00,9053,1576,8195,2434,10629,0
2019/03,247,14/03/2019,4,SP 255 fra Nonantola e Sant'Agata Bolognese,10754,00,9211,1543,8281,2473,10754,0
2019/03,251,01/03/2019,5,SP 610 tra Imola e Casalfiumanese in località Ca' Miseria,13920,00,13242,678,10616,3304,13920,0
2019/03,251,02/03/2019,6,SP 610 tra Imola e Casalfiumanese in località Ca' Miseria,12824,00,12639,185,9568,3256,0,12824
2019/03,251,03/03/2019,7,SP 610 tra Imola e Casalfiumanese in località Ca' Miseria,10716,00,10670,46,8138,2578,0,10716
2019/03,251,04/03/2019,1,SP 610 tra Imola e Casalfiumanese in località Ca' Miseria,12807,00,12085,722,10102,2705,12807,0
2019/03,251,05/03/2019,2,SP 610 tra Imola e Casalfiumanese in località Ca' Miseria,13937,00,13227,710,10974,2963,13937,0
2019/03,251,06/03/2019,3,SP 610 tra Imola e Casalfiumanese in località Ca' Miseria,13405,00,12601,804,10358,3047,13405,0
2019/03,251,07/03/2019,4,SP 610 tra Imola e Casalfiumanese in località Ca' Miseria,13345,10,12667,677,10138,3207,13345,0
2019/03,251,08/03/2019,5,SP 610 tra Imola e Casalfiumanese in località Ca' Miseria,14231,10,13522,708,10745,3486,14231,0
2019/03,251,09/03/2019,6,SP 610 tra Imola e Casalfiumanese in località Ca' Miseria,12835,10,12642,192,9501,3334,0,12835
2019/03,251,10/03/2019,7,SP 610 tra Imola e Casalfiumanese in località Ca' Miseria,10561,00,10517,44,8248,2313,0,10561
2019/03,251,11/03/2019,1,SP 610 tra Imola e Casalfiumanese in località Ca' Miseria,12445,10,11768,676,9790,2655,12445,0
2019/03,251,12/03/2019,2,SP 610 tra Imola e Casalfiumanese in località Ca' Miseria,13203,00,12542,661,10214,2989,13203,0
2019/03,251,13/03/2019,3,SP 610 tra Imola e Casalfiumanese in località Ca' Miseria,13254,00,12585,669,10220,3034,13254,0
2019/03,251,14/03/2019,4,SP 610 tra Imola e Casalfiumanese in località Ca' Miseria,13417,00,12755,662,10317,3100,13417,0
2019/03,252,01/03/2019,5,SP 3_2 tra Budrio e bivio SP 29 per Medicina,9766,00,8967,799,7750,2016,9766,0
2019/03,252,02/03/2019,6,SP 3_2 tra Budrio e bivio SP 29 per Medicina,7076,00,6920,156,5317,1759,0,7076
2019/03,252,03/03/2019,7,SP 3_2 tra Budrio e bivio SP 29 per Medicina,7832,10,7799,32,6165,1667,0,7832
2019/03,252,04/03/2019,1,SP 3_2 tra Budrio e bivio SP 29 per Medicina,9720,20,8898,820,7952,1768,9720,0
2019/03,252,05/03/2019,2,SP 3_2 tra Budrio e bivio SP 29 per Medicina,9461,00,8660,801,7586,1875,9461,0
2019/03,252,06/03/2019,3,SP 3_2 tra Budrio e bivio SP 29 per Medicina,9375,10,8589,785,7389,1986,9375,0
2019/03,252,07/03/2019,4,SP 3_2 tra Budrio e bivio SP 29 per Medicina,9817,00,8951,866,7865,1952,9817,0
2019/03,252,08/03/2019,5,SP 3_2 tra Budrio e bivio SP 29 per Medicina,10158,00,9297,861,7894,2264,10158,0
2019/03,252,09/03/2019,6,SP 3_2 tra Budrio e bivio SP 29 per Medicina,7385,00,7233,152,5404,1981,0,7385
2019/03,252,10/03/2019,7,SP 3_2 tra Budrio e bivio SP 29 per Medicina,6561,00,6522,39,4968,1593,0,6561
2019/03,252,11/03/2019,1,SP 3_2 tra Budrio e bivio SP 29 per Medicina,9346,10,8581,764,7492,1854,9346,0
2019/03,252,12/03/2019,2,SP 3_2 tra Budrio e bivio SP 29 per Medicina,9635,20,8730,903,7748,1887,9635,0
2019/03,252,13/03/2019,3,SP 3_2 tra Budrio e bivio SP 29 per Medicina,9546,00,8795,751,7596,1950,9546,0
2019/03,252,14/03/2019,4,SP 3_2 tra Budrio e bivio SP 29 per Medicina,9719,10,8850,868,7848,1871,9719,0
2019/03,254,02/03/2019,6,SS 9 tra Ozzano Emilia e Castel San Pietro,14670,00,14413,257,10771,3899,0,14670
2019/03,254,03/03/2019,7,SS 9 tra Ozzano Emilia e Castel San Pietro,12038,10,11985,52,8980,3058,0,12038
2019/03,254,04/03/2019,1,SS 9 tra Ozzano Emilia e Castel San Pietro,16387,00,15734,653,12985,3402,16387,0
2019/03,254,05/03/2019,2,SS 9 tra Ozzano Emilia e Castel San Pietro,16525,00,15873,652,13021,3504,16525,0
2019/03,254,06/03/2019,3,SS 9 tra Ozzano Emilia e Castel San Pietro,16705,00,16059,646,13009,3696,16705,0
2019/03,254,07/03/2019,4,SS 9 tra Ozzano Emilia e Castel San Pietro,16851,00,16220,631,12981,3870,16851,0
2019/03,254,08/03/2019,5,SS 9 tra Ozzano Emilia e Castel San Pietro,17975,00,17361,614,13648,4327,17975,0
2019/03,254,09/03/2019,6,SS 9 tra Ozzano Emilia e Castel San Pietro,14897,30,14625,269,10689,4208,0,14897
2019/03,254,10/03/2019,7,SS 9 tra Ozzano Emilia e Castel San Pietro,11971,00,11921,50,8734,3237,0,11971
2019/03,254,11/03/2019,1,SS 9 tra Ozzano Emilia e Castel San Pietro,16354,00,15694,660,12839,3515,16354,0
2019/03,254,12/03/2019,2,SS 9 tra Ozzano Emilia e Castel San Pietro,16925,00,16276,649,13250,3675,16925,0
2019/03,254,13/03/2019,3,SS 9 tra Ozzano Emilia e Castel San Pietro,17093,00,16437,656,13003,4090,17093,0
2019/03,254,14/03/2019,4,SS 9 tra Ozzano Emilia e Castel San Pietro,16878,10,16160,717,12992,3886,16878,0
2019/03,255,01/03/2019,5,SS 9 tra Castel San Pietro e Imola,20574,50,19866,703,15657,4917,20574,0
2019/03,255,02/03/2019,6,SS 9 tra Castel San Pietro e Imola,18253,40,17994,255,13714,4539,0,18253
2019/03,255,03/03/2019,7,SS 9 tra Castel San Pietro e Imola,15320,20,15229,89,11558,3762,0,15320
2019/03,255,04/03/2019,1,SS 9 tra Castel San Pietro e Imola,19926,10,19128,797,15774,4152,19926,0
2019/03,255,05/03/2019,2,SS 9 tra Castel San Pietro e Imola,19605,20,18802,801,15517,4088,19605,0
2019/03,255,06/03/2019,3,SS 9 tra Castel San Pietro e Imola,19623,00,18888,735,15528,4095,19623,0
2019/03,255,07/03/2019,4,SS 9 tra Castel San Pietro e Imola,19996,20,19220,774,15394,4602,19996,0
2019/03,255,08/03/2019,5,SS 9 tra Castel San Pietro e Imola,20934,20,20161,771,15948,4986,20934,0
2019/03,255,09/03/2019,6,SS 9 tra Castel San Pietro e Imola,18499,20,18225,272,13753,4746,0,18499
2019/03,255,10/03/2019,7,SS 9 tra Castel San Pietro e Imola,14880,00,14794,86,11337,3543,0,14880
2019/03,255,11/03/2019,1,SS 9 tra Castel San Pietro e Imola,19189,00,18462,727,15307,3882,19189,0
2019/03,255,12/03/2019,2,SS 9 tra Castel San Pietro e Imola,19719,10,18967,751,15761,3958,19719,0
2019/03,255,13/03/2019,3,SS 9 tra Castel San Pietro e Imola,20543,20,19767,774,15814,4729,20543,0
2019/03,255,14/03/2019,4,SS 9 tra Castel San Pietro e Imola,20022,50,19219,798,15418,4604,20022,0
2019/03,256,01/03/2019,5,SP 302R tra Faenza (bivio SP 66) e Brisighella,8538,00,8317,221,6560,1978,8538,0
2019/03,256,02/03/2019,6,SP 302R tra Faenza (bivio SP 66) e Brisighella,8879,00,8728,151,6758,2121,0,8879
2019/03,256,03/03/2019,7,SP 302R tra Faenza (bivio SP 66) e Brisighella,8657,10,8627,29,6948,1709,0,8657
2019/03,256,04/03/2019,1,SP 302R tra Faenza (bivio SP 66) e Brisighella,8237,10,8001,235,6496,1741,8237,0
2019/03,256,05/03/2019,2,SP 302R tra Faenza (bivio SP 66) e Brisighella,8018,00,7779,239,6281,1737,8018,0
2019/03,256,06/03/2019,3,SP 302R tra Faenza (bivio SP 66) e Brisighella,8339,00,8102,237,6597,1742,8339,0
2019/03,256,07/03/2019,4,SP 302R tra Faenza (bivio SP 66) e Brisighella,8469,20,8182,285,6501,1968,8469,0
2019/03,256,08/03/2019,5,SP 302R tra Faenza (bivio SP 66) e Brisighella,8962,10,8675,286,6882,2080,8962,0
2019/03,256,09/03/2019,6,SP 302R tra Faenza (bivio SP 66) e Brisighella,8866,10,8747,118,6645,2221,0,8866
2019/03,256,10/03/2019,7,SP 302R tra Faenza (bivio SP 66) e Brisighella,8124,00,8087,37,6458,1666,0,8124
2019/03,256,11/03/2019,1,SP 302R tra Faenza (bivio SP 66) e Brisighella,8137,00,7882,255,6478,1659,8137,0
2019/03,256,12/03/2019,2,SP 302R tra Faenza (bivio SP 66) e Brisighella,8319,10,8075,243,6532,1787,8319,0
2019/03,256,13/03/2019,3,SP 302R tra Faenza (bivio SP 66) e Brisighella,8364,20,8092,270,6552,1812,8364,0
2019/03,256,14/03/2019,4,SP 302R tra Faenza (bivio SP 66) e Brisighella,8422,00,8161,261,6598,1824,8422,0
2019/03,257,01/03/2019,5,SP 302R tra Faenza e il bivio SP 4 (a sud di Russi),6684,00,6474,210,5088,1596,6684,0
2019/03,257,02/03/2019,6,SP 302R tra Faenza e il bivio SP 4 (a sud di Russi),5957,00,5869,88,4395,1562,0,5957
2019/03,257,03/03/2019,7,SP 302R tra Faenza e il bivio SP 4 (a sud di Russi),5376,00,5345,31,4036,1340,0,5376
2019/03,257,04/03/2019,1,SP 302R tra Faenza e il bivio SP 4 (a sud di Russi),6191,00,5964,227,4955,1236,6191,0
2019/03,257,05/03/2019,2,SP 302R tra Faenza e il bivio SP 4 (a sud di Russi),6171,00,5963,208,4972,1199,6171,0
2019/03,257,06/03/2019,3,SP 302R tra Faenza e il bivio SP 4 (a sud di Russi),6301,00,6071,230,4991,1310,6301,0
2019/03,257,07/03/2019,4,SP 302R tra Faenza e il bivio SP 4 (a sud di Russi),6382,00,6139,243,5002,1380,6382,0
2019/03,257,08/03/2019,5,SP 302R tra Faenza e il bivio SP 4 (a sud di Russi),6789,00,6552,237,5234,1555,6789,0
2019/03,257,09/03/2019,6,SP 302R tra Faenza e il bivio SP 4 (a sud di Russi),5830,10,5720,109,4246,1584,0,5830
2019/03,257,10/03/2019,7,SP 302R tra Faenza e il bivio SP 4 (a sud di Russi),5000,00,4970,30,3800,1200,0,5000
2019/03,257,11/03/2019,1,SP 302R tra Faenza e il bivio SP 4 (a sud di Russi),6171,00,5974,197,4860,1311,6171,0
2019/03,257,12/03/2019,2,SP 302R tra Faenza e il bivio SP 4 (a sud di Russi),6354,00,6148,206,4996,1358,6354,0
2019/03,257,13/03/2019,3,SP 302R tra Faenza e il bivio SP 4 (a sud di Russi),6395,00,6199,196,4977,1418,6395,0
2019/03,257,14/03/2019,4,SP 302R tra Faenza e il bivio SP 4 (a sud di Russi),6411,00,6214,197,4991,1420,6411,0
2019/03,258,01/03/2019,5,SS 9 tra Forlimpopoli e Cesena,25861,00,23645,2216,19660,6201,25861,0
2019/03,258,02/03/2019,6,SS 9 tra Forlimpopoli e Cesena,22205,20,21439,764,15848,6357,0,22205
2019/03,258,03/03/2019,7,SS 9 tra Forlimpopoli e Cesena,17498,00,17313,185,12624,4874,0,17498
2019/03,258,04/03/2019,1,SS 9 tra Forlimpopoli e Cesena,24459,70,22260,2192,19209,5250,24459,0
2019/03,258,05/03/2019,2,SS 9 tra Forlimpopoli e Cesena,24888,110,22682,2195,19470,5418,24888,0
2019/03,258,06/03/2019,3,SS 9 tra Forlimpopoli e Cesena,25553,30,23259,2291,19825,5728,25553,0
2019/03,258,07/03/2019,4,SS 9 tra Forlimpopoli e Cesena,25266,30,23023,2240,19575,5691,25266,0
2019/03,258,08/03/2019,5,SS 9 tra Forlimpopoli e Cesena,26879,90,24697,2173,20256,6623,26879,0
2019/03,258,09/03/2019,6,SS 9 tra Forlimpopoli e Cesena,21866,00,21030,836,15463,6403,0,21866
2019/03,258,10/03/2019,7,SS 9 tra Forlimpopoli e Cesena,17337,20,17125,210,12355,4982,0,17337
2019/03,258,11/03/2019,1,SS 9 tra Forlimpopoli e Cesena,24055,70,22061,1987,18984,5071,24055,0
2019/03,258,12/03/2019,2,SS 9 tra Forlimpopoli e Cesena,25166,50,23038,2123,19568,5598,25166,0
2019/03,258,13/03/2019,3,SS 9 tra Forlimpopoli e Cesena,25643,50,23516,2122,19651,5992,25643,0
2019/03,258,14/03/2019,4,SS 9 tra Forlimpopoli e Cesena,25004,70,22846,2151,18926,6078,25004,0
2019/03,259,01/03/2019,5,SP 7 in località Calabrina al Confine Provinciale,8575,00,8207,368,6391,2184,8575,0
2019/03,259,02/03/2019,6,SP 7 in località Calabrina al Confine Provinciale,9233,00,9029,204,6386,2847,0,9233
2019/03,259,03/03/2019,7,SP 7 in località Calabrina al Confine Provinciale,8375,00,8296,79,5931,2444,0,8375
2019/03,259,04/03/2019,1,SP 7 in località Calabrina al Confine Provinciale,7560,00,7112,448,5925,1635,7560,0
2019/03,259,05/03/2019,2,SP 7 in località Calabrina al Confine Provinciale,7729,00,7270,459,6017,1712,7729,0
2019/03,259,06/03/2019,3,SP 7 in località Calabrina al Confine Provinciale,7848,00,7391,457,6160,1688,7848,0
2019/03,259,07/03/2019,4,SP 7 in località Calabrina al Confine Provinciale,8291,00,7840,451,6372,1919,8291,0
2019/03,259,08/03/2019,5,SP 7 in località Calabrina al Confine Provinciale,8831,00,8409,422,6415,2416,8831,0
2019/03,259,09/03/2019,6,SP 7 in località Calabrina al Confine Provinciale,9151,00,8983,168,6168,2983,0,9151
2019/03,259,10/03/2019,7,SP 7 in località Calabrina al Confine Provinciale,7814,00,7759,55,5666,2148,0,7814
2019/03,259,11/03/2019,1,SP 7 in località Calabrina al Confine Provinciale,7535,00,7093,442,5973,1562,7535,0
2019/03,259,12/03/2019,2,SP 7 in località Calabrina al Confine Provinciale,7716,00,7298,418,6021,1695,7716,0
2019/03,259,13/03/2019,3,SP 7 in località Calabrina al Confine Provinciale,7660,00,7192,468,5913,1747,7660,0
2019/03,259,14/03/2019,4,SP 7 in località Calabrina al Confine Provinciale,7954,00,7507,447,6067,1887,7954,0
2019/03,260,01/03/2019,5,SP 8 tra Cesena e A 14,11921,00,11601,320,9344,2577,11921,0
2019/03,260,02/03/2019,6,SP 8 tra Cesena e A 14,11279,10,11151,127,8371,2908,0,11279
2019/03,260,03/03/2019,7,SP 8 tra Cesena e A 14,10622,00,10607,15,8190,2432,0,10622
2019/03,260,04/03/2019,1,SP 8 tra Cesena e A 14,11361,00,11023,338,9212,2149,11361,0
2019/03,260,05/03/2019,2,SP 8 tra Cesena e A 14,11506,10,11142,363,9326,2180,11506,0
2019/03,260,06/03/2019,3,SP 8 tra Cesena e A 14,11489,00,11124,365,9228,2261,11489,0
2019/03,260,07/03/2019,4,SP 8 tra Cesena e A 14,11571,00,11207,364,9239,2332,11571,0
2019/03,260,08/03/2019,5,SP 8 tra Cesena e A 14,12517,00,12149,368,9696,2821,12517,0
2019/03,260,09/03/2019,6,SP 8 tra Cesena e A 14,11661,10,11530,130,8412,3249,0,11661
2019/03,260,10/03/2019,7,SP 8 tra Cesena e A 14,9780,10,9757,22,7472,2308,0,9780
2019/03,260,11/03/2019,1,SP 8 tra Cesena e A 14,11174,00,10841,333,9142,2032,11174,0
2019/03,260,12/03/2019,2,SP 8 tra Cesena e A 14,11307,00,10978,329,9108,2199,11307,0
2019/03,260,13/03/2019,3,SP 8 tra Cesena e A 14,11701,00,11316,385,9197,2504,11701,0
2019/03,260,14/03/2019,4,SP 8 tra Cesena e A 14,11601,00,11223,378,9239,2362,11601,0
2019/03,261,01/03/2019,5,SS 9 tra Cesena e Savignano sul Rubicone,29478,00,27236,2242,22706,6772,29478,0
2019/03,261,02/03/2019,6,SS 9 tra Cesena e Savignano sul Rubicone,23127,00,22334,793,16468,6659,0,23127
2019/03,261,03/03/2019,7,SS 9 tra Cesena e Savignano sul Rubicone,17573,20,17437,134,12397,5176,0,17573
2019/03,261,04/03/2019,1,SS 9 tra Cesena e Savignano sul Rubicone,28240,00,26002,2238,22453,5787,28240,0
2019/03,261,05/03/2019,2,SS 9 tra Cesena e Savignano sul Rubicone,28446,00,26134,2312,22471,5975,28446,0
2019/03,261,06/03/2019,3,SS 9 tra Cesena e Savignano sul Rubicone,29209,00,26781,2428,23031,6178,29209,0
2019/03,261,07/03/2019,4,SS 9 tra Cesena e Savignano sul Rubicone,29515,00,27196,2319,23095,6420,29515,0
2019/03,261,08/03/2019,5,SS 9 tra Cesena e Savignano sul Rubicone,30568,00,28231,2337,23452,7116,30568,0
2019/03,261,09/03/2019,6,SS 9 tra Cesena e Savignano sul Rubicone,23107,30,22259,845,16332,6775,0,23107
2019/03,261,10/03/2019,7,SS 9 tra Cesena e Savignano sul Rubicone,16325,20,16178,145,11212,5113,0,16325
2019/03,261,11/03/2019,1,SS 9 tra Cesena e Savignano sul Rubicone,28714,00,26424,2290,23057,5657,28714,0
2019/03,261,12/03/2019,2,SS 9 tra Cesena e Savignano sul Rubicone,28955,00,26602,2353,22869,6086,28955,0
2019/03,261,13/03/2019,3,SS 9 tra Cesena e Savignano sul Rubicone,29163,00,26911,2252,22737,6426,29163,0
2019/03,261,14/03/2019,4,SS 9 tra Cesena e Savignano sul Rubicone,29468,10,27074,2393,22936,6532,29468,0
2019/03,262,01/03/2019,5,SS 9 tra Savignano sul Rubicone e Santarcangelo di Romagna,,,,,,,,
2019/03,262,02/03/2019,6,SS 9 tra Savignano sul Rubicone e Santarcangelo di Romagna,,,,,,,,
2019/03,262,03/03/2019,7,SS 9 tra Savignano sul Rubicone e Santarcangelo di Romagna,,,,,,,,
2019/03,262,04/03/2019,1,SS 9 tra Savignano sul Rubicone e Santarcangelo di Romagna,,,,,,,,
2019/03,262,05/03/2019,2,SS 9 tra Savignano sul Rubicone e Santarcangelo di Romagna,,,,,,,,
2019/03,262,06/03/2019,3,SS 9 tra Savignano sul Rubicone e Santarcangelo di Romagna,,,,,,,,
2019/03,262,07/03/2019,4,SS 9 tra Savignano sul Rubicone e Santarcangelo di Romagna,,,,,,,,
2019/03,262,08/03/2019,5,SS 9 tra Savignano sul Rubicone e Santarcangelo di Romagna,,,,,,,,
2019/03,262,09/03/2019,6,SS 9 tra Savignano sul Rubicone e Santarcangelo di Romagna,,,,,,,,
2019/03,262,10/03/2019,7,SS 9 tra Savignano sul Rubicone e Santarcangelo di Romagna,,,,,,,,
2019/03,262,11/03/2019,1,SS 9 tra Savignano sul Rubicone e Santarcangelo di Romagna,,,,,,,,
2019/03,262,12/03/2019,2,SS 9 tra Savignano sul Rubicone e Santarcangelo di Romagna,,,,,,,,
2019/03,262,13/03/2019,3,SS 9 tra Savignano sul Rubicone e Santarcangelo di Romagna,,,,,,,,
2019/03,262,14/03/2019,4,SS 9 tra Savignano sul Rubicone e Santarcangelo di Romagna,,,,,,,,
2019/03,263,01/03/2019,5,Via Adriatica (ex SS 16) tra Riccione e Misano Adriatico,17990,00,17541,449,13348,4642,17990,0
2019/03,263,02/03/2019,6,Via Adriatica (ex SS 16) tra Riccione e Misano Adriatico,17856,00,17696,160,12150,5706,0,17856
2019/03,263,03/03/2019,7,Via Adriatica (ex SS 16) tra Riccione e Misano Adriatico,15276,00,15219,57,10314,4962,0,15276
2019/03,263,04/03/2019,1,Via Adriatica (ex SS 16) tra Riccione e Misano Adriatico,16510,00,16114,396,13001,3509,16510,0
2019/03,263,05/03/2019,2,Via Adriatica (ex SS 16) tra Riccione e Misano Adriatico,16470,00,16005,465,12938,3532,16470,0
2019/03,263,06/03/2019,3,Via Adriatica (ex SS 16) tra Riccione e Misano Adriatico,16566,10,16100,465,13022,3544,16566,0
2019/03,263,07/03/2019,4,Via Adriatica (ex SS 16) tra Riccione e Misano Adriatico,17028,20,16563,463,13199,3829,17028,0
2019/03,263,08/03/2019,5,Via Adriatica (ex SS 16) tra Riccione e Misano Adriatico,18525,00,18093,432,13695,4830,18525,0
2019/03,263,09/03/2019,6,Via Adriatica (ex SS 16) tra Riccione e Misano Adriatico,17100,10,16916,183,11582,5518,0,17100
2019/03,263,10/03/2019,7,Via Adriatica (ex SS 16) tra Riccione e Misano Adriatico,14199,20,14142,55,9814,4385,0,14199
2019/03,263,11/03/2019,1,Via Adriatica (ex SS 16) tra Riccione e Misano Adriatico,16410,00,15985,425,12933,3477,16410,0
2019/03,263,12/03/2019,2,Via Adriatica (ex SS 16) tra Riccione e Misano Adriatico,16884,00,16425,459,13107,3777,16884,0
2019/03,263,13/03/2019,3,Via Adriatica (ex SS 16) tra Riccione e Misano Adriatico,16281,00,15867,414,12699,3582,16281,0
2019/03,263,14/03/2019,4,Via Adriatica (ex SS 16) tra Riccione e Misano Adriatico,17145,00,16726,419,13255,3890,17145,0
2019/03,269,01/03/2019,5,SS 12 a Medolla,20831,00,18898,1933,16223,4608,20831,0
2019/03,269,02/03/2019,6,SS 12 a Medolla,15838,10,15514,323,11158,4680,0,15838
2019/03,269,03/03/2019,7,SS 12 a Medolla,13017,00,12953,64,9194,3823,0,13017
2019/03,269,04/03/2019,1,SS 12 a Medolla,19604,00,17660,1944,15764,3840,19604,0
2019/03,269,05/03/2019,2,SS 12 a Medolla,20483,00,18525,1958,16434,4049,20483,0
2019/03,269,06/03/2019,3,SS 12 a Medolla,20680,10,18523,2156,16548,4132,20680,0
2019/03,269,07/03/2019,4,SS 12 a Medolla,20870,10,18869,2000,16646,4224,20870,0
2019/03,269,08/03/2019,5,SS 12 a Medolla,21540,10,19554,1985,16570,4970,21540,0
2019/03,269,09/03/2019,6,SS 12 a Medolla,15524,00,15213,311,10976,4548,0,15524
2019/03,269,10/03/2019,7,SS 12 a Medolla,13614,00,13545,69,9739,3875,0,13614
2019/03,269,11/03/2019,1,SS 12 a Medolla,20128,00,17988,2140,16220,3908,20128,0
2019/03,269,12/03/2019,2,SS 12 a Medolla,20539,10,18421,2117,16531,4008,20539,0
2019/03,269,13/03/2019,3,SS 12 a Medolla,20566,10,18513,2052,16448,4118,20566,0
2019/03,269,14/03/2019,4,SS 12 a Medolla,20543,00,18456,2087,16344,4199,20543,0
2019/03,275,01/03/2019,5,SP 5 dall'intersezione SP 3 a intersezione per Ca' de Fabbri,11540,00,11023,517,9000,2540,11540,0
2019/03,275,02/03/2019,6,SP 5 dall'intersezione SP 3 a intersezione per Ca' de Fabbri,8846,00,8684,162,6541,2305,0,8846
2019/03,275,03/03/2019,7,SP 5 dall'intersezione SP 3 a intersezione per Ca' de Fabbri,6713,00,6677,36,4892,1821,0,6713
2019/03,275,04/03/2019,1,SP 5 dall'intersezione SP 3 a intersezione per Ca' de Fabbri,10901,10,10389,511,8745,2156,10901,0
2019/03,275,05/03/2019,2,SP 5 dall'intersezione SP 3 a intersezione per Ca' de Fabbri,11340,10,10776,563,9039,2301,11340,0
2019/03,275,06/03/2019,3,SP 5 dall'intersezione SP 3 a intersezione per Ca' de Fabbri,11297,00,10773,524,8951,2346,11297,0
2019/03,275,07/03/2019,4,SP 5 dall'intersezione SP 3 a intersezione per Ca' de Fabbri,11378,00,10797,581,8941,2437,11378,0
2019/03,275,08/03/2019,5,SP 5 dall'intersezione SP 3 a intersezione per Ca' de Fabbri,11975,00,11459,516,9312,2663,11975,0
2019/03,275,09/03/2019,6,SP 5 dall'intersezione SP 3 a intersezione per Ca' de Fabbri,9019,00,8853,166,6600,2419,0,9019
2019/03,275,10/03/2019,7,SP 5 dall'intersezione SP 3 a intersezione per Ca' de Fabbri,6677,00,6634,43,4913,1764,0,6677
2019/03,275,11/03/2019,1,SP 5 dall'intersezione SP 3 a intersezione per Ca' de Fabbri,11096,00,10607,489,8959,2137,11096,0
2019/03,275,12/03/2019,2,SP 5 dall'intersezione SP 3 a intersezione per Ca' de Fabbri,11251,30,10715,533,9003,2248,11251,0
2019/03,275,13/03/2019,3,SP 5 dall'intersezione SP 3 a intersezione per Ca' de Fabbri,11592,00,11054,538,9271,2321,11592,0
2019/03,275,14/03/2019,4,SP 5 dall'intersezione SP 3 a intersezione per Ca' de Fabbri,11218,00,10654,564,8801,2417,11218,0
2019/03,276,01/03/2019,5,SP 3_2 tra intersezione SP 5 e ponte torrente Idice,12756,00,11677,1079,10029,2727,12756,0
2019/03,276,02/03/2019,6,SP 3_2 tra intersezione SP 5 e ponte torrente Idice,7910,00,7708,202,5732,2178,0,7910
2019/03,276,03/03/2019,7,SP 3_2 tra intersezione SP 5 e ponte torrente Idice,7497,00,7452,45,5669,1828,0,7497
2019/03,276,04/03/2019,1,SP 3_2 tra intersezione SP 5 e ponte torrente Idice,12988,00,11860,1128,10658,2330,12988,0
2019/03,276,05/03/2019,2,SP 3_2 tra intersezione SP 5 e ponte torrente Idice,12691,00,11561,1130,10189,2502,12691,0
2019/03,276,06/03/2019,3,SP 3_2 tra intersezione SP 5 e ponte torrente Idice,12554,00,11491,1063,9917,2637,12554,0
2019/03,276,07/03/2019,4,SP 3_2 tra intersezione SP 5 e ponte torrente Idice,13060,00,11903,1157,10401,2659,13060,0
2019/03,276,08/03/2019,5,SP 3_2 tra intersezione SP 5 e ponte torrente Idice,12798,00,11694,1104,9940,2858,12798,0
2019/03,276,09/03/2019,6,SP 3_2 tra intersezione SP 5 e ponte torrente Idice,8524,00,8296,228,6166,2358,0,8524
2019/03,276,10/03/2019,7,SP 3_2 tra intersezione SP 5 e ponte torrente Idice,6747,00,6697,50,4930,1817,0,6747
2019/03,276,11/03/2019,1,SP 3_2 tra intersezione SP 5 e ponte torrente Idice,12130,00,11038,1092,9792,2338,12130,0
2019/03,276,12/03/2019,2,SP 3_2 tra intersezione SP 5 e ponte torrente Idice,13157,00,11969,1188,10578,2579,13157,0
2019/03,276,13/03/2019,3,SP 3_2 tra intersezione SP 5 e ponte torrente Idice,13106,00,11999,1107,10331,2775,13106,0
2019/03,276,14/03/2019,4,SP 3_2 tra intersezione SP 5 e ponte torrente Idice,13369,00,12064,1305,10678,2691,13369,0
2019/03,277,01/03/2019,5,SP 6 tra Budrio e San Martino in Argine,7947,00,7467,480,6108,1839,7947,0
2019/03,277,02/03/2019,6,SP 6 tra Budrio e San Martino in Argine,6213,00,6061,152,4611,1602,0,6213
2019/03,277,03/03/2019,7,SP 6 tra Budrio e San Martino in Argine,4550,00,4523,27,3307,1243,0,4550
2019/03,277,04/03/2019,1,SP 6 tra Budrio e San Martino in Argine,7843,00,7341,502,6228,1615,7843,0
2019/03,277,05/03/2019,2,SP 6 tra Budrio e San Martino in Argine,7815,00,7391,424,6107,1708,7815,0
2019/03,277,06/03/2019,3,SP 6 tra Budrio e San Martino in Argine,8047,00,7576,471,6385,1662,8047,0
2019/03,277,07/03/2019,4,SP 6 tra Budrio e San Martino in Argine,8108,10,7624,483,6236,1872,8108,0
2019/03,277,08/03/2019,5,SP 6 tra Budrio e San Martino in Argine,8593,00,8055,538,6689,1904,8593,0
2019/03,277,09/03/2019,6,SP 6 tra Budrio e San Martino in Argine,6063,00,5896,167,4443,1620,0,6063
2019/03,277,10/03/2019,7,SP 6 tra Budrio e San Martino in Argine,4670,00,4638,32,3336,1334,0,4670
2019/03,277,11/03/2019,1,SP 6 tra Budrio e San Martino in Argine,7817,00,7334,483,6171,1646,7817,0
2019/03,277,12/03/2019,2,SP 6 tra Budrio e San Martino in Argine,7903,00,7452,451,6140,1763,7903,0
2019/03,277,13/03/2019,3,SP 6 tra Budrio e San Martino in Argine,8021,00,7531,490,6261,1760,8021,0
2019/03,277,14/03/2019,4,SP 6 tra Budrio e San Martino in Argine,8058,00,7566,492,6280,1778,8058,0
2019/03,278,01/03/2019,5,SP 6 tra Budrio e bivio SP 253,14567,00,13854,713,11412,3155,14567,0
2019/03,278,02/03/2019,6,SP 6 tra Budrio e bivio SP 253,11570,00,11390,180,8606,2964,0,11570
2019/03,278,03/03/2019,7,SP 6 tra Budrio e bivio SP 253,8412,00,8371,41,6127,2285,0,8412
2019/03,278,04/03/2019,1,SP 6 tra Budrio e bivio SP 253,13765,00,13028,737,11062,2703,13765,0
2019/03,278,05/03/2019,2,SP 6 tra Budrio e bivio SP 253,14544,00,13777,767,11676,2868,14544,0
2019/03,278,06/03/2019,3,SP 6 tra Budrio e bivio SP 253,14038,20,13327,709,11044,2994,14038,0
2019/03,278,07/03/2019,4,SP 6 tra Budrio e bivio SP 253,14218,00,13433,785,11126,3092,14218,0
2019/03,278,08/03/2019,5,SP 6 tra Budrio e bivio SP 253,15140,00,14435,705,11788,3352,15140,0
2019/03,278,09/03/2019,6,SP 6 tra Budrio e bivio SP 253,11417,00,11233,184,8320,3097,0,11417
2019/03,278,10/03/2019,7,SP 6 tra Budrio e bivio SP 253,8228,00,8183,45,6006,2222,0,8228
2019/03,278,11/03/2019,1,SP 6 tra Budrio e bivio SP 253,13867,00,13217,650,11161,2706,13867,0
2019/03,278,12/03/2019,2,SP 6 tra Budrio e bivio SP 253,14334,10,13544,789,11377,2957,14334,0
2019/03,278,13/03/2019,3,SP 6 tra Budrio e bivio SP 253,14359,00,13615,744,11342,3017,14359,0
2019/03,278,14/03/2019,4,SP 6 tra Budrio e bivio SP 253,14244,00,13424,820,11286,2958,14244,0
2019/03,279,01/03/2019,5,SP 31 dal bivio SP 28 per Castenaso a Ponte Rizzoli,14818,00,13859,959,12188,2630,14818,0
2019/03,279,02/03/2019,6,SP 31 dal bivio SP 28 per Castenaso a Ponte Rizzoli,9860,10,9691,168,7572,2288,0,9860
2019/03,279,03/03/2019,7,SP 31 dal bivio SP 28 per Castenaso a Ponte Rizzoli,8446,00,8399,47,6553,1893,0,8446
2019/03,279,04/03/2019,1,SP 31 dal bivio SP 28 per Castenaso a Ponte Rizzoli,14893,20,13717,1174,12564,2329,14893,0
2019/03,279,05/03/2019,2,SP 31 dal bivio SP 28 per Castenaso a Ponte Rizzoli,14517,00,13402,1115,12132,2385,14517,0
2019/03,279,06/03/2019,3,SP 31 dal bivio SP 28 per Castenaso a Ponte Rizzoli,14510,00,13449,1061,12104,2406,14510,0
2019/03,279,07/03/2019,4,SP 31 dal bivio SP 28 per Castenaso a Ponte Rizzoli,14698,00,13636,1062,12115,2583,14698,0
2019/03,279,08/03/2019,5,SP 31 dal bivio SP 28 per Castenaso a Ponte Rizzoli,15123,00,14109,1014,12335,2788,15123,0
2019/03,279,09/03/2019,6,SP 31 dal bivio SP 28 per Castenaso a Ponte Rizzoli,9982,10,9820,161,7618,2364,0,9982
2019/03,279,10/03/2019,7,SP 31 dal bivio SP 28 per Castenaso a Ponte Rizzoli,8316,00,8271,45,6474,1842,0,8316
2019/03,279,11/03/2019,1,SP 31 dal bivio SP 28 per Castenaso a Ponte Rizzoli,13905,00,12958,947,11695,2210,13905,0
2019/03,279,12/03/2019,2,SP 31 dal bivio SP 28 per Castenaso a Ponte Rizzoli,14868,00,13746,1122,12515,2353,14868,0
2019/03,279,13/03/2019,3,SP 31 dal bivio SP 28 per Castenaso a Ponte Rizzoli,14981,00,13877,1104,12036,2945,14981,0
2019/03,279,14/03/2019,4,SP 31 dal bivio SP 28 per Castenaso a Ponte Rizzoli,14610,00,13566,1044,12201,2409,14610,0
2019/03,280,01/03/2019,5,SP 26 tra Gesso e Ponte Rivabella,22071,10,21562,508,16700,5371,22071,0
2019/03,280,02/03/2019,6,SP 26 tra Gesso e Ponte Rivabella,19952,10,19762,189,14693,5259,0,19952
2019/03,280,03/03/2019,7,SP 26 tra Gesso e Ponte Rivabella,15656,10,15622,33,11646,4010,0,15656
2019/03,280,04/03/2019,1,SP 26 tra Gesso e Ponte Rivabella,21352,20,20820,530,16756,4596,21352,0
2019/03,280,05/03/2019,2,SP 26 tra Gesso e Ponte Rivabella,21211,00,20745,466,16405,4806,21211,0
2019/03,280,06/03/2019,3,SP 26 tra Gesso e Ponte Rivabella,21346,00,20803,543,16449,4897,21346,0
2019/03,280,07/03/2019,4,SP 26 tra Gesso e Ponte Rivabella,21802,10,21314,487,16708,5094,21802,0
2019/03,280,08/03/2019,5,SP 26 tra Gesso e Ponte Rivabella,23498,00,22977,521,17580,5918,23498,0
2019/03,280,09/03/2019,6,SP 26 tra Gesso e Ponte Rivabella,19803,00,19624,179,14501,5302,0,19803
2019/03,280,10/03/2019,7,SP 26 tra Gesso e Ponte Rivabella,15952,00,15907,45,12032,3920,0,15952
2019/03,280,11/03/2019,1,SP 26 tra Gesso e Ponte Rivabella,20997,00,20517,480,16535,4462,20997,0
2019/03,280,12/03/2019,2,SP 26 tra Gesso e Ponte Rivabella,21293,00,20746,547,16415,4878,21293,0
2019/03,280,13/03/2019,3,SP 26 tra Gesso e Ponte Rivabella,21437,00,20871,566,16399,5038,21437,0
2019/03,280,14/03/2019,4,SP 26 tra Gesso e Ponte Rivabella,21540,00,21037,503,16513,5027,21540,0
2019/03,281,01/03/2019,5,SP 78_1 tra Bazzano e Intersezione SP 27 a Monteveglio,7832,10,7608,223,5697,2135,7832,0
2019/03,281,02/03/2019,6,SP 78_1 tra Bazzano e Intersezione SP 27 a Monteveglio,6944,10,6852,91,5258,1686,0,6944
2019/03,281,03/03/2019,7,SP 78_1 tra Bazzano e Intersezione SP 27 a Monteveglio,5369,00,5331,38,4182,1187,0,5369
2019/03,281,04/03/2019,1,SP 78_1 tra Bazzano e Intersezione SP 27 a Monteveglio,6829,00,6590,239,5526,1303,6829,0
2019/03,281,05/03/2019,2,SP 78_1 tra Bazzano e Intersezione SP 27 a Monteveglio,6847,00,6627,220,5428,1419,6847,0
2019/03,281,06/03/2019,3,SP 78_1 tra Bazzano e Intersezione SP 27 a Monteveglio,7130,50,6870,255,5690,1440,7130,0
2019/03,281,07/03/2019,4,SP 78_1 tra Bazzano e Intersezione SP 27 a Monteveglio,7119,10,6896,222,5617,1502,7119,0
2019/03,281,08/03/2019,5,SP 78_1 tra Bazzano e Intersezione SP 27 a Monteveglio,7478,20,7219,257,5738,1740,7478,0
2019/03,281,09/03/2019,6,SP 78_1 tra Bazzano e Intersezione SP 27 a Monteveglio,7099,10,6994,104,5320,1779,0,7099
2019/03,281,10/03/2019,7,SP 78_1 tra Bazzano e Intersezione SP 27 a Monteveglio,5343,00,5297,46,4080,1263,0,5343
2019/03,281,11/03/2019,1,SP 78_1 tra Bazzano e Intersezione SP 27 a Monteveglio,6756,30,6503,250,5422,1334,6756,0
2019/03,281,12/03/2019,2,SP 78_1 tra Bazzano e Intersezione SP 27 a Monteveglio,6814,50,6563,246,5386,1428,6814,0
2019/03,281,13/03/2019,3,SP 78_1 tra Bazzano e Intersezione SP 27 a Monteveglio,7057,40,6808,245,5546,1511,7057,0
2019/03,281,14/03/2019,4,SP 78_1 tra Bazzano e Intersezione SP 27 a Monteveglio,7047,10,6805,241,5575,1472,7047,0
2019/03,282,01/03/2019,5,SS 9 tra Anzola dell'Emilia e Bologna,25338,00,22976,2362,18831,6507,25338,0
2019/03,282,02/03/2019,6,SS 9 tra Anzola dell'Emilia e Bologna,18565,00,18039,526,12961,5604,0,18565
2019/03,282,03/03/2019,7,SS 9 tra Anzola dell'Emilia e Bologna,15174,00,15042,132,10465,4709,0,15174
2019/03,282,04/03/2019,1,SS 9 tra Anzola dell'Emilia e Bologna,23930,00,21637,2293,18320,5610,23930,0
2019/03,282,05/03/2019,2,SS 9 tra Anzola dell'Emilia e Bologna,24186,00,21849,2337,18367,5819,24186,0
2019/03,282,06/03/2019,3,SS 9 tra Anzola dell'Emilia e Bologna,25368,00,22785,2583,19137,6231,25368,0
2019/03,282,07/03/2019,4,SS 9 tra Anzola dell'Emilia e Bologna,26327,00,23742,2585,19852,6475,26327,0
2019/03,282,08/03/2019,5,SS 9 tra Anzola dell'Emilia e Bologna,27115,30,24620,2492,20275,6840,27115,0
2019/03,282,09/03/2019,6,SS 9 tra Anzola dell'Emilia e Bologna,18886,10,18354,531,13165,5721,0,18886
2019/03,282,10/03/2019,7,SS 9 tra Anzola dell'Emilia e Bologna,18355,00,17768,587,10903,7452,0,18355
2019/03,282,11/03/2019,1,SS 9 tra Anzola dell'Emilia e Bologna,24633,10,22222,2410,18927,5706,24633,0
2019/03,282,12/03/2019,2,SS 9 tra Anzola dell'Emilia e Bologna,24256,10,21963,2292,18201,6055,24256,0
2019/03,282,13/03/2019,3,SS 9 tra Anzola dell'Emilia e Bologna,24176,10,21922,2253,17853,6323,24176,0
2019/03,282,14/03/2019,4,SS 9 tra Anzola dell'Emilia e Bologna,24470,00,22078,2392,18308,6162,24470,0
2019/03,285,01/03/2019,5,SP 1 fra Crevalcore e Decima,6745,00,6262,483,5160,1585,6745,0
2019/03,285,02/03/2019,6,SP 1 fra Crevalcore e Decima,5495,00,5388,107,3895,1600,0,5495
2019/03,285,03/03/2019,7,SP 1 fra Crevalcore e Decima,4541,00,4507,34,3349,1192,0,4541
2019/03,285,07/03/2019,4,SP 1 fra Crevalcore e Decima,6384,00,5953,431,4954,1430,6384,0
2019/03,285,08/03/2019,5,SP 1 fra Crevalcore e Decima,6880,00,6480,400,5206,1674,6880,0
2019/03,285,09/03/2019,6,SP 1 fra Crevalcore e Decima,5417,00,5319,98,3763,1654,0,5417
2019/03,285,10/03/2019,7,SP 1 fra Crevalcore e Decima,3951,00,3927,24,2712,1239,0,3951
2019/03,285,11/03/2019,1,SP 1 fra Crevalcore e Decima,6212,00,5805,407,4976,1236,6212,0
2019/03,285,12/03/2019,2,SP 1 fra Crevalcore e Decima,6441,00,5978,463,5061,1380,6441,0
2019/03,285,13/03/2019,3,SP 1 fra Crevalcore e Decima,6475,00,5990,485,5061,1414,6475,0
2019/03,285,14/03/2019,4,SP 1 fra Crevalcore e Decima,6637,00,6153,484,5215,1422,6637,0
2019/03,287,01/03/2019,5,SP 6 fra Cento e Pilastrello,8100,00,7676,424,6274,1826,8100,0
2019/03,287,02/03/2019,6,SP 6 fra Cento e Pilastrello,7264,10,7160,103,5202,2062,0,7264
2019/03,287,03/03/2019,7,SP 6 fra Cento e Pilastrello,5462,00,5445,17,3995,1467,0,5462
2019/03,287,04/03/2019,1,SP 6 fra Cento e Pilastrello,7794,10,7266,527,6355,1439,7794,0
2019/03,287,05/03/2019,2,SP 6 fra Cento e Pilastrello,8013,10,7507,505,6385,1628,8013,0
2019/03,287,06/03/2019,3,SP 6 fra Cento e Pilastrello,8089,00,7577,512,6364,1725,8089,0
2019/03,287,07/03/2019,4,SP 6 fra Cento e Pilastrello,8097,10,7592,504,6505,1592,8097,0
2019/03,287,08/03/2019,5,SP 6 fra Cento e Pilastrello,8554,20,8066,486,6615,1939,8554,0
2019/03,287,09/03/2019,6,SP 6 fra Cento e Pilastrello,7250,00,7141,109,5153,2097,0,7250
2019/03,287,10/03/2019,7,SP 6 fra Cento e Pilastrello,5842,00,5812,30,4226,1616,0,5842
2019/03,287,11/03/2019,1,SP 6 fra Cento e Pilastrello,7723,10,7195,527,6312,1411,7723,0
2019/03,287,12/03/2019,2,SP 6 fra Cento e Pilastrello,7864,00,7338,526,6371,1493,7864,0
2019/03,287,13/03/2019,3,SP 6 fra Cento e Pilastrello,7826,00,7309,517,6231,1595,7826,0
2019/03,287,14/03/2019,4,SP 6 fra Cento e Pilastrello,8127,00,7581,546,6511,1616,8127,0
2019/03,288,01/03/2019,5,SP 42 fra Pieve di Cento e Castello d'Argile,19644,00,18759,885,14900,4744,19644,0
2019/03,288,02/03/2019,6,SP 42 fra Pieve di Cento e Castello d'Argile,14775,10,14555,219,10549,4226,0,14775
2019/03,288,03/03/2019,7,SP 42 fra Pieve di Cento e Castello d'Argile,12519,00,12437,82,9091,3428,0,12519
2019/03,288,04/03/2019,1,SP 42 fra Pieve di Cento e Castello d'Argile,18644,00,17730,914,14590,4054,18644,0
2019/03,288,05/03/2019,2,SP 42 fra Pieve di Cento e Castello d'Argile,19033,00,18136,897,14791,4242,19033,0
2019/03,288,06/03/2019,3,SP 42 fra Pieve di Cento e Castello d'Argile,19226,10,18245,980,14769,4457,19226,0
2019/03,288,07/03/2019,4,SP 42 fra Pieve di Cento e Castello d'Argile,19291,00,18378,913,14897,4394,19291,0
2019/03,288,08/03/2019,5,SP 42 fra Pieve di Cento e Castello d'Argile,20125,10,19250,874,15135,4990,20125,0
2019/03,288,09/03/2019,6,SP 42 fra Pieve di Cento e Castello d'Argile,15512,00,15276,236,10905,4607,0,15512
2019/03,288,10/03/2019,7,SP 42 fra Pieve di Cento e Castello d'Argile,12854,00,12768,86,9310,3544,0,12854
2019/03,288,11/03/2019,1,SP 42 fra Pieve di Cento e Castello d'Argile,18581,10,17677,903,14600,3981,18581,0
2019/03,288,12/03/2019,2,SP 42 fra Pieve di Cento e Castello d'Argile,19090,00,18197,893,14859,4231,19090,0
2019/03,288,13/03/2019,3,SP 42 fra Pieve di Cento e Castello d'Argile,19095,00,18225,870,14587,4508,19095,0
2019/03,288,14/03/2019,4,SP 42 fra Pieve di Cento e Castello d'Argile,19800,00,18890,910,15338,4462,19800,0
2019/03,289,06/03/2019,3,SP 66 fra Cento e Sant'Agostino,14728,00,13915,813,11812,2916,14728,0
2019/03,289,07/03/2019,4,SP 66 fra Cento e Sant'Agostino,14717,10,13903,813,11735,2982,14717,0
2019/03,289,08/03/2019,5,SP 66 fra Cento e Sant'Agostino,16016,00,15260,756,12321,3695,16016,0
2019/03,289,09/03/2019,6,SP 66 fra Cento e Sant'Agostino,13150,00,12952,198,9626,3524,0,13150
2019/03,289,10/03/2019,7,SP 66 fra Cento e Sant'Agostino,10500,00,10451,49,7719,2781,0,10500
2019/03,289,11/03/2019,1,SP 66 fra Cento e Sant'Agostino,14417,00,13561,856,11792,2625,14417,0
2019/03,289,12/03/2019,2,SP 66 fra Cento e Sant'Agostino,14679,10,13831,847,11845,2834,14679,0
2019/03,289,13/03/2019,3,SP 66 fra Cento e Sant'Agostino,14988,10,14162,825,12030,2958,14988,0
2019/03,289,14/03/2019,4,SP 66 fra Cento e Sant'Agostino,14927,00,14113,814,12017,2910,14927,0
2019/03,290,01/03/2019,5,SP 11 fra Pieve di Cento e San Pietro in Casale,6776,00,6410,366,5238,1538,6776,0
2019/03,290,02/03/2019,6,SP 11 fra Pieve di Cento e San Pietro in Casale,5975,00,5844,131,4176,1799,0,5975
2019/03,290,03/03/2019,7,SP 11 fra Pieve di Cento e San Pietro in Casale,4861,00,4806,55,3434,1427,0,4861
2019/03,290,04/03/2019,1,SP 11 fra Pieve di Cento e San Pietro in Casale,6447,00,6055,392,5181,1266,6447,0
2019/03,290,05/03/2019,2,SP 11 fra Pieve di Cento e San Pietro in Casale,7066,00,6635,431,5116,1950,7066,0
2019/03,290,06/03/2019,3,SP 11 fra Pieve di Cento e San Pietro in Casale,7306,00,6877,429,5100,2206,7306,0
2019/03,290,07/03/2019,4,SP 11 fra Pieve di Cento e San Pietro in Casale,6468,00,6076,392,5141,1327,6468,0
2019/03,290,08/03/2019,5,SP 11 fra Pieve di Cento e San Pietro in Casale,7174,00,6798,376,5265,1909,7174,0
2019/03,290,09/03/2019,6,SP 11 fra Pieve di Cento e San Pietro in Casale,6040,00,5914,126,4142,1898,0,6040
2019/03,290,10/03/2019,7,SP 11 fra Pieve di Cento e San Pietro in Casale,4712,00,4661,51,3249,1463,0,4712
2019/03,290,11/03/2019,1,SP 11 fra Pieve di Cento e San Pietro in Casale,6313,00,5914,399,5108,1205,6313,0
2019/03,290,12/03/2019,2,SP 11 fra Pieve di Cento e San Pietro in Casale,6484,00,6079,405,5249,1235,6484,0
2019/03,290,13/03/2019,3,SP 11 fra Pieve di Cento e San Pietro in Casale,6487,10,6118,368,5178,1309,6487,0
2019/03,290,14/03/2019,4,SP 11 fra Pieve di Cento e San Pietro in Casale,6618,00,6218,400,5296,1322,6618,0
2019/03,291,01/03/2019,5,SP 4 tra San Pietro in Casale e San Vincenzo/San Venanzio,11181,00,10777,404,8437,2744,11181,0
2019/03,291,02/03/2019,6,SP 4 tra San Pietro in Casale e San Vincenzo/San Venanzio,9089,00,8974,115,6632,2457,0,9089
2019/03,291,03/03/2019,7,SP 4 tra San Pietro in Casale e San Vincenzo/San Venanzio,7206,00,7173,33,5337,1869,0,7206
2019/03,291,04/03/2019,1,SP 4 tra San Pietro in Casale e San Vincenzo/San Venanzio,10490,00,10050,440,8195,2295,10490,0
2019/03,291,05/03/2019,2,SP 4 tra San Pietro in Casale e San Vincenzo/San Venanzio,10507,20,10087,418,7878,2629,10507,0
2019/03,291,06/03/2019,3,SP 4 tra San Pietro in Casale e San Vincenzo/San Venanzio,10580,00,10204,376,7920,2660,10580,0
2019/03,291,07/03/2019,4,SP 4 tra San Pietro in Casale e San Vincenzo/San Venanzio,10511,10,10107,403,7984,2527,10511,0
2019/03,291,08/03/2019,5,SP 4 tra San Pietro in Casale e San Vincenzo/San Venanzio,11477,00,11069,408,8603,2874,11477,0
2019/03,291,09/03/2019,6,SP 4 tra San Pietro in Casale e San Vincenzo/San Venanzio,9136,00,9001,135,6666,2470,0,9136
2019/03,291,10/03/2019,7,SP 4 tra San Pietro in Casale e San Vincenzo/San Venanzio,7368,00,7333,35,5520,1848,0,7368
2019/03,291,11/03/2019,1,SP 4 tra San Pietro in Casale e San Vincenzo/San Venanzio,10356,00,9943,413,8053,2303,10356,0
2019/03,291,12/03/2019,2,SP 4 tra San Pietro in Casale e San Vincenzo/San Venanzio,10421,00,9998,423,8083,2338,10421,0
2019/03,291,13/03/2019,3,SP 4 tra San Pietro in Casale e San Vincenzo/San Venanzio,10519,00,10131,388,7977,2542,10519,0
2019/03,291,14/03/2019,4,SP 4 tra San Pietro in Casale e San Vincenzo/San Venanzio,10631,00,10209,422,8117,2514,10631,0
2019/03,292,01/03/2019,5,SP 4 tra San Giorgio di Piano e Intersezione SP 11 c/o San Pietro in Casale,18880,00,18184,696,14109,4771,18880,0
2019/03,292,02/03/2019,6,SP 4 tra San Giorgio di Piano e Intersezione SP 11 c/o San Pietro in Casale,15136,00,14940,196,10744,4392,0,15136
2019/03,292,03/03/2019,7,SP 4 tra San Giorgio di Piano e Intersezione SP 11 c/o San Pietro in Casale,12443,00,12405,38,9064,3379,0,12443
2019/03,292,04/03/2019,1,SP 4 tra San Giorgio di Piano e Intersezione SP 11 c/o San Pietro in Casale,17830,10,17140,689,13884,3946,17830,0
2019/03,292,05/03/2019,2,SP 4 tra San Giorgio di Piano e Intersezione SP 11 c/o San Pietro in Casale,18755,00,18111,644,13979,4776,18755,0
2019/03,292,06/03/2019,3,SP 4 tra San Giorgio di Piano e Intersezione SP 11 c/o San Pietro in Casale,18463,00,17825,638,13524,4939,18463,0
2019/03,292,07/03/2019,4,SP 4 tra San Giorgio di Piano e Intersezione SP 11 c/o San Pietro in Casale,18140,00,17496,644,13632,4508,18140,0
2019/03,292,08/03/2019,5,SP 4 tra San Giorgio di Piano e Intersezione SP 11 c/o San Pietro in Casale,19617,00,18921,696,14480,5137,19617,0
2019/03,292,09/03/2019,6,SP 4 tra San Giorgio di Piano e Intersezione SP 11 c/o San Pietro in Casale,15115,20,14880,233,10647,4468,0,15115
2019/03,292,10/03/2019,7,SP 4 tra San Giorgio di Piano e Intersezione SP 11 c/o San Pietro in Casale,10873,00,10829,44,7707,3166,0,10873
2019/03,292,11/03/2019,1,SP 4 tra San Giorgio di Piano e Intersezione SP 11 c/o San Pietro in Casale,17946,00,17283,663,13961,3985,17946,0
2019/03,292,12/03/2019,2,SP 4 tra San Giorgio di Piano e Intersezione SP 11 c/o San Pietro in Casale,18490,00,17826,664,14122,4368,18490,0
2019/03,292,13/03/2019,3,SP 4 tra San Giorgio di Piano e Intersezione SP 11 c/o San Pietro in Casale,18280,00,17636,644,13742,4538,18280,0
2019/03,292,14/03/2019,4,SP 4 tra San Giorgio di Piano e Intersezione SP 11 c/o San Pietro in Casale,19216,00,18473,743,14817,4399,19216,0
2019/03,295,01/03/2019,5,SP 9 fra Colorno e Torrile centro abitato di Bezze,7160,00,6650,510,5741,1419,7160,0
2019/03,295,02/03/2019,6,SP 9 fra Colorno e Torrile centro abitato di Bezze,4841,00,4671,170,3674,1167,0,4841
2019/03,295,03/03/2019,7,SP 9 fra Colorno e Torrile centro abitato di Bezze,3845,00,3783,62,2952,893,0,3845
2019/03,295,04/03/2019,1,SP 9 fra Colorno e Torrile centro abitato di Bezze,6657,10,6175,481,5385,1272,6657,0
2019/03,295,05/03/2019,2,SP 9 fra Colorno e Torrile centro abitato di Bezze,6922,10,6439,482,5536,1386,6922,0
2019/03,295,06/03/2019,3,SP 9 fra Colorno e Torrile centro abitato di Bezze,6827,00,6335,492,5403,1424,6827,0
2019/03,295,07/03/2019,4,SP 9 fra Colorno e Torrile centro abitato di Bezze,6848,00,6378,470,5518,1330,6848,0
2019/03,295,08/03/2019,5,SP 9 fra Colorno e Torrile centro abitato di Bezze,6981,00,6483,498,5525,1456,6981,0
2019/03,295,09/03/2019,6,SP 9 fra Colorno e Torrile centro abitato di Bezze,5019,20,4825,192,3793,1226,0,5019
2019/03,295,10/03/2019,7,SP 9 fra Colorno e Torrile centro abitato di Bezze,3706,10,3630,75,2774,932,0,3706
2019/03,295,11/03/2019,1,SP 9 fra Colorno e Torrile centro abitato di Bezze,6742,10,6222,519,5502,1240,6742,0
2019/03,295,12/03/2019,2,SP 9 fra Colorno e Torrile centro abitato di Bezze,6899,10,6401,497,5615,1284,6899,0
2019/03,295,13/03/2019,3,SP 9 fra Colorno e Torrile centro abitato di Bezze,7042,00,6573,469,5625,1417,7042,0
2019/03,295,14/03/2019,4,SP 9 fra Colorno e Torrile centro abitato di Bezze,6976,00,6477,499,5601,1375,6976,0
2019/03,298,01/03/2019,5,SP 588R da Castione Marchesi (A 1) a Busseto,3131,00,2961,170,2478,653,3131,0
2019/03,298,02/03/2019,6,SP 588R da Castione Marchesi (A 1) a Busseto,2617,10,2560,56,1896,721,0,2617
2019/03,298,03/03/2019,7,SP 588R da Castione Marchesi (A 1) a Busseto,2109,00,2085,24,1574,535,0,2109
2019/03,298,04/03/2019,1,SP 588R da Castione Marchesi (A 1) a Busseto,2912,10,2750,161,2349,563,2912,0
2019/03,298,05/03/2019,2,SP 588R da Castione Marchesi (A 1) a Busseto,3053,00,2878,175,2447,606,3053,0
2019/03,298,06/03/2019,3,SP 588R da Castione Marchesi (A 1) a Busseto,2988,00,2801,187,2390,598,2988,0
2019/03,298,07/03/2019,4,SP 588R da Castione Marchesi (A 1) a Busseto,3116,10,2902,213,2483,633,3116,0
2019/03,298,08/03/2019,5,SP 588R da Castione Marchesi (A 1) a Busseto,3285,00,3090,195,2555,730,3285,0
2019/03,298,09/03/2019,6,SP 588R da Castione Marchesi (A 1) a Busseto,2747,00,2666,81,1954,793,0,2747
2019/03,298,10/03/2019,7,SP 588R da Castione Marchesi (A 1) a Busseto,2099,00,2069,30,1561,538,0,2099
2019/03,298,11/03/2019,1,SP 588R da Castione Marchesi (A 1) a Busseto,2867,00,2683,184,2353,514,2867,0
2019/03,298,12/03/2019,2,SP 588R da Castione Marchesi (A 1) a Busseto,3133,00,2926,207,2515,618,3133,0
2019/03,298,13/03/2019,3,SP 588R da Castione Marchesi (A 1) a Busseto,3054,00,2868,186,2428,626,3054,0
2019/03,298,14/03/2019,4,SP 588R da Castione Marchesi (A 1) a Busseto,3118,10,2913,204,2516,602,3118,0
2019/03,300,01/03/2019,5,SP 462R fra Fiorenzuola d'Arda e Cortemaggiore,8914,10,7893,1020,6998,1916,8914,0
2019/03,300,02/03/2019,6,SP 462R fra Fiorenzuola d'Arda e Cortemaggiore,7457,10,7140,316,5701,1756,0,7457
2019/03,300,03/03/2019,7,SP 462R fra Fiorenzuola d'Arda e Cortemaggiore,8009,00,7914,95,6458,1551,0,8009
2019/03,300,04/03/2019,1,SP 462R fra Fiorenzuola d'Arda e Cortemaggiore,8368,20,7288,1078,6749,1619,8368,0
2019/03,300,05/03/2019,2,SP 462R fra Fiorenzuola d'Arda e Cortemaggiore,8336,00,7300,1036,6759,1577,8336,0
2019/03,300,06/03/2019,3,SP 462R fra Fiorenzuola d'Arda e Cortemaggiore,8531,10,7446,1084,6870,1661,8531,0
2019/03,300,07/03/2019,4,SP 462R fra Fiorenzuola d'Arda e Cortemaggiore,8670,30,7541,1126,6998,1672,8670,0
2019/03,300,08/03/2019,5,SP 462R fra Fiorenzuola d'Arda e Cortemaggiore,9128,30,8005,1120,7076,2052,9128,0
2019/03,300,09/03/2019,6,SP 462R fra Fiorenzuola d'Arda e Cortemaggiore,6930,00,6607,323,5113,1817,0,6930
2019/03,300,10/03/2019,7,SP 462R fra Fiorenzuola d'Arda e Cortemaggiore,5911,00,5842,69,4560,1351,0,5911
2019/03,300,11/03/2019,1,SP 462R fra Fiorenzuola d'Arda e Cortemaggiore,9138,10,7938,1199,7565,1573,9138,0
2019/03,300,12/03/2019,2,SP 462R fra Fiorenzuola d'Arda e Cortemaggiore,8413,10,7338,1074,6808,1605,8413,0
2019/03,300,13/03/2019,3,SP 462R fra Fiorenzuola d'Arda e Cortemaggiore,8746,20,7689,1055,7047,1699,8746,0
2019/03,300,14/03/2019,4,SP 462R fra Fiorenzuola d'Arda e Cortemaggiore,8762,50,7664,1093,7022,1740,8762,0
2019/03,301,01/03/2019,5,SP 4 tra Fiorenzuola d'Arda (Tg Sud) e Castell'Arquato,8862,10,8219,642,6830,2032,8862,0
2019/03,301,02/03/2019,6,SP 4 tra Fiorenzuola d'Arda (Tg Sud) e Castell'Arquato,8375,10,8258,116,6340,2035,0,8375
2019/03,301,03/03/2019,7,SP 4 tra Fiorenzuola d'Arda (Tg Sud) e Castell'Arquato,7198,00,7178,20,5472,1726,0,7198
2019/03,301,04/03/2019,1,SP 4 tra Fiorenzuola d'Arda (Tg Sud) e Castell'Arquato,7922,00,7417,505,6357,1565,7922,0
2019/03,301,05/03/2019,2,SP 4 tra Fiorenzuola d'Arda (Tg Sud) e Castell'Arquato,8298,10,7778,519,6590,1708,8298,0
2019/03,301,06/03/2019,3,SP 4 tra Fiorenzuola d'Arda (Tg Sud) e Castell'Arquato,8282,00,7839,443,6400,1882,8282,0
2019/03,301,07/03/2019,4,SP 4 tra Fiorenzuola d'Arda (Tg Sud) e Castell'Arquato,8362,00,7852,510,6552,1810,8362,0
2019/03,301,08/03/2019,5,SP 4 tra Fiorenzuola d'Arda (Tg Sud) e Castell'Arquato,8828,00,8377,451,6753,2075,8828,0
2019/03,301,09/03/2019,6,SP 4 tra Fiorenzuola d'Arda (Tg Sud) e Castell'Arquato,7933,10,7795,137,5977,1956,0,7933
2019/03,301,10/03/2019,7,SP 4 tra Fiorenzuola d'Arda (Tg Sud) e Castell'Arquato,6716,00,6677,39,5096,1620,0,6716
2019/03,301,11/03/2019,1,SP 4 tra Fiorenzuola d'Arda (Tg Sud) e Castell'Arquato,8022,00,7518,504,6471,1551,8022,0
2019/03,301,12/03/2019,2,SP 4 tra Fiorenzuola d'Arda (Tg Sud) e Castell'Arquato,8358,30,7809,546,6626,1732,8358,0
2019/03,301,13/03/2019,3,SP 4 tra Fiorenzuola d'Arda (Tg Sud) e Castell'Arquato,8328,00,7822,506,6573,1755,8328,0
2019/03,301,14/03/2019,4,SP 4 tra Fiorenzuola d'Arda (Tg Sud) e Castell'Arquato,8832,10,8272,559,6935,1897,8832,0
2019/03,303,01/03/2019,5,SP 11 fra Borgonovo e Gragnano,10088,00,9564,524,7906,2182,10088,0
2019/03,303,02/03/2019,6,SP 11 fra Borgonovo e Gragnano,8734,10,8567,166,6628,2106,0,8734
2019/03,303,03/03/2019,7,SP 11 fra Borgonovo e Gragnano,7637,00,7605,32,5884,1753,0,7637
2019/03,303,04/03/2019,1,SP 11 fra Borgonovo e Gragnano,9426,10,8916,509,7595,1831,9426,0
2019/03,303,05/03/2019,2,SP 11 fra Borgonovo e Gragnano,9457,10,8947,509,7526,1931,9457,0
2019/03,303,06/03/2019,3,SP 11 fra Borgonovo e Gragnano,9505,00,8995,510,7541,1964,9505,0
2019/03,303,07/03/2019,4,SP 11 fra Borgonovo e Gragnano,9684,10,9159,524,7671,2013,9684,0
2019/03,303,08/03/2019,5,SP 11 fra Borgonovo e Gragnano,10047,10,9579,467,7833,2214,10047,0
2019/03,303,09/03/2019,6,SP 11 fra Borgonovo e Gragnano,8863,00,8706,157,6529,2334,0,8863
2019/03,303,10/03/2019,7,SP 11 fra Borgonovo e Gragnano,7642,00,7602,40,5853,1789,0,7642
2019/03,303,11/03/2019,1,SP 11 fra Borgonovo e Gragnano,9305,00,8802,503,7487,1818,9305,0
2019/03,303,12/03/2019,2,SP 11 fra Borgonovo e Gragnano,9416,00,8933,483,7496,1920,9416,0
2019/03,303,13/03/2019,3,SP 11 fra Borgonovo e Gragnano,9651,10,9146,504,7659,1992,9651,0
2019/03,303,14/03/2019,4,SP 11 fra Borgonovo e Gragnano,9860,20,9343,515,7817,2043,9860,0
2019/03,304,01/03/2019,5,SP 42 fra Podenzano e bivio SP 6/ponte fiume Nure in località San Giorgio Piacentino,7370,00,6875,495,5698,1672,7370,0
2019/03,304,02/03/2019,6,SP 42 fra Podenzano e bivio SP 6/ponte fiume Nure in località San Giorgio Piacentino,5847,10,5731,115,4201,1646,0,5847
2019/03,304,03/03/2019,7,SP 42 fra Podenzano e bivio SP 6/ponte fiume Nure in località San Giorgio Piacentino,5585,10,5566,18,4376,1209,0,5585
2019/03,304,04/03/2019,1,SP 42 fra Podenzano e bivio SP 6/ponte fiume Nure in località San Giorgio Piacentino,6827,00,6353,474,5487,1340,6827,0
2019/03,304,05/03/2019,2,SP 42 fra Podenzano e bivio SP 6/ponte fiume Nure in località San Giorgio Piacentino,7063,00,6525,538,5622,1441,7063,0
2019/03,304,06/03/2019,3,SP 42 fra Podenzano e bivio SP 6/ponte fiume Nure in località San Giorgio Piacentino,7253,00,6750,503,5751,1502,7253,0
2019/03,304,07/03/2019,4,SP 42 fra Podenzano e bivio SP 6/ponte fiume Nure in località San Giorgio Piacentino,7135,00,6677,458,5630,1505,7135,0
2019/03,304,08/03/2019,5,SP 42 fra Podenzano e bivio SP 6/ponte fiume Nure in località San Giorgio Piacentino,7436,00,6958,478,5704,1732,7436,0
2019/03,304,09/03/2019,6,SP 42 fra Podenzano e bivio SP 6/ponte fiume Nure in località San Giorgio Piacentino,6143,00,6028,115,4548,1595,0,6143
2019/03,304,10/03/2019,7,SP 42 fra Podenzano e bivio SP 6/ponte fiume Nure in località San Giorgio Piacentino,5500,00,5482,18,4348,1152,0,5500
2019/03,304,11/03/2019,1,SP 42 fra Podenzano e bivio SP 6/ponte fiume Nure in località San Giorgio Piacentino,6712,00,6312,400,5371,1341,6712,0
2019/03,304,12/03/2019,2,SP 42 fra Podenzano e bivio SP 6/ponte fiume Nure in località San Giorgio Piacentino,6887,00,6482,405,5504,1383,6887,0
2019/03,304,13/03/2019,3,SP 42 fra Podenzano e bivio SP 6/ponte fiume Nure in località San Giorgio Piacentino,7179,00,6756,423,5664,1515,7179,0
2019/03,304,14/03/2019,4,SP 42 fra Podenzano e bivio SP 6/ponte fiume Nure in località San Giorgio Piacentino,7193,00,6679,514,5757,1436,7193,0
2019/03,305,01/03/2019,5,SP 6Bis fra Carpaneto e Castell'Arquato,4905,00,4460,445,3781,1124,4905,0
2019/03,305,02/03/2019,6,SP 6Bis fra Carpaneto e Castell'Arquato,4523,00,4374,149,3329,1194,0,4523
2019/03,305,03/03/2019,7,SP 6Bis fra Carpaneto e Castell'Arquato,4433,00,4387,46,3526,907,0,4433
2019/03,305,04/03/2019,1,SP 6Bis fra Carpaneto e Castell'Arquato,4312,00,3824,488,3487,825,4312,0
2019/03,305,05/03/2019,2,SP 6Bis fra Carpaneto e Castell'Arquato,4426,10,3940,485,3524,902,4426,0
2019/03,305,06/03/2019,3,SP 6Bis fra Carpaneto e Castell'Arquato,4515,00,4214,301,3556,959,4515,0
2019/03,305,07/03/2019,4,SP 6Bis fra Carpaneto e Castell'Arquato,4348,00,4047,301,3441,907,4348,0
2019/03,305,08/03/2019,5,SP 6Bis fra Carpaneto e Castell'Arquato,4710,00,4442,268,3595,1115,4710,0
2019/03,305,09/03/2019,6,SP 6Bis fra Carpaneto e Castell'Arquato,4737,10,4602,134,3463,1274,0,4737
2019/03,305,10/03/2019,7,SP 6Bis fra Carpaneto e Castell'Arquato,4347,00,4301,46,3381,966,0,4347
2019/03,305,11/03/2019,1,SP 6Bis fra Carpaneto e Castell'Arquato,4019,00,3763,256,3197,822,4019,0
2019/03,305,12/03/2019,2,SP 6Bis fra Carpaneto e Castell'Arquato,4139,10,3930,208,3322,817,4139,0
2019/03,305,13/03/2019,3,SP 6Bis fra Carpaneto e Castell'Arquato,4358,10,4113,244,3391,967,4358,0
2019/03,305,14/03/2019,4,SP 6Bis fra Carpaneto e Castell'Arquato,4371,00,4102,269,3427,944,4371,0
2019/03,306,01/03/2019,5,SP 654R fra Ponte dell'Olio e Bettola,4736,20,4514,220,3617,1119,4736,0
2019/03,306,02/03/2019,6,SP 654R fra Ponte dell'Olio e Bettola,4516,10,4438,77,3518,998,0,4516
2019/03,306,03/03/2019,7,SP 654R fra Ponte dell'Olio e Bettola,4728,00,4700,28,3844,884,0,4728
2019/03,306,04/03/2019,1,SP 654R fra Ponte dell'Olio e Bettola,4719,20,4516,201,3879,840,4719,0
2019/03,306,05/03/2019,2,SP 654R fra Ponte dell'Olio e Bettola,4479,00,4322,157,3530,949,4479,0
2019/03,306,06/03/2019,3,SP 654R fra Ponte dell'Olio e Bettola,4346,20,4178,166,3449,897,4346,0
2019/03,306,07/03/2019,4,SP 654R fra Ponte dell'Olio e Bettola,4352,10,4160,191,3464,888,4352,0
2019/03,306,08/03/2019,5,SP 654R fra Ponte dell'Olio e Bettola,4718,00,4554,164,3587,1131,4718,0
2019/03,306,09/03/2019,6,SP 654R fra Ponte dell'Olio e Bettola,4577,10,4478,98,3463,1114,0,4577
2019/03,306,10/03/2019,7,SP 654R fra Ponte dell'Olio e Bettola,4647,00,4624,23,3692,955,0,4647
2019/03,306,11/03/2019,1,SP 654R fra Ponte dell'Olio e Bettola,4841,00,4681,160,3984,857,4841,0
2019/03,306,12/03/2019,2,SP 654R fra Ponte dell'Olio e Bettola,4272,00,4108,164,3451,821,4272,0
2019/03,306,13/03/2019,3,SP 654R fra Ponte dell'Olio e Bettola,4402,20,4236,164,3494,908,4402,0
2019/03,306,14/03/2019,4,SP 654R fra Ponte dell'Olio e Bettola,4116,20,3976,138,3294,822,4116,0
2019/03,307,01/03/2019,5,SS 45 tra Rivergaro e Perino,4782,00,4556,226,3671,1111,4782,0
2019/03,307,02/03/2019,6,SS 45 tra Rivergaro e Perino,5350,00,5243,107,4328,1022,0,5350
2019/03,307,03/03/2019,7,SS 45 tra Rivergaro e Perino,8178,00,8152,26,7042,1136,0,8178
2019/03,307,04/03/2019,1,SS 45 tra Rivergaro e Perino,4052,00,3874,178,3268,784,4052,0
2019/03,307,05/03/2019,2,SS 45 tra Rivergaro e Perino,4223,00,4038,185,3397,826,4223,0
2019/03,307,06/03/2019,3,SS 45 tra Rivergaro e Perino,4411,00,4207,204,3547,864,4411,0
2019/03,307,07/03/2019,4,SS 45 tra Rivergaro e Perino,4190,00,3997,193,3355,835,4190,0
2019/03,307,08/03/2019,5,SS 45 tra Rivergaro e Perino,4940,10,4725,214,3784,1156,4940,0
2019/03,307,09/03/2019,6,SS 45 tra Rivergaro e Perino,5722,00,5596,126,4489,1233,0,5722
2019/03,307,10/03/2019,7,SS 45 tra Rivergaro e Perino,7002,00,6974,28,5824,1178,0,7002
2019/03,307,11/03/2019,1,SS 45 tra Rivergaro e Perino,4284,00,4082,202,3403,881,4284,0
2019/03,307,12/03/2019,2,SS 45 tra Rivergaro e Perino,4331,30,4107,221,3527,804,4331,0
2019/03,307,13/03/2019,3,SS 45 tra Rivergaro e Perino,4320,00,4111,209,3425,895,4320,0
2019/03,307,14/03/2019,4,SS 45 tra Rivergaro e Perino,4302,00,4098,204,3368,934,4302,0
2019/03,308,01/03/2019,5,SP 412R fra Pianello Val Tidone e Borgonovo Val Tidone,7177,00,6868,309,5681,1496,7177,0
2019/03,308,02/03/2019,6,SP 412R fra Pianello Val Tidone e Borgonovo Val Tidone,7171,20,7037,132,5602,1569,0,7171
2019/03,308,03/03/2019,7,SP 412R fra Pianello Val Tidone e Borgonovo Val Tidone,6652,00,6620,32,5324,1328,0,6652
2019/03,308,04/03/2019,1,SP 412R fra Pianello Val Tidone e Borgonovo Val Tidone,6731,00,6384,347,5453,1278,6731,0
2019/03,308,05/03/2019,2,SP 412R fra Pianello Val Tidone e Borgonovo Val Tidone,6644,10,6292,351,5300,1344,6644,0
2019/03,308,06/03/2019,3,SP 412R fra Pianello Val Tidone e Borgonovo Val Tidone,7041,00,6664,377,5759,1282,7041,0
2019/03,308,07/03/2019,4,SP 412R fra Pianello Val Tidone e Borgonovo Val Tidone,6916,10,6474,441,5474,1442,6916,0
2019/03,308,08/03/2019,5,SP 412R fra Pianello Val Tidone e Borgonovo Val Tidone,7299,10,6952,346,5699,1600,7299,0
2019/03,308,09/03/2019,6,SP 412R fra Pianello Val Tidone e Borgonovo Val Tidone,7242,10,7106,135,5528,1714,0,7242
2019/03,308,10/03/2019,7,SP 412R fra Pianello Val Tidone e Borgonovo Val Tidone,6573,10,6538,34,5256,1317,0,6573
2019/03,308,11/03/2019,1,SP 412R fra Pianello Val Tidone e Borgonovo Val Tidone,6499,00,6194,305,5328,1171,6499,0
2019/03,308,12/03/2019,2,SP 412R fra Pianello Val Tidone e Borgonovo Val Tidone,6555,00,6241,314,5271,1284,6555,0
2019/03,308,13/03/2019,3,SP 412R fra Pianello Val Tidone e Borgonovo Val Tidone,7267,10,6938,328,5928,1339,7267,0
2019/03,308,14/03/2019,4,SP 412R fra Pianello Val Tidone e Borgonovo Val Tidone,6762,00,6396,366,5374,1388,6762,0
2019/03,309,01/03/2019,5,SP 10R fra Castelvetro Piacentino e Monticelli d'Ongina,12388,00,11847,541,9607,2781,12388,0
2019/03,309,02/03/2019,6,SP 10R fra Castelvetro Piacentino e Monticelli d'Ongina,11236,00,11057,179,8311,2925,0,11236
2019/03,309,03/03/2019,7,SP 10R fra Castelvetro Piacentino e Monticelli d'Ongina,9846,00,9795,51,7660,2186,0,9846
2019/03,309,04/03/2019,1,SP 10R fra Castelvetro Piacentino e Monticelli d'Ongina,11058,20,10548,508,8764,2294,11058,0
2019/03,309,05/03/2019,2,SP 10R fra Castelvetro Piacentino e Monticelli d'Ongina,11140,10,10603,536,8921,2219,11140,0
2019/03,309,06/03/2019,3,SP 10R fra Castelvetro Piacentino e Monticelli d'Ongina,11401,20,10859,540,9052,2349,11401,0
2019/03,309,07/03/2019,4,SP 10R fra Castelvetro Piacentino e Monticelli d'Ongina,11373,00,10825,548,9034,2339,11373,0
2019/03,309,08/03/2019,5,SP 10R fra Castelvetro Piacentino e Monticelli d'Ongina,12184,10,11668,515,9361,2823,12184,0
2019/03,309,09/03/2019,6,SP 10R fra Castelvetro Piacentino e Monticelli d'Ongina,11186,10,11030,155,8190,2996,0,11186
2019/03,309,10/03/2019,7,SP 10R fra Castelvetro Piacentino e Monticelli d'Ongina,9726,00,9666,60,7524,2202,0,9726
2019/03,309,11/03/2019,1,SP 10R fra Castelvetro Piacentino e Monticelli d'Ongina,11322,20,10804,516,9033,2289,11322,0
2019/03,309,12/03/2019,2,SP 10R fra Castelvetro Piacentino e Monticelli d'Ongina,11110,10,10595,514,8783,2327,11110,0
2019/03,309,13/03/2019,3,SP 10R fra Castelvetro Piacentino e Monticelli d'Ongina,11265,10,10700,564,8936,2329,11265,0
2019/03,309,14/03/2019,4,SP 10R fra Castelvetro Piacentino e Monticelli d'Ongina,11428,20,10885,541,9025,2403,11428,0
2019/03,310,01/03/2019,5,SP 358R fra Cadelbosco di Sopra e Castelnovo di Sotto,16694,00,15761,933,12831,3863,16694,0
2019/03,310,02/03/2019,6,SP 358R fra Cadelbosco di Sopra e Castelnovo di Sotto,12113,00,11881,232,9545,2568,0,12113
2019/03,311,01/03/2019,5,SP 62RVar tra la località San Giacomo (bivio SP 42) ed SP 2 (c/o Tagliata),12083,00,9587,2496,9497,2586,12083,0
2019/03,311,02/03/2019,6,SP 62RVar tra la località San Giacomo (bivio SP 42) ed SP 2 (c/o Tagliata),8630,00,8210,420,6330,2300,0,8630
2019/03,311,03/03/2019,7,SP 62RVar tra la località San Giacomo (bivio SP 42) ed SP 2 (c/o Tagliata),8565,00,8442,123,6171,2394,0,8565
2019/03,311,04/03/2019,1,SP 62RVar tra la località San Giacomo (bivio SP 42) ed SP 2 (c/o Tagliata),11444,00,8776,2668,9246,2198,11444,0
2019/03,311,05/03/2019,2,SP 62RVar tra la località San Giacomo (bivio SP 42) ed SP 2 (c/o Tagliata),11853,00,9001,2852,9477,2376,11853,0
2019/03,311,06/03/2019,3,SP 62RVar tra la località San Giacomo (bivio SP 42) ed SP 2 (c/o Tagliata),11807,00,8886,2921,9366,2441,11807,0
2019/03,311,07/03/2019,4,SP 62RVar tra la località San Giacomo (bivio SP 42) ed SP 2 (c/o Tagliata),11936,00,9025,2911,9601,2335,11936,0
2019/03,311,08/03/2019,5,SP 62RVar tra la località San Giacomo (bivio SP 42) ed SP 2 (c/o Tagliata),12348,00,9663,2685,9701,2647,12348,0
2019/03,311,09/03/2019,6,SP 62RVar tra la località San Giacomo (bivio SP 42) ed SP 2 (c/o Tagliata),8635,00,8190,445,6301,2334,0,8635
2019/03,311,10/03/2019,7,SP 62RVar tra la località San Giacomo (bivio SP 42) ed SP 2 (c/o Tagliata),8696,00,8559,137,6130,2566,0,8696
2019/03,311,11/03/2019,1,SP 62RVar tra la località San Giacomo (bivio SP 42) ed SP 2 (c/o Tagliata),11501,10,8843,2657,9269,2232,11501,0
2019/03,311,12/03/2019,2,SP 62RVar tra la località San Giacomo (bivio SP 42) ed SP 2 (c/o Tagliata),11941,00,8927,3014,9701,2240,11941,0
2019/03,311,13/03/2019,3,SP 62RVar tra la località San Giacomo (bivio SP 42) ed SP 2 (c/o Tagliata),11734,00,8818,2916,9346,2388,11734,0
2019/03,311,14/03/2019,4,SP 62RVar tra la località San Giacomo (bivio SP 42) ed SP 2 (c/o Tagliata),11872,00,9032,2840,9532,2340,11872,0
2019/03,312,01/03/2019,5,SP 42 fra Novellara e San Giacomo (SP 62R),,,,,,,,
2019/03,312,02/03/2019,6,SP 42 fra Novellara e San Giacomo (SP 62R),,,,,,,,
2019/03,312,03/03/2019,7,SP 42 fra Novellara e San Giacomo (SP 62R),,,,,,,,
2019/03,312,04/03/2019,1,SP 42 fra Novellara e San Giacomo (SP 62R),,,,,,,,
2019/03,312,05/03/2019,2,SP 42 fra Novellara e San Giacomo (SP 62R),14269,00,12861,1408,11371,2898,14269,0
2019/03,312,06/03/2019,3,SP 42 fra Novellara e San Giacomo (SP 62R),14371,00,12912,1459,11432,2939,14371,0
2019/03,312,07/03/2019,4,SP 42 fra Novellara e San Giacomo (SP 62R),14441,00,13068,1373,11630,2811,14441,0
2019/03,312,08/03/2019,5,SP 42 fra Novellara e San Giacomo (SP 62R),15080,00,13678,1402,11679,3401,15080,0
2019/03,312,09/03/2019,6,SP 42 fra Novellara e San Giacomo (SP 62R),11708,00,11496,212,8244,3464,0,11708
2019/03,312,10/03/2019,7,SP 42 fra Novellara e San Giacomo (SP 62R),10283,00,10202,81,7281,3002,0,10283
2019/03,312,11/03/2019,1,SP 42 fra Novellara e San Giacomo (SP 62R),14037,00,12623,1414,11365,2672,14037,0
2019/03,312,12/03/2019,2,SP 42 fra Novellara e San Giacomo (SP 62R),14561,00,13088,1473,11785,2776,14561,0
2019/03,312,13/03/2019,3,SP 42 fra Novellara e San Giacomo (SP 62R),14591,00,13154,1437,11425,3166,14591,0
2019/03,312,14/03/2019,4,SP 42 fra Novellara e San Giacomo (SP 62R),14588,10,13199,1388,11577,3011,14588,0
2019/03,314,01/03/2019,5,SP 2 fra Reggiolo (bivio SP 2) e località Villarotta (SP 84),9457,00,9030,427,7344,2113,9457,0
2019/03,314,02/03/2019,6,SP 2 fra Reggiolo (bivio SP 2) e località Villarotta (SP 84),7863,00,7649,214,5730,2133,0,7863
2019/03,314,03/03/2019,7,SP 2 fra Reggiolo (bivio SP 2) e località Villarotta (SP 84),6078,10,6022,55,4211,1867,0,6078
2019/03,314,04/03/2019,1,SP 2 fra Reggiolo (bivio SP 2) e località Villarotta (SP 84),8740,00,8319,421,6982,1758,8740,0
2019/03,314,05/03/2019,2,SP 2 fra Reggiolo (bivio SP 2) e località Villarotta (SP 84),9016,00,8547,469,7205,1811,9016,0
2019/03,314,06/03/2019,3,SP 2 fra Reggiolo (bivio SP 2) e località Villarotta (SP 84),9094,00,8587,507,7218,1876,9094,0
2019/03,314,07/03/2019,4,SP 2 fra Reggiolo (bivio SP 2) e località Villarotta (SP 84),9079,00,8614,465,7161,1918,9079,0
2019/03,314,08/03/2019,5,SP 2 fra Reggiolo (bivio SP 2) e località Villarotta (SP 84),9688,00,9257,431,7363,2325,9688,0
2019/03,314,09/03/2019,6,SP 2 fra Reggiolo (bivio SP 2) e località Villarotta (SP 84),7915,10,7779,135,5550,2365,0,7915
2019/03,314,10/03/2019,7,SP 2 fra Reggiolo (bivio SP 2) e località Villarotta (SP 84),6377,00,6337,40,4282,2095,0,6377
2019/03,314,11/03/2019,1,SP 2 fra Reggiolo (bivio SP 2) e località Villarotta (SP 84),8625,00,8212,413,6852,1773,8625,0
2019/03,314,12/03/2019,2,SP 2 fra Reggiolo (bivio SP 2) e località Villarotta (SP 84),8977,00,8547,430,7174,1803,8977,0
2019/03,314,13/03/2019,3,SP 2 fra Reggiolo (bivio SP 2) e località Villarotta (SP 84),9152,00,8724,428,7185,1967,9152,0
2019/03,314,14/03/2019,4,SP 2 fra Reggiolo (bivio SP 2) e località Villarotta (SP 84),9039,00,8607,432,7236,1803,9039,0
2019/03,318,01/03/2019,5,SP 51 fra Sassuolo (bivio SP 467R) e Rubiera,11799,10,9095,2703,9288,2511,11799,0
2019/03,318,02/03/2019,6,SP 51 fra Sassuolo (bivio SP 467R) e Rubiera,8392,10,8119,272,5831,2561,0,8392
2019/03,318,03/03/2019,7,SP 51 fra Sassuolo (bivio SP 467R) e Rubiera,6974,00,6915,59,4984,1990,0,6974
2019/03,318,04/03/2019,1,SP 51 fra Sassuolo (bivio SP 467R) e Rubiera,10926,00,8479,2447,8787,2139,10926,0
2019/03,318,05/03/2019,2,SP 51 fra Sassuolo (bivio SP 467R) e Rubiera,11395,20,8430,2963,9223,2172,11395,0
2019/03,318,06/03/2019,3,SP 51 fra Sassuolo (bivio SP 467R) e Rubiera,11445,10,8573,2871,9204,2241,11445,0
2019/03,318,07/03/2019,4,SP 51 fra Sassuolo (bivio SP 467R) e Rubiera,11750,10,8664,3085,9461,2289,11750,0
2019/03,318,08/03/2019,5,SP 51 fra Sassuolo (bivio SP 467R) e Rubiera,12157,00,9145,3012,9481,2676,12157,0
2019/03,318,09/03/2019,6,SP 51 fra Sassuolo (bivio SP 467R) e Rubiera,8264,00,8025,239,5601,2663,0,8264
2019/03,318,10/03/2019,7,SP 51 fra Sassuolo (bivio SP 467R) e Rubiera,8177,10,8106,70,5790,2387,0,8177
2019/03,318,11/03/2019,1,SP 51 fra Sassuolo (bivio SP 467R) e Rubiera,11213,30,8466,2744,9132,2081,11213,0
2019/03,318,12/03/2019,2,SP 51 fra Sassuolo (bivio SP 467R) e Rubiera,11466,10,8531,2934,9367,2099,11466,0
2019/03,318,13/03/2019,3,SP 51 fra Sassuolo (bivio SP 467R) e Rubiera,11639,30,8631,3005,9416,2223,11639,0
2019/03,318,14/03/2019,4,SP 51 fra Sassuolo (bivio SP 467R) e Rubiera,11967,50,8681,3281,9628,2339,11967,0
2019/03,319,01/03/2019,5,SP 15 tra Sassuolo e Magreta,,,,,,,,
2019/03,319,02/03/2019,6,SP 15 tra Sassuolo e Magreta,,,,,,,,
2019/03,319,03/03/2019,7,SP 15 tra Sassuolo e Magreta,,,,,,,,
2019/03,319,04/03/2019,1,SP 15 tra Sassuolo e Magreta,,,,,,,,
2019/03,319,05/03/2019,2,SP 15 tra Sassuolo e Magreta,,,,,,,,
2019/03,319,06/03/2019,3,SP 15 tra Sassuolo e Magreta,,,,,,,,
2019/03,319,07/03/2019,4,SP 15 tra Sassuolo e Magreta,,,,,,,,
2019/03,319,08/03/2019,5,SP 15 tra Sassuolo e Magreta,,,,,,,,
2019/03,319,09/03/2019,6,SP 15 tra Sassuolo e Magreta,,,,,,,,
2019/03,319,10/03/2019,7,SP 15 tra Sassuolo e Magreta,,,,,,,,
2019/03,319,11/03/2019,1,SP 15 tra Sassuolo e Magreta,,,,,,,,
2019/03,319,12/03/2019,2,SP 15 tra Sassuolo e Magreta,7223,00,6900,323,6071,1152,7223,0
2019/03,319,13/03/2019,3,SP 15 tra Sassuolo e Magreta,7237,00,6937,300,5962,1275,7237,0
2019/03,319,14/03/2019,4,SP 15 tra Sassuolo e Magreta,7361,00,7050,311,6107,1254,7361,0
2019/03,321,01/03/2019,5,SP 467 tra SP 486 e confine provinciale,,,,,,,,
2019/03,321,02/03/2019,6,SP 467 tra SP 486 e confine provinciale,,,,,,,,
2019/03,321,03/03/2019,7,SP 467 tra SP 486 e confine provinciale,,,,,,,,
2019/03,321,04/03/2019,1,SP 467 tra SP 486 e confine provinciale,,,,,,,,
2019/03,321,05/03/2019,2,SP 467 tra SP 486 e confine provinciale,,,,,,,,
2019/03,321,06/03/2019,3,SP 467 tra SP 486 e confine provinciale,,,,,,,,
2019/03,321,07/03/2019,4,SP 467 tra SP 486 e confine provinciale,,,,,,,,
2019/03,321,08/03/2019,5,SP 467 tra SP 486 e confine provinciale,,,,,,,,
2019/03,321,09/03/2019,6,SP 467 tra SP 486 e confine provinciale,,,,,,,,
2019/03,321,10/03/2019,7,SP 467 tra SP 486 e confine provinciale,,,,,,,,
2019/03,321,11/03/2019,1,SP 467 tra SP 486 e confine provinciale,,,,,,,,
2019/03,321,12/03/2019,2,SP 467 tra SP 486 e confine provinciale,,,,,,,,
2019/03,321,13/03/2019,3,SP 467 tra SP 486 e confine provinciale,,,,,,,,
2019/03,321,14/03/2019,4,SP 467 tra SP 486 e confine provinciale,,,,,,,,
2019/03,323,01/03/2019,5,SP 467 fra SP 3 e SS 12,27971,00,24132,3839,21808,6163,27971,0
2019/03,323,02/03/2019,6,SP 467 fra SP 3 e SS 12,18493,10,17871,621,13275,5218,0,18493
2019/03,323,03/03/2019,7,SP 467 fra SP 3 e SS 12,14299,20,14200,97,10393,3906,0,14299
2019/03,323,04/03/2019,1,SP 467 fra SP 3 e SS 12,26535,00,23017,3518,20955,5580,26535,0
2019/03,323,05/03/2019,2,SP 467 fra SP 3 e SS 12,26861,20,22953,3906,21136,5725,26861,0
2019/03,323,06/03/2019,3,SP 467 fra SP 3 e SS 12,27178,10,23314,3863,21343,5835,27178,0
2019/03,323,07/03/2019,4,SP 467 fra SP 3 e SS 12,27438,00,23311,4127,21447,5991,27438,0
2019/03,323,08/03/2019,5,SP 467 fra SP 3 e SS 12,28557,20,24729,3826,22063,6494,28557,0
2019/03,323,09/03/2019,6,SP 467 fra SP 3 e SS 12,18767,00,18127,640,13404,5363,0,18767
2019/03,323,10/03/2019,7,SP 467 fra SP 3 e SS 12,14678,10,14582,95,10815,3863,0,14678
2019/03,323,11/03/2019,1,SP 467 fra SP 3 e SS 12,26663,10,23076,3586,21157,5506,26663,0
2019/03,323,12/03/2019,2,SP 467 fra SP 3 e SS 12,26799,10,22963,3835,21137,5662,26799,0
2019/03,323,13/03/2019,3,SP 467 fra SP 3 e SS 12,27374,00,23399,3975,21463,5911,27374,0
2019/03,323,14/03/2019,4,SP 467 fra SP 3 e SS 12,27608,00,23578,4030,21524,6084,27608,0
2019/03,328,01/03/2019,5,SP 486 tra Modena e Baggiovara,25377,30,24763,611,19312,6065,25377,0
2019/03,328,02/03/2019,6,SP 486 tra Modena e Baggiovara,23128,00,22850,278,16469,6659,0,23128
2019/03,328,03/03/2019,7,SP 486 tra Modena e Baggiovara,18046,00,17920,126,12784,5262,0,18046
2019/03,328,04/03/2019,1,SP 486 tra Modena e Baggiovara,24524,40,23956,564,19455,5069,24524,0
2019/03,328,05/03/2019,2,SP 486 tra Modena e Baggiovara,24952,20,24378,572,19469,5483,24952,0
2019/03,328,06/03/2019,3,SP 486 tra Modena e Baggiovara,25231,10,24667,563,19465,5766,25231,0
2019/03,328,07/03/2019,4,SP 486 tra Modena e Baggiovara,25429,30,24871,555,19681,5748,25429,0
2019/03,328,08/03/2019,5,SP 486 tra Modena e Baggiovara,26449,00,25880,569,20037,6412,26449,0
2019/03,328,09/03/2019,6,SP 486 tra Modena e Baggiovara,22887,10,22626,260,16015,6872,0,22887
2019/03,328,10/03/2019,7,SP 486 tra Modena e Baggiovara,16367,00,16265,102,11425,4942,0,16367
2019/03,328,11/03/2019,1,SP 486 tra Modena e Baggiovara,24624,20,24084,538,19480,5144,24624,0
2019/03,328,12/03/2019,2,SP 486 tra Modena e Baggiovara,25315,60,24696,613,19753,5562,25315,0
2019/03,328,13/03/2019,3,SP 486 tra Modena e Baggiovara,25106,00,24559,547,19362,5744,25106,0
2019/03,328,14/03/2019,4,SP 486 tra Modena e Baggiovara,25121,70,24524,590,19431,5690,25121,0
2019/03,330,01/03/2019,5,SS 64 tra Sasso Marconi e Marzabotto,13478,00,12852,626,10283,3195,13478,0
2019/03,330,02/03/2019,6,SS 64 tra Sasso Marconi e Marzabotto,12049,00,11881,168,9189,2860,0,12049
2019/03,330,03/03/2019,7,SS 64 tra Sasso Marconi e Marzabotto,11348,00,11313,35,8820,2528,0,11348
2019/03,330,04/03/2019,1,SS 64 tra Sasso Marconi e Marzabotto,12606,00,11943,663,9968,2638,12606,0
2019/03,330,05/03/2019,2,SS 64 tra Sasso Marconi e Marzabotto,12683,00,11998,685,10000,2683,12683,0
2019/03,330,06/03/2019,3,SS 64 tra Sasso Marconi e Marzabotto,12928,00,12259,669,10086,2842,12928,0
2019/03,330,07/03/2019,4,SS 64 tra Sasso Marconi e Marzabotto,13178,00,12509,669,10218,2960,13178,0
2019/03,330,08/03/2019,5,SS 64 tra Sasso Marconi e Marzabotto,14304,00,13670,634,10912,3392,14304,0
2019/03,330,09/03/2019,6,SS 64 tra Sasso Marconi e Marzabotto,12640,00,12461,179,9601,3039,0,12640
2019/03,330,10/03/2019,7,SS 64 tra Sasso Marconi e Marzabotto,10900,00,10866,34,8462,2438,0,10900
2019/03,330,11/03/2019,1,SS 64 tra Sasso Marconi e Marzabotto,12641,00,11964,677,10011,2630,12641,0
2019/03,330,12/03/2019,2,SS 64 tra Sasso Marconi e Marzabotto,12905,00,12224,681,10148,2757,12905,0
2019/03,330,13/03/2019,3,SS 64 tra Sasso Marconi e Marzabotto,12864,00,12192,672,9975,2889,12864,0
2019/03,330,14/03/2019,4,SS 64 tra Sasso Marconi e Marzabotto,13176,00,12501,675,10313,2863,13176,0
2019/03,331,01/03/2019,5,SP 325 tra Casello A 1 (Sasso Marconi) e Vado,8059,00,7690,369,6117,1942,8059,0
2019/03,331,02/03/2019,6,SP 325 tra Casello A 1 (Sasso Marconi) e Vado,6773,00,6691,82,5144,1629,0,6773
2019/03,331,03/03/2019,7,SP 325 tra Casello A 1 (Sasso Marconi) e Vado,5516,00,5493,23,4215,1301,0,5516
2019/03,331,04/03/2019,1,SP 325 tra Casello A 1 (Sasso Marconi) e Vado,7372,00,6975,397,5767,1605,7372,0
2019/03,331,05/03/2019,2,SP 325 tra Casello A 1 (Sasso Marconi) e Vado,7720,00,7305,415,5930,1790,7720,0
2019/03,331,06/03/2019,3,SP 325 tra Casello A 1 (Sasso Marconi) e Vado,7463,00,7082,381,5747,1716,7463,0
2019/03,331,07/03/2019,4,SP 325 tra Casello A 1 (Sasso Marconi) e Vado,7746,10,7317,428,5919,1827,7746,0
2019/03,331,08/03/2019,5,SP 325 tra Casello A 1 (Sasso Marconi) e Vado,8339,00,7954,385,6198,2141,8339,0
2019/03,331,09/03/2019,6,SP 325 tra Casello A 1 (Sasso Marconi) e Vado,7035,00,6930,105,5249,1786,0,7035
2019/03,331,10/03/2019,7,SP 325 tra Casello A 1 (Sasso Marconi) e Vado,5541,00,5493,48,4250,1291,0,5541
2019/03,331,11/03/2019,1,SP 325 tra Casello A 1 (Sasso Marconi) e Vado,7264,00,6849,415,5709,1555,7264,0
2019/03,331,12/03/2019,2,SP 325 tra Casello A 1 (Sasso Marconi) e Vado,8242,00,7800,442,6423,1819,8242,0
2019/03,331,13/03/2019,3,SP 325 tra Casello A 1 (Sasso Marconi) e Vado,7683,00,7214,469,5899,1784,7683,0
2019/03,331,14/03/2019,4,SP 325 tra Casello A 1 (Sasso Marconi) e Vado,7902,00,7410,492,5999,1903,7902,0
2019/03,332,01/03/2019,5,SP 306R fra Castel Bolognese e Riolo Terme,8885,00,8405,480,6845,2040,8885,0
2019/03,332,02/03/2019,6,SP 306R fra Castel Bolognese e Riolo Terme,8203,20,8001,200,6021,2182,0,8203
2019/03,332,03/03/2019,7,SP 306R fra Castel Bolognese e Riolo Terme,6616,00,6591,25,4933,1683,0,6616
2019/03,332,04/03/2019,1,SP 306R fra Castel Bolognese e Riolo Terme,8390,10,7885,504,6586,1804,8390,0
2019/03,332,05/03/2019,2,SP 306R fra Castel Bolognese e Riolo Terme,8630,20,8106,522,6713,1917,8630,0
2019/03,332,06/03/2019,3,SP 306R fra Castel Bolognese e Riolo Terme,8577,00,8048,529,6757,1820,8577,0
2019/03,332,07/03/2019,4,SP 306R fra Castel Bolognese e Riolo Terme,8553,00,8037,516,6596,1957,8553,0
2019/03,332,08/03/2019,5,SP 306R fra Castel Bolognese e Riolo Terme,9200,00,8616,584,6928,2272,9200,0
2019/03,332,09/03/2019,6,SP 306R fra Castel Bolognese e Riolo Terme,8300,00,8104,196,6068,2232,0,8300
2019/03,332,10/03/2019,7,SP 306R fra Castel Bolognese e Riolo Terme,7137,10,7092,44,5508,1629,0,7137
2019/03,332,11/03/2019,1,SP 306R fra Castel Bolognese e Riolo Terme,8365,00,7859,506,6632,1733,8365,0
2019/03,332,12/03/2019,2,SP 306R fra Castel Bolognese e Riolo Terme,8610,10,8040,569,6802,1808,8610,0
2019/03,332,13/03/2019,3,SP 306R fra Castel Bolognese e Riolo Terme,8685,10,8189,495,6669,2016,8685,0
2019/03,332,14/03/2019,4,SP 306R fra Castel Bolognese e Riolo Terme,9003,10,8443,559,6938,2065,9003,0
2019/03,333,01/03/2019,5,SS 9 tra Castel Bolognese e Faenza,24213,00,23420,793,17560,6653,24213,0
2019/03,333,02/03/2019,6,SS 9 tra Castel Bolognese e Faenza,23351,10,23030,320,15967,7384,0,23351
2019/03,333,03/03/2019,7,SS 9 tra Castel Bolognese e Faenza,18277,20,18202,73,12619,5658,0,18277
2019/03,333,04/03/2019,1,SS 9 tra Castel Bolognese e Faenza,22725,00,21924,801,17266,5459,22725,0
2019/03,333,05/03/2019,2,SS 9 tra Castel Bolognese e Faenza,23163,00,22320,843,17059,6104,23163,0
2019/03,333,06/03/2019,3,SS 9 tra Castel Bolognese e Faenza,23048,00,22184,864,17441,5607,23048,0
2019/03,333,07/03/2019,4,SS 9 tra Castel Bolognese e Faenza,22837,00,21967,870,17197,5640,22837,0
2019/03,333,08/03/2019,5,SS 9 tra Castel Bolognese e Faenza,24889,00,23978,911,17772,7117,24889,0
2019/03,333,09/03/2019,6,SS 9 tra Castel Bolognese e Faenza,22779,00,22453,326,15017,7762,0,22779
2019/03,333,10/03/2019,7,SS 9 tra Castel Bolognese e Faenza,18162,00,18080,82,12667,5495,0,18162
2019/03,333,11/03/2019,1,SS 9 tra Castel Bolognese e Faenza,22217,00,21365,852,17106,5111,22217,0
2019/03,333,12/03/2019,2,SS 9 tra Castel Bolognese e Faenza,23137,00,22183,954,17594,5543,23137,0
2019/03,333,13/03/2019,3,SS 9 tra Castel Bolognese e Faenza,23184,00,22307,877,17721,5463,23184,0
2019/03,333,14/03/2019,4,SS 9 tra Castel Bolognese e Faenza,23342,00,22407,935,17677,5665,23342,0
2019/03,334,01/03/2019,5,SP 8 dal Casello A 1 (Faenza) a Cotignola,15513,00,14653,860,11729,3784,15513,0
2019/03,334,02/03/2019,6,SP 8 dal Casello A 1 (Faenza) a Cotignola,14087,00,13895,192,10093,3994,0,14087
2019/03,334,03/03/2019,7,SP 8 dal Casello A 1 (Faenza) a Cotignola,14722,00,14676,46,11421,3301,0,14722
2019/03,334,04/03/2019,1,SP 8 dal Casello A 1 (Faenza) a Cotignola,14706,00,13734,972,11562,3144,14706,0
2019/03,334,05/03/2019,2,SP 8 dal Casello A 1 (Faenza) a Cotignola,15279,00,14189,1090,11992,3287,15279,0
2019/03,334,06/03/2019,3,SP 8 dal Casello A 1 (Faenza) a Cotignola,15575,00,14448,1127,12281,3294,15575,0
2019/03,334,07/03/2019,4,SP 8 dal Casello A 1 (Faenza) a Cotignola,15161,00,14117,1044,11973,3188,15161,0
2019/03,334,08/03/2019,5,SP 8 dal Casello A 1 (Faenza) a Cotignola,16155,00,15136,1019,12436,3719,16155,0
2019/03,334,09/03/2019,6,SP 8 dal Casello A 1 (Faenza) a Cotignola,14355,00,14165,190,10177,4178,0,14355
2019/03,334,10/03/2019,7,SP 8 dal Casello A 1 (Faenza) a Cotignola,12370,00,12333,37,9141,3229,0,12370
2019/03,334,11/03/2019,1,SP 8 dal Casello A 1 (Faenza) a Cotignola,14657,00,13615,1042,11619,3038,14657,0
2019/03,334,12/03/2019,2,SP 8 dal Casello A 1 (Faenza) a Cotignola,15055,00,14133,922,12043,3012,15055,0
2019/03,334,13/03/2019,3,SP 8 dal Casello A 1 (Faenza) a Cotignola,15469,00,14547,922,12345,3124,15469,0
2019/03,334,14/03/2019,4,SP 8 dal Casello A 1 (Faenza) a Cotignola,15378,00,14477,901,12038,3340,15378,0
2019/03,335,01/03/2019,5,SP 7 tra l'A 14 (bivio SP 29) e l'A 14dir (Barbiano),7762,00,7238,524,6030,1732,7762,0
2019/03,335,02/03/2019,6,SP 7 tra l'A 14 (bivio SP 29) e l'A 14dir (Barbiano),6490,00,6386,104,4642,1848,0,6490
2019/03,335,03/03/2019,7,SP 7 tra l'A 14 (bivio SP 29) e l'A 14dir (Barbiano),5345,00,5312,33,3847,1498,0,5345
2019/03,335,04/03/2019,1,SP 7 tra l'A 14 (bivio SP 29) e l'A 14dir (Barbiano),7748,00,7103,645,6214,1534,7748,0
2019/03,335,05/03/2019,2,SP 7 tra l'A 14 (bivio SP 29) e l'A 14dir (Barbiano),8021,00,7402,619,6361,1660,8021,0
2019/03,335,06/03/2019,3,SP 7 tra l'A 14 (bivio SP 29) e l'A 14dir (Barbiano),8101,00,7509,592,6537,1564,8101,0
2019/03,335,07/03/2019,4,SP 7 tra l'A 14 (bivio SP 29) e l'A 14dir (Barbiano),8085,00,7457,628,6406,1679,8085,0
2019/03,335,08/03/2019,5,SP 7 tra l'A 14 (bivio SP 29) e l'A 14dir (Barbiano),8287,00,7671,616,6330,1957,8287,0
2019/03,335,09/03/2019,6,SP 7 tra l'A 14 (bivio SP 29) e l'A 14dir (Barbiano),6455,00,6319,136,4502,1953,0,6455
2019/03,335,10/03/2019,7,SP 7 tra l'A 14 (bivio SP 29) e l'A 14dir (Barbiano),5560,00,5533,27,3941,1619,0,5560
2019/03,335,11/03/2019,1,SP 7 tra l'A 14 (bivio SP 29) e l'A 14dir (Barbiano),7564,00,6968,596,6159,1405,7564,0
2019/03,335,12/03/2019,2,SP 7 tra l'A 14 (bivio SP 29) e l'A 14dir (Barbiano),7751,00,7114,637,6254,1497,7751,0
2019/03,335,13/03/2019,3,SP 7 tra l'A 14 (bivio SP 29) e l'A 14dir (Barbiano),8063,00,7486,577,6463,1600,8063,0
2019/03,335,14/03/2019,4,SP 7 tra l'A 14 (bivio SP 29) e l'A 14dir (Barbiano),7947,00,7298,649,6322,1625,7947,0
2019/03,336,01/03/2019,5,SP 253R tra Lugo (ponte fiume Senio) e Bagnacavallo,11967,00,11344,623,9341,2626,11967,0
2019/03,336,02/03/2019,6,SP 253R tra Lugo (ponte fiume Senio) e Bagnacavallo,10192,00,10024,168,7680,2512,0,10192
2019/03,336,03/03/2019,7,SP 253R tra Lugo (ponte fiume Senio) e Bagnacavallo,7992,00,7952,40,6121,1871,0,7992
2019/03,336,04/03/2019,1,SP 253R tra Lugo (ponte fiume Senio) e Bagnacavallo,11543,00,10871,672,9427,2116,11543,0
2019/03,336,05/03/2019,2,SP 253R tra Lugo (ponte fiume Senio) e Bagnacavallo,11567,00,10751,816,9236,2331,11567,0
2019/03,336,06/03/2019,3,SP 253R tra Lugo (ponte fiume Senio) e Bagnacavallo,11812,00,11080,732,9496,2316,11812,0
2019/03,336,07/03/2019,4,SP 253R tra Lugo (ponte fiume Senio) e Bagnacavallo,11607,00,10849,758,9318,2289,11607,0
2019/03,336,08/03/2019,5,SP 253R tra Lugo (ponte fiume Senio) e Bagnacavallo,12614,10,11856,757,9723,2891,12614,0
2019/03,336,09/03/2019,6,SP 253R tra Lugo (ponte fiume Senio) e Bagnacavallo,10373,00,10077,296,7633,2740,0,10373
2019/03,336,10/03/2019,7,SP 253R tra Lugo (ponte fiume Senio) e Bagnacavallo,6817,10,6777,39,4964,1853,0,6817
2019/03,336,11/03/2019,1,SP 253R tra Lugo (ponte fiume Senio) e Bagnacavallo,11228,00,10531,697,9094,2134,11228,0
2019/03,336,12/03/2019,2,SP 253R tra Lugo (ponte fiume Senio) e Bagnacavallo,11608,00,10870,738,9220,2388,11608,0
2019/03,336,13/03/2019,3,SP 253R tra Lugo (ponte fiume Senio) e Bagnacavallo,11770,00,11115,655,9467,2303,11770,0
2019/03,336,14/03/2019,4,SP 253R tra Lugo (ponte fiume Senio) e Bagnacavallo,11582,00,10890,692,9291,2291,11582,0
2019/03,337,01/03/2019,5,SP 14 fra Lugo (bivio SSPP 41/46) e Fusignano,12453,30,11930,520,9811,2642,12453,0
2019/03,337,02/03/2019,6,SP 14 fra Lugo (bivio SSPP 41/46) e Fusignano,10259,10,10083,175,7738,2521,0,10259
2019/03,337,03/03/2019,7,SP 14 fra Lugo (bivio SSPP 41/46) e Fusignano,6999,10,6959,39,5052,1947,0,6999
2019/03,337,04/03/2019,1,SP 14 fra Lugo (bivio SSPP 41/46) e Fusignano,12245,10,11569,675,9990,2255,12245,0
2019/03,337,05/03/2019,2,SP 14 fra Lugo (bivio SSPP 41/46) e Fusignano,12264,10,11579,684,9948,2316,12264,0
2019/03,337,06/03/2019,3,SP 14 fra Lugo (bivio SSPP 41/46) e Fusignano,12595,00,11911,684,10242,2353,12595,0
2019/03,337,07/03/2019,4,SP 14 fra Lugo (bivio SSPP 41/46) e Fusignano,11962,00,11374,588,9545,2417,11962,0
2019/03,337,08/03/2019,5,SP 14 fra Lugo (bivio SSPP 41/46) e Fusignano,12828,10,12256,571,9989,2839,12828,0
2019/03,337,09/03/2019,6,SP 14 fra Lugo (bivio SSPP 41/46) e Fusignano,10316,00,10136,180,7853,2463,0,10316
2019/03,337,10/03/2019,7,SP 14 fra Lugo (bivio SSPP 41/46) e Fusignano,6902,00,6883,19,4994,1908,0,6902
2019/03,337,11/03/2019,1,SP 14 fra Lugo (bivio SSPP 41/46) e Fusignano,11593,00,10930,663,9375,2218,11593,0
2019/03,337,12/03/2019,2,SP 14 fra Lugo (bivio SSPP 41/46) e Fusignano,12273,20,11603,668,9894,2379,12273,0
2019/03,337,13/03/2019,3,SP 14 fra Lugo (bivio SSPP 41/46) e Fusignano,12488,00,11828,660,9965,2523,12488,0
2019/03,337,14/03/2019,4,SP 14 fra Lugo (bivio SSPP 41/46) e Fusignano,12089,10,11447,641,9635,2454,12089,0
2019/03,339,01/03/2019,5,SP 3 tra San Lorenzo in Noceto e Predappio,7938,00,7569,369,6235,1703,7938,0
2019/03,339,02/03/2019,6,SP 3 tra San Lorenzo in Noceto e Predappio,7044,00,6934,110,5250,1794,0,7044
2019/03,339,03/03/2019,7,SP 3 tra San Lorenzo in Noceto e Predappio,6095,00,6076,19,4678,1417,0,6095
2019/03,339,04/03/2019,1,SP 3 tra San Lorenzo in Noceto e Predappio,7606,00,7232,374,6083,1523,7606,0
2019/03,339,05/03/2019,2,SP 3 tra San Lorenzo in Noceto e Predappio,7764,00,7397,367,6114,1650,7764,0
2019/03,339,06/03/2019,3,SP 3 tra San Lorenzo in Noceto e Predappio,7941,00,7554,387,6409,1532,7941,0
2019/03,339,07/03/2019,4,SP 3 tra San Lorenzo in Noceto e Predappio,7936,00,7575,361,6302,1634,7936,0
2019/03,339,08/03/2019,5,SP 3 tra San Lorenzo in Noceto e Predappio,8611,00,8237,374,6603,2008,8611,0
2019/03,339,09/03/2019,6,SP 3 tra San Lorenzo in Noceto e Predappio,7465,00,7366,99,5398,2067,0,7465
2019/03,339,10/03/2019,7,SP 3 tra San Lorenzo in Noceto e Predappio,6281,00,6255,26,4872,1409,0,6281
2019/03,339,11/03/2019,1,SP 3 tra San Lorenzo in Noceto e Predappio,7583,00,7207,376,6196,1387,7583,0
2019/03,339,12/03/2019,2,SP 3 tra San Lorenzo in Noceto e Predappio,7870,00,7485,385,6279,1591,7870,0
2019/03,339,13/03/2019,3,SP 3 tra San Lorenzo in Noceto e Predappio,7746,10,7390,355,6141,1605,7746,0
2019/03,339,14/03/2019,4,SP 3 tra San Lorenzo in Noceto e Predappio,7927,00,7527,400,6264,1663,7927,0
2019/03,340,01/03/2019,5,SP 72 tra San Martino in Strada e bivio ex SS 310R (Meldola),10597,00,10079,518,8242,2355,10597,0
2019/03,340,02/03/2019,6,SP 72 tra San Martino in Strada e bivio ex SS 310R (Meldola),8637,00,8475,162,6402,2235,0,8637
2019/03,340,03/03/2019,7,SP 72 tra San Martino in Strada e bivio ex SS 310R (Meldola),7447,00,7418,29,5577,1870,0,7447
2019/03,340,04/03/2019,1,SP 72 tra San Martino in Strada e bivio ex SS 310R (Meldola),10155,10,9712,442,8191,1964,10155,0
2019/03,340,05/03/2019,2,SP 72 tra San Martino in Strada e bivio ex SS 310R (Meldola),10424,10,10009,414,8365,2059,10424,0
2019/03,340,06/03/2019,3,SP 72 tra San Martino in Strada e bivio ex SS 310R (Meldola),10389,00,9958,431,8324,2065,10389,0
2019/03,340,07/03/2019,4,SP 72 tra San Martino in Strada e bivio ex SS 310R (Meldola),10433,00,9999,434,8168,2265,10433,0
2019/03,340,08/03/2019,5,SP 72 tra San Martino in Strada e bivio ex SS 310R (Meldola),10894,10,10405,488,8427,2467,10894,0
2019/03,340,09/03/2019,6,SP 72 tra San Martino in Strada e bivio ex SS 310R (Meldola),8792,00,8634,158,6315,2477,0,8792
2019/03,340,10/03/2019,7,SP 72 tra San Martino in Strada e bivio ex SS 310R (Meldola),7263,10,7239,23,5486,1777,0,7263
2019/03,340,11/03/2019,1,SP 72 tra San Martino in Strada e bivio ex SS 310R (Meldola),9967,00,9537,430,8041,1926,9967,0
2019/03,340,12/03/2019,2,SP 72 tra San Martino in Strada e bivio ex SS 310R (Meldola),10577,00,10158,419,8460,2117,10577,0
2019/03,340,13/03/2019,3,SP 72 tra San Martino in Strada e bivio ex SS 310R (Meldola),10417,00,10000,417,8250,2167,10417,0
2019/03,340,14/03/2019,4,SP 72 tra San Martino in Strada e bivio ex SS 310R (Meldola),10485,00,10039,446,8257,2228,10485,0
2019/03,342,01/03/2019,5,SP 33 in località Gatteo,18974,00,17295,1679,14877,4097,18974,0
2019/03,342,02/03/2019,6,SP 33 in località Gatteo,15814,10,15325,488,11700,4114,0,15814
2019/03,342,03/03/2019,7,SP 33 in località Gatteo,13080,00,12996,84,9755,3325,0,13080
2019/03,342,04/03/2019,1,SP 33 in località Gatteo,17897,10,16197,1699,14504,3393,17897,0
2019/03,342,05/03/2019,2,SP 33 in località Gatteo,17880,00,16184,1696,14355,3525,17880,0
2019/03,342,06/03/2019,3,SP 33 in località Gatteo,18009,20,16305,1702,14460,3549,18009,0
2019/03,342,07/03/2019,4,SP 33 in località Gatteo,18089,00,16410,1679,14289,3800,18089,0
2019/03,342,08/03/2019,5,SP 33 in località Gatteo,19137,00,17471,1666,14757,4380,19137,0
2019/03,342,09/03/2019,6,SP 33 in località Gatteo,15738,00,15255,483,11478,4260,0,15738
2019/03,342,10/03/2019,7,SP 33 in località Gatteo,12271,00,12171,100,9015,3256,0,12271
2019/03,342,11/03/2019,1,SP 33 in località Gatteo,17304,00,15613,1691,14094,3210,17304,0
2019/03,342,12/03/2019,2,SP 33 in località Gatteo,18287,10,16549,1737,14780,3507,18287,0
2019/03,342,13/03/2019,3,SP 33 in località Gatteo,18296,10,16560,1735,14596,3700,18296,0
2019/03,342,14/03/2019,4,SP 33 in località Gatteo,18204,00,16430,1774,14472,3732,18204,0
2019/03,343,01/03/2019,5,SP 4 tra Galeata e Santa Sofia,5581,00,5264,317,4311,1270,5581,0
2019/03,343,02/03/2019,6,SP 4 tra Galeata e Santa Sofia,5476,00,5313,163,4117,1359,0,5476
2019/03,343,03/03/2019,7,SP 4 tra Galeata e Santa Sofia,4927,00,4897,30,3981,946,0,4927
2019/03,343,04/03/2019,1,SP 4 tra Galeata e Santa Sofia,5452,00,5096,356,4258,1194,5452,0
2019/03,343,05/03/2019,2,SP 4 tra Galeata e Santa Sofia,5596,00,5276,320,4361,1235,5596,0
2019/03,343,06/03/2019,3,SP 4 tra Galeata e Santa Sofia,5447,00,5137,310,4246,1201,5447,0
2019/03,343,07/03/2019,4,SP 4 tra Galeata e Santa Sofia,5690,00,5374,316,4383,1307,5690,0
2019/03,343,08/03/2019,5,SP 4 tra Galeata e Santa Sofia,5948,00,5611,337,4544,1404,5948,0
2019/03,343,09/03/2019,6,SP 4 tra Galeata e Santa Sofia,5646,10,5463,182,4064,1582,0,5646
2019/03,343,10/03/2019,7,SP 4 tra Galeata e Santa Sofia,4877,00,4845,32,3860,1017,0,4877
2019/03,343,11/03/2019,1,SP 4 tra Galeata e Santa Sofia,5536,10,5183,352,4324,1212,5536,0
2019/03,343,12/03/2019,2,SP 4 tra Galeata e Santa Sofia,5876,00,5529,347,4677,1199,5876,0
2019/03,343,13/03/2019,3,SP 4 tra Galeata e Santa Sofia,5525,00,5165,360,4253,1272,5525,0
2019/03,343,14/03/2019,4,SP 4 tra Galeata e Santa Sofia,5747,00,5369,378,4464,1283,5747,0
2019/03,344,01/03/2019,5,SS 3Bis/E 45 tra Borello e Mercato Saraceno,16882,00,15782,1100,13036,3846,16882,0
2019/03,344,02/03/2019,6,SS 3Bis/E 45 tra Borello e Mercato Saraceno,15184,10,14816,367,11636,3548,0,15184
2019/03,344,03/03/2019,7,SS 3Bis/E 45 tra Borello e Mercato Saraceno,16484,00,16292,192,12751,3733,0,16484
2019/03,344,04/03/2019,1,SS 3Bis/E 45 tra Borello e Mercato Saraceno,15434,20,14154,1278,12255,3179,15434,0
2019/03,344,05/03/2019,2,SS 3Bis/E 45 tra Borello e Mercato Saraceno,15233,10,13999,1233,12206,3027,15233,0
2019/03,344,06/03/2019,3,SS 3Bis/E 45 tra Borello e Mercato Saraceno,15326,00,14223,1103,12103,3223,15326,0
2019/03,344,07/03/2019,4,SS 3Bis/E 45 tra Borello e Mercato Saraceno,15406,10,14347,1058,12176,3230,15406,0
2019/03,344,08/03/2019,5,SS 3Bis/E 45 tra Borello e Mercato Saraceno,18012,00,16794,1218,13835,4177,18012,0
2019/03,344,09/03/2019,6,SS 3Bis/E 45 tra Borello e Mercato Saraceno,15488,00,15116,372,11661,3827,0,15488
2019/03,344,10/03/2019,7,SS 3Bis/E 45 tra Borello e Mercato Saraceno,16658,00,16476,182,12882,3776,0,16658
2019/03,344,11/03/2019,1,SS 3Bis/E 45 tra Borello e Mercato Saraceno,15248,20,14216,1030,12169,3079,15248,0
2019/03,344,12/03/2019,2,SS 3Bis/E 45 tra Borello e Mercato Saraceno,14738,00,13716,1022,11773,2965,14738,0
2019/03,344,13/03/2019,3,SS 3Bis/E 45 tra Borello e Mercato Saraceno,15254,00,14141,1113,12010,3244,15254,0
2019/03,344,14/03/2019,4,SS 3Bis/E 45 tra Borello e Mercato Saraceno,15601,20,14478,1121,12295,3306,15601,0
2019/03,348,01/03/2019,5,SP 10 dal bivio con SP 89 (San Mauro Pascoli) c/o A 14  al bivio SS 16 (San Mauro Mare),,,,,,,,
2019/03,348,02/03/2019,6,SP 10 dal bivio con SP 89 (San Mauro Pascoli) c/o A 14  al bivio SS 16 (San Mauro Mare),,,,,,,,
2019/03,348,03/03/2019,7,SP 10 dal bivio con SP 89 (San Mauro Pascoli) c/o A 14  al bivio SS 16 (San Mauro Mare),,,,,,,,
2019/03,348,04/03/2019,1,SP 10 dal bivio con SP 89 (San Mauro Pascoli) c/o A 14  al bivio SS 16 (San Mauro Mare),,,,,,,,
2019/03,348,05/03/2019,2,SP 10 dal bivio con SP 89 (San Mauro Pascoli) c/o A 14  al bivio SS 16 (San Mauro Mare),,,,,,,,
2019/03,348,06/03/2019,3,SP 10 dal bivio con SP 89 (San Mauro Pascoli) c/o A 14  al bivio SS 16 (San Mauro Mare),,,,,,,,
2019/03,348,07/03/2019,4,SP 10 dal bivio con SP 89 (San Mauro Pascoli) c/o A 14  al bivio SS 16 (San Mauro Mare),,,,,,,,
2019/03,348,08/03/2019,5,SP 10 dal bivio con SP 89 (San Mauro Pascoli) c/o A 14  al bivio SS 16 (San Mauro Mare),,,,,,,,
2019/03,348,09/03/2019,6,SP 10 dal bivio con SP 89 (San Mauro Pascoli) c/o A 14  al bivio SS 16 (San Mauro Mare),,,,,,,,
2019/03,348,10/03/2019,7,SP 10 dal bivio con SP 89 (San Mauro Pascoli) c/o A 14  al bivio SS 16 (San Mauro Mare),,,,,,,,
2019/03,348,11/03/2019,1,SP 10 dal bivio con SP 89 (San Mauro Pascoli) c/o A 14  al bivio SS 16 (San Mauro Mare),,,,,,,,
2019/03,348,12/03/2019,2,SP 10 dal bivio con SP 89 (San Mauro Pascoli) c/o A 14  al bivio SS 16 (San Mauro Mare),,,,,,,,
2019/03,348,13/03/2019,3,SP 10 dal bivio con SP 89 (San Mauro Pascoli) c/o A 14  al bivio SS 16 (San Mauro Mare),,,,,,,,
2019/03,348,14/03/2019,4,SP 10 dal bivio con SP 89 (San Mauro Pascoli) c/o A 14  al bivio SS 16 (San Mauro Mare),,,,,,,,
2019/03,349,01/03/2019,5,SS 16 tra Cervia e Cesenatico,21977,20,19804,2171,16568,5409,21977,0
2019/03,349,02/03/2019,6,SS 16 tra Cervia e Cesenatico,22718,30,22173,542,16195,6523,0,22718
2019/03,349,03/03/2019,7,SS 16 tra Cervia e Cesenatico,24726,10,24564,161,18660,6066,0,24726
2019/03,349,04/03/2019,1,SS 16 tra Cervia e Cesenatico,20580,00,18195,2385,16213,4367,20580,0
2019/03,349,05/03/2019,2,SS 16 tra Cervia e Cesenatico,20609,00,18102,2507,16360,4249,20609,0
2019/03,349,06/03/2019,3,SS 16 tra Cervia e Cesenatico,20860,10,18388,2471,16381,4479,20860,0
2019/03,349,07/03/2019,4,SS 16 tra Cervia e Cesenatico,22237,00,19756,2481,17350,4887,22237,0
2019/03,349,08/03/2019,5,SS 16 tra Cervia e Cesenatico,23740,00,21355,2385,17422,6318,23740,0
2019/03,349,09/03/2019,6,SS 16 tra Cervia e Cesenatico,23238,00,22633,605,15962,7276,0,23238
2019/03,349,10/03/2019,7,SS 16 tra Cervia e Cesenatico,23792,10,23592,199,18029,5763,0,23792
2019/03,349,11/03/2019,1,SS 16 tra Cervia e Cesenatico,20038,20,17713,2323,16005,4033,20038,0
2019/03,349,12/03/2019,2,SS 16 tra Cervia e Cesenatico,20762,20,18169,2591,16438,4324,20762,0
2019/03,349,13/03/2019,3,SS 16 tra Cervia e Cesenatico,21188,00,18685,2503,16692,4496,21188,0
2019/03,349,14/03/2019,4,SS 16 tra Cervia e Cesenatico,21997,10,19485,2511,17032,4965,21997,0
2019/03,350,01/03/2019,5,SP 41 tra Rimini (viadotto A 14) e bivio SP 49 (località Ospedaletto),9990,00,9655,335,7870,2120,9990,0
2019/03,350,02/03/2019,6,SP 41 tra Rimini (viadotto A 14) e bivio SP 49 (località Ospedaletto),8960,10,8810,149,6725,2235,0,8960
2019/03,350,03/03/2019,7,SP 41 tra Rimini (viadotto A 14) e bivio SP 49 (località Ospedaletto),7876,00,7847,29,5939,1937,0,7876
2019/03,350,04/03/2019,1,SP 41 tra Rimini (viadotto A 14) e bivio SP 49 (località Ospedaletto),9281,10,8908,372,7560,1721,9281,0
2019/03,350,05/03/2019,2,SP 41 tra Rimini (viadotto A 14) e bivio SP 49 (località Ospedaletto),9186,10,8843,342,7331,1855,9186,0
2019/03,350,06/03/2019,3,SP 41 tra Rimini (viadotto A 14) e bivio SP 49 (località Ospedaletto),9325,00,8953,372,7284,2041,9325,0
2019/03,350,07/03/2019,4,SP 41 tra Rimini (viadotto A 14) e bivio SP 49 (località Ospedaletto),9660,00,9253,407,7587,2073,9660,0
2019/03,350,08/03/2019,5,SP 41 tra Rimini (viadotto A 14) e bivio SP 49 (località Ospedaletto),10188,10,9807,380,7858,2330,10188,0
2019/03,350,09/03/2019,6,SP 41 tra Rimini (viadotto A 14) e bivio SP 49 (località Ospedaletto),8677,00,8539,138,6482,2195,0,8677
2019/03,350,10/03/2019,7,SP 41 tra Rimini (viadotto A 14) e bivio SP 49 (località Ospedaletto),6777,00,6745,32,4872,1905,0,6777
2019/03,350,11/03/2019,1,SP 41 tra Rimini (viadotto A 14) e bivio SP 49 (località Ospedaletto),9350,10,8996,353,7552,1798,9350,0
2019/03,350,12/03/2019,2,SP 41 tra Rimini (viadotto A 14) e bivio SP 49 (località Ospedaletto),9418,00,9080,338,7373,2045,9418,0
2019/03,350,13/03/2019,3,SP 41 tra Rimini (viadotto A 14) e bivio SP 49 (località Ospedaletto),9692,10,9340,351,7689,2003,9692,0
2019/03,350,14/03/2019,4,SP 41 tra Rimini (viadotto A 14) e bivio SP 49 (località Ospedaletto),9397,10,9066,330,7423,1974,9397,0
2019/03,351,01/03/2019,5,SS 72 tra Rimini e  San Marino,,,,,,,,
2019/03,351,02/03/2019,6,SS 72 tra Rimini e  San Marino,,,,,,,,
2019/03,351,03/03/2019,7,SS 72 tra Rimini e  San Marino,,,,,,,,
2019/03,351,04/03/2019,1,SS 72 tra Rimini e  San Marino,,,,,,,,
2019/03,351,05/03/2019,2,SS 72 tra Rimini e  San Marino,,,,,,,,
2019/03,351,06/03/2019,3,SS 72 tra Rimini e  San Marino,,,,,,,,
2019/03,351,07/03/2019,4,SS 72 tra Rimini e  San Marino,,,,,,,,
2019/03,351,08/03/2019,5,SS 72 tra Rimini e  San Marino,,,,,,,,
2019/03,351,09/03/2019,6,SS 72 tra Rimini e  San Marino,,,,,,,,
2019/03,351,10/03/2019,7,SS 72 tra Rimini e  San Marino,,,,,,,,
2019/03,351,11/03/2019,1,SS 72 tra Rimini e  San Marino,,,,,,,,
2019/03,351,12/03/2019,2,SS 72 tra Rimini e  San Marino,,,,,,,,
2019/03,351,13/03/2019,3,SS 72 tra Rimini e  San Marino,,,,,,,,
2019/03,351,14/03/2019,4,SS 72 tra Rimini e  San Marino,,,,,,,,
2019/03,354,01/03/2019,5,SP 31 tra Viadotto A 14 e Coriano,13092,30,12721,368,10033,3059,13092,0
2019/03,354,02/03/2019,6,SP 31 tra Viadotto A 14 e Coriano,11585,10,11417,167,8413,3172,0,11585
2019/03,354,03/03/2019,7,SP 31 tra Viadotto A 14 e Coriano,10439,20,10379,58,7501,2938,0,10439
2019/03,354,04/03/2019,1,SP 31 tra Viadotto A 14 e Coriano,12526,10,12197,328,10041,2485,12526,0
2019/03,354,05/03/2019,2,SP 31 tra Viadotto A 14 e Coriano,12452,20,12115,335,9914,2538,12452,0
2019/03,354,06/03/2019,3,SP 31 tra Viadotto A 14 e Coriano,12374,20,12001,371,9844,2530,12374,0
2019/03,354,07/03/2019,4,SP 31 tra Viadotto A 14 e Coriano,12478,30,12093,382,9769,2709,12478,0
2019/03,354,08/03/2019,5,SP 31 tra Viadotto A 14 e Coriano,13115,10,12733,381,10065,3050,13115,0
2019/03,354,09/03/2019,6,SP 31 tra Viadotto A 14 e Coriano,11948,30,11814,131,8572,3376,0,11948
2019/03,354,10/03/2019,7,SP 31 tra Viadotto A 14 e Coriano,10479,00,10441,38,7679,2800,0,10479
2019/03,354,11/03/2019,1,SP 31 tra Viadotto A 14 e Coriano,12315,10,11975,339,9921,2394,12315,0
2019/03,354,12/03/2019,2,SP 31 tra Viadotto A 14 e Coriano,12503,40,12161,338,9866,2637,12503,0
2019/03,354,13/03/2019,3,SP 31 tra Viadotto A 14 e Coriano,12344,20,11997,345,9708,2636,12344,0
2019/03,354,14/03/2019,4,SP 31 tra Viadotto A 14 e Coriano,12765,30,12419,343,10040,2725,12765,0
2019/03,355,01/03/2019,5,SP 17V tra San Giovanni in Marignano e Morciano di Romagna (variante),16975,00,16293,682,13448,3527,16975,0
2019/03,355,02/03/2019,6,SP 17V tra San Giovanni in Marignano e Morciano di Romagna (variante),14504,00,14368,136,11069,3435,0,14504
2019/03,355,03/03/2019,7,SP 17V tra San Giovanni in Marignano e Morciano di Romagna (variante),11674,00,11645,29,8796,2878,0,11674
2019/03,355,04/03/2019,1,SP 17V tra San Giovanni in Marignano e Morciano di Romagna (variante),16406,00,15714,692,13360,3046,16406,0
2019/03,355,05/03/2019,2,SP 17V tra San Giovanni in Marignano e Morciano di Romagna (variante),16351,00,15650,701,13127,3224,16351,0
2019/03,355,06/03/2019,3,SP 17V tra San Giovanni in Marignano e Morciano di Romagna (variante),16507,00,15729,778,13265,3242,16507,0
2019/03,355,07/03/2019,4,SP 17V tra San Giovanni in Marignano e Morciano di Romagna (variante),17016,00,16239,777,13606,3410,17016,0
2019/03,355,08/03/2019,5,SP 17V tra San Giovanni in Marignano e Morciano di Romagna (variante),18019,00,17266,753,14014,4005,18019,0
2019/03,355,09/03/2019,6,SP 17V tra San Giovanni in Marignano e Morciano di Romagna (variante),16813,00,16666,147,12352,4461,0,16813
2019/03,355,10/03/2019,7,SP 17V tra San Giovanni in Marignano e Morciano di Romagna (variante),16820,00,16771,49,13049,3771,0,16820
2019/03,355,11/03/2019,1,SP 17V tra San Giovanni in Marignano e Morciano di Romagna (variante),16151,00,15491,660,12974,3177,16151,0
2019/03,355,12/03/2019,2,SP 17V tra San Giovanni in Marignano e Morciano di Romagna (variante),17200,00,16446,754,13581,3619,17200,0
2019/03,355,13/03/2019,3,SP 17V tra San Giovanni in Marignano e Morciano di Romagna (variante),17148,00,16368,780,13595,3553,17148,0
2019/03,355,14/03/2019,4,SP 17V tra San Giovanni in Marignano e Morciano di Romagna (variante),17217,00,16498,719,13562,3655,17217,0
2019/03,356,01/03/2019,5,SP 2 fra Reggiolo c/o bivio variante nord e confine regionale,8093,10,7104,988,6252,1841,8093,0
2019/03,356,02/03/2019,6,SP 2 fra Reggiolo c/o bivio variante nord e confine regionale,6665,10,6439,225,4736,1929,0,6665
2019/03,356,03/03/2019,7,SP 2 fra Reggiolo c/o bivio variante nord e confine regionale,4930,00,4865,65,3391,1539,0,4930
2019/03,356,04/03/2019,1,SP 2 fra Reggiolo c/o bivio variante nord e confine regionale,7460,00,6517,943,5965,1495,7460,0
2019/03,356,05/03/2019,2,SP 2 fra Reggiolo c/o bivio variante nord e confine regionale,7572,00,6619,953,5971,1601,7572,0
2019/03,356,06/03/2019,3,SP 2 fra Reggiolo c/o bivio variante nord e confine regionale,7744,00,6736,1008,6134,1610,7744,0
2019/03,356,07/03/2019,4,SP 2 fra Reggiolo c/o bivio variante nord e confine regionale,7637,00,6715,922,6082,1555,7637,0
2019/03,356,08/03/2019,5,SP 2 fra Reggiolo c/o bivio variante nord e confine regionale,8417,00,7449,968,6401,2016,8417,0
2019/03,356,09/03/2019,6,SP 2 fra Reggiolo c/o bivio variante nord e confine regionale,6635,00,6445,190,4627,2008,0,6635
2019/03,356,10/03/2019,7,SP 2 fra Reggiolo c/o bivio variante nord e confine regionale,4832,00,4773,59,3267,1565,0,4832
2019/03,356,11/03/2019,1,SP 2 fra Reggiolo c/o bivio variante nord e confine regionale,7543,10,6547,995,6093,1450,7543,0
2019/03,356,12/03/2019,2,SP 2 fra Reggiolo c/o bivio variante nord e confine regionale,7806,00,6813,993,6192,1614,7806,0
2019/03,356,13/03/2019,3,SP 2 fra Reggiolo c/o bivio variante nord e confine regionale,7654,00,6698,956,6067,1587,7654,0
2019/03,356,14/03/2019,4,SP 2 fra Reggiolo c/o bivio variante nord e confine regionale,7920,00,6935,985,6258,1662,7920,0
2019/03,357,01/03/2019,5,SP 306R fra Casola Valsenio e bivio SP 65 c/o località Isola,3566,00,3212,354,2828,738,3566,0
2019/03,357,02/03/2019,6,SP 306R fra Casola Valsenio e bivio SP 65 c/o località Isola,3316,00,3192,124,2552,764,0,3316
2019/03,357,03/03/2019,7,SP 306R fra Casola Valsenio e bivio SP 65 c/o località Isola,3141,10,3127,13,2491,650,0,3141
2019/03,357,04/03/2019,1,SP 306R fra Casola Valsenio e bivio SP 65 c/o località Isola,3175,00,2865,310,2572,603,3175,0
2019/03,357,05/03/2019,2,SP 306R fra Casola Valsenio e bivio SP 65 c/o località Isola,3470,10,3165,304,2814,656,3470,0
2019/03,357,06/03/2019,3,SP 306R fra Casola Valsenio e bivio SP 65 c/o località Isola,3444,00,3161,283,2768,676,3444,0
2019/03,357,07/03/2019,4,SP 306R fra Casola Valsenio e bivio SP 65 c/o località Isola,3504,20,3172,330,2763,741,3504,0
2019/03,357,08/03/2019,5,SP 306R fra Casola Valsenio e bivio SP 65 c/o località Isola,3719,20,3373,344,2950,769,3719,0
2019/03,357,09/03/2019,6,SP 306R fra Casola Valsenio e bivio SP 65 c/o località Isola,3356,30,3250,103,2534,822,0,3356
2019/03,357,10/03/2019,7,SP 306R fra Casola Valsenio e bivio SP 65 c/o località Isola,3916,00,3900,16,3283,633,0,3916
2019/03,357,11/03/2019,1,SP 306R fra Casola Valsenio e bivio SP 65 c/o località Isola,3309,10,3034,274,2686,623,3309,0
2019/03,357,12/03/2019,2,SP 306R fra Casola Valsenio e bivio SP 65 c/o località Isola,3554,20,3181,371,2857,697,3554,0
2019/03,357,13/03/2019,3,SP 306R fra Casola Valsenio e bivio SP 65 c/o località Isola,3206,20,2885,319,2573,633,3206,0
2019/03,357,14/03/2019,4,SP 306R fra Casola Valsenio e bivio SP 65 c/o località Isola,3623,30,3202,418,2910,713,3623,0
2019/03,376,01/03/2019,5,SP 68 tra Portomaggiore e la Superstrada Ferrara-Mare,3438,00,3243,195,2692,746,3438,0
2019/03,376,02/03/2019,6,SP 68 tra Portomaggiore e la Superstrada Ferrara-Mare,2945,00,2879,66,2273,672,0,2945
2019/03,376,03/03/2019,7,SP 68 tra Portomaggiore e la Superstrada Ferrara-Mare,2627,00,2622,5,2065,562,0,2627
2019/03,376,04/03/2019,1,SP 68 tra Portomaggiore e la Superstrada Ferrara-Mare,3311,20,3103,206,2679,632,3311,0
2019/03,376,05/03/2019,2,SP 68 tra Portomaggiore e la Superstrada Ferrara-Mare,3402,10,3168,233,2771,631,3402,0
2019/03,376,06/03/2019,3,SP 68 tra Portomaggiore e la Superstrada Ferrara-Mare,3319,10,3098,220,2711,608,3319,0
2019/03,376,07/03/2019,4,SP 68 tra Portomaggiore e la Superstrada Ferrara-Mare,3441,00,3217,224,2773,668,3441,0
2019/03,376,08/03/2019,5,SP 68 tra Portomaggiore e la Superstrada Ferrara-Mare,3802,00,3594,208,2984,818,3802,0
2019/03,376,09/03/2019,6,SP 68 tra Portomaggiore e la Superstrada Ferrara-Mare,2894,00,2804,90,2140,754,0,2894
2019/03,376,10/03/2019,7,SP 68 tra Portomaggiore e la Superstrada Ferrara-Mare,2416,00,2404,12,1858,558,0,2416
2019/03,376,11/03/2019,1,SP 68 tra Portomaggiore e la Superstrada Ferrara-Mare,3181,00,3005,176,2577,604,3181,0
2019/03,376,12/03/2019,2,SP 68 tra Portomaggiore e la Superstrada Ferrara-Mare,3284,10,3085,198,2666,618,3284,0
2019/03,376,13/03/2019,3,SP 68 tra Portomaggiore e la Superstrada Ferrara-Mare,3215,10,3026,188,2592,623,3215,0
2019/03,376,14/03/2019,4,SP 68 tra Portomaggiore e la Superstrada Ferrara-Mare,3302,00,3117,185,2671,631,3302,0
2019/03,377,01/03/2019,5,SP 18 tra Bondeno e il confine regionale (Lombardia),5331,10,4928,402,4173,1158,5331,0
2019/03,377,02/03/2019,6,SP 18 tra Bondeno e il confine regionale (Lombardia),4249,10,4150,98,3150,1099,0,4249
2019/03,377,03/03/2019,7,SP 18 tra Bondeno e il confine regionale (Lombardia),3575,00,3557,18,2613,962,0,3575
2019/03,377,04/03/2019,1,SP 18 tra Bondeno e il confine regionale (Lombardia),4967,00,4540,427,4032,935,4967,0
2019/03,377,05/03/2019,2,SP 18 tra Bondeno e il confine regionale (Lombardia),5025,00,4571,454,4067,958,5025,0
2019/03,377,06/03/2019,3,SP 18 tra Bondeno e il confine regionale (Lombardia),4959,00,4517,442,3880,1079,4959,0
2019/03,377,07/03/2019,4,SP 18 tra Bondeno e il confine regionale (Lombardia),5239,00,4810,429,4224,1015,5239,0
2019/03,377,08/03/2019,5,SP 18 tra Bondeno e il confine regionale (Lombardia),5380,00,4983,397,4148,1232,5380,0
2019/03,377,09/03/2019,6,SP 18 tra Bondeno e il confine regionale (Lombardia),4418,00,4322,96,3140,1278,0,4418
2019/03,377,10/03/2019,7,SP 18 tra Bondeno e il confine regionale (Lombardia),5622,00,5592,30,4500,1122,0,5622
2019/03,377,11/03/2019,1,SP 18 tra Bondeno e il confine regionale (Lombardia),4996,00,4585,411,4053,943,4996,0
2019/03,377,12/03/2019,2,SP 18 tra Bondeno e il confine regionale (Lombardia),5065,00,4638,427,4113,952,5065,0
2019/03,377,13/03/2019,3,SP 18 tra Bondeno e il confine regionale (Lombardia),5099,00,4646,453,4063,1036,5099,0
2019/03,377,14/03/2019,4,SP 18 tra Bondeno e il confine regionale (Lombardia),5101,00,4659,442,4088,1013,5101,0
2019/03,381,01/03/2019,5,SS 724 Tangenziale nord di Modena,,,,,,,,
2019/03,381,02/03/2019,6,SS 724 Tangenziale nord di Modena,,,,,,,,
2019/03,381,03/03/2019,7,SS 724 Tangenziale nord di Modena,,,,,,,,
2019/03,381,04/03/2019,1,SS 724 Tangenziale nord di Modena,,,,,,,,
2019/03,381,05/03/2019,2,SS 724 Tangenziale nord di Modena,,,,,,,,
2019/03,381,06/03/2019,3,SS 724 Tangenziale nord di Modena,,,,,,,,
2019/03,383,01/03/2019,5,SS 722 Tangenziale nord di Reggio Emilia,35062,50,30919,4138,27259,7803,35062,0
2019/03,383,02/03/2019,6,SS 722 Tangenziale nord di Reggio Emilia,25290,20,24548,740,17992,7298,0,25290
2019/03,383,03/03/2019,7,SS 722 Tangenziale nord di Reggio Emilia,20142,30,19935,204,13929,6213,0,20142
2019/03,383,04/03/2019,1,SS 722 Tangenziale nord di Reggio Emilia,33270,70,29244,4019,26773,6497,33270,0
2019/03,383,05/03/2019,2,SS 722 Tangenziale nord di Reggio Emilia,34011,60,29736,4269,27206,6805,34011,0
2019/03,383,06/03/2019,3,SS 722 Tangenziale nord di Reggio Emilia,34142,80,29878,4256,27258,6884,34142,0
2019/03,383,07/03/2019,4,SS 722 Tangenziale nord di Reggio Emilia,35356,90,31033,4314,27759,7597,35356,0
2019/03,383,08/03/2019,5,SS 722 Tangenziale nord di Reggio Emilia,35816,60,31695,4115,27760,8056,35816,0
2019/03,383,09/03/2019,6,SS 722 Tangenziale nord di Reggio Emilia,25529,20,24612,915,18034,7495,0,25529
2019/03,383,10/03/2019,7,SS 722 Tangenziale nord di Reggio Emilia,22171,40,21949,218,15304,6867,0,22171
2019/03,383,11/03/2019,1,SS 722 Tangenziale nord di Reggio Emilia,33812,90,29760,4043,26968,6844,33812,0
2019/03,383,12/03/2019,2,SS 722 Tangenziale nord di Reggio Emilia,34773,30,30411,4359,28001,6772,34773,0
2019/03,383,13/03/2019,3,SS 722 Tangenziale nord di Reggio Emilia,34277,100,30076,4191,27195,7082,34277,0
2019/03,383,14/03/2019,4,SS 722 Tangenziale nord di Reggio Emilia,35063,60,30766,4291,27812,7251,35063,0
2019/03,385,01/03/2019,5,SP 10R fra Castel San Giovanni e Confine regionale (Lombardia),13296,00,11921,1375,10237,3059,13296,0
2019/03,385,02/03/2019,6,SP 10R fra Castel San Giovanni e Confine regionale (Lombardia),10330,10,10046,283,7537,2793,0,10330
2019/03,385,03/03/2019,7,SP 10R fra Castel San Giovanni e Confine regionale (Lombardia),8886,00,8796,90,6547,2339,0,8886
2019/03,385,04/03/2019,1,SP 10R fra Castel San Giovanni e Confine regionale (Lombardia),12100,00,10721,1379,9518,2582,12100,0
2019/03,385,05/03/2019,2,SP 10R fra Castel San Giovanni e Confine regionale (Lombardia),12899,00,11467,1432,10015,2884,12899,0
2019/03,385,06/03/2019,3,SP 10R fra Castel San Giovanni e Confine regionale (Lombardia),12702,00,11274,1428,9915,2787,12702,0
2019/03,385,07/03/2019,4,SP 10R fra Castel San Giovanni e Confine regionale (Lombardia),13464,60,11789,1669,10621,2843,13464,0
2019/03,385,08/03/2019,5,SP 10R fra Castel San Giovanni e Confine regionale (Lombardia),13827,00,12453,1374,10409,3418,13827,0
2019/03,385,09/03/2019,6,SP 10R fra Castel San Giovanni e Confine regionale (Lombardia),11219,10,10883,335,8137,3082,0,11219
2019/03,385,10/03/2019,7,SP 10R fra Castel San Giovanni e Confine regionale (Lombardia),8968,10,8878,89,6641,2327,0,8968
2019/03,385,11/03/2019,1,SP 10R fra Castel San Giovanni e Confine regionale (Lombardia),12392,00,10921,1471,9753,2639,12392,0
2019/03,385,12/03/2019,2,SP 10R fra Castel San Giovanni e Confine regionale (Lombardia),12814,10,11390,1423,9993,2821,12814,0
2019/03,385,13/03/2019,3,SP 10R fra Castel San Giovanni e Confine regionale (Lombardia),13013,00,11572,1441,10104,2909,13013,0
2019/03,385,14/03/2019,4,SP 10R fra Castel San Giovanni e Confine regionale (Lombardia),12805,00,11360,1445,9949,2856,12805,0
2019/03,388,01/03/2019,5,SP 31 fra bivio SP 12 in località Castelnuovo Fogliani e il confine provinciale,4875,00,4735,140,3810,1065,4875,0
2019/03,388,02/03/2019,6,SP 31 fra bivio SP 12 in località Castelnuovo Fogliani e il confine provinciale,4937,00,4862,75,3689,1248,0,4937
2019/03,388,03/03/2019,7,SP 31 fra bivio SP 12 in località Castelnuovo Fogliani e il confine provinciale,4750,00,4731,19,3766,984,0,4750
2019/03,388,04/03/2019,1,SP 31 fra bivio SP 12 in località Castelnuovo Fogliani e il confine provinciale,4439,00,4296,143,3658,781,4439,0
2019/03,388,05/03/2019,2,SP 31 fra bivio SP 12 in località Castelnuovo Fogliani e il confine provinciale,4583,00,4435,148,3748,835,4583,0
2019/03,388,06/03/2019,3,SP 31 fra bivio SP 12 in località Castelnuovo Fogliani e il confine provinciale,4350,00,4178,172,3491,859,4350,0
2019/03,388,07/03/2019,4,SP 31 fra bivio SP 12 in località Castelnuovo Fogliani e il confine provinciale,4604,00,4470,134,3658,946,4604,0
2019/03,388,08/03/2019,5,SP 31 fra bivio SP 12 in località Castelnuovo Fogliani e il confine provinciale,4850,00,4703,147,3765,1085,4850,0
2019/03,388,09/03/2019,6,SP 31 fra bivio SP 12 in località Castelnuovo Fogliani e il confine provinciale,4812,00,4726,86,3579,1233,0,4812
2019/03,388,10/03/2019,7,SP 31 fra bivio SP 12 in località Castelnuovo Fogliani e il confine provinciale,4375,00,4353,22,3419,956,0,4375
2019/03,388,11/03/2019,1,SP 31 fra bivio SP 12 in località Castelnuovo Fogliani e il confine provinciale,4177,10,4035,141,3398,779,4177,0
2019/03,388,12/03/2019,2,SP 31 fra bivio SP 12 in località Castelnuovo Fogliani e il confine provinciale,4460,00,4300,160,3586,874,4460,0
2019/03,388,13/03/2019,3,SP 31 fra bivio SP 12 in località Castelnuovo Fogliani e il confine provinciale,4373,00,4225,148,3527,846,4373,0
2019/03,388,14/03/2019,4,SP 31 fra bivio SP 12 in località Castelnuovo Fogliani e il confine provinciale,4646,00,4509,137,3782,864,4646,0
2019/03,389,01/03/2019,5,SP 588R fra Villanova d’Arda e confine provinciale,4194,00,3856,338,3308,886,4194,0
2019/03,389,02/03/2019,6,SP 588R fra Villanova d’Arda e confine provinciale,3869,00,3762,107,2912,957,0,3869
2019/03,389,03/03/2019,7,SP 588R fra Villanova d’Arda e confine provinciale,3330,00,3291,39,2538,792,0,3330
2019/03,389,04/03/2019,1,SP 588R fra Villanova d’Arda e confine provinciale,3756,10,3389,366,3044,712,3756,0
2019/03,389,05/03/2019,2,SP 588R fra Villanova d’Arda e confine provinciale,4119,00,3760,359,3355,764,4119,0
2019/03,389,06/03/2019,3,SP 588R fra Villanova d’Arda e confine provinciale,3962,10,3583,378,3160,802,3962,0
2019/03,389,07/03/2019,4,SP 588R fra Villanova d’Arda e confine provinciale,4063,00,3676,387,3230,833,4063,0
2019/03,389,08/03/2019,5,SP 588R fra Villanova d’Arda e confine provinciale,4320,00,3968,352,3381,939,4320,0
2019/03,389,09/03/2019,6,SP 588R fra Villanova d’Arda e confine provinciale,3795,00,3682,113,2733,1062,0,3795
2019/03,389,10/03/2019,7,SP 588R fra Villanova d’Arda e confine provinciale,3305,00,3260,45,2512,793,0,3305
2019/03,389,11/03/2019,1,SP 588R fra Villanova d’Arda e confine provinciale,3849,00,3462,387,3141,708,3849,0
2019/03,389,12/03/2019,2,SP 588R fra Villanova d’Arda e confine provinciale,4102,10,3725,376,3302,800,4102,0
2019/03,389,13/03/2019,3,SP 588R fra Villanova d’Arda e confine provinciale,4058,10,3677,380,3229,829,4058,0
2019/03,389,14/03/2019,4,SP 588R fra Villanova d’Arda e confine provinciale,4146,10,3723,422,3313,833,4146,0
2019/03,390,01/03/2019,5,SP 462R dal bivio SP 10R in località Monticelli a Cortemaggiore,3092,00,2944,148,2407,685,3092,0
2019/03,390,02/03/2019,6,SP 462R dal bivio SP 10R in località Monticelli a Cortemaggiore,2953,00,2892,61,2182,771,0,2953
2019/03,390,03/03/2019,7,SP 462R dal bivio SP 10R in località Monticelli a Cortemaggiore,3567,00,3533,34,2940,627,0,3567
2019/03,390,04/03/2019,1,SP 462R dal bivio SP 10R in località Monticelli a Cortemaggiore,2815,00,2680,135,2240,575,2815,0
2019/03,390,05/03/2019,2,SP 462R dal bivio SP 10R in località Monticelli a Cortemaggiore,2960,00,2798,162,2418,542,2960,0
2019/03,390,06/03/2019,3,SP 462R dal bivio SP 10R in località Monticelli a Cortemaggiore,3022,00,2866,156,2370,652,3022,0
2019/03,390,07/03/2019,4,SP 462R dal bivio SP 10R in località Monticelli a Cortemaggiore,3044,00,2891,153,2436,608,3044,0
2019/03,390,08/03/2019,5,SP 462R dal bivio SP 10R in località Monticelli a Cortemaggiore,3264,00,3097,167,2473,791,3264,0
2019/03,390,09/03/2019,6,SP 462R dal bivio SP 10R in località Monticelli a Cortemaggiore,2949,00,2881,68,2139,810,0,2949
2019/03,390,10/03/2019,7,SP 462R dal bivio SP 10R in località Monticelli a Cortemaggiore,2819,00,2801,18,2172,647,0,2819
2019/03,390,11/03/2019,1,SP 462R dal bivio SP 10R in località Monticelli a Cortemaggiore,2844,00,2676,168,2330,514,2844,0
2019/03,390,12/03/2019,2,SP 462R dal bivio SP 10R in località Monticelli a Cortemaggiore,3011,00,2841,170,2417,594,3011,0
2019/03,390,13/03/2019,3,SP 462R dal bivio SP 10R in località Monticelli a Cortemaggiore,3017,00,2857,160,2415,602,3017,0
2019/03,390,14/03/2019,4,SP 462R dal bivio SP 10R in località Monticelli a Cortemaggiore,2942,00,2772,170,2326,616,2942,0
2019/03,391,01/03/2019,5,SP 10R fra Castelvetro Piacentino e confine regionale (Lombardia),22386,00,21825,561,16828,5558,22386,0
2019/03,391,02/03/2019,6,SP 10R fra Castelvetro Piacentino e confine regionale (Lombardia),21653,00,21405,248,15544,6109,0,21653
2019/03,391,03/03/2019,7,SP 10R fra Castelvetro Piacentino e confine regionale (Lombardia),19356,00,19267,89,14454,4902,0,19356
2019/03,391,04/03/2019,1,SP 10R fra Castelvetro Piacentino e confine regionale (Lombardia),19070,00,18601,469,14805,4265,19070,0
2019/03,391,05/03/2019,2,SP 10R fra Castelvetro Piacentino e confine regionale (Lombardia),19797,00,19265,532,15378,4419,19797,0
2019/03,391,06/03/2019,3,SP 10R fra Castelvetro Piacentino e confine regionale (Lombardia),20671,00,20157,514,16220,4451,20671,0
2019/03,391,07/03/2019,4,SP 10R fra Castelvetro Piacentino e confine regionale (Lombardia),20426,00,19926,500,15927,4499,20426,0
2019/03,391,08/03/2019,5,SP 10R fra Castelvetro Piacentino e confine regionale (Lombardia),22787,00,22305,482,16983,5804,22787,0
2019/03,391,09/03/2019,6,SP 10R fra Castelvetro Piacentino e confine regionale (Lombardia),21773,00,21542,231,15318,6455,0,21773
2019/03,391,10/03/2019,7,SP 10R fra Castelvetro Piacentino e confine regionale (Lombardia),18562,00,18467,95,13565,4997,0,18562
2019/03,391,11/03/2019,1,SP 10R fra Castelvetro Piacentino e confine regionale (Lombardia),19879,00,19361,518,15694,4185,19879,0
2019/03,391,12/03/2019,2,SP 10R fra Castelvetro Piacentino e confine regionale (Lombardia),19901,00,19351,550,15554,4347,19901,0
2019/03,391,13/03/2019,3,SP 10R fra Castelvetro Piacentino e confine regionale (Lombardia),20694,00,20148,546,16153,4541,20694,0
2019/03,391,14/03/2019,4,SP 10R fra Castelvetro Piacentino e confine regionale (Lombardia),20622,00,20117,505,16065,4557,20622,0
2019/03,393,01/03/2019,5,SP 10R fra Caorso e Roncaglia,12202,20,10787,1413,9258,2944,12202,0
2019/03,393,02/03/2019,6,SP 10R fra Caorso e Roncaglia,8915,00,8601,314,6419,2496,0,8915
2019/03,393,03/03/2019,7,SP 10R fra Caorso e Roncaglia,7217,30,7150,64,5358,1859,0,7217
2019/03,393,04/03/2019,1,SP 10R fra Caorso e Roncaglia,11428,20,9843,1583,9116,2312,11428,0
2019/03,393,05/03/2019,2,SP 10R fra Caorso e Roncaglia,11548,10,9938,1609,9078,2470,11548,0
2019/03,393,06/03/2019,3,SP 10R fra Caorso e Roncaglia,11764,00,10164,1600,9152,2612,11764,0
2019/03,393,07/03/2019,4,SP 10R fra Caorso e Roncaglia,11754,10,10108,1645,9155,2599,11754,0
2019/03,393,08/03/2019,5,SP 10R fra Caorso e Roncaglia,12119,10,10537,1581,9227,2892,12119,0
2019/03,393,09/03/2019,6,SP 10R fra Caorso e Roncaglia,9014,00,8741,273,6357,2657,0,9014
2019/03,393,10/03/2019,7,SP 10R fra Caorso e Roncaglia,6921,10,6857,63,4999,1922,0,6921
2019/03,393,11/03/2019,1,SP 10R fra Caorso e Roncaglia,11805,20,9971,1832,9319,2486,11805,0
2019/03,393,12/03/2019,2,SP 10R fra Caorso e Roncaglia,11334,00,9730,1604,8870,2464,11334,0
2019/03,393,13/03/2019,3,SP 10R fra Caorso e Roncaglia,11773,20,10022,1749,9202,2571,11773,0
2019/03,393,14/03/2019,4,SP 10R fra Caorso e Roncaglia,11747,00,10130,1617,9047,2700,11747,0
2019/03,394,01/03/2019,5,SP 523R da Roccamurata (bivio SP 308R) a Borgo Val di Taro,4899,00,4476,423,3719,1180,4899,0
2019/03,394,02/03/2019,6,SP 523R da Roccamurata (bivio SP 308R) a Borgo Val di Taro,4337,00,4253,84,3138,1199,0,4337
2019/03,394,03/03/2019,7,SP 523R da Roccamurata (bivio SP 308R) a Borgo Val di Taro,4606,00,4579,27,3309,1297,0,4606
2019/03,394,04/03/2019,1,SP 523R da Roccamurata (bivio SP 308R) a Borgo Val di Taro,4822,00,4438,384,3851,971,4822,0
2019/03,394,05/03/2019,2,SP 523R da Roccamurata (bivio SP 308R) a Borgo Val di Taro,4622,00,4257,365,3646,976,4622,0
2019/03,394,06/03/2019,3,SP 523R da Roccamurata (bivio SP 308R) a Borgo Val di Taro,4781,00,4348,433,3740,1041,4781,0
2019/03,394,07/03/2019,4,SP 523R da Roccamurata (bivio SP 308R) a Borgo Val di Taro,4673,00,4240,433,3678,995,4673,0
2019/03,394,08/03/2019,5,SP 523R da Roccamurata (bivio SP 308R) a Borgo Val di Taro,5115,00,4686,429,3947,1168,5115,0
2019/03,394,09/03/2019,6,SP 523R da Roccamurata (bivio SP 308R) a Borgo Val di Taro,3919,00,3787,132,3063,856,0,3919
2019/03,394,10/03/2019,7,SP 523R da Roccamurata (bivio SP 308R) a Borgo Val di Taro,3710,00,3681,29,2888,822,0,3710
2019/03,394,11/03/2019,1,SP 523R da Roccamurata (bivio SP 308R) a Borgo Val di Taro,4908,00,4475,433,3959,949,4908,0
2019/03,394,12/03/2019,2,SP 523R da Roccamurata (bivio SP 308R) a Borgo Val di Taro,4752,00,4333,419,3750,1002,4752,0
2019/03,394,13/03/2019,3,SP 523R da Roccamurata (bivio SP 308R) a Borgo Val di Taro,4623,10,4197,425,3725,898,4623,0
2019/03,394,14/03/2019,4,SP 523R da Roccamurata (bivio SP 308R) a Borgo Val di Taro,4792,00,4393,399,3785,1007,4792,0
2019/03,395,01/03/2019,5,SP 308R da Fornovo di Taro (bivio SS 62) a Solignano,4515,00,4279,236,3499,1016,4515,0
2019/03,395,02/03/2019,6,SP 308R da Fornovo di Taro (bivio SS 62) a Solignano,3957,00,3900,57,3033,924,0,3957
2019/03,395,03/03/2019,7,SP 308R da Fornovo di Taro (bivio SS 62) a Solignano,4045,00,4029,16,3087,958,0,4045
2019/03,395,04/03/2019,1,SP 308R da Fornovo di Taro (bivio SS 62) a Solignano,4282,00,4052,230,3370,912,4282,0
2019/03,395,05/03/2019,2,SP 308R da Fornovo di Taro (bivio SS 62) a Solignano,4431,00,4173,258,3531,900,4431,0
2019/03,395,06/03/2019,3,SP 308R da Fornovo di Taro (bivio SS 62) a Solignano,4285,00,4014,271,3332,953,4285,0
2019/03,395,07/03/2019,4,SP 308R da Fornovo di Taro (bivio SS 62) a Solignano,4301,10,4070,230,3391,910,4301,0
2019/03,395,08/03/2019,5,SP 308R da Fornovo di Taro (bivio SS 62) a Solignano,4755,00,4540,215,3636,1119,4755,0
2019/03,395,09/03/2019,6,SP 308R da Fornovo di Taro (bivio SS 62) a Solignano,3775,10,3710,64,2926,849,0,3775
2019/03,395,10/03/2019,7,SP 308R da Fornovo di Taro (bivio SS 62) a Solignano,3607,00,3583,24,2824,783,0,3607
2019/03,395,11/03/2019,1,SP 308R da Fornovo di Taro (bivio SS 62) a Solignano,4262,00,4016,246,3355,907,4262,0
2019/03,395,12/03/2019,2,SP 308R da Fornovo di Taro (bivio SS 62) a Solignano,4534,00,4293,241,3560,974,4534,0
2019/03,395,13/03/2019,3,SP 308R da Fornovo di Taro (bivio SS 62) a Solignano,4393,00,4173,220,3452,941,4393,0
2019/03,395,14/03/2019,4,SP 308R da Fornovo di Taro (bivio SS 62) a Solignano,4410,00,4213,197,3444,966,4410,0
2019/03,396,01/03/2019,5,SP 28 fra Fornovo di Taro e Varano de Melegari centro abitato Viazzano,8587,00,8220,367,6764,1823,8587,0
2019/03,396,02/03/2019,6,SP 28 fra Fornovo di Taro e Varano de Melegari centro abitato Viazzano,6772,00,6662,110,5303,1469,0,6772
2019/03,396,03/03/2019,7,SP 28 fra Fornovo di Taro e Varano de Melegari centro abitato Viazzano,6059,00,6018,41,4808,1251,0,6059
2019/03,396,04/03/2019,1,SP 28 fra Fornovo di Taro e Varano de Melegari centro abitato Viazzano,7588,00,7236,352,6285,1303,7588,0
2019/03,396,05/03/2019,2,SP 28 fra Fornovo di Taro e Varano de Melegari centro abitato Viazzano,7863,00,7526,337,6384,1479,7863,0
2019/03,396,06/03/2019,3,SP 28 fra Fornovo di Taro e Varano de Melegari centro abitato Viazzano,7892,00,7538,354,6321,1571,7892,0
2019/03,396,07/03/2019,4,SP 28 fra Fornovo di Taro e Varano de Melegari centro abitato Viazzano,8115,00,7765,350,6531,1584,8115,0
2019/03,396,08/03/2019,5,SP 28 fra Fornovo di Taro e Varano de Melegari centro abitato Viazzano,8313,00,7941,372,6599,1714,8313,0
2019/03,396,09/03/2019,6,SP 28 fra Fornovo di Taro e Varano de Melegari centro abitato Viazzano,6844,00,6744,100,5286,1558,0,6844
2019/03,396,10/03/2019,7,SP 28 fra Fornovo di Taro e Varano de Melegari centro abitato Viazzano,6105,00,6050,55,4873,1232,0,6105
2019/03,396,11/03/2019,1,SP 28 fra Fornovo di Taro e Varano de Melegari centro abitato Viazzano,7640,00,7284,356,6262,1378,7640,0
2019/03,396,12/03/2019,2,SP 28 fra Fornovo di Taro e Varano de Melegari centro abitato Viazzano,8060,10,7706,353,6540,1520,8060,0
2019/03,396,13/03/2019,3,SP 28 fra Fornovo di Taro e Varano de Melegari centro abitato Viazzano,7842,10,7459,382,6286,1556,7842,0
2019/03,396,14/03/2019,4,SP 28 fra Fornovo di Taro e Varano de Melegari centro abitato Viazzano,8250,10,7875,374,6603,1647,8250,0
2019/03,397,01/03/2019,5,SP 12 fra casello A 1 e Fidenza,,,,,,,,
2019/03,397,02/03/2019,6,SP 12 fra casello A 1 e Fidenza,,,,,,,,
2019/03,397,03/03/2019,7,SP 12 fra casello A 1 e Fidenza,,,,,,,,
2019/03,397,04/03/2019,1,SP 12 fra casello A 1 e Fidenza,,,,,,,,
2019/03,397,05/03/2019,2,SP 12 fra casello A 1 e Fidenza,,,,,,,,
2019/03,397,06/03/2019,3,SP 12 fra casello A 1 e Fidenza,,,,,,,,
2019/03,397,07/03/2019,4,SP 12 fra casello A 1 e Fidenza,,,,,,,,
2019/03,397,08/03/2019,5,SP 12 fra casello A 1 e Fidenza,,,,,,,,
2019/03,397,09/03/2019,6,SP 12 fra casello A 1 e Fidenza,,,,,,,,
2019/03,397,10/03/2019,7,SP 12 fra casello A 1 e Fidenza,,,,,,,,
2019/03,397,11/03/2019,1,SP 12 fra casello A 1 e Fidenza,,,,,,,,
2019/03,397,12/03/2019,2,SP 12 fra casello A 1 e Fidenza,,,,,,,,
2019/03,397,13/03/2019,3,SP 12 fra casello A 1 e Fidenza,,,,,,,,
2019/03,397,14/03/2019,4,SP 12 fra casello A 1 e Fidenza,,,,,,,,
2019/03,398,01/03/2019,5,SP 11 tra Fontevivo e Cispadana (tangenziale),,,,,,,,
2019/03,398,02/03/2019,6,SP 11 tra Fontevivo e Cispadana (tangenziale),,,,,,,,
2019/03,398,03/03/2019,7,SP 11 tra Fontevivo e Cispadana (tangenziale),,,,,,,,
2019/03,398,04/03/2019,1,SP 11 tra Fontevivo e Cispadana (tangenziale),,,,,,,,
2019/03,398,05/03/2019,2,SP 11 tra Fontevivo e Cispadana (tangenziale),,,,,,,,
2019/03,398,06/03/2019,3,SP 11 tra Fontevivo e Cispadana (tangenziale),,,,,,,,
2019/03,398,07/03/2019,4,SP 11 tra Fontevivo e Cispadana (tangenziale),,,,,,,,
2019/03,398,08/03/2019,5,SP 11 tra Fontevivo e Cispadana (tangenziale),,,,,,,,
2019/03,398,09/03/2019,6,SP 11 tra Fontevivo e Cispadana (tangenziale),,,,,,,,
2019/03,398,10/03/2019,7,SP 11 tra Fontevivo e Cispadana (tangenziale),,,,,,,,
2019/03,398,11/03/2019,1,SP 11 tra Fontevivo e Cispadana (tangenziale),,,,,,,,
2019/03,398,12/03/2019,2,SP 11 tra Fontevivo e Cispadana (tangenziale),,,,,,,,
2019/03,398,13/03/2019,3,SP 11 tra Fontevivo e Cispadana (tangenziale),,,,,,,,
2019/03,398,14/03/2019,4,SP 11 tra Fontevivo e Cispadana (tangenziale),,,,,,,,
2019/03,399,01/03/2019,5,SP 43 tra Trecasali (bivio SP 8) e Torrile,3754,10,3380,373,2933,821,3754,0
2019/03,399,02/03/2019,6,SP 43 tra Trecasali (bivio SP 8) e Torrile,2639,10,2498,140,1961,678,0,2639
2019/03,399,03/03/2019,7,SP 43 tra Trecasali (bivio SP 8) e Torrile,2142,00,2097,45,1610,532,0,2142
2019/03,399,04/03/2019,1,SP 43 tra Trecasali (bivio SP 8) e Torrile,3588,00,3226,362,2826,762,3588,0
2019/03,399,05/03/2019,2,SP 43 tra Trecasali (bivio SP 8) e Torrile,3818,20,3389,427,2952,866,3818,0
2019/03,399,06/03/2019,3,SP 43 tra Trecasali (bivio SP 8) e Torrile,3774,20,3382,390,2891,883,3774,0
2019/03,399,07/03/2019,4,SP 43 tra Trecasali (bivio SP 8) e Torrile,3693,10,3302,390,2873,820,3693,0
2019/03,399,08/03/2019,5,SP 43 tra Trecasali (bivio SP 8) e Torrile,3944,10,3545,398,3045,899,3944,0
2019/03,399,09/03/2019,6,SP 43 tra Trecasali (bivio SP 8) e Torrile,2670,10,2502,167,1957,713,0,2670
2019/03,399,10/03/2019,7,SP 43 tra Trecasali (bivio SP 8) e Torrile,2033,00,1979,54,1478,555,0,2033
2019/03,399,11/03/2019,1,SP 43 tra Trecasali (bivio SP 8) e Torrile,3713,10,3277,435,2934,779,3713,0
2019/03,399,12/03/2019,2,SP 43 tra Trecasali (bivio SP 8) e Torrile,3859,00,3432,427,3042,817,3859,0
2019/03,399,13/03/2019,3,SP 43 tra Trecasali (bivio SP 8) e Torrile,3860,10,3483,376,2976,884,3860,0
2019/03,399,14/03/2019,4,SP 43 tra Trecasali (bivio SP 8) e Torrile,3812,10,3429,382,2974,838,3812,0
2019/03,400,01/03/2019,5,SP 10 da San Secondo Parmense al bivio per Roccabianca centro abitato Pizzo,7689,00,6558,1131,6006,1683,7689,0
2019/03,400,02/03/2019,6,SP 10 da San Secondo Parmense al bivio per Roccabianca centro abitato Pizzo,6252,00,5951,301,4715,1537,0,6252
2019/03,400,03/03/2019,7,SP 10 da San Secondo Parmense al bivio per Roccabianca centro abitato Pizzo,5453,00,5349,104,4031,1422,0,5453
2019/03,400,04/03/2019,1,SP 10 da San Secondo Parmense al bivio per Roccabianca centro abitato Pizzo,7189,00,6113,1076,5821,1368,7189,0
2019/03,400,05/03/2019,2,SP 10 da San Secondo Parmense al bivio per Roccabianca centro abitato Pizzo,7537,00,6376,1161,6039,1498,7537,0
2019/03,400,06/03/2019,3,SP 10 da San Secondo Parmense al bivio per Roccabianca centro abitato Pizzo,7789,20,6608,1179,6284,1505,7789,0
2019/03,400,07/03/2019,4,SP 10 da San Secondo Parmense al bivio per Roccabianca centro abitato Pizzo,7841,10,6584,1256,6144,1697,7841,0
2019/03,400,08/03/2019,5,SP 10 da San Secondo Parmense al bivio per Roccabianca centro abitato Pizzo,8188,10,7005,1182,6397,1791,8188,0
2019/03,400,09/03/2019,6,SP 10 da San Secondo Parmense al bivio per Roccabianca centro abitato Pizzo,6207,00,5897,310,4610,1597,0,6207
2019/03,400,10/03/2019,7,SP 10 da San Secondo Parmense al bivio per Roccabianca centro abitato Pizzo,5390,00,5304,86,3996,1394,0,5390
2019/03,400,11/03/2019,1,SP 10 da San Secondo Parmense al bivio per Roccabianca centro abitato Pizzo,7410,00,6158,1252,5928,1482,7410,0
2019/03,400,12/03/2019,2,SP 10 da San Secondo Parmense al bivio per Roccabianca centro abitato Pizzo,7420,00,6237,1183,5969,1451,7420,0
2019/03,400,13/03/2019,3,SP 10 da San Secondo Parmense al bivio per Roccabianca centro abitato Pizzo,7631,10,6408,1222,6090,1541,7631,0
2019/03,400,14/03/2019,4,SP 10 da San Secondo Parmense al bivio per Roccabianca centro abitato Pizzo,7353,00,6266,1087,5868,1485,7353,0
2019/03,401,01/03/2019,5,SP 513R fra Traversetolo e confine provinciale,7402,00,6795,607,5807,1595,7402,0
2019/03,401,02/03/2019,6,SP 513R fra Traversetolo e confine provinciale,6218,40,6045,169,4849,1369,0,6218
2019/03,401,03/03/2019,7,SP 513R fra Traversetolo e confine provinciale,7450,10,7408,41,6243,1207,0,7450
2019/03,401,04/03/2019,1,SP 513R fra Traversetolo e confine provinciale,6896,10,6272,623,5681,1215,6896,0
2019/03,401,05/03/2019,2,SP 513R fra Traversetolo e confine provinciale,7283,30,6647,633,5905,1378,7283,0
2019/03,401,06/03/2019,3,SP 513R fra Traversetolo e confine provinciale,7406,00,6809,597,5950,1456,7406,0
2019/03,401,07/03/2019,4,SP 513R fra Traversetolo e confine provinciale,7371,10,6768,602,5988,1383,7371,0
2019/03,401,08/03/2019,5,SP 513R fra Traversetolo e confine provinciale,7862,30,7213,646,6207,1655,7862,0
2019/03,401,09/03/2019,6,SP 513R fra Traversetolo e confine provinciale,6550,20,6404,144,5051,1499,0,6550
2019/03,401,10/03/2019,7,SP 513R fra Traversetolo e confine provinciale,7689,00,7646,43,6396,1293,0,7689
2019/03,401,11/03/2019,1,SP 513R fra Traversetolo e confine provinciale,7003,10,6342,660,5749,1254,7003,0
2019/03,401,12/03/2019,2,SP 513R fra Traversetolo e confine provinciale,7431,20,6774,655,6066,1365,7431,0
2019/03,401,13/03/2019,3,SP 513R fra Traversetolo e confine provinciale,7621,00,6918,703,6206,1415,7621,0
2019/03,401,14/03/2019,4,SP 513R fra Traversetolo e confine provinciale,7610,10,6940,669,6224,1386,7610,0
2019/03,402,01/03/2019,5,SP 18 da Pilastrello (bivio SP 513R) al bivio per la Pedemontana,15057,00,14681,376,11774,3283,15057,0
2019/03,402,02/03/2019,6,SP 18 da Pilastrello (bivio SP 513R) al bivio per la Pedemontana,12490,00,12368,122,9466,3024,0,12490
2019/03,402,03/03/2019,7,SP 18 da Pilastrello (bivio SP 513R) al bivio per la Pedemontana,9599,00,9565,34,7078,2521,0,9599
2019/03,402,04/03/2019,1,SP 18 da Pilastrello (bivio SP 513R) al bivio per la Pedemontana,14384,00,14025,359,11682,2702,14384,0
2019/03,402,05/03/2019,2,SP 18 da Pilastrello (bivio SP 513R) al bivio per la Pedemontana,14781,00,14445,336,11848,2933,14781,0
2019/03,402,06/03/2019,3,SP 18 da Pilastrello (bivio SP 513R) al bivio per la Pedemontana,14661,00,14274,387,11761,2900,14661,0
2019/03,402,07/03/2019,4,SP 18 da Pilastrello (bivio SP 513R) al bivio per la Pedemontana,14505,00,14199,306,11611,2894,14505,0
2019/03,402,08/03/2019,5,SP 18 da Pilastrello (bivio SP 513R) al bivio per la Pedemontana,15378,20,15066,310,11917,3461,15378,0
2019/03,402,09/03/2019,6,SP 18 da Pilastrello (bivio SP 513R) al bivio per la Pedemontana,13035,00,12920,115,9716,3319,0,13035
2019/03,402,10/03/2019,7,SP 18 da Pilastrello (bivio SP 513R) al bivio per la Pedemontana,9322,10,9295,26,6933,2389,0,9322
2019/03,402,11/03/2019,1,SP 18 da Pilastrello (bivio SP 513R) al bivio per la Pedemontana,13984,00,13681,303,11479,2505,13984,0
2019/03,402,12/03/2019,2,SP 18 da Pilastrello (bivio SP 513R) al bivio per la Pedemontana,14783,00,14406,377,11955,2828,14783,0
2019/03,402,13/03/2019,3,SP 18 da Pilastrello (bivio SP 513R) al bivio per la Pedemontana,14456,10,14100,355,11491,2965,14456,0
2019/03,402,14/03/2019,4,SP 18 da Pilastrello (bivio SP 513R) al bivio per la Pedemontana,14353,00,14044,309,11580,2773,14353,0
2019/03,403,01/03/2019,5,SP 72 tra Parma e Mezzani,8564,20,7971,591,6965,1599,8564,0
2019/03,403,02/03/2019,6,SP 72 tra Parma e Mezzani,5978,00,5893,85,4456,1522,0,5978
2019/03,403,03/03/2019,7,SP 72 tra Parma e Mezzani,4672,00,4639,33,3437,1235,0,4672
2019/03,403,04/03/2019,1,SP 72 tra Parma e Mezzani,8231,00,7591,640,6845,1386,8231,0
2019/03,403,05/03/2019,2,SP 72 tra Parma e Mezzani,8576,00,7928,648,7037,1539,8576,0
2019/03,403,06/03/2019,3,SP 72 tra Parma e Mezzani,8372,00,7723,649,6920,1452,8372,0
2019/03,403,07/03/2019,4,SP 72 tra Parma e Mezzani,8617,00,7995,622,7048,1569,8617,0
2019/03,403,08/03/2019,5,SP 72 tra Parma e Mezzani,8726,00,8107,619,7083,1643,8726,0
2019/03,403,09/03/2019,6,SP 72 tra Parma e Mezzani,6123,00,6024,99,4530,1593,0,6123
2019/03,403,10/03/2019,7,SP 72 tra Parma e Mezzani,4470,00,4440,30,3276,1194,0,4470
2019/03,403,11/03/2019,1,SP 72 tra Parma e Mezzani,8295,10,7620,674,6934,1361,8295,0
2019/03,403,12/03/2019,2,SP 72 tra Parma e Mezzani,8483,10,7820,662,7021,1462,8483,0
2019/03,403,13/03/2019,3,SP 72 tra Parma e Mezzani,8458,00,7809,649,6873,1585,8458,0
2019/03,403,14/03/2019,4,SP 72 tra Parma e Mezzani,8565,10,7864,700,7061,1504,8565,0
2019/03,404,01/03/2019,5,exSP 32 (via Dante Alighieri) da Felino a Pilastro,7093,20,6910,181,5520,1573,7093,0
2019/03,404,02/03/2019,6,exSP 32 (via Dante Alighieri) da Felino a Pilastro,5876,20,5781,93,4487,1389,0,5876
2019/03,404,03/03/2019,7,exSP 32 (via Dante Alighieri) da Felino a Pilastro,4566,10,4540,25,3363,1203,0,4566
2019/03,404,04/03/2019,1,exSP 32 (via Dante Alighieri) da Felino a Pilastro,6865,10,6690,174,5538,1327,6865,0
2019/03,404,05/03/2019,2,exSP 32 (via Dante Alighieri) da Felino a Pilastro,7417,40,7225,188,5880,1537,7417,0
2019/03,404,06/03/2019,3,exSP 32 (via Dante Alighieri) da Felino a Pilastro,7297,20,7124,171,5768,1529,7297,0
2019/03,404,07/03/2019,4,exSP 32 (via Dante Alighieri) da Felino a Pilastro,7297,30,7100,194,5767,1530,7297,0
2019/03,404,08/03/2019,5,exSP 32 (via Dante Alighieri) da Felino a Pilastro,7771,20,7572,197,6005,1766,7771,0
2019/03,404,09/03/2019,6,exSP 32 (via Dante Alighieri) da Felino a Pilastro,6495,20,6406,87,4803,1692,0,6495
2019/03,404,10/03/2019,7,exSP 32 (via Dante Alighieri) da Felino a Pilastro,4976,10,4944,31,3764,1212,0,4976
2019/03,404,11/03/2019,1,exSP 32 (via Dante Alighieri) da Felino a Pilastro,6911,10,6748,162,5569,1342,6911,0
2019/03,404,12/03/2019,2,exSP 32 (via Dante Alighieri) da Felino a Pilastro,7238,20,7060,176,5799,1439,7238,0
2019/03,404,13/03/2019,3,exSP 32 (via Dante Alighieri) da Felino a Pilastro,7320,50,7104,211,5840,1480,7320,0
2019/03,404,14/03/2019,4,exSP 32 (via Dante Alighieri) da Felino a Pilastro,7312,30,7121,188,5820,1492,7312,0
2019/03,405,01/03/2019,5,SP 15 fra SS62 e Sala Baganza,11259,00,10431,828,8834,2425,11259,0
2019/03,405,02/03/2019,6,SP 15 fra SS62 e Sala Baganza,8681,00,8493,188,6417,2264,0,8681
2019/03,405,03/03/2019,7,SP 15 fra SS62 e Sala Baganza,6973,00,6951,22,5035,1938,0,6973
2019/03,405,04/03/2019,1,SP 15 fra SS62 e Sala Baganza,10937,00,10129,808,8893,2044,10937,0
2019/03,405,05/03/2019,2,SP 15 fra SS62 e Sala Baganza,11324,00,10539,785,9051,2273,11324,0
2019/03,405,06/03/2019,3,SP 15 fra SS62 e Sala Baganza,11174,00,10344,830,8944,2230,11174,0
2019/03,405,07/03/2019,4,SP 15 fra SS62 e Sala Baganza,11214,00,10371,843,9049,2165,11214,0
2019/03,405,08/03/2019,5,SP 15 fra SS62 e Sala Baganza,11704,00,10878,826,9123,2581,11704,0
2019/03,405,09/03/2019,6,SP 15 fra SS62 e Sala Baganza,8980,00,8789,191,6606,2374,0,8980
2019/03,405,10/03/2019,7,SP 15 fra SS62 e Sala Baganza,6554,00,6525,29,4832,1722,0,6554
2019/03,405,11/03/2019,1,SP 15 fra SS62 e Sala Baganza,10472,00,9645,827,8594,1878,10472,0
2019/03,405,12/03/2019,2,SP 15 fra SS62 e Sala Baganza,11268,00,10473,795,9088,2180,11268,0
2019/03,405,13/03/2019,3,SP 15 fra SS62 e Sala Baganza,11100,00,10286,814,8928,2172,11100,0
2019/03,405,14/03/2019,4,SP 15 fra SS62 e Sala Baganza,11151,00,10264,887,8949,2202,11151,0
2019/03,410,01/03/2019,5,SP 54 fra Pomposa e Codigoro,4298,00,4065,233,3307,991,4298,0
2019/03,410,02/03/2019,6,SP 54 fra Pomposa e Codigoro,4358,00,4268,90,3142,1216,0,4358
2019/03,410,03/03/2019,7,SP 54 fra Pomposa e Codigoro,4073,00,4059,14,2936,1137,0,4073
2019/03,410,04/03/2019,1,SP 54 fra Pomposa e Codigoro,4461,00,4191,270,3699,762,4461,0
2019/03,410,05/03/2019,2,SP 54 fra Pomposa e Codigoro,4495,00,4212,283,3727,768,4495,0
2019/03,410,06/03/2019,3,SP 54 fra Pomposa e Codigoro,4547,00,4289,258,3731,816,4547,0
2019/03,410,07/03/2019,4,SP 54 fra Pomposa e Codigoro,4753,00,4445,308,3841,912,4753,0
2019/03,410,08/03/2019,5,SP 54 fra Pomposa e Codigoro,5101,00,4802,299,3946,1155,5101,0
2019/03,410,09/03/2019,6,SP 54 fra Pomposa e Codigoro,4376,00,4276,100,3141,1235,0,4376
2019/03,410,10/03/2019,7,SP 54 fra Pomposa e Codigoro,4199,00,4177,22,3129,1070,0,4199
2019/03,410,11/03/2019,1,SP 54 fra Pomposa e Codigoro,4190,00,3941,249,3373,817,4190,0
2019/03,410,12/03/2019,2,SP 54 fra Pomposa e Codigoro,4632,00,4321,311,3847,785,4632,0
2019/03,410,13/03/2019,3,SP 54 fra Pomposa e Codigoro,4376,00,4104,272,3539,837,4376,0
2019/03,410,14/03/2019,4,SP 54 fra Pomposa e Codigoro,4699,00,4423,276,3817,882,4699,0
2019/03,411,01/03/2019,5,SP 53 fra Codigoro e Marozzo,5459,00,5359,100,4400,1059,5459,0
2019/03,411,02/03/2019,6,SP 53 fra Codigoro e Marozzo,4450,00,4410,40,3356,1094,0,4450
2019/03,411,03/03/2019,7,SP 53 fra Codigoro e Marozzo,3698,00,3689,9,2643,1055,0,3698
2019/03,411,04/03/2019,1,SP 53 fra Codigoro e Marozzo,5425,00,5330,95,4399,1026,5425,0
2019/03,411,05/03/2019,2,SP 53 fra Codigoro e Marozzo,5584,00,5484,100,4550,1034,5584,0
2019/03,411,06/03/2019,3,SP 53 fra Codigoro e Marozzo,5448,00,5351,97,4415,1033,5448,0
2019/03,411,07/03/2019,4,SP 53 fra Codigoro e Marozzo,5394,00,5279,115,4333,1061,5394,0
2019/03,411,08/03/2019,5,SP 53 fra Codigoro e Marozzo,5593,10,5478,114,4517,1076,5593,0
2019/03,411,09/03/2019,6,SP 53 fra Codigoro e Marozzo,4395,00,4342,53,3241,1154,0,4395
2019/03,411,10/03/2019,7,SP 53 fra Codigoro e Marozzo,3316,00,3307,9,2358,958,0,3316
2019/03,411,11/03/2019,1,SP 53 fra Codigoro e Marozzo,5291,00,5204,87,4280,1011,5291,0
2019/03,411,12/03/2019,2,SP 53 fra Codigoro e Marozzo,5445,00,5345,100,4448,997,5445,0
2019/03,411,13/03/2019,3,SP 53 fra Codigoro e Marozzo,5285,00,5179,106,4351,934,5285,0
2019/03,411,14/03/2019,4,SP 53 fra Codigoro e Marozzo,5510,00,5403,107,4487,1023,5510,0
2019/03,425,01/03/2019,5,SS 67 tra Dovadola e Rocca San Casciano,3729,00,3499,230,2978,751,3729,0
2019/03,425,02/03/2019,6,SS 67 tra Dovadola e Rocca San Casciano,3696,00,3625,71,2920,776,0,3696
2019/03,425,03/03/2019,7,SS 67 tra Dovadola e Rocca San Casciano,3156,10,3128,27,2553,603,0,3156
2019/03,425,04/03/2019,1,SS 67 tra Dovadola e Rocca San Casciano,3464,00,3274,190,2755,709,3464,0
2019/03,425,05/03/2019,2,SS 67 tra Dovadola e Rocca San Casciano,3627,00,3398,229,2947,680,3627,0
2019/03,425,06/03/2019,3,SS 67 tra Dovadola e Rocca San Casciano,3530,00,3320,210,2809,721,3530,0
2019/03,425,07/03/2019,4,SS 67 tra Dovadola e Rocca San Casciano,3664,00,3433,231,2933,731,3664,0
2019/03,425,08/03/2019,5,SS 67 tra Dovadola e Rocca San Casciano,3872,00,3658,214,3030,842,3872,0
2019/03,425,09/03/2019,6,SS 67 tra Dovadola e Rocca San Casciano,3542,00,3456,86,2729,813,0,3542
2019/03,425,10/03/2019,7,SS 67 tra Dovadola e Rocca San Casciano,3153,00,3134,19,2573,580,0,3153
2019/03,425,11/03/2019,1,SS 67 tra Dovadola e Rocca San Casciano,3326,00,3119,207,2708,618,3326,0
2019/03,425,12/03/2019,2,SS 67 tra Dovadola e Rocca San Casciano,3520,00,3323,197,2889,631,3520,0
2019/03,425,13/03/2019,3,SS 67 tra Dovadola e Rocca San Casciano,3518,00,3329,189,2805,713,3518,0
2019/03,425,14/03/2019,4,SS 67 tra Dovadola e Rocca San Casciano,3507,10,3255,251,2819,688,3507,0
2019/03,426,01/03/2019,5,SS 63 tra Casina e Vezzano sul Crostolo,15536,00,15045,491,11762,3774,15536,0
2019/03,426,02/03/2019,6,SS 63 tra Casina e Vezzano sul Crostolo,14508,00,14281,227,10769,3739,0,14508
2019/03,426,03/03/2019,7,SS 63 tra Casina e Vezzano sul Crostolo,13443,00,13375,68,10421,3022,0,13443
2019/03,426,04/03/2019,1,SS 63 tra Casina e Vezzano sul Crostolo,14178,00,13693,485,11039,3139,14178,0
2019/03,426,05/03/2019,2,SS 63 tra Casina e Vezzano sul Crostolo,14399,00,13918,481,11129,3270,14399,0
2019/03,426,06/03/2019,3,SS 63 tra Casina e Vezzano sul Crostolo,14745,00,14262,483,11306,3439,14745,0
2019/03,426,07/03/2019,4,SS 63 tra Casina e Vezzano sul Crostolo,14933,10,14397,535,11377,3556,14933,0
2019/03,426,08/03/2019,5,SS 63 tra Casina e Vezzano sul Crostolo,15761,00,15272,489,11783,3978,15761,0
2019/03,426,09/03/2019,6,SS 63 tra Casina e Vezzano sul Crostolo,14976,00,14762,214,11064,3912,0,14976
2019/03,426,10/03/2019,7,SS 63 tra Casina e Vezzano sul Crostolo,12858,00,12777,81,9714,3144,0,12858
2019/03,426,11/03/2019,1,SS 63 tra Casina e Vezzano sul Crostolo,14522,00,14005,517,11416,3106,14522,0
2019/03,426,12/03/2019,2,SS 63 tra Casina e Vezzano sul Crostolo,14526,00,14042,484,11292,3234,14526,0
2019/03,426,13/03/2019,3,SS 63 tra Casina e Vezzano sul Crostolo,14963,00,14459,504,11554,3409,14963,0
2019/03,426,14/03/2019,4,SS 63 tra Casina e Vezzano sul Crostolo,14925,00,14396,529,11394,3531,14925,0
2019/03,428,01/03/2019,5,SP 19 fra Colombaia (bivio SP 76) e il Bivio SP 486R al confine provinciale,3977,00,3547,430,3072,905,3977,0
2019/03,428,02/03/2019,6,SP 19 fra Colombaia (bivio SP 76) e il Bivio SP 486R al confine provinciale,3393,00,3335,58,2624,769,0,3393
2019/03,428,04/03/2019,1,SP 19 fra Colombaia (bivio SP 76) e il Bivio SP 486R al confine provinciale,3646,00,3255,391,2851,795,3646,0
2019/03,428,05/03/2019,2,SP 19 fra Colombaia (bivio SP 76) e il Bivio SP 486R al confine provinciale,3656,00,3248,408,2797,859,3656,0
2019/03,428,06/03/2019,3,SP 19 fra Colombaia (bivio SP 76) e il Bivio SP 486R al confine provinciale,3761,00,3308,453,2911,850,3761,0
2019/03,428,07/03/2019,4,SP 19 fra Colombaia (bivio SP 76) e il Bivio SP 486R al confine provinciale,3883,00,3411,472,3045,838,3883,0
2019/03,428,08/03/2019,5,SP 19 fra Colombaia (bivio SP 76) e il Bivio SP 486R al confine provinciale,4145,00,3712,433,3159,986,4145,0
2019/03,428,13/03/2019,3,SP 19 fra Colombaia (bivio SP 76) e il Bivio SP 486R al confine provinciale,3719,00,3256,463,2891,828,3719,0
2019/03,428,14/03/2019,4,SP 19 fra Colombaia (bivio SP 76) e il Bivio SP 486R al confine provinciale,3962,00,3444,518,3089,873,3962,0
2019/03,429,01/03/2019,5,SP 12 fra San Polo d'Enza e Montecchio Emilia (variante a sud abitato),8305,10,7491,813,6564,1741,8305,0
2019/03,429,02/03/2019,6,SP 12 fra San Polo d'Enza e Montecchio Emilia (variante a sud abitato),7398,00,7212,186,5640,1758,0,7398
2019/03,429,03/03/2019,7,SP 12 fra San Polo d'Enza e Montecchio Emilia (variante a sud abitato),6236,00,6152,84,4775,1461,0,6236
2019/03,429,04/03/2019,1,SP 12 fra San Polo d'Enza e Montecchio Emilia (variante a sud abitato),8051,00,7211,840,6641,1410,8051,0
2019/03,429,05/03/2019,2,SP 12 fra San Polo d'Enza e Montecchio Emilia (variante a sud abitato),8120,00,7173,947,6601,1519,8120,0
2019/03,429,06/03/2019,3,SP 12 fra San Polo d'Enza e Montecchio Emilia (variante a sud abitato),8152,10,7266,885,6576,1576,8152,0
2019/03,429,07/03/2019,4,SP 12 fra San Polo d'Enza e Montecchio Emilia (variante a sud abitato),8376,00,7450,926,6798,1578,8376,0
2019/03,429,08/03/2019,5,SP 12 fra San Polo d'Enza e Montecchio Emilia (variante a sud abitato),8722,00,7810,912,6872,1850,8722,0
2019/03,429,09/03/2019,6,SP 12 fra San Polo d'Enza e Montecchio Emilia (variante a sud abitato),7572,00,7341,231,5850,1722,0,7572
2019/03,429,10/03/2019,7,SP 12 fra San Polo d'Enza e Montecchio Emilia (variante a sud abitato),6312,00,6223,89,4906,1406,0,6312
2019/03,429,11/03/2019,1,SP 12 fra San Polo d'Enza e Montecchio Emilia (variante a sud abitato),8229,00,7320,909,6774,1455,8229,0
2019/03,429,12/03/2019,2,SP 12 fra San Polo d'Enza e Montecchio Emilia (variante a sud abitato),8351,00,7380,971,6844,1507,8351,0
2019/03,429,13/03/2019,3,SP 12 fra San Polo d'Enza e Montecchio Emilia (variante a sud abitato),8347,00,7443,904,6742,1605,8347,0
2019/03,429,14/03/2019,4,SP 12 fra San Polo d'Enza e Montecchio Emilia (variante a sud abitato),8523,10,7553,969,6860,1663,8523,0
2019/03,430,01/03/2019,5,SP 28 tra Montecchio Emilia e bivio circonvallazione,11241,00,10540,701,8902,2339,11241,0
2019/03,430,02/03/2019,6,SP 28 tra Montecchio Emilia e bivio circonvallazione,8309,00,8180,129,6195,2114,0,8309
2019/03,430,03/03/2019,7,SP 28 tra Montecchio Emilia e bivio circonvallazione,6138,10,6092,45,4496,1642,0,6138
2019/03,430,04/03/2019,1,SP 28 tra Montecchio Emilia e bivio circonvallazione,10710,00,10072,638,8869,1841,10710,0
2019/03,430,05/03/2019,2,SP 28 tra Montecchio Emilia e bivio circonvallazione,10767,10,10133,633,8653,2114,10767,0
2019/03,430,07/03/2019,4,SP 28 tra Montecchio Emilia e bivio circonvallazione,10442,10,9822,619,8312,2130,10442,0
2019/03,430,08/03/2019,5,SP 28 tra Montecchio Emilia e bivio circonvallazione,11075,00,10430,645,8632,2443,11075,0
2019/03,431,01/03/2019,5,SP 12 fra Sant'Ilario d'Enza (variante a sud) e Montecchio Emilia,7092,00,6780,312,5577,1515,7092,0
2019/03,431,02/03/2019,6,SP 12 fra Sant'Ilario d'Enza (variante a sud) e Montecchio Emilia,6330,00,6232,98,4900,1430,0,6330
2019/03,431,03/03/2019,7,SP 12 fra Sant'Ilario d'Enza (variante a sud) e Montecchio Emilia,4677,00,4659,18,3396,1281,0,4677
2019/03,431,04/03/2019,1,SP 12 fra Sant'Ilario d'Enza (variante a sud) e Montecchio Emilia,6571,00,6315,256,5467,1104,6571,0
2019/03,431,05/03/2019,2,SP 12 fra Sant'Ilario d'Enza (variante a sud) e Montecchio Emilia,6691,00,6415,276,5359,1332,6691,0
2019/03,431,06/03/2019,3,SP 12 fra Sant'Ilario d'Enza (variante a sud) e Montecchio Emilia,6730,00,6459,271,5416,1314,6730,0
2019/03,431,07/03/2019,4,SP 12 fra Sant'Ilario d'Enza (variante a sud) e Montecchio Emilia,6666,00,6444,222,5317,1349,6666,0
2019/03,431,08/03/2019,5,SP 12 fra Sant'Ilario d'Enza (variante a sud) e Montecchio Emilia,7016,10,6741,274,5470,1546,7016,0
2019/03,431,09/03/2019,6,SP 12 fra Sant'Ilario d'Enza (variante a sud) e Montecchio Emilia,6264,00,6184,80,4700,1564,0,6264
2019/03,431,10/03/2019,7,SP 12 fra Sant'Ilario d'Enza (variante a sud) e Montecchio Emilia,4704,00,4687,17,3540,1164,0,4704
2019/03,431,11/03/2019,1,SP 12 fra Sant'Ilario d'Enza (variante a sud) e Montecchio Emilia,6789,00,6532,257,5546,1243,6789,0
2019/03,431,12/03/2019,2,SP 12 fra Sant'Ilario d'Enza (variante a sud) e Montecchio Emilia,6671,10,6405,265,5395,1276,6671,0
2019/03,431,13/03/2019,3,SP 12 fra Sant'Ilario d'Enza (variante a sud) e Montecchio Emilia,6660,00,6353,307,5369,1291,6660,0
2019/03,431,14/03/2019,4,SP 12 fra Sant'Ilario d'Enza (variante a sud) e Montecchio Emilia,6917,00,6599,318,5588,1329,6917,0
2019/03,432,01/03/2019,5,SP 67 fra Calerno e Montecchio Emilia,11107,00,9741,1366,8788,2319,11107,0
2019/03,432,02/03/2019,6,SP 67 fra Calerno e Montecchio Emilia,7704,00,7470,234,5697,2007,0,7704
2019/03,432,03/03/2019,7,SP 67 fra Calerno e Montecchio Emilia,6971,00,6873,98,5054,1917,0,6971
2019/03,432,04/03/2019,1,SP 67 fra Calerno e Montecchio Emilia,10370,00,9102,1268,8537,1833,10370,0
2019/03,432,05/03/2019,2,SP 67 fra Calerno e Montecchio Emilia,10589,00,9133,1456,8528,2061,10589,0
2019/03,432,06/03/2019,3,SP 67 fra Calerno e Montecchio Emilia,10847,10,9520,1326,8819,2028,10847,0
2019/03,432,07/03/2019,4,SP 67 fra Calerno e Montecchio Emilia,11045,00,9642,1403,8894,2151,11045,0
2019/03,432,08/03/2019,5,SP 67 fra Calerno e Montecchio Emilia,11380,00,10002,1378,8993,2387,11380,0
2019/03,432,09/03/2019,6,SP 67 fra Calerno e Montecchio Emilia,7845,00,7589,256,5820,2025,0,7845
2019/03,432,10/03/2019,7,SP 67 fra Calerno e Montecchio Emilia,7008,00,6893,115,5135,1873,0,7008
2019/03,432,11/03/2019,1,SP 67 fra Calerno e Montecchio Emilia,10730,00,9378,1352,8718,2012,10730,0
2019/03,432,12/03/2019,2,SP 67 fra Calerno e Montecchio Emilia,10940,00,9604,1336,8875,2065,10940,0
2019/03,432,13/03/2019,3,SP 67 fra Calerno e Montecchio Emilia,10788,00,9429,1359,8694,2094,10788,0
2019/03,432,14/03/2019,4,SP 67 fra Calerno e Montecchio Emilia,11172,00,9720,1452,9048,2124,11172,0
2019/03,434,01/03/2019,5,Via San Nicola (ex SP 39) tra bivio per Taneto a Caprara,3566,00,3484,82,2766,800,3566,0
2019/03,434,02/03/2019,6,Via San Nicola (ex SP 39) tra bivio per Taneto a Caprara,3017,00,2978,39,2255,762,0,3017
2019/03,434,03/03/2019,7,Via San Nicola (ex SP 39) tra bivio per Taneto a Caprara,2241,00,2230,11,1594,647,0,2241
2019/03,434,04/03/2019,1,Via San Nicola (ex SP 39) tra bivio per Taneto a Caprara,3345,20,3270,73,2672,673,3345,0
2019/03,434,05/03/2019,2,Via San Nicola (ex SP 39) tra bivio per Taneto a Caprara,3452,00,3359,93,2755,697,3452,0
2019/03,434,06/03/2019,3,Via San Nicola (ex SP 39) tra bivio per Taneto a Caprara,3416,00,3322,94,2694,722,3416,0
2019/03,434,07/03/2019,4,Via San Nicola (ex SP 39) tra bivio per Taneto a Caprara,3414,10,3339,74,2724,690,3414,0
2019/03,434,08/03/2019,5,Via San Nicola (ex SP 39) tra bivio per Taneto a Caprara,3623,00,3559,64,2766,857,3623,0
2019/03,434,09/03/2019,6,Via San Nicola (ex SP 39) tra bivio per Taneto a Caprara,3056,00,3014,42,2237,819,0,3056
2019/03,434,10/03/2019,7,Via San Nicola (ex SP 39) tra bivio per Taneto a Caprara,2226,00,2215,11,1603,623,0,2226
2019/03,434,11/03/2019,1,Via San Nicola (ex SP 39) tra bivio per Taneto a Caprara,3350,10,3263,86,2672,678,3350,0
2019/03,434,12/03/2019,2,Via San Nicola (ex SP 39) tra bivio per Taneto a Caprara,3427,00,3349,78,2739,688,3427,0
2019/03,434,13/03/2019,3,Via San Nicola (ex SP 39) tra bivio per Taneto a Caprara,3431,10,3342,88,2673,758,3431,0
2019/03,434,14/03/2019,4,Via San Nicola (ex SP 39) tra bivio per Taneto a Caprara,3510,00,3427,83,2802,708,3510,0
2019/03,435,01/03/2019,5,SP 37Bis dalla località Selbagnone al bivio SP 72 (Meldola),7957,50,7484,468,6173,1784,7957,0
2019/03,435,02/03/2019,6,SP 37Bis dalla località Selbagnone al bivio SP 72 (Meldola),6854,20,6692,160,5032,1822,0,6854
2019/03,435,03/03/2019,7,SP 37Bis dalla località Selbagnone al bivio SP 72 (Meldola),6070,00,6043,27,4656,1414,0,6070
2019/03,435,04/03/2019,1,SP 37Bis dalla località Selbagnone al bivio SP 72 (Meldola),7576,60,7058,512,6060,1516,7576,0
2019/03,435,05/03/2019,2,SP 37Bis dalla località Selbagnone al bivio SP 72 (Meldola),7703,90,7192,502,6129,1574,7703,0
2019/03,435,06/03/2019,3,SP 37Bis dalla località Selbagnone al bivio SP 72 (Meldola),7837,50,7320,512,6205,1632,7837,0
2019/03,435,07/03/2019,4,SP 37Bis dalla località Selbagnone al bivio SP 72 (Meldola),7783,40,7325,454,6097,1686,7783,0
2019/03,435,08/03/2019,5,SP 37Bis dalla località Selbagnone al bivio SP 72 (Meldola),8201,50,7725,471,6240,1961,8201,0
2019/03,435,09/03/2019,6,SP 37Bis dalla località Selbagnone al bivio SP 72 (Meldola),6919,20,6730,187,4964,1955,0,6919
2019/03,435,10/03/2019,7,SP 37Bis dalla località Selbagnone al bivio SP 72 (Meldola),5723,00,5697,26,4306,1417,0,5723
2019/03,435,11/03/2019,1,SP 37Bis dalla località Selbagnone al bivio SP 72 (Meldola),7332,60,6840,486,5859,1473,7332,0
2019/03,435,12/03/2019,2,SP 37Bis dalla località Selbagnone al bivio SP 72 (Meldola),7686,20,7229,455,6074,1612,7686,0
2019/03,435,13/03/2019,3,SP 37Bis dalla località Selbagnone al bivio SP 72 (Meldola),7658,50,7179,474,5951,1707,7658,0
2019/03,435,14/03/2019,4,SP 37Bis dalla località Selbagnone al bivio SP 72 (Meldola),7755,50,7286,464,6055,1700,7755,0
2019/03,436,01/03/2019,5,SP 26 da Santa Sofia a San Piero in Bagno,892,00,863,29,695,197,892,0
2019/03,436,02/03/2019,6,SP 26 da Santa Sofia a San Piero in Bagno,935,00,915,20,694,241,0,935
2019/03,436,03/03/2019,7,SP 26 da Santa Sofia a San Piero in Bagno,1046,00,1039,7,815,231,0,1046
2019/03,436,04/03/2019,1,SP 26 da Santa Sofia a San Piero in Bagno,828,00,779,49,603,225,828,0
2019/03,436,05/03/2019,2,SP 26 da Santa Sofia a San Piero in Bagno,852,00,808,44,652,200,852,0
2019/03,436,06/03/2019,3,SP 26 da Santa Sofia a San Piero in Bagno,894,10,853,40,732,162,894,0
2019/03,436,07/03/2019,4,SP 26 da Santa Sofia a San Piero in Bagno,852,00,818,34,653,199,852,0
2019/03,436,08/03/2019,5,SP 26 da Santa Sofia a San Piero in Bagno,959,00,918,41,739,220,959,0
2019/03,436,09/03/2019,6,SP 26 da Santa Sofia a San Piero in Bagno,908,00,880,28,686,222,0,908
2019/03,436,10/03/2019,7,SP 26 da Santa Sofia a San Piero in Bagno,864,00,863,1,674,190,0,864
2019/03,436,11/03/2019,1,SP 26 da Santa Sofia a San Piero in Bagno,858,00,806,52,666,192,858,0
2019/03,436,12/03/2019,2,SP 26 da Santa Sofia a San Piero in Bagno,890,00,851,39,715,175,890,0
2019/03,436,13/03/2019,3,SP 26 da Santa Sofia a San Piero in Bagno,912,00,866,46,736,176,912,0
2019/03,436,14/03/2019,4,SP 26 da Santa Sofia a San Piero in Bagno,900,10,846,53,696,204,900,0
2019/03,437,01/03/2019,5,SP 13 tra SS 9 (Santarcangelo di Romagna) e SP 92 (località Camerano),7464,00,6475,989,5915,1549,7464,0
2019/03,437,02/03/2019,6,SP 13 tra SS 9 (Santarcangelo di Romagna) e SP 92 (località Camerano),6112,10,5857,254,4552,1560,0,6112
2019/03,437,03/03/2019,7,SP 13 tra SS 9 (Santarcangelo di Romagna) e SP 92 (località Camerano),4880,10,4851,28,3657,1223,0,4880
2019/03,437,04/03/2019,1,SP 13 tra SS 9 (Santarcangelo di Romagna) e SP 92 (località Camerano),7003,00,5913,1090,5673,1330,7003,0
2019/03,437,05/03/2019,2,SP 13 tra SS 9 (Santarcangelo di Romagna) e SP 92 (località Camerano),6881,10,5881,999,5506,1375,6881,0
2019/03,437,06/03/2019,3,SP 13 tra SS 9 (Santarcangelo di Romagna) e SP 92 (località Camerano),7179,10,6203,975,5803,1376,7179,0
2019/03,437,07/03/2019,4,SP 13 tra SS 9 (Santarcangelo di Romagna) e SP 92 (località Camerano),7173,00,6070,1103,5633,1540,7173,0
2019/03,437,08/03/2019,5,SP 13 tra SS 9 (Santarcangelo di Romagna) e SP 92 (località Camerano),7598,00,6438,1160,6016,1582,7598,0
2019/03,437,09/03/2019,6,SP 13 tra SS 9 (Santarcangelo di Romagna) e SP 92 (località Camerano),6035,00,5735,300,4509,1526,0,6035
2019/03,437,10/03/2019,7,SP 13 tra SS 9 (Santarcangelo di Romagna) e SP 92 (località Camerano),4873,00,4840,33,3611,1262,0,4873
2019/03,437,11/03/2019,1,SP 13 tra SS 9 (Santarcangelo di Romagna) e SP 92 (località Camerano),6923,00,5814,1109,5658,1265,6923,0
2019/03,437,12/03/2019,2,SP 13 tra SS 9 (Santarcangelo di Romagna) e SP 92 (località Camerano),7163,00,6019,1144,5757,1406,7163,0
2019/03,437,13/03/2019,3,SP 13 tra SS 9 (Santarcangelo di Romagna) e SP 92 (località Camerano),7251,00,6102,1149,5869,1382,7251,0
2019/03,437,14/03/2019,4,SP 13 tra SS 9 (Santarcangelo di Romagna) e SP 92 (località Camerano),7238,10,6000,1237,5789,1449,7238,0
2019/03,438,01/03/2019,5,SP 14 tra Colombare (bivio SP 14Ter) e bivio SP 258R,8625,00,8022,603,6819,1806,8625,0
2019/03,438,02/03/2019,6,SP 14 tra Colombare (bivio SP 14Ter) e bivio SP 258R,7097,10,6971,125,5308,1789,0,7097
2019/03,438,03/03/2019,7,SP 14 tra Colombare (bivio SP 14Ter) e bivio SP 258R,6716,00,6690,26,5270,1446,0,6716
2019/03,438,04/03/2019,1,SP 14 tra Colombare (bivio SP 14Ter) e bivio SP 258R,7913,10,7246,666,6448,1465,7913,0
2019/03,438,05/03/2019,2,SP 14 tra Colombare (bivio SP 14Ter) e bivio SP 258R,8204,10,7504,699,6626,1578,8204,0
2019/03,438,06/03/2019,3,SP 14 tra Colombare (bivio SP 14Ter) e bivio SP 258R,8233,00,7535,698,6648,1585,8233,0
2019/03,438,07/03/2019,4,SP 14 tra Colombare (bivio SP 14Ter) e bivio SP 258R,8434,10,7676,757,6706,1728,8434,0
2019/03,438,08/03/2019,5,SP 14 tra Colombare (bivio SP 14Ter) e bivio SP 258R,8920,00,8136,784,6965,1955,8920,0
2019/03,438,09/03/2019,6,SP 14 tra Colombare (bivio SP 14Ter) e bivio SP 258R,7183,20,6961,220,5302,1881,0,7183
2019/03,438,10/03/2019,7,SP 14 tra Colombare (bivio SP 14Ter) e bivio SP 258R,6470,00,6449,21,4979,1491,0,6470
2019/03,438,11/03/2019,1,SP 14 tra Colombare (bivio SP 14Ter) e bivio SP 258R,8002,10,7221,780,6607,1395,8002,0
2019/03,438,12/03/2019,2,SP 14 tra Colombare (bivio SP 14Ter) e bivio SP 258R,8232,00,7541,691,6673,1559,8232,0
2019/03,438,13/03/2019,3,SP 14 tra Colombare (bivio SP 14Ter) e bivio SP 258R,8231,20,7412,817,6685,1546,8231,0
2019/03,438,14/03/2019,4,SP 14 tra Colombare (bivio SP 14Ter) e bivio SP 258R,8274,00,7438,836,6636,1638,8274,0
2019/03,439,01/03/2019,5,SP 49 da Santarcangelo di Romagna alla località Posta (bivio SP 258R),13513,00,12581,932,10545,2968,13513,0
2019/03,439,02/03/2019,6,SP 49 da Santarcangelo di Romagna alla località Posta (bivio SP 258R),11470,00,11225,245,8429,3041,0,11470
2019/03,439,03/03/2019,7,SP 49 da Santarcangelo di Romagna alla località Posta (bivio SP 258R),9678,10,9652,25,7126,2552,0,9678
2019/03,439,04/03/2019,1,SP 49 da Santarcangelo di Romagna alla località Posta (bivio SP 258R),12136,30,11276,857,9838,2298,12136,0
2019/03,439,05/03/2019,2,SP 49 da Santarcangelo di Romagna alla località Posta (bivio SP 258R),12762,30,11816,943,10233,2529,12762,0
2019/03,439,06/03/2019,3,SP 49 da Santarcangelo di Romagna alla località Posta (bivio SP 258R),12554,10,11706,847,10045,2509,12554,0
2019/03,439,07/03/2019,4,SP 49 da Santarcangelo di Romagna alla località Posta (bivio SP 258R),12603,10,11678,924,10055,2548,12603,0
2019/03,439,08/03/2019,5,SP 49 da Santarcangelo di Romagna alla località Posta (bivio SP 258R),13841,20,12970,869,10727,3114,13841,0
2019/03,439,09/03/2019,6,SP 49 da Santarcangelo di Romagna alla località Posta (bivio SP 258R),11663,00,11413,250,8576,3087,0,11663
2019/03,439,10/03/2019,7,SP 49 da Santarcangelo di Romagna alla località Posta (bivio SP 258R),9132,00,9103,29,6733,2399,0,9132
2019/03,439,11/03/2019,1,SP 49 da Santarcangelo di Romagna alla località Posta (bivio SP 258R),11777,10,10995,781,9553,2224,11777,0
2019/03,439,12/03/2019,2,SP 49 da Santarcangelo di Romagna alla località Posta (bivio SP 258R),12562,00,11700,862,9997,2565,12562,0
2019/03,439,13/03/2019,3,SP 49 da Santarcangelo di Romagna alla località Posta (bivio SP 258R),12442,10,11578,863,9856,2586,12442,0
2019/03,439,14/03/2019,4,SP 49 da Santarcangelo di Romagna alla località Posta (bivio SP 258R),12781,00,11846,935,10084,2697,12781,0
2019/03,440,01/03/2019,5,SP 35 tra bivio SP 50 (località Cella) e Sant'Andrea in Casale,14121,10,13798,322,10934,3187,14121,0
2019/03,440,02/03/2019,6,SP 35 tra bivio SP 50 (località Cella) e Sant'Andrea in Casale,13096,20,12937,157,9576,3520,0,13096
2019/03,440,03/03/2019,7,SP 35 tra bivio SP 50 (località Cella) e Sant'Andrea in Casale,10731,00,10706,25,7644,3087,0,10731
2019/03,440,04/03/2019,1,SP 35 tra bivio SP 50 (località Cella) e Sant'Andrea in Casale,13233,00,12911,322,10648,2585,13233,0
2019/03,440,05/03/2019,2,SP 35 tra bivio SP 50 (località Cella) e Sant'Andrea in Casale,13650,00,13247,403,10903,2747,13650,0
2019/03,440,06/03/2019,3,SP 35 tra bivio SP 50 (località Cella) e Sant'Andrea in Casale,13834,10,13445,388,10931,2903,13834,0
2019/03,440,07/03/2019,4,SP 35 tra bivio SP 50 (località Cella) e Sant'Andrea in Casale,13978,00,13592,386,11067,2911,13978,0
2019/03,440,08/03/2019,5,SP 35 tra bivio SP 50 (località Cella) e Sant'Andrea in Casale,14896,00,14512,384,11308,3588,14896,0
2019/03,440,09/03/2019,6,SP 35 tra bivio SP 50 (località Cella) e Sant'Andrea in Casale,14123,40,13977,142,10042,4081,0,14123
2019/03,440,10/03/2019,7,SP 35 tra bivio SP 50 (località Cella) e Sant'Andrea in Casale,12310,00,12286,24,8968,3342,0,12310
2019/03,440,11/03/2019,1,SP 35 tra bivio SP 50 (località Cella) e Sant'Andrea in Casale,13291,00,12992,299,10495,2796,13291,0
2019/03,440,12/03/2019,2,SP 35 tra bivio SP 50 (località Cella) e Sant'Andrea in Casale,14189,00,13822,367,11091,3098,14189,0
2019/03,440,13/03/2019,3,SP 35 tra bivio SP 50 (località Cella) e Sant'Andrea in Casale,13779,00,13424,355,10718,3061,13779,0
2019/03,440,14/03/2019,4,SP 35 tra bivio SP 50 (località Cella) e Sant'Andrea in Casale,14461,10,14105,355,11264,3197,14461,0
2019/03,441,01/03/2019,5,SP 58 tra San Giovanni in Marignano e il confine regionale (Marche),9414,10,8999,414,7315,2099,9414,0
2019/03,441,02/03/2019,6,SP 58 tra San Giovanni in Marignano e il confine regionale (Marche),8331,00,8215,116,5960,2371,0,8331
2019/03,441,03/03/2019,7,SP 58 tra San Giovanni in Marignano e il confine regionale (Marche),7166,00,7142,24,5113,2053,0,7166
2019/03,441,04/03/2019,1,SP 58 tra San Giovanni in Marignano e il confine regionale (Marche),9124,00,8665,459,7426,1698,9124,0
2019/03,441,05/03/2019,2,SP 58 tra San Giovanni in Marignano e il confine regionale (Marche),9237,00,8736,501,7369,1868,9237,0
2019/03,441,06/03/2019,3,SP 58 tra San Giovanni in Marignano e il confine regionale (Marche),9039,10,8507,531,7203,1836,9039,0
2019/03,441,07/03/2019,4,SP 58 tra San Giovanni in Marignano e il confine regionale (Marche),9191,00,8782,409,7257,1934,9191,0
2019/03,441,08/03/2019,5,SP 58 tra San Giovanni in Marignano e il confine regionale (Marche),9742,00,9278,464,7434,2308,9742,0
2019/03,441,09/03/2019,6,SP 58 tra San Giovanni in Marignano e il confine regionale (Marche),8349,00,8224,125,5978,2371,0,8349
2019/03,441,10/03/2019,7,SP 58 tra San Giovanni in Marignano e il confine regionale (Marche),7471,00,7445,26,5449,2022,0,7471
2019/03,441,11/03/2019,1,SP 58 tra San Giovanni in Marignano e il confine regionale (Marche),8807,00,8395,412,7091,1716,8807,0
2019/03,441,12/03/2019,2,SP 58 tra San Giovanni in Marignano e il confine regionale (Marche),9228,00,8739,489,7400,1828,9228,0
2019/03,441,13/03/2019,3,SP 58 tra San Giovanni in Marignano e il confine regionale (Marche),9035,00,8558,477,7199,1836,9035,0
2019/03,441,14/03/2019,4,SP 58 tra San Giovanni in Marignano e il confine regionale (Marche),9477,00,9004,473,7484,1993,9477,0
2019/03,442,01/03/2019,5,SP 118 tra Casemurate (bivio SP 254R) e il confine provinciale,3998,00,3620,378,3079,919,3998,0
2019/03,442,02/03/2019,6,SP 118 tra Casemurate (bivio SP 254R) e il confine provinciale,3640,30,3499,138,2664,976,0,3640
2019/03,442,03/03/2019,7,SP 118 tra Casemurate (bivio SP 254R) e il confine provinciale,3188,10,3154,33,2374,814,0,3188
2019/03,442,04/03/2019,1,SP 118 tra Casemurate (bivio SP 254R) e il confine provinciale,3615,10,3264,350,2857,758,3615,0
2019/03,442,05/03/2019,2,SP 118 tra Casemurate (bivio SP 254R) e il confine provinciale,3638,00,3336,302,2864,774,3638,0
2019/03,442,06/03/2019,3,SP 118 tra Casemurate (bivio SP 254R) e il confine provinciale,3785,00,3452,333,2991,794,3785,0
2019/03,442,07/03/2019,4,SP 118 tra Casemurate (bivio SP 254R) e il confine provinciale,3741,00,3438,303,2937,804,3741,0
2019/03,442,08/03/2019,5,SP 118 tra Casemurate (bivio SP 254R) e il confine provinciale,3931,10,3582,348,2917,1014,3931,0
2019/03,442,09/03/2019,6,SP 118 tra Casemurate (bivio SP 254R) e il confine provinciale,3780,10,3638,141,2785,995,0,3780
2019/03,442,10/03/2019,7,SP 118 tra Casemurate (bivio SP 254R) e il confine provinciale,2923,00,2883,40,2143,780,0,2923
2019/03,442,11/03/2019,1,SP 118 tra Casemurate (bivio SP 254R) e il confine provinciale,3587,00,3253,334,2877,710,3587,0
2019/03,442,12/03/2019,2,SP 118 tra Casemurate (bivio SP 254R) e il confine provinciale,3601,10,3266,334,2836,765,3601,0
2019/03,442,13/03/2019,3,SP 118 tra Casemurate (bivio SP 254R) e il confine provinciale,3636,10,3303,332,2854,782,3636,0
2019/03,442,14/03/2019,4,SP 118 tra Casemurate (bivio SP 254R) e il confine provinciale,3779,10,3441,337,2983,796,3779,0
2019/03,443,01/03/2019,5,SP 16 tra Faenza e il confine provinciale,6066,00,5790,276,4572,1494,6066,0
2019/03,443,02/03/2019,6,SP 16 tra Faenza e il confine provinciale,6069,10,5973,95,4250,1819,0,6069
2019/03,443,03/03/2019,7,SP 16 tra Faenza e il confine provinciale,4970,00,4945,25,3908,1062,0,4970
2019/03,443,04/03/2019,1,SP 16 tra Faenza e il confine provinciale,5523,00,5221,302,4344,1179,5523,0
2019/03,443,05/03/2019,2,SP 16 tra Faenza e il confine provinciale,5931,00,5669,262,4677,1254,5931,0
2019/03,443,06/03/2019,3,SP 16 tra Faenza e il confine provinciale,5842,00,5530,312,4644,1198,5842,0
2019/03,443,07/03/2019,4,SP 16 tra Faenza e il confine provinciale,6051,10,5728,322,4750,1301,6051,0
2019/03,443,08/03/2019,5,SP 16 tra Faenza e il confine provinciale,6292,10,5990,301,4793,1499,6292,0
2019/03,443,09/03/2019,6,SP 16 tra Faenza e il confine provinciale,5771,00,5704,67,4239,1532,0,5771
2019/03,443,10/03/2019,7,SP 16 tra Faenza e il confine provinciale,4659,00,4640,19,3572,1087,0,4659
2019/03,443,11/03/2019,1,SP 16 tra Faenza e il confine provinciale,5482,00,5249,233,4362,1120,5482,0
2019/03,443,12/03/2019,2,SP 16 tra Faenza e il confine provinciale,5741,00,5488,253,4550,1191,5741,0
2019/03,443,13/03/2019,3,SP 16 tra Faenza e il confine provinciale,5647,00,5363,284,4477,1170,5647,0
2019/03,443,14/03/2019,4,SP 16 tra Faenza e il confine provinciale,5856,10,5570,285,4583,1273,5856,0
2019/03,444,01/03/2019,5,SP 5 fra Russi e San Pancrazio,,,,,,,,
2019/03,444,02/03/2019,6,SP 5 fra Russi e San Pancrazio,,,,,,,,
2019/03,444,03/03/2019,7,SP 5 fra Russi e San Pancrazio,,,,,,,,
2019/03,444,04/03/2019,1,SP 5 fra Russi e San Pancrazio,,,,,,,,
2019/03,444,05/03/2019,2,SP 5 fra Russi e San Pancrazio,,,,,,,,
2019/03,444,06/03/2019,3,SP 5 fra Russi e San Pancrazio,,,,,,,,
2019/03,444,07/03/2019,4,SP 5 fra Russi e San Pancrazio,,,,,,,,
2019/03,444,08/03/2019,5,SP 5 fra Russi e San Pancrazio,,,,,,,,
2019/03,444,09/03/2019,6,SP 5 fra Russi e San Pancrazio,,,,,,,,
2019/03,444,10/03/2019,7,SP 5 fra Russi e San Pancrazio,,,,,,,,
2019/03,444,11/03/2019,1,SP 5 fra Russi e San Pancrazio,,,,,,,,
2019/03,444,12/03/2019,2,SP 5 fra Russi e San Pancrazio,,,,,,,,
2019/03,444,13/03/2019,3,SP 5 fra Russi e San Pancrazio,,,,,,,,
2019/03,444,14/03/2019,4,SP 5 fra Russi e San Pancrazio,,,,,,,,
2019/03,445,01/03/2019,5,SP 610R fra SP 253R e Conselice,5988,10,5164,823,4636,1352,5988,0
2019/03,445,02/03/2019,6,SP 610R fra SP 253R e Conselice,4641,10,4487,153,3328,1313,0,4641
2019/03,445,03/03/2019,7,SP 610R fra SP 253R e Conselice,4356,00,4309,47,3242,1114,0,4356
2019/03,445,04/03/2019,1,SP 610R fra SP 253R e Conselice,5706,10,4911,794,4556,1150,5706,0
2019/03,445,05/03/2019,2,SP 610R fra SP 253R e Conselice,5781,20,4939,840,4501,1280,5781,0
2019/03,445,06/03/2019,3,SP 610R fra SP 253R e Conselice,5949,10,5089,859,4670,1279,5949,0
2019/03,445,07/03/2019,4,SP 610R fra SP 253R e Conselice,5817,20,4969,846,4518,1299,5817,0
2019/03,445,08/03/2019,5,SP 610R fra SP 253R e Conselice,6301,10,5420,880,4744,1557,6301,0
2019/03,445,09/03/2019,6,SP 610R fra SP 253R e Conselice,4670,00,4487,183,3350,1320,0,4670
2019/03,445,10/03/2019,7,SP 610R fra SP 253R e Conselice,4177,10,4127,49,3150,1027,0,4177
2019/03,445,11/03/2019,1,SP 610R fra SP 253R e Conselice,5661,00,4849,812,4549,1112,5661,0
2019/03,445,12/03/2019,2,SP 610R fra SP 253R e Conselice,5746,00,4897,849,4551,1195,5746,0
2019/03,445,13/03/2019,3,SP 610R fra SP 253R e Conselice,5887,10,5011,875,4612,1275,5887,0
2019/03,445,14/03/2019,4,SP 610R fra SP 253R e Conselice,5789,10,4941,847,4488,1301,5789,0
2019/03,446,01/03/2019,5,SP 13 in località Santa Maria di Fabriago,9226,10,8684,541,7259,1967,9226,0
2019/03,446,02/03/2019,6,SP 13 in località Santa Maria di Fabriago,7389,10,7221,167,5494,1895,0,7389
2019/03,446,03/03/2019,7,SP 13 in località Santa Maria di Fabriago,5844,00,5811,33,4204,1640,0,5844
2019/03,446,04/03/2019,1,SP 13 in località Santa Maria di Fabriago,9014,00,8343,671,7229,1785,9014,0
2019/03,446,05/03/2019,2,SP 13 in località Santa Maria di Fabriago,9396,00,8448,948,7507,1889,9396,0
2019/03,446,06/03/2019,3,SP 13 in località Santa Maria di Fabriago,9742,00,8810,932,7749,1993,9742,0
2019/03,446,07/03/2019,4,SP 13 in località Santa Maria di Fabriago,9443,10,8430,1012,7503,1940,9443,0
2019/03,446,08/03/2019,5,SP 13 in località Santa Maria di Fabriago,9948,10,9018,929,7718,2230,9948,0
2019/03,446,09/03/2019,6,SP 13 in località Santa Maria di Fabriago,7786,00,7371,415,5788,1998,0,7786
2019/03,446,10/03/2019,7,SP 13 in località Santa Maria di Fabriago,5537,00,5513,24,3922,1615,0,5537
2019/03,446,11/03/2019,1,SP 13 in località Santa Maria di Fabriago,9035,00,8274,761,7231,1804,9035,0
2019/03,446,12/03/2019,2,SP 13 in località Santa Maria di Fabriago,9318,00,8614,704,7467,1851,9318,0
2019/03,446,13/03/2019,3,SP 13 in località Santa Maria di Fabriago,9589,00,8948,641,7621,1968,9589,0
2019/03,446,14/03/2019,4,SP 13 in località Santa Maria di Fabriago,9341,10,8608,732,7457,1884,9341,0
2019/03,447,01/03/2019,5,SP 28 in località Molinazzo (Comune di Gossolengo),5984,00,5677,307,4717,1267,5984,0
2019/03,447,02/03/2019,6,SP 28 in località Molinazzo (Comune di Gossolengo),5248,00,5161,87,3969,1279,0,5248
2019/03,447,03/03/2019,7,SP 28 in località Molinazzo (Comune di Gossolengo),5699,00,5671,28,4687,1012,0,5699
2019/03,447,04/03/2019,1,SP 28 in località Molinazzo (Comune di Gossolengo),5163,00,4906,257,4169,994,5163,0
2019/03,447,05/03/2019,2,SP 28 in località Molinazzo (Comune di Gossolengo),5291,00,5104,187,4314,977,5291,0
2019/03,447,06/03/2019,3,SP 28 in località Molinazzo (Comune di Gossolengo),5417,00,5188,229,4395,1022,5417,0
2019/03,447,07/03/2019,4,SP 28 in località Molinazzo (Comune di Gossolengo),5485,10,5290,194,4405,1080,5485,0
2019/03,447,08/03/2019,5,SP 28 in località Molinazzo (Comune di Gossolengo),5906,00,5654,252,4589,1317,5906,0
2019/03,447,09/03/2019,6,SP 28 in località Molinazzo (Comune di Gossolengo),5564,00,5480,84,4095,1469,0,5564
2019/03,447,10/03/2019,7,SP 28 in località Molinazzo (Comune di Gossolengo),5367,00,5353,14,4301,1066,0,5367
2019/03,447,11/03/2019,1,SP 28 in località Molinazzo (Comune di Gossolengo),5217,00,5023,194,4202,1015,5217,0
2019/03,447,12/03/2019,2,SP 28 in località Molinazzo (Comune di Gossolengo),5400,00,5198,202,4449,951,5400,0
2019/03,447,13/03/2019,3,SP 28 in località Molinazzo (Comune di Gossolengo),5460,00,5178,282,4417,1043,5460,0
2019/03,447,14/03/2019,4,SP 28 in località Molinazzo (Comune di Gossolengo),5588,10,5303,284,4501,1087,5588,0
2019/03,448,01/03/2019,5,SP 5 fra Reggiolo e intersezione SP 45 per Fabbrico,7939,00,7078,861,6068,1871,7939,0
2019/03,448,02/03/2019,6,SP 5 fra Reggiolo e intersezione SP 45 per Fabbrico,6455,00,6290,165,4492,1963,0,6455
2019/03,448,03/03/2019,7,SP 5 fra Reggiolo e intersezione SP 45 per Fabbrico,5727,00,5694,33,4073,1654,0,5727
2019/03,448,04/03/2019,1,SP 5 fra Reggiolo e intersezione SP 45 per Fabbrico,7410,00,6596,814,5951,1459,7410,0
2019/03,448,05/03/2019,2,SP 5 fra Reggiolo e intersezione SP 45 per Fabbrico,7711,00,6854,857,6131,1580,7711,0
2019/03,448,06/03/2019,3,SP 5 fra Reggiolo e intersezione SP 45 per Fabbrico,7641,10,6859,781,5997,1644,7641,0
2019/03,448,07/03/2019,4,SP 5 fra Reggiolo e intersezione SP 45 per Fabbrico,7675,00,6805,870,6039,1636,7675,0
2019/03,448,08/03/2019,5,SP 5 fra Reggiolo e intersezione SP 45 per Fabbrico,7916,10,7124,791,6059,1857,7916,0
2019/03,448,09/03/2019,6,SP 5 fra Reggiolo e intersezione SP 45 per Fabbrico,6362,00,6210,152,4496,1866,0,6362
2019/03,448,10/03/2019,7,SP 5 fra Reggiolo e intersezione SP 45 per Fabbrico,5539,00,5509,30,3756,1783,0,5539
2019/03,448,11/03/2019,1,SP 5 fra Reggiolo e intersezione SP 45 per Fabbrico,7412,00,6581,831,5954,1458,7412,0
2019/03,448,12/03/2019,2,SP 5 fra Reggiolo e intersezione SP 45 per Fabbrico,7799,00,6973,826,6179,1620,7799,0
2019/03,448,13/03/2019,3,SP 5 fra Reggiolo e intersezione SP 45 per Fabbrico,7712,00,6885,827,6010,1702,7712,0
2019/03,448,14/03/2019,4,SP 5 fra Reggiolo e intersezione SP 45 per Fabbrico,7946,00,7159,787,6230,1716,7946,0
2019/03,449,01/03/2019,5,SP 111 fra via Emilia e la variante Asse Val d'Enza,12749,00,10671,2078,10002,2747,12749,0
2019/03,449,02/03/2019,6,SP 111 fra via Emilia e la variante Asse Val d'Enza,8225,00,7820,405,6011,2214,0,8225
2019/03,449,03/03/2019,7,SP 111 fra via Emilia e la variante Asse Val d'Enza,8135,00,7986,149,5944,2191,0,8135
2019/03,449,04/03/2019,1,SP 111 fra via Emilia e la variante Asse Val d'Enza,11877,00,9852,2025,9586,2291,11877,0
2019/03,449,05/03/2019,2,SP 111 fra via Emilia e la variante Asse Val d'Enza,12102,10,9887,2214,9684,2418,12102,0
2019/03,449,06/03/2019,3,SP 111 fra via Emilia e la variante Asse Val d'Enza,12285,30,10096,2186,9853,2432,12285,0
2019/03,449,07/03/2019,4,SP 111 fra via Emilia e la variante Asse Val d'Enza,12923,00,10588,2335,10292,2631,12923,0
2019/03,449,08/03/2019,5,SP 111 fra via Emilia e la variante Asse Val d'Enza,13067,00,10831,2236,10292,2775,13067,0
2019/03,449,09/03/2019,6,SP 111 fra via Emilia e la variante Asse Val d'Enza,8361,00,7948,413,6122,2239,0,8361
2019/03,449,10/03/2019,7,SP 111 fra via Emilia e la variante Asse Val d'Enza,7817,00,7655,162,5654,2163,0,7817
2019/03,449,11/03/2019,1,SP 111 fra via Emilia e la variante Asse Val d'Enza,11998,10,9828,2169,9667,2331,11998,0
2019/03,449,12/03/2019,2,SP 111 fra via Emilia e la variante Asse Val d'Enza,12329,00,10225,2104,9959,2370,12329,0
2019/03,449,13/03/2019,3,SP 111 fra via Emilia e la variante Asse Val d'Enza,12542,00,10333,2209,10078,2464,12542,0
2019/03,449,14/03/2019,4,SP 111 fra via Emilia e la variante Asse Val d'Enza,12802,00,10525,2277,10337,2465,12802,0
2019/03,450,01/03/2019,5,SP 35 sul Ponte Po,9181,60,8252,923,7022,2159,9181,0
2019/03,450,02/03/2019,6,SP 35 sul Ponte Po,7623,00,7451,172,5577,2046,0,7623
2019/03,450,03/03/2019,7,SP 35 sul Ponte Po,5731,10,5686,44,3986,1745,0,5731
2019/03,450,04/03/2019,1,SP 35 sul Ponte Po,8018,40,7053,961,6479,1539,8018,0
2019/03,450,05/03/2019,2,SP 35 sul Ponte Po,8367,30,7327,1037,6698,1669,8367,0
2019/03,450,06/03/2019,3,SP 35 sul Ponte Po,8554,60,7510,1038,6823,1731,8554,0
2019/03,450,07/03/2019,4,SP 35 sul Ponte Po,8684,60,7697,981,6945,1739,8684,0
2019/03,450,08/03/2019,5,SP 35 sul Ponte Po,9371,40,8386,981,7188,2183,9371,0
2019/03,450,09/03/2019,6,SP 35 sul Ponte Po,7891,00,7755,136,5680,2211,0,7891
2019/03,450,10/03/2019,7,SP 35 sul Ponte Po,6214,00,6181,33,4233,1981,0,6214
2019/03,450,11/03/2019,1,SP 35 sul Ponte Po,8111,10,7170,940,6569,1542,8111,0
2019/03,450,12/03/2019,2,SP 35 sul Ponte Po,8684,40,7666,1014,7018,1666,8684,0
2019/03,450,13/03/2019,3,SP 35 sul Ponte Po,8831,30,7798,1030,7046,1785,8831,0
2019/03,450,14/03/2019,4,SP 35 sul Ponte Po,8742,120,7753,977,7034,1708,8742,0
2019/03,451,01/03/2019,5,SP 62RVar sulla variante di Luzzara (c/o Codisotto),13177,00,10241,2936,10133,3044,13177,0
2019/03,451,02/03/2019,6,SP 62RVar sulla variante di Luzzara (c/o Codisotto),9687,00,9236,451,6973,2714,0,9687
2019/03,451,03/03/2019,7,SP 62RVar sulla variante di Luzzara (c/o Codisotto),9291,00,9156,135,6438,2853,0,9291
2019/03,451,04/03/2019,1,SP 62RVar sulla variante di Luzzara (c/o Codisotto),12195,30,9163,3029,9682,2513,12195,0
2019/03,451,05/03/2019,2,SP 62RVar sulla variante di Luzzara (c/o Codisotto),12218,00,9047,3171,9628,2590,12218,0
2019/03,451,06/03/2019,3,SP 62RVar sulla variante di Luzzara (c/o Codisotto),12500,00,9210,3290,9870,2630,12500,0
2019/03,451,07/03/2019,4,SP 62RVar sulla variante di Luzzara (c/o Codisotto),12740,20,9511,3227,10118,2622,12740,0
2019/03,451,08/03/2019,5,SP 62RVar sulla variante di Luzzara (c/o Codisotto),13297,00,10313,2984,10237,3060,13297,0
2019/03,451,09/03/2019,6,SP 62RVar sulla variante di Luzzara (c/o Codisotto),9665,00,9273,392,7041,2624,0,9665
2019/03,451,10/03/2019,7,SP 62RVar sulla variante di Luzzara (c/o Codisotto),9081,00,8953,128,6274,2807,0,9081
2019/03,451,11/03/2019,1,SP 62RVar sulla variante di Luzzara (c/o Codisotto),11855,00,8888,2967,9383,2472,11855,0
2019/03,451,12/03/2019,2,SP 62RVar sulla variante di Luzzara (c/o Codisotto),12532,10,9288,3243,10042,2490,12532,0
2019/03,451,13/03/2019,3,SP 62RVar sulla variante di Luzzara (c/o Codisotto),12426,00,9188,3238,9800,2626,12426,0
2019/03,451,14/03/2019,4,SP 62RVar sulla variante di Luzzara (c/o Codisotto),12679,00,9528,3151,9982,2697,12679,0
2019/03,452,01/03/2019,5,SP 3 sulla variante tra Bagnolo in Piano e il casello A 1 di Reggio Emilia,13077,00,11828,1249,10048,3029,13077,0
2019/03,452,02/03/2019,6,SP 3 sulla variante tra Bagnolo in Piano e il casello A 1 di Reggio Emilia,9962,00,9735,227,6923,3039,0,9962
2019/03,452,03/03/2019,7,SP 3 sulla variante tra Bagnolo in Piano e il casello A 1 di Reggio Emilia,8775,00,8705,70,6115,2660,0,8775
2019/03,452,04/03/2019,1,SP 3 sulla variante tra Bagnolo in Piano e il casello A 1 di Reggio Emilia,12253,10,10985,1267,9824,2429,12253,0
2019/03,452,05/03/2019,2,SP 3 sulla variante tra Bagnolo in Piano e il casello A 1 di Reggio Emilia,12514,00,11166,1348,10013,2501,12514,0
2019/03,452,06/03/2019,3,SP 3 sulla variante tra Bagnolo in Piano e il casello A 1 di Reggio Emilia,12735,00,11292,1443,10138,2597,12735,0
2019/03,452,07/03/2019,4,SP 3 sulla variante tra Bagnolo in Piano e il casello A 1 di Reggio Emilia,12843,00,11376,1467,10005,2838,12843,0
2019/03,452,08/03/2019,5,SP 3 sulla variante tra Bagnolo in Piano e il casello A 1 di Reggio Emilia,13308,00,11928,1380,10278,3030,13308,0
2019/03,452,09/03/2019,6,SP 3 sulla variante tra Bagnolo in Piano e il casello A 1 di Reggio Emilia,9875,10,9539,335,6896,2979,0,9875
2019/03,452,10/03/2019,7,SP 3 sulla variante tra Bagnolo in Piano e il casello A 1 di Reggio Emilia,8651,00,8570,81,5940,2711,0,8651
2019/03,452,11/03/2019,1,SP 3 sulla variante tra Bagnolo in Piano e il casello A 1 di Reggio Emilia,12355,00,11047,1308,9847,2508,12355,0
2019/03,452,12/03/2019,2,SP 3 sulla variante tra Bagnolo in Piano e il casello A 1 di Reggio Emilia,12721,00,11365,1356,10125,2596,12721,0
2019/03,452,13/03/2019,3,SP 3 sulla variante tra Bagnolo in Piano e il casello A 1 di Reggio Emilia,12769,10,11440,1328,9989,2780,12769,0
2019/03,452,14/03/2019,4,SP 3 sulla variante tra Bagnolo in Piano e il casello A 1 di Reggio Emilia,12937,00,11578,1359,10131,2806,12937,0
2019/03,453,01/03/2019,5,Asse viario Modena-Sassuolo tra Modena e Baggiovara,57045,50,51105,5935,44080,12965,57045,0
2019/03,453,02/03/2019,6,Asse viario Modena-Sassuolo tra Modena e Baggiovara,42562,10,41552,1009,29801,12761,0,42562
2019/03,453,03/03/2019,7,Asse viario Modena-Sassuolo tra Modena e Baggiovara,36095,10,35874,220,25197,10898,0,36095
2019/03,453,04/03/2019,1,Asse viario Modena-Sassuolo tra Modena e Baggiovara,54577,00,49102,5475,43610,10967,54577,0
2019/03,453,05/03/2019,2,Asse viario Modena-Sassuolo tra Modena e Baggiovara,55629,20,49429,6198,44091,11538,55629,0
2019/03,453,06/03/2019,3,Asse viario Modena-Sassuolo tra Modena e Baggiovara,56503,10,50212,6290,44644,11859,56503,0
2019/03,453,07/03/2019,4,Asse viario Modena-Sassuolo tra Modena e Baggiovara,57188,40,50499,6685,45081,12107,57188,0
2019/03,453,08/03/2019,5,Asse viario Modena-Sassuolo tra Modena e Baggiovara,58578,20,52258,6318,45301,13277,58578,0
2019/03,453,09/03/2019,6,Asse viario Modena-Sassuolo tra Modena e Baggiovara,43151,10,42189,961,29821,13330,0,43151
2019/03,453,10/03/2019,7,Asse viario Modena-Sassuolo tra Modena e Baggiovara,34272,00,34043,229,23370,10902,0,34272
2019/03,453,11/03/2019,1,Asse viario Modena-Sassuolo tra Modena e Baggiovara,54646,30,48988,5655,43787,10859,54646,0
2019/03,453,12/03/2019,2,Asse viario Modena-Sassuolo tra Modena e Baggiovara,54721,20,48519,6200,43383,11338,54721,0
2019/03,453,13/03/2019,3,Asse viario Modena-Sassuolo tra Modena e Baggiovara,56413,00,49955,6458,44593,11820,56413,0
2019/03,453,14/03/2019,4,Asse viario Modena-Sassuolo tra Modena e Baggiovara,57087,10,50496,6590,44812,12275,57087,0
2019/03,502,01/03/2019,5,SP 26 tra località Pioppa e viadotto A 1 (c/o Zola Predosa),14312,00,13341,971,11646,2666,14312,0
2019/03,502,02/03/2019,6,SP 26 tra località Pioppa e viadotto A 1 (c/o Zola Predosa),9649,00,9502,147,7201,2448,0,9649
2019/03,502,03/03/2019,7,SP 26 tra località Pioppa e viadotto A 1 (c/o Zola Predosa),7220,00,7184,36,5474,1746,0,7220
2019/03,502,04/03/2019,1,SP 26 tra località Pioppa e viadotto A 1 (c/o Zola Predosa),13703,00,12698,1005,11490,2213,13703,0
2019/03,502,05/03/2019,2,SP 26 tra località Pioppa e viadotto A 1 (c/o Zola Predosa),13894,00,12853,1041,11568,2326,13894,0
2019/03,502,06/03/2019,3,SP 26 tra località Pioppa e viadotto A 1 (c/o Zola Predosa),14193,20,13126,1065,11659,2534,14193,0
2019/03,502,07/03/2019,4,SP 26 tra località Pioppa e viadotto A 1 (c/o Zola Predosa),14667,00,13580,1087,12104,2563,14667,0
2019/03,502,08/03/2019,5,SP 26 tra località Pioppa e viadotto A 1 (c/o Zola Predosa),15134,00,14064,1070,12223,2911,15134,0
2019/03,502,09/03/2019,6,SP 26 tra località Pioppa e viadotto A 1 (c/o Zola Predosa),9654,00,9503,151,7193,2461,0,9654
2019/03,502,10/03/2019,7,SP 26 tra località Pioppa e viadotto A 1 (c/o Zola Predosa),7569,00,7502,67,5801,1768,0,7569
2019/03,502,11/03/2019,1,SP 26 tra località Pioppa e viadotto A 1 (c/o Zola Predosa),13768,00,12743,1025,11556,2212,13768,0
2019/03,502,12/03/2019,2,SP 26 tra località Pioppa e viadotto A 1 (c/o Zola Predosa),14050,00,13043,1007,11673,2377,14050,0
2019/03,502,13/03/2019,3,SP 26 tra località Pioppa e viadotto A 1 (c/o Zola Predosa),14110,10,13128,981,11599,2511,14110,0
2019/03,502,14/03/2019,4,SP 26 tra località Pioppa e viadotto A 1 (c/o Zola Predosa),14434,10,13447,986,11888,2546,14434,0
2019/03,504,01/03/2019,5,SP 7 dalla località Ca de' Mandorli al bivio per Castel de Britti,11812,10,11466,345,9063,2749,11812,0
2019/03,504,02/03/2019,6,SP 7 dalla località Ca de' Mandorli al bivio per Castel de Britti,10548,10,10400,147,7971,2577,0,10548
2019/03,504,03/03/2019,7,SP 7 dalla località Ca de' Mandorli al bivio per Castel de Britti,8754,00,8723,31,6684,2070,0,8754
2019/03,504,04/03/2019,1,SP 7 dalla località Ca de' Mandorli al bivio per Castel de Britti,11091,00,10776,315,8628,2463,11091,0
2019/03,504,05/03/2019,2,SP 7 dalla località Ca de' Mandorli al bivio per Castel de Britti,11450,00,11145,305,8861,2589,11450,0
2019/03,504,06/03/2019,3,SP 7 dalla località Ca de' Mandorli al bivio per Castel de Britti,11583,00,11224,359,8960,2623,11583,0
2019/03,504,07/03/2019,4,SP 7 dalla località Ca de' Mandorli al bivio per Castel de Britti,11301,10,11013,287,8706,2595,11301,0
2019/03,504,08/03/2019,5,SP 7 dalla località Ca de' Mandorli al bivio per Castel de Britti,12258,00,11914,344,9228,3030,12258,0
2019/03,504,09/03/2019,6,SP 7 dalla località Ca de' Mandorli al bivio per Castel de Britti,10673,00,10526,147,7955,2718,0,10673
2019/03,504,10/03/2019,7,SP 7 dalla località Ca de' Mandorli al bivio per Castel de Britti,8541,00,8513,28,6435,2106,0,8541
2019/03,504,11/03/2019,1,SP 7 dalla località Ca de' Mandorli al bivio per Castel de Britti,11035,00,10722,313,8722,2313,11035,0
2019/03,504,12/03/2019,2,SP 7 dalla località Ca de' Mandorli al bivio per Castel de Britti,11444,00,11124,320,8827,2617,11444,0
2019/03,504,13/03/2019,3,SP 7 dalla località Ca de' Mandorli al bivio per Castel de Britti,11623,00,11304,319,8976,2647,11623,0
2019/03,504,14/03/2019,4,SP 7 dalla località Ca de' Mandorli al bivio per Castel de Britti,11455,00,11112,343,8827,2628,11455,0
2019/03,505,01/03/2019,5,SP 610 tra casello A 1 (Imola) e bivio SP 51 per Castel Guelfo di Bologna,13941,10,11592,2348,10631,3310,13941,0
2019/03,505,02/03/2019,6,SP 610 tra casello A 1 (Imola) e bivio SP 51 per Castel Guelfo di Bologna,10546,00,10143,403,7309,3237,0,10546
2019/03,505,03/03/2019,7,SP 610 tra casello A 1 (Imola) e bivio SP 51 per Castel Guelfo di Bologna,9111,00,8945,166,6352,2759,0,9111
2019/03,505,04/03/2019,1,SP 610 tra casello A 1 (Imola) e bivio SP 51 per Castel Guelfo di Bologna,13109,10,10892,2216,10319,2790,13109,0
2019/03,505,05/03/2019,2,SP 610 tra casello A 1 (Imola) e bivio SP 51 per Castel Guelfo di Bologna,13717,00,11358,2359,10625,3092,13717,0
2019/03,505,06/03/2019,3,SP 610 tra casello A 1 (Imola) e bivio SP 51 per Castel Guelfo di Bologna,13753,30,11299,2451,10658,3095,13753,0
2019/03,505,07/03/2019,4,SP 610 tra casello A 1 (Imola) e bivio SP 51 per Castel Guelfo di Bologna,13512,50,11191,2316,10555,2957,13512,0
2019/03,505,08/03/2019,5,SP 610 tra casello A 1 (Imola) e bivio SP 51 per Castel Guelfo di Bologna,14435,30,12028,2404,10869,3566,14435,0
2019/03,505,09/03/2019,6,SP 610 tra casello A 1 (Imola) e bivio SP 51 per Castel Guelfo di Bologna,10400,20,9995,403,7129,3271,0,10400
2019/03,505,10/03/2019,7,SP 610 tra casello A 1 (Imola) e bivio SP 51 per Castel Guelfo di Bologna,8905,00,8763,142,6248,2657,0,8905
2019/03,505,11/03/2019,1,SP 610 tra casello A 1 (Imola) e bivio SP 51 per Castel Guelfo di Bologna,13109,00,10844,2265,10321,2788,13109,0
2019/03,505,12/03/2019,2,SP 610 tra casello A 1 (Imola) e bivio SP 51 per Castel Guelfo di Bologna,13493,00,11141,2352,10431,3062,13493,0
2019/03,505,13/03/2019,3,SP 610 tra casello A 1 (Imola) e bivio SP 51 per Castel Guelfo di Bologna,13661,30,11222,2436,10588,3073,13661,0
2019/03,505,14/03/2019,4,SP 610 tra casello A 1 (Imola) e bivio SP 51 per Castel Guelfo di Bologna,13823,20,11465,2356,10655,3168,13823,0
2019/03,600,01/03/2019,5,SP 19 tra SP31 e Medicina,8120,20,7237,881,6498,1622,8120,0
2019/03,600,02/03/2019,6,SP 19 tra SP31 e Medicina,5327,00,5181,146,3963,1364,0,5327
2019/03,600,03/03/2019,7,SP 19 tra SP31 e Medicina,4881,00,4849,32,3457,1424,0,4881
2019/03,600,04/03/2019,1,SP 19 tra SP31 e Medicina,8008,00,7105,903,6725,1283,8008,0
2019/03,600,05/03/2019,2,SP 19 tra SP31 e Medicina,7019,00,6255,764,5638,1381,7019,0
2019/03,600,06/03/2019,3,SP 19 tra SP31 e Medicina,7614,20,6782,830,6264,1350,7614,0
2019/03,600,07/03/2019,4,SP 19 tra SP31 e Medicina,8010,10,7089,920,6568,1442,8010,0
2019/03,600,08/03/2019,5,SP 19 tra SP31 e Medicina,8362,00,7451,911,6647,1715,8362,0
2019/03,600,09/03/2019,6,SP 19 tra SP31 e Medicina,6236,00,6088,148,4693,1543,0,6236
2019/03,600,10/03/2019,7,SP 19 tra SP31 e Medicina,5733,00,5700,33,4422,1311,0,5733
2019/03,600,11/03/2019,1,SP 19 tra SP31 e Medicina,7620,00,6836,784,6243,1377,7620,0
2019/03,600,12/03/2019,2,SP 19 tra SP31 e Medicina,7979,00,7004,975,6536,1443,7979,0
2019/03,600,13/03/2019,3,SP 19 tra SP31 e Medicina,7769,10,6987,781,6280,1489,7769,0
2019/03,600,14/03/2019,4,SP 19 tra SP31 e Medicina,8032,00,7131,901,6493,1539,8032,0
2019/03,601,01/03/2019,5,SP 21 da Castel San Pietro al bivio SP 35 (c/o Sassoleone),3455,00,3372,83,2635,820,3455,0
2019/03,601,02/03/2019,6,SP 21 da Castel San Pietro al bivio SP 35 (c/o Sassoleone),3548,10,3500,47,2633,915,0,3548
2019/03,601,03/03/2019,7,SP 21 da Castel San Pietro al bivio SP 35 (c/o Sassoleone),3414,00,3392,22,2645,769,0,3414
2019/03,601,04/03/2019,1,SP 21 da Castel San Pietro al bivio SP 35 (c/o Sassoleone),3150,00,3083,67,2517,633,3150,0
2019/03,601,05/03/2019,2,SP 21 da Castel San Pietro al bivio SP 35 (c/o Sassoleone),3083,10,3009,73,2395,688,3083,0
2019/03,601,06/03/2019,3,SP 21 da Castel San Pietro al bivio SP 35 (c/o Sassoleone),3135,00,3066,69,2433,702,3135,0
2019/03,601,07/03/2019,4,SP 21 da Castel San Pietro al bivio SP 35 (c/o Sassoleone),3235,00,3157,78,2492,743,3235,0
2019/03,601,08/03/2019,5,SP 21 da Castel San Pietro al bivio SP 35 (c/o Sassoleone),3356,00,3276,80,2481,875,3356,0
2019/03,601,09/03/2019,6,SP 21 da Castel San Pietro al bivio SP 35 (c/o Sassoleone),3534,00,3473,61,2688,846,0,3534
2019/03,601,10/03/2019,7,SP 21 da Castel San Pietro al bivio SP 35 (c/o Sassoleone),3065,00,3044,21,2415,650,0,3065
2019/03,601,11/03/2019,1,SP 21 da Castel San Pietro al bivio SP 35 (c/o Sassoleone),3130,00,3055,75,2473,657,3130,0
2019/03,601,12/03/2019,2,SP 21 da Castel San Pietro al bivio SP 35 (c/o Sassoleone),3199,10,3119,79,2481,718,3199,0
2019/03,601,13/03/2019,3,SP 21 da Castel San Pietro al bivio SP 35 (c/o Sassoleone),3157,00,3073,84,2466,691,3157,0
2019/03,601,14/03/2019,4,SP 21 da Castel San Pietro al bivio SP 35 (c/o Sassoleone),3240,00,3156,84,2491,749,3240,0
2019/03,602,01/03/2019,5,SP 9_1 da Crevalcore alla località Caselle,1719,00,1642,77,1322,397,1719,0
2019/03,602,02/03/2019,6,SP 9_1 da Crevalcore alla località Caselle,1590,00,1561,29,1199,391,0,1590
2019/03,602,03/03/2019,7,SP 9_1 da Crevalcore alla località Caselle,1198,00,1193,5,928,270,0,1198
2019/03,602,04/03/2019,1,SP 9_1 da Crevalcore alla località Caselle,1707,00,1614,93,1395,312,1707,0
2019/03,602,05/03/2019,2,SP 9_1 da Crevalcore alla località Caselle,1614,00,1554,60,1323,291,1614,0
2019/03,602,06/03/2019,3,SP 9_1 da Crevalcore alla località Caselle,1680,10,1600,79,1339,341,1680,0
2019/03,602,07/03/2019,4,SP 9_1 da Crevalcore alla località Caselle,1622,00,1534,88,1330,292,1622,0
2019/03,602,08/03/2019,5,SP 9_1 da Crevalcore alla località Caselle,1809,00,1745,64,1401,408,1809,0
2019/03,602,09/03/2019,6,SP 9_1 da Crevalcore alla località Caselle,1490,00,1433,57,1126,364,0,1490
2019/03,602,10/03/2019,7,SP 9_1 da Crevalcore alla località Caselle,1187,00,1182,5,928,259,0,1187
2019/03,602,11/03/2019,1,SP 9_1 da Crevalcore alla località Caselle,1638,00,1562,76,1350,288,1638,0
2019/03,602,12/03/2019,2,SP 9_1 da Crevalcore alla località Caselle,1735,00,1646,89,1332,403,1735,0
2019/03,602,13/03/2019,3,SP 9_1 da Crevalcore alla località Caselle,1638,00,1566,72,1315,323,1638,0
2019/03,602,14/03/2019,4,SP 9_1 da Crevalcore alla località Caselle,1661,00,1575,86,1318,343,1661,0
2019/03,603,01/03/2019,5,SP 10 dalla località Decima ai confini provinciali di Bologna e Ferrara,4304,00,4141,163,3141,1163,4304,0
2019/03,603,02/03/2019,6,SP 10 dalla località Decima ai confini provinciali di Bologna e Ferrara,3319,00,3263,56,2331,988,0,3319
2019/03,603,03/03/2019,7,SP 10 dalla località Decima ai confini provinciali di Bologna e Ferrara,3034,00,3021,13,2176,858,0,3034
2019/03,603,04/03/2019,1,SP 10 dalla località Decima ai confini provinciali di Bologna e Ferrara,3937,00,3770,167,3059,878,3937,0
2019/03,603,05/03/2019,2,SP 10 dalla località Decima ai confini provinciali di Bologna e Ferrara,4129,10,3965,163,3117,1012,4129,0
2019/03,603,06/03/2019,3,SP 10 dalla località Decima ai confini provinciali di Bologna e Ferrara,4192,00,4030,162,3135,1057,4192,0
2019/03,603,07/03/2019,4,SP 10 dalla località Decima ai confini provinciali di Bologna e Ferrara,4166,00,3988,178,3165,1001,4166,0
2019/03,603,08/03/2019,5,SP 10 dalla località Decima ai confini provinciali di Bologna e Ferrara,4459,00,4268,191,3260,1199,4459,0
2019/03,603,09/03/2019,6,SP 10 dalla località Decima ai confini provinciali di Bologna e Ferrara,3446,00,3388,58,2387,1059,0,3446
2019/03,603,10/03/2019,7,SP 10 dalla località Decima ai confini provinciali di Bologna e Ferrara,2955,00,2941,14,2131,824,0,2955
2019/03,603,11/03/2019,1,SP 10 dalla località Decima ai confini provinciali di Bologna e Ferrara,3950,00,3770,180,3036,914,3950,0
2019/03,603,12/03/2019,2,SP 10 dalla località Decima ai confini provinciali di Bologna e Ferrara,4044,00,3848,196,3077,967,4044,0
2019/03,603,13/03/2019,3,SP 10 dalla località Decima ai confini provinciali di Bologna e Ferrara,4066,10,3896,169,3026,1040,4066,0
2019/03,603,14/03/2019,4,SP 10 dalla località Decima ai confini provinciali di Bologna e Ferrara,4225,00,4047,178,3172,1053,4225,0
2019/03,604,01/03/2019,5,SP 37 da Sasso Marconi alla intersezione SP 58,5397,00,5199,198,4464,933,5397,0
2019/03,604,02/03/2019,6,SP 37 da Sasso Marconi alla intersezione SP 58,3895,00,3863,32,3025,870,0,3895
2019/03,604,03/03/2019,7,SP 37 da Sasso Marconi alla intersezione SP 58,3722,20,3711,9,2930,792,0,3722
2019/03,604,04/03/2019,1,SP 37 da Sasso Marconi alla intersezione SP 58,5044,20,4798,244,4252,792,5044,0
2019/03,604,05/03/2019,2,SP 37 da Sasso Marconi alla intersezione SP 58,5105,00,4854,251,4264,841,5105,0
2019/03,604,06/03/2019,3,SP 37 da Sasso Marconi alla intersezione SP 58,5326,10,5081,244,4417,909,5326,0
2019/03,604,07/03/2019,4,SP 37 da Sasso Marconi alla intersezione SP 58,5277,00,5077,200,4397,880,5277,0
2019/03,604,08/03/2019,5,SP 37 da Sasso Marconi alla intersezione SP 58,5757,10,5539,217,4743,1014,5757,0
2019/03,604,09/03/2019,6,SP 37 da Sasso Marconi alla intersezione SP 58,4169,00,4143,26,3311,858,0,4169
2019/03,604,10/03/2019,7,SP 37 da Sasso Marconi alla intersezione SP 58,3637,00,3617,20,2903,734,0,3637
2019/03,604,11/03/2019,1,SP 37 da Sasso Marconi alla intersezione SP 58,5035,00,4786,249,4265,770,5035,0
2019/03,604,12/03/2019,2,SP 37 da Sasso Marconi alla intersezione SP 58,4454,10,4301,152,3635,819,4454,0
2019/03,604,13/03/2019,3,SP 37 da Sasso Marconi alla intersezione SP 58,5387,00,5158,229,4494,893,5387,0
2019/03,604,14/03/2019,4,SP 37 da Sasso Marconi alla intersezione SP 58,5498,10,5241,256,4569,929,5498,0
2019/03,605,01/03/2019,5,SP 324 da Silla alla intersezione SP 623,8050,10,7689,360,6388,1662,8050,0
2019/03,605,02/03/2019,6,SP 324 da Silla alla intersezione SP 623,7094,10,6987,106,5497,1597,0,7094
2019/03,605,03/03/2019,7,SP 324 da Silla alla intersezione SP 623,6148,00,6100,48,4856,1292,0,6148
2019/03,605,04/03/2019,1,SP 324 da Silla alla intersezione SP 623,7239,20,6930,307,6031,1208,7239,0
2019/03,605,05/03/2019,2,SP 324 da Silla alla intersezione SP 623,7483,00,7148,335,6128,1355,7483,0
2019/03,605,06/03/2019,3,SP 324 da Silla alla intersezione SP 623,7537,10,7196,340,6097,1440,7537,0
2019/03,605,07/03/2019,4,SP 324 da Silla alla intersezione SP 623,7268,00,6953,315,5880,1388,7268,0
2019/03,605,08/03/2019,5,SP 324 da Silla alla intersezione SP 623,8448,10,8130,317,6548,1900,8448,0
2019/03,605,09/03/2019,6,SP 324 da Silla alla intersezione SP 623,7227,00,7114,113,5390,1837,0,7227
2019/03,605,10/03/2019,7,SP 324 da Silla alla intersezione SP 623,5437,00,5390,47,4256,1181,0,5437
2019/03,605,11/03/2019,1,SP 324 da Silla alla intersezione SP 623,7253,00,6931,322,5936,1317,7253,0
2019/03,605,12/03/2019,2,SP 324 da Silla alla intersezione SP 623,7354,00,7048,306,6037,1317,7354,0
2019/03,605,13/03/2019,3,SP 324 da Silla alla intersezione SP 623,7392,00,7033,359,6054,1338,7392,0
2019/03,605,14/03/2019,4,SP 324 da Silla alla intersezione SP 623,7578,10,7262,315,6183,1395,7578,0
2019/03,606,01/03/2019,5,SP 70 Cispadana in località Sant'Agostino/San Carlo,6328,20,5848,478,4991,1337,6328,0
2019/03,606,02/03/2019,6,SP 70 Cispadana in località Sant'Agostino/San Carlo,4897,10,4842,54,3653,1244,0,4897
2019/03,606,03/03/2019,7,SP 70 Cispadana in località Sant'Agostino/San Carlo,5543,20,5520,21,4207,1336,0,5543
2019/03,606,04/03/2019,1,SP 70 Cispadana in località Sant'Agostino/San Carlo,6073,10,5640,432,4969,1104,6073,0
2019/03,606,06/03/2019,3,SP 70 Cispadana in località Sant'Agostino/San Carlo,6327,20,5828,497,5151,1176,6327,0
2019/03,606,07/03/2019,4,SP 70 Cispadana in località Sant'Agostino/San Carlo,4844,50,4387,452,3997,847,4844,0
2019/03,606,08/03/2019,5,SP 70 Cispadana in località Sant'Agostino/San Carlo,6236,20,5791,443,4900,1336,6236,0
2019/03,606,12/03/2019,2,SP 70 Cispadana in località Sant'Agostino/San Carlo,6103,30,5564,536,4978,1125,6103,0
2019/03,607,01/03/2019,5,SP 1 da Villafranca di Forlì al confine provinciale,4384,00,4119,265,3453,931,4384,0
2019/03,607,02/03/2019,6,SP 1 da Villafranca di Forlì al confine provinciale,3459,00,3390,69,2529,930,0,3459
2019/03,607,03/03/2019,7,SP 1 da Villafranca di Forlì al confine provinciale,3708,00,3693,15,2829,879,0,3708
2019/03,607,04/03/2019,1,SP 1 da Villafranca di Forlì al confine provinciale,4285,00,3968,317,3442,843,4285,0
2019/03,607,05/03/2019,2,SP 1 da Villafranca di Forlì al confine provinciale,4567,00,4216,351,3638,929,4567,0
2019/03,607,06/03/2019,3,SP 1 da Villafranca di Forlì al confine provinciale,4424,00,4142,282,3557,867,4424,0
2019/03,607,07/03/2019,4,SP 1 da Villafranca di Forlì al confine provinciale,4473,00,4166,307,3598,875,4473,0
2019/03,607,08/03/2019,5,SP 1 da Villafranca di Forlì al confine provinciale,4656,00,4379,277,3612,1044,4656,0
2019/03,607,09/03/2019,6,SP 1 da Villafranca di Forlì al confine provinciale,3500,00,3444,56,2543,957,0,3500
2019/03,607,10/03/2019,7,SP 1 da Villafranca di Forlì al confine provinciale,3220,00,3205,15,2456,764,0,3220
2019/03,607,11/03/2019,1,SP 1 da Villafranca di Forlì al confine provinciale,4293,00,4004,289,3496,797,4293,0
2019/03,607,12/03/2019,2,SP 1 da Villafranca di Forlì al confine provinciale,4417,00,4080,337,3558,859,4417,0
2019/03,607,13/03/2019,3,SP 1 da Villafranca di Forlì al confine provinciale,4478,00,4180,298,3601,877,4478,0
2019/03,607,14/03/2019,4,SP 1 da Villafranca di Forlì al confine provinciale,4431,00,4123,308,3536,895,4431,0
2019/03,608,01/03/2019,5,SP 140 da Diegaro (SS 9) a Pievesestina (E 45),14449,20,13034,1413,11209,3240,14449,0
2019/03,608,02/03/2019,6,SP 140 da Diegaro (SS 9) a Pievesestina (E 45),10723,10,10234,488,7780,2943,0,10723
2019/03,608,03/03/2019,7,SP 140 da Diegaro (SS 9) a Pievesestina (E 45),8374,00,8251,123,6055,2319,0,8374
2019/03,608,04/03/2019,1,SP 140 da Diegaro (SS 9) a Pievesestina (E 45),13713,10,12235,1477,10955,2758,13713,0
2019/03,608,05/03/2019,2,SP 140 da Diegaro (SS 9) a Pievesestina (E 45),13982,00,12498,1484,11108,2874,13982,0
2019/03,608,06/03/2019,3,SP 140 da Diegaro (SS 9) a Pievesestina (E 45),14271,00,12714,1557,11208,3063,14271,0
2019/03,608,07/03/2019,4,SP 140 da Diegaro (SS 9) a Pievesestina (E 45),14084,10,12649,1434,11038,3046,14084,0
2019/03,608,08/03/2019,5,SP 140 da Diegaro (SS 9) a Pievesestina (E 45),14872,00,13407,1465,11494,3378,14872,0
2019/03,608,09/03/2019,6,SP 140 da Diegaro (SS 9) a Pievesestina (E 45),10850,00,10330,520,7680,3170,0,10850
2019/03,608,10/03/2019,7,SP 140 da Diegaro (SS 9) a Pievesestina (E 45),8267,00,8111,156,6040,2227,0,8267
2019/03,608,11/03/2019,1,SP 140 da Diegaro (SS 9) a Pievesestina (E 45),13703,20,12373,1328,11012,2691,13703,0
2019/03,608,12/03/2019,2,SP 140 da Diegaro (SS 9) a Pievesestina (E 45),14142,10,12767,1374,11074,3068,14142,0
2019/03,608,13/03/2019,3,SP 140 da Diegaro (SS 9) a Pievesestina (E 45),14037,40,12731,1302,10991,3046,14037,0
2019/03,608,14/03/2019,4,SP 140 da Diegaro (SS 9) a Pievesestina (E 45),14293,20,12909,1382,11132,3161,14293,0
2019/03,609,01/03/2019,5,SP 4 dal bivio SP22 (per SS 12) al bivio SP 26 (per Pavullo nel Frignano),4461,00,4036,425,3381,1080,4461,0
2019/03,609,02/03/2019,6,SP 4 dal bivio SP22 (per SS 12) al bivio SP 26 (per Pavullo nel Frignano),5026,00,4910,116,4006,1020,0,5026
2019/03,609,03/03/2019,7,SP 4 dal bivio SP22 (per SS 12) al bivio SP 26 (per Pavullo nel Frignano),6364,00,6322,42,5378,986,0,6364
2019/03,609,04/03/2019,1,SP 4 dal bivio SP22 (per SS 12) al bivio SP 26 (per Pavullo nel Frignano),3897,10,3515,381,3143,754,3897,0
2019/03,609,05/03/2019,2,SP 4 dal bivio SP22 (per SS 12) al bivio SP 26 (per Pavullo nel Frignano),3745,00,3363,382,2970,775,3745,0
2019/03,609,06/03/2019,3,SP 4 dal bivio SP22 (per SS 12) al bivio SP 26 (per Pavullo nel Frignano),3904,00,3538,366,3132,772,3904,0
2019/03,609,07/03/2019,4,SP 4 dal bivio SP22 (per SS 12) al bivio SP 26 (per Pavullo nel Frignano),3904,10,3478,425,3092,812,3904,0
2019/03,609,08/03/2019,5,SP 4 dal bivio SP22 (per SS 12) al bivio SP 26 (per Pavullo nel Frignano),4297,00,3902,395,3252,1045,4297,0
2019/03,609,10/03/2019,7,SP 4 dal bivio SP22 (per SS 12) al bivio SP 26 (per Pavullo nel Frignano),5476,00,5423,53,4568,908,0,5476
2019/03,609,11/03/2019,1,SP 4 dal bivio SP22 (per SS 12) al bivio SP 26 (per Pavullo nel Frignano),3663,00,3321,342,2933,730,3663,0
2019/03,609,12/03/2019,2,SP 4 dal bivio SP22 (per SS 12) al bivio SP 26 (per Pavullo nel Frignano),3590,10,3211,378,2859,731,3590,0
2019/03,609,13/03/2019,3,SP 4 dal bivio SP22 (per SS 12) al bivio SP 26 (per Pavullo nel Frignano),3723,00,3318,405,2909,814,3723,0
2019/03,609,14/03/2019,4,SP 4 dal bivio SP22 (per SS 12) al bivio SP 26 (per Pavullo nel Frignano),3831,00,3490,341,3025,806,3831,0
2019/03,610,01/03/2019,5,SP 11 da Soragna a Roncole Verdi,3907,20,3578,327,3038,869,3907,0
2019/03,610,02/03/2019,6,SP 11 da Soragna a Roncole Verdi,3081,00,2988,93,2228,853,0,3081
2019/03,610,03/03/2019,7,SP 11 da Soragna a Roncole Verdi,2736,00,2707,29,2024,712,0,2736
2019/03,610,04/03/2019,1,SP 11 da Soragna a Roncole Verdi,3684,00,3387,297,2939,745,3684,0
2019/03,610,05/03/2019,2,SP 11 da Soragna a Roncole Verdi,3846,00,3540,306,3055,791,3846,0
2019/03,610,06/03/2019,3,SP 11 da Soragna a Roncole Verdi,3805,00,3470,335,3023,782,3805,0
2019/03,610,07/03/2019,4,SP 11 da Soragna a Roncole Verdi,3758,10,3477,280,2959,799,3758,0
2019/03,610,08/03/2019,5,SP 11 da Soragna a Roncole Verdi,4037,00,3743,294,3073,964,4037,0
2019/03,610,09/03/2019,6,SP 11 da Soragna a Roncole Verdi,3122,10,3019,102,2264,858,0,3122
2019/03,610,10/03/2019,7,SP 11 da Soragna a Roncole Verdi,2793,00,2765,28,2176,617,0,2793
2019/03,610,11/03/2019,1,SP 11 da Soragna a Roncole Verdi,3705,00,3372,333,2954,751,3705,0
2019/03,610,12/03/2019,2,SP 11 da Soragna a Roncole Verdi,3768,00,3462,306,3032,736,3768,0
2019/03,610,13/03/2019,3,SP 11 da Soragna a Roncole Verdi,3723,00,3392,331,2979,744,3723,0
2019/03,610,14/03/2019,4,SP 11 da Soragna a Roncole Verdi,3963,00,3628,335,3113,850,3963,0
2019/03,611,01/03/2019,5,SP 357R da Fornovo di Taro al bivio SP 93 per Fidenza,,,,,,,,
2019/03,611,02/03/2019,6,SP 357R da Fornovo di Taro al bivio SP 93 per Fidenza,,,,,,,,
2019/03,611,03/03/2019,7,SP 357R da Fornovo di Taro al bivio SP 93 per Fidenza,,,,,,,,
2019/03,611,04/03/2019,1,SP 357R da Fornovo di Taro al bivio SP 93 per Fidenza,,,,,,,,
2019/03,611,05/03/2019,2,SP 357R da Fornovo di Taro al bivio SP 93 per Fidenza,,,,,,,,
2019/03,611,06/03/2019,3,SP 357R da Fornovo di Taro al bivio SP 93 per Fidenza,,,,,,,,
2019/03,611,07/03/2019,4,SP 357R da Fornovo di Taro al bivio SP 93 per Fidenza,,,,,,,,
2019/03,611,08/03/2019,5,SP 357R da Fornovo di Taro al bivio SP 93 per Fidenza,,,,,,,,
2019/03,611,09/03/2019,6,SP 357R da Fornovo di Taro al bivio SP 93 per Fidenza,,,,,,,,
2019/03,611,10/03/2019,7,SP 357R da Fornovo di Taro al bivio SP 93 per Fidenza,,,,,,,,
2019/03,611,11/03/2019,1,SP 357R da Fornovo di Taro al bivio SP 93 per Fidenza,,,,,,,,
2019/03,611,12/03/2019,2,SP 357R da Fornovo di Taro al bivio SP 93 per Fidenza,,,,,,,,
2019/03,611,13/03/2019,3,SP 357R da Fornovo di Taro al bivio SP 93 per Fidenza,,,,,,,,
2019/03,611,14/03/2019,4,SP 357R da Fornovo di Taro al bivio SP 93 per Fidenza,,,,,,,,
2019/03,612,01/03/2019,5,SP 665R dalla località Pilastro a Langhirano,19948,00,18755,1193,15770,4178,19948,0
2019/03,612,02/03/2019,6,SP 665R dalla località Pilastro a Langhirano,15886,20,15608,276,11846,4040,0,15886
2019/03,612,03/03/2019,7,SP 665R dalla località Pilastro a Langhirano,14141,10,14078,62,10766,3375,0,14141
2019/03,612,04/03/2019,1,SP 665R dalla località Pilastro a Langhirano,17767,00,16692,1075,14661,3106,17767,0
2019/03,612,05/03/2019,2,SP 665R dalla località Pilastro a Langhirano,17704,10,16651,1052,14327,3377,17704,0
2019/03,612,06/03/2019,3,SP 665R dalla località Pilastro a Langhirano,17803,10,16681,1121,14125,3678,17803,0
2019/03,612,07/03/2019,4,SP 665R dalla località Pilastro a Langhirano,17503,00,16424,1079,13883,3620,17503,0
2019/03,612,08/03/2019,5,SP 665R dalla località Pilastro a Langhirano,18500,00,17367,1133,14440,4060,18500,0
2019/03,612,09/03/2019,6,SP 665R dalla località Pilastro a Langhirano,15802,00,15519,283,11782,4020,0,15802
2019/03,612,10/03/2019,7,SP 665R dalla località Pilastro a Langhirano,12367,00,12289,78,9477,2890,0,12367
2019/03,612,11/03/2019,1,SP 665R dalla località Pilastro a Langhirano,17549,10,16478,1070,14345,3204,17549,0
2019/03,612,12/03/2019,2,SP 665R dalla località Pilastro a Langhirano,17791,00,16704,1087,14567,3224,17791,0
2019/03,612,13/03/2019,3,SP 665R dalla località Pilastro a Langhirano,17460,00,16372,1088,14085,3375,17460,0
2019/03,612,14/03/2019,4,SP 665R dalla località Pilastro a Langhirano,17892,10,16796,1095,14365,3527,17892,0
2019/03,613,01/03/2019,5,SP 16 dalla località Basilicanova al bivio SP 32 centro abitato Mamiano,7059,00,6733,326,5394,1665,7059,0
2019/03,613,02/03/2019,6,SP 16 dalla località Basilicanova al bivio SP 32 centro abitato Mamiano,5891,00,5742,149,4224,1667,0,5891
2019/03,613,03/03/2019,7,SP 16 dalla località Basilicanova al bivio SP 32 centro abitato Mamiano,4517,00,4484,33,3369,1148,0,4517
2019/03,613,04/03/2019,1,SP 16 dalla località Basilicanova al bivio SP 32 centro abitato Mamiano,6726,00,6421,305,5363,1363,6726,0
2019/03,613,05/03/2019,2,SP 16 dalla località Basilicanova al bivio SP 32 centro abitato Mamiano,6762,00,6497,265,5351,1411,6762,0
2019/03,613,06/03/2019,3,SP 16 dalla località Basilicanova al bivio SP 32 centro abitato Mamiano,7020,00,6740,280,5519,1501,7020,0
2019/03,613,07/03/2019,4,SP 16 dalla località Basilicanova al bivio SP 32 centro abitato Mamiano,6908,00,6649,259,5407,1501,6908,0
2019/03,613,08/03/2019,5,SP 16 dalla località Basilicanova al bivio SP 32 centro abitato Mamiano,7508,00,7225,283,5690,1818,7508,0
2019/03,613,09/03/2019,6,SP 16 dalla località Basilicanova al bivio SP 32 centro abitato Mamiano,6193,10,6066,126,4481,1712,0,6193
2019/03,613,10/03/2019,7,SP 16 dalla località Basilicanova al bivio SP 32 centro abitato Mamiano,4610,00,4562,48,3367,1243,0,4610
2019/03,613,11/03/2019,1,SP 16 dalla località Basilicanova al bivio SP 32 centro abitato Mamiano,6723,00,6421,302,5443,1280,6723,0
2019/03,613,12/03/2019,2,SP 16 dalla località Basilicanova al bivio SP 32 centro abitato Mamiano,6870,10,6569,300,5411,1459,6870,0
2019/03,613,13/03/2019,3,SP 16 dalla località Basilicanova al bivio SP 32 centro abitato Mamiano,6741,10,6471,269,5300,1441,6741,0
2019/03,613,14/03/2019,4,SP 16 dalla località Basilicanova al bivio SP 32 centro abitato Mamiano,6796,00,6511,285,5311,1485,6796,0
2019/03,614,01/03/2019,5,SP 587R dal bivio SP 10R alla A 21Dir,7382,10,6828,553,5744,1638,7382,0
2019/03,614,02/03/2019,6,SP 587R dal bivio SP 10R alla A 21Dir,6471,00,6238,233,4993,1478,0,6471
2019/03,614,03/03/2019,7,SP 587R dal bivio SP 10R alla A 21Dir,5995,00,5953,42,4841,1154,0,5995
2019/03,614,04/03/2019,1,SP 587R dal bivio SP 10R alla A 21Dir,6940,00,6387,553,5652,1288,6940,0
2019/03,614,05/03/2019,2,SP 587R dal bivio SP 10R alla A 21Dir,7085,00,6533,552,5695,1390,7085,0
2019/03,614,06/03/2019,3,SP 587R dal bivio SP 10R alla A 21Dir,7174,00,6625,549,5684,1490,7174,0
2019/03,614,07/03/2019,4,SP 587R dal bivio SP 10R alla A 21Dir,7296,10,6606,689,5797,1499,7296,0
2019/03,614,08/03/2019,5,SP 587R dal bivio SP 10R alla A 21Dir,7648,00,7001,647,5886,1762,7648,0
2019/03,614,09/03/2019,6,SP 587R dal bivio SP 10R alla A 21Dir,5845,00,5574,271,4320,1525,0,5845
2019/03,614,10/03/2019,7,SP 587R dal bivio SP 10R alla A 21Dir,4480,00,4439,41,3281,1199,0,4480
2019/03,614,11/03/2019,1,SP 587R dal bivio SP 10R alla A 21Dir,7754,00,7106,648,6478,1276,7754,0
2019/03,614,12/03/2019,2,SP 587R dal bivio SP 10R alla A 21Dir,7091,00,6537,554,5694,1397,7091,0
2019/03,614,13/03/2019,3,SP 587R dal bivio SP 10R alla A 21Dir,7205,00,6640,565,5805,1400,7205,0
2019/03,614,14/03/2019,4,SP 587R dal bivio SP 10R alla A 21Dir,7252,00,6626,626,5765,1487,7252,0
2019/03,615,01/03/2019,5,Piazzale Milano (ex SS 9) c/o ponte fiume Po,28591,270,27994,570,21066,7525,28591,0
2019/03,615,02/03/2019,6,Piazzale Milano (ex SS 9) c/o ponte fiume Po,27998,80,27633,357,20675,7323,0,27998
2019/03,615,03/03/2019,7,Piazzale Milano (ex SS 9) c/o ponte fiume Po,22839,00,22734,105,16581,6258,0,22839
2019/03,615,04/03/2019,1,Piazzale Milano (ex SS 9) c/o ponte fiume Po,26106,110,25547,548,19962,6144,26106,0
2019/03,615,05/03/2019,2,Piazzale Milano (ex SS 9) c/o ponte fiume Po,25935,180,25320,597,19720,6215,25935,0
2019/03,615,06/03/2019,3,Piazzale Milano (ex SS 9) c/o ponte fiume Po,26143,300,25491,622,19823,6320,26143,0
2019/03,615,07/03/2019,4,Piazzale Milano (ex SS 9) c/o ponte fiume Po,26760,170,26136,607,20035,6725,26760,0
2019/03,615,08/03/2019,5,Piazzale Milano (ex SS 9) c/o ponte fiume Po,28823,290,28146,648,21260,7563,28823,0
2019/03,615,09/03/2019,6,Piazzale Milano (ex SS 9) c/o ponte fiume Po,27788,80,27430,350,19822,7966,0,27788
2019/03,615,10/03/2019,7,Piazzale Milano (ex SS 9) c/o ponte fiume Po,22577,290,22330,218,15972,6605,0,22577
2019/03,615,11/03/2019,1,Piazzale Milano (ex SS 9) c/o ponte fiume Po,28180,240,27420,736,21799,6381,28180,0
2019/03,615,12/03/2019,2,Piazzale Milano (ex SS 9) c/o ponte fiume Po,26054,170,25443,594,19798,6256,26054,0
2019/03,615,13/03/2019,3,Piazzale Milano (ex SS 9) c/o ponte fiume Po,27031,160,26405,610,20425,6606,27031,0
2019/03,615,14/03/2019,4,Piazzale Milano (ex SS 9) c/o ponte fiume Po,26713,150,26091,607,20160,6553,26713,0
2019/03,616,01/03/2019,5,SP 588R dal casello A 21 di Castelvetro Piacentino a Villanova d'Arda,4260,20,3953,305,3368,892,4260,0
2019/03,616,02/03/2019,6,SP 588R dal casello A 21 di Castelvetro Piacentino a Villanova d'Arda,4075,00,4000,75,3009,1066,0,4075
2019/03,616,03/03/2019,7,SP 588R dal casello A 21 di Castelvetro Piacentino a Villanova d'Arda,3524,00,3494,30,2689,835,0,3524
2019/03,616,04/03/2019,1,SP 588R dal casello A 21 di Castelvetro Piacentino a Villanova d'Arda,3872,00,3485,387,3166,706,3872,0
2019/03,616,05/03/2019,2,SP 588R dal casello A 21 di Castelvetro Piacentino a Villanova d'Arda,3992,00,3664,328,3182,810,3992,0
2019/03,616,06/03/2019,3,SP 588R dal casello A 21 di Castelvetro Piacentino a Villanova d'Arda,4022,10,3674,347,3207,815,4022,0
2019/03,616,07/03/2019,4,SP 588R dal casello A 21 di Castelvetro Piacentino a Villanova d'Arda,3998,00,3671,327,3204,794,3998,0
2019/03,616,08/03/2019,5,SP 588R dal casello A 21 di Castelvetro Piacentino a Villanova d'Arda,4426,00,4128,298,3439,987,4426,0
2019/03,616,09/03/2019,6,SP 588R dal casello A 21 di Castelvetro Piacentino a Villanova d'Arda,4073,00,4005,68,2960,1113,0,4073
2019/03,616,10/03/2019,7,SP 588R dal casello A 21 di Castelvetro Piacentino a Villanova d'Arda,3628,00,3594,34,2684,944,0,3628
2019/03,616,11/03/2019,1,SP 588R dal casello A 21 di Castelvetro Piacentino a Villanova d'Arda,3853,00,3534,319,3189,664,3853,0
2019/03,616,12/03/2019,2,SP 588R dal casello A 21 di Castelvetro Piacentino a Villanova d'Arda,3969,10,3664,304,3179,790,3969,0
2019/03,616,13/03/2019,3,SP 588R dal casello A 21 di Castelvetro Piacentino a Villanova d'Arda,4113,00,3771,342,3314,799,4113,0
2019/03,616,14/03/2019,4,SP 588R dal casello A 21 di Castelvetro Piacentino a Villanova d'Arda,4119,00,3792,327,3341,778,4119,0
2019/03,617,01/03/2019,5,SP 7 dalla intersezione tangenziale sud/ovest di Piacenza a San Nicolò,8036,00,7663,373,6393,1643,8036,0
2019/03,617,02/03/2019,6,SP 7 dalla intersezione tangenziale sud/ovest di Piacenza a San Nicolò,7470,00,7346,124,5685,1785,0,7470
2019/03,617,03/03/2019,7,SP 7 dalla intersezione tangenziale sud/ovest di Piacenza a San Nicolò,5628,00,5616,12,4309,1319,0,5628
2019/03,617,04/03/2019,1,SP 7 dalla intersezione tangenziale sud/ovest di Piacenza a San Nicolò,7721,00,7321,400,6299,1422,7721,0
2019/03,617,05/03/2019,2,SP 7 dalla intersezione tangenziale sud/ovest di Piacenza a San Nicolò,7534,00,7102,432,6138,1396,7534,0
2019/03,617,06/03/2019,3,SP 7 dalla intersezione tangenziale sud/ovest di Piacenza a San Nicolò,7978,10,7458,519,6481,1497,7978,0
2019/03,617,07/03/2019,4,SP 7 dalla intersezione tangenziale sud/ovest di Piacenza a San Nicolò,7605,00,7123,482,6217,1388,7605,0
2019/03,617,08/03/2019,5,SP 7 dalla intersezione tangenziale sud/ovest di Piacenza a San Nicolò,8680,00,8102,578,6856,1824,8680,0
2019/03,617,09/03/2019,6,SP 7 dalla intersezione tangenziale sud/ovest di Piacenza a San Nicolò,7939,00,7781,158,5989,1950,0,7939
2019/03,617,10/03/2019,7,SP 7 dalla intersezione tangenziale sud/ovest di Piacenza a San Nicolò,5608,00,5591,17,4282,1326,0,5608
2019/03,617,11/03/2019,1,SP 7 dalla intersezione tangenziale sud/ovest di Piacenza a San Nicolò,7631,00,7193,438,6349,1282,7631,0
2019/03,617,12/03/2019,2,SP 7 dalla intersezione tangenziale sud/ovest di Piacenza a San Nicolò,7805,10,7389,415,6339,1466,7805,0
2019/03,617,13/03/2019,3,SP 7 dalla intersezione tangenziale sud/ovest di Piacenza a San Nicolò,7822,10,7344,477,6296,1526,7822,0
2019/03,617,14/03/2019,4,SP 7 dalla intersezione tangenziale sud/ovest di Piacenza a San Nicolò,7868,00,7376,492,6317,1551,7868,0
2019/03,618,01/03/2019,5,SP 253R fra Bagnacavallo (A14 Dir) e Godo (bivio SP 302R),7840,00,7332,508,6067,1773,7840,0
2019/03,618,02/03/2019,6,SP 253R fra Bagnacavallo (A14 Dir) e Godo (bivio SP 302R),6691,00,6558,133,4891,1800,0,6691
2019/03,618,03/03/2019,7,SP 253R fra Bagnacavallo (A14 Dir) e Godo (bivio SP 302R),5461,00,5434,27,4115,1346,0,5461
2019/03,618,04/03/2019,1,SP 253R fra Bagnacavallo (A14 Dir) e Godo (bivio SP 302R),7591,10,7058,532,6170,1421,7591,0
2019/03,618,05/03/2019,2,SP 253R fra Bagnacavallo (A14 Dir) e Godo (bivio SP 302R),7638,00,7059,579,6190,1448,7638,0
2019/03,618,06/03/2019,3,SP 253R fra Bagnacavallo (A14 Dir) e Godo (bivio SP 302R),7818,00,7280,538,6253,1565,7818,0
2019/03,618,07/03/2019,4,SP 253R fra Bagnacavallo (A14 Dir) e Godo (bivio SP 302R),7628,00,7109,519,6091,1537,7628,0
2019/03,618,08/03/2019,5,SP 253R fra Bagnacavallo (A14 Dir) e Godo (bivio SP 302R),8256,00,7708,548,6322,1934,8256,0
2019/03,618,09/03/2019,6,SP 253R fra Bagnacavallo (A14 Dir) e Godo (bivio SP 302R),6598,00,6457,141,4855,1743,0,6598
2019/03,618,10/03/2019,7,SP 253R fra Bagnacavallo (A14 Dir) e Godo (bivio SP 302R),4822,00,4793,29,3628,1194,0,4822
2019/03,618,11/03/2019,1,SP 253R fra Bagnacavallo (A14 Dir) e Godo (bivio SP 302R),7540,00,7027,513,6129,1411,7540,0
2019/03,618,12/03/2019,2,SP 253R fra Bagnacavallo (A14 Dir) e Godo (bivio SP 302R),7693,00,7110,583,6264,1429,7693,0
2019/03,618,13/03/2019,3,SP 253R fra Bagnacavallo (A14 Dir) e Godo (bivio SP 302R),7787,00,7272,515,6183,1604,7787,0
2019/03,618,14/03/2019,4,SP 253R fra Bagnacavallo (A14 Dir) e Godo (bivio SP 302R),7817,10,7307,509,6255,1562,7817,0
2019/03,619,01/03/2019,5,SP 8 da Bagnacavallo al bivio SS 16,3251,290,3027,195,2459,792,3251,0
2019/03,619,02/03/2019,6,SP 8 da Bagnacavallo al bivio SS 16,,,,,,,,
2019/03,619,03/03/2019,7,SP 8 da Bagnacavallo al bivio SS 16,,,,,,,,
2019/03,619,04/03/2019,1,SP 8 da Bagnacavallo al bivio SS 16,,,,,,,,
2019/03,619,05/03/2019,2,SP 8 da Bagnacavallo al bivio SS 16,,,,,,,,
2019/03,619,06/03/2019,3,SP 8 da Bagnacavallo al bivio SS 16,3319,00,3129,190,2612,707,3319,0
2019/03,619,07/03/2019,4,SP 8 da Bagnacavallo al bivio SS 16,3416,20,3187,227,2652,764,3416,0
2019/03,619,08/03/2019,5,SP 8 da Bagnacavallo al bivio SS 16,3526,30,3303,220,2657,869,3526,0
2019/03,619,09/03/2019,6,SP 8 da Bagnacavallo al bivio SS 16,2929,00,2886,43,2115,814,0,2929
2019/03,619,10/03/2019,7,SP 8 da Bagnacavallo al bivio SS 16,2310,00,2302,8,1755,555,0,2310
2019/03,619,11/03/2019,1,SP 8 da Bagnacavallo al bivio SS 16,3256,20,3020,234,2605,651,3256,0
2019/03,619,12/03/2019,2,SP 8 da Bagnacavallo al bivio SS 16,3253,20,3037,214,2588,665,3253,0
2019/03,619,13/03/2019,3,SP 8 da Bagnacavallo al bivio SS 16,3338,10,3129,208,2596,742,3338,0
2019/03,619,14/03/2019,4,SP 8 da Bagnacavallo al bivio SS 16,3347,10,3105,241,2681,666,3347,0
2019/03,620,01/03/2019,5,SP 113 sulla variante di San Martino in Rio/Correggio c/o le località Prato/Gazzata,8900,00,7780,1120,6994,1906,8900,0
2019/03,620,02/03/2019,6,SP 113 sulla variante di San Martino in Rio/Correggio c/o le località Prato/Gazzata,5866,00,5670,196,4189,1677,0,5866
2019/03,620,03/03/2019,7,SP 113 sulla variante di San Martino in Rio/Correggio c/o le località Prato/Gazzata,5012,00,4962,50,3511,1501,0,5012
2019/03,620,04/03/2019,1,SP 113 sulla variante di San Martino in Rio/Correggio c/o le località Prato/Gazzata,8496,00,7386,1110,6877,1619,8496,0
2019/03,620,05/03/2019,2,SP 113 sulla variante di San Martino in Rio/Correggio c/o le località Prato/Gazzata,8485,00,7368,1117,6819,1666,8485,0
2019/03,620,06/03/2019,3,SP 113 sulla variante di San Martino in Rio/Correggio c/o le località Prato/Gazzata,8631,00,7519,1112,6939,1692,8631,0
2019/03,620,07/03/2019,4,SP 113 sulla variante di San Martino in Rio/Correggio c/o le località Prato/Gazzata,8739,00,7643,1096,6887,1852,8739,0
2019/03,620,08/03/2019,5,SP 113 sulla variante di San Martino in Rio/Correggio c/o le località Prato/Gazzata,8997,00,7855,1142,7040,1957,8997,0
2019/03,620,09/03/2019,6,SP 113 sulla variante di San Martino in Rio/Correggio c/o le località Prato/Gazzata,6071,00,5859,212,4286,1785,0,6071
2019/03,620,10/03/2019,7,SP 113 sulla variante di San Martino in Rio/Correggio c/o le località Prato/Gazzata,6062,00,5997,65,4381,1681,0,6062
2019/03,620,11/03/2019,1,SP 113 sulla variante di San Martino in Rio/Correggio c/o le località Prato/Gazzata,8370,00,7248,1122,6746,1624,8370,0
2019/03,620,12/03/2019,2,SP 113 sulla variante di San Martino in Rio/Correggio c/o le località Prato/Gazzata,8613,00,7399,1214,6918,1695,8613,0
2019/03,620,13/03/2019,3,SP 113 sulla variante di San Martino in Rio/Correggio c/o le località Prato/Gazzata,8558,00,7509,1049,6817,1741,8558,0
2019/03,620,14/03/2019,4,SP 113 sulla variante di San Martino in Rio/Correggio c/o le località Prato/Gazzata,8739,00,7570,1169,7016,1723,8739,0
2019/03,621,01/03/2019,5,SP 513R a nord di Vetto,2226,10,2105,120,1705,521,2226,0
2019/03,621,02/03/2019,6,SP 513R a nord di Vetto,2099,00,2049,50,1666,433,0,2099
2019/03,621,03/03/2019,7,SP 513R a nord di Vetto,2533,00,2523,10,2124,409,0,2533
2019/03,621,04/03/2019,1,SP 513R a nord di Vetto,2051,00,1920,131,1606,445,2051,0
2019/03,621,05/03/2019,2,SP 513R a nord di Vetto,2106,00,1984,122,1664,442,2106,0
2019/03,621,06/03/2019,3,SP 513R a nord di Vetto,2168,00,1983,185,1716,452,2168,0
2019/03,621,07/03/2019,4,SP 513R a nord di Vetto,2098,00,1969,129,1593,505,2098,0
2019/03,621,08/03/2019,5,SP 513R a nord di Vetto,2320,00,2176,144,1751,569,2320,0
2019/03,621,09/03/2019,6,SP 513R a nord di Vetto,2261,00,2205,56,1818,443,0,2261
2019/03,621,10/03/2019,7,SP 513R a nord di Vetto,2432,00,2404,28,2006,426,0,2432
2019/03,621,11/03/2019,1,SP 513R a nord di Vetto,2066,00,1915,151,1605,461,2066,0
2019/03,621,12/03/2019,2,SP 513R a nord di Vetto,2223,00,2082,141,1756,467,2223,0
2019/03,621,13/03/2019,3,SP 513R a nord di Vetto,2079,00,1946,133,1628,451,2079,0
2019/03,621,14/03/2019,4,SP 513R a nord di Vetto,2176,00,2032,144,1686,490,2176,0
2019/03,622,01/03/2019,5,SP 468R tra Correggio e il confine provinciale,,,,,,,,
2019/03,622,02/03/2019,6,SP 468R tra Correggio e il confine provinciale,,,,,,,,
2019/03,622,03/03/2019,7,SP 468R tra Correggio e il confine provinciale,,,,,,,,
2019/03,622,04/03/2019,1,SP 468R tra Correggio e il confine provinciale,,,,,,,,
2019/03,622,05/03/2019,2,SP 468R tra Correggio e il confine provinciale,,,,,,,,
2019/03,622,06/03/2019,3,SP 468R tra Correggio e il confine provinciale,,,,,,,,
2019/03,622,07/03/2019,4,SP 468R tra Correggio e il confine provinciale,,,,,,,,
2019/03,622,08/03/2019,5,SP 468R tra Correggio e il confine provinciale,,,,,,,,
2019/03,622,09/03/2019,6,SP 468R tra Correggio e il confine provinciale,,,,,,,,
2019/03,622,10/03/2019,7,SP 468R tra Correggio e il confine provinciale,,,,,,,,
2019/03,622,11/03/2019,1,SP 468R tra Correggio e il confine provinciale,,,,,,,,
2019/03,622,12/03/2019,2,SP 468R tra Correggio e il confine provinciale,,,,,,,,
2019/03,622,13/03/2019,3,SP 468R tra Correggio e il confine provinciale,,,,,,,,
2019/03,622,14/03/2019,4,SP 468R tra Correggio e il confine provinciale,,,,,,,,
2019/03,623,01/03/2019,5,SP 30 tra Campagnola Emilia e il confine provinciale,16160,00,14958,1202,12535,3625,16160,0
2019/03,623,02/03/2019,6,SP 30 tra Campagnola Emilia e il confine provinciale,13286,00,12998,288,9522,3764,0,13286
2019/03,623,03/03/2019,7,SP 30 tra Campagnola Emilia e il confine provinciale,10475,00,10405,70,7428,3047,0,10475
2019/03,623,04/03/2019,1,SP 30 tra Campagnola Emilia e il confine provinciale,14836,00,13573,1263,11925,2911,14836,0
2019/03,623,05/03/2019,2,SP 30 tra Campagnola Emilia e il confine provinciale,15483,00,14169,1314,12304,3179,15483,0
2019/03,623,06/03/2019,3,SP 30 tra Campagnola Emilia e il confine provinciale,15901,00,14527,1374,12698,3203,15901,0
2019/03,623,07/03/2019,4,SP 30 tra Campagnola Emilia e il confine provinciale,15599,10,14380,1218,12277,3322,15599,0
2019/03,623,08/03/2019,5,SP 30 tra Campagnola Emilia e il confine provinciale,16365,10,15228,1136,12437,3928,16365,0
2019/03,623,09/03/2019,6,SP 30 tra Campagnola Emilia e il confine provinciale,13293,00,13026,267,9281,4012,0,13293
2019/03,623,10/03/2019,7,SP 30 tra Campagnola Emilia e il confine provinciale,10674,00,10595,79,7557,3117,0,10674
2019/03,623,11/03/2019,1,SP 30 tra Campagnola Emilia e il confine provinciale,14899,00,13722,1177,11932,2967,14899,0
2019/03,623,12/03/2019,2,SP 30 tra Campagnola Emilia e il confine provinciale,15336,00,14119,1217,12265,3071,15336,0
2019/03,623,13/03/2019,3,SP 30 tra Campagnola Emilia e il confine provinciale,15707,10,14496,1210,12374,3333,15707,0
2019/03,623,14/03/2019,4,SP 30 tra Campagnola Emilia e il confine provinciale,15708,00,14407,1301,12312,3396,15708,0
2019/03,624,01/03/2019,5,SP 23 tra Rivalta e la variante di Montecavolo,11946,00,11561,385,8969,2977,11946,0
2019/03,624,02/03/2019,6,SP 23 tra Rivalta e la variante di Montecavolo,11496,10,11388,107,8447,3049,0,11496
2019/03,624,03/03/2019,7,SP 23 tra Rivalta e la variante di Montecavolo,8917,00,8898,19,6582,2335,0,8917
2019/03,624,04/03/2019,1,SP 23 tra Rivalta e la variante di Montecavolo,11253,10,10863,389,8855,2398,11253,0
2019/03,624,05/03/2019,2,SP 23 tra Rivalta e la variante di Montecavolo,11262,00,10854,408,8752,2510,11262,0
2019/03,624,06/03/2019,3,SP 23 tra Rivalta e la variante di Montecavolo,11743,00,11366,377,9102,2641,11743,0
2019/03,624,07/03/2019,4,SP 23 tra Rivalta e la variante di Montecavolo,11742,10,11359,382,9025,2717,11742,0
2019/03,624,08/03/2019,5,SP 23 tra Rivalta e la variante di Montecavolo,12458,00,12079,379,9402,3056,12458,0
2019/03,624,09/03/2019,6,SP 23 tra Rivalta e la variante di Montecavolo,11280,00,11174,106,8205,3075,0,11280
2019/03,624,10/03/2019,7,SP 23 tra Rivalta e la variante di Montecavolo,8746,00,8727,19,6505,2241,0,8746
2019/03,624,11/03/2019,1,SP 23 tra Rivalta e la variante di Montecavolo,11111,00,10700,411,8659,2452,11111,0
2019/03,624,12/03/2019,2,SP 23 tra Rivalta e la variante di Montecavolo,11460,00,11091,369,8984,2476,11460,0
2019/03,624,13/03/2019,3,SP 23 tra Rivalta e la variante di Montecavolo,11435,00,11050,385,8868,2567,11435,0
2019/03,624,14/03/2019,4,SP 23 tra Rivalta e la variante di Montecavolo,11408,00,11014,394,8711,2697,11408,0
2019/03,625,01/03/2019,5,SP 14 da Poggio Berni (bivio SP 73) a Sant'Arcangelo di Romagna,,,,,,,,
2019/03,625,02/03/2019,6,SP 14 da Poggio Berni (bivio SP 73) a Sant'Arcangelo di Romagna,,,,,,,,
2019/03,625,03/03/2019,7,SP 14 da Poggio Berni (bivio SP 73) a Sant'Arcangelo di Romagna,,,,,,,,
2019/03,625,04/03/2019,1,SP 14 da Poggio Berni (bivio SP 73) a Sant'Arcangelo di Romagna,,,,,,,,
2019/03,625,05/03/2019,2,SP 14 da Poggio Berni (bivio SP 73) a Sant'Arcangelo di Romagna,,,,,,,,
2019/03,625,06/03/2019,3,SP 14 da Poggio Berni (bivio SP 73) a Sant'Arcangelo di Romagna,,,,,,,,
2019/03,625,07/03/2019,4,SP 14 da Poggio Berni (bivio SP 73) a Sant'Arcangelo di Romagna,,,,,,,,
2019/03,625,08/03/2019,5,SP 14 da Poggio Berni (bivio SP 73) a Sant'Arcangelo di Romagna,,,,,,,,
2019/03,625,09/03/2019,6,SP 14 da Poggio Berni (bivio SP 73) a Sant'Arcangelo di Romagna,,,,,,,,
2019/03,625,10/03/2019,7,SP 14 da Poggio Berni (bivio SP 73) a Sant'Arcangelo di Romagna,,,,,,,,
2019/03,625,11/03/2019,1,SP 14 da Poggio Berni (bivio SP 73) a Sant'Arcangelo di Romagna,,,,,,,,
2019/03,625,12/03/2019,2,SP 14 da Poggio Berni (bivio SP 73) a Sant'Arcangelo di Romagna,,,,,,,,
2019/03,625,13/03/2019,3,SP 14 da Poggio Berni (bivio SP 73) a Sant'Arcangelo di Romagna,,,,,,,,
2019/03,625,14/03/2019,4,SP 14 da Poggio Berni (bivio SP 73) a Sant'Arcangelo di Romagna,,,,,,,,
2019/03,626,01/03/2019,5,SP 18 da San Clemente al bivio SP 132 (località Osteria Nuova),8328,00,7894,434,6599,1729,8328,0
2019/03,626,02/03/2019,6,SP 18 da San Clemente al bivio SP 132 (località Osteria Nuova),7871,00,7685,186,6010,1861,0,7871
2019/03,626,03/03/2019,7,SP 18 da San Clemente al bivio SP 132 (località Osteria Nuova),6563,10,6542,20,5023,1540,0,6563
2019/03,626,04/03/2019,1,SP 18 da San Clemente al bivio SP 132 (località Osteria Nuova),7951,00,7514,437,6448,1503,7951,0
2019/03,626,05/03/2019,2,SP 18 da San Clemente al bivio SP 132 (località Osteria Nuova),8003,00,7550,453,6411,1592,8003,0
2019/03,626,06/03/2019,3,SP 18 da San Clemente al bivio SP 132 (località Osteria Nuova),7875,00,7442,433,6371,1504,7875,0
2019/03,626,07/03/2019,4,SP 18 da San Clemente al bivio SP 132 (località Osteria Nuova),8273,00,7854,419,6574,1699,8273,0
2019/03,626,08/03/2019,5,SP 18 da San Clemente al bivio SP 132 (località Osteria Nuova),8511,10,8059,451,6601,1910,8511,0
2019/03,626,09/03/2019,6,SP 18 da San Clemente al bivio SP 132 (località Osteria Nuova),8433,00,8270,163,6205,2228,0,8433
2019/03,626,10/03/2019,7,SP 18 da San Clemente al bivio SP 132 (località Osteria Nuova),7811,00,7790,21,5986,1825,0,7811
2019/03,626,11/03/2019,1,SP 18 da San Clemente al bivio SP 132 (località Osteria Nuova),7572,00,7168,404,6086,1486,7572,0
2019/03,626,12/03/2019,2,SP 18 da San Clemente al bivio SP 132 (località Osteria Nuova),8044,00,7586,458,6485,1559,8044,0
2019/03,626,13/03/2019,3,SP 18 da San Clemente al bivio SP 132 (località Osteria Nuova),8019,10,7559,459,6420,1599,8019,0
2019/03,626,14/03/2019,4,SP 18 da San Clemente al bivio SP 132 (località Osteria Nuova),8424,00,8004,420,6653,1771,8424,0
2019/03,627,01/03/2019,5,SS 64 variante di Riola di Vergato,8534,20,8058,474,6601,1933,8534,0
2019/03,627,02/03/2019,6,SS 64 variante di Riola di Vergato,8009,00,7848,161,6219,1790,0,8009
2019/03,627,03/03/2019,7,SS 64 variante di Riola di Vergato,7611,10,7569,41,6042,1569,0,7611
2019/03,627,04/03/2019,1,SS 64 variante di Riola di Vergato,8247,00,7772,475,6733,1514,8247,0
2019/03,627,05/03/2019,2,SS 64 variante di Riola di Vergato,7897,10,7410,486,6377,1520,7897,0
2019/03,627,06/03/2019,3,SS 64 variante di Riola di Vergato,8113,00,7624,489,6466,1647,8113,0
2019/03,627,07/03/2019,4,SS 64 variante di Riola di Vergato,8179,00,7704,475,6511,1668,8179,0
2019/03,627,08/03/2019,5,SS 64 variante di Riola di Vergato,9122,00,8633,489,6973,2149,9122,0
2019/03,627,09/03/2019,6,SS 64 variante di Riola di Vergato,8336,00,8178,158,6476,1860,0,8336
2019/03,627,10/03/2019,7,SS 64 variante di Riola di Vergato,6996,10,6955,40,5425,1571,0,6996
2019/03,627,11/03/2019,1,SS 64 variante di Riola di Vergato,8222,10,7713,508,6735,1487,8222,0
2019/03,627,12/03/2019,2,SS 64 variante di Riola di Vergato,8002,00,7528,474,6472,1530,8002,0
2019/03,627,13/03/2019,3,SS 64 variante di Riola di Vergato,8242,00,7787,455,6539,1703,8242,0
2019/03,627,14/03/2019,4,SS 64 variante di Riola di Vergato,8184,10,7735,448,6521,1663,8184,0
2019/03,629,01/03/2019,5,SS 727 (tg Forli') tra intersezione SS 9 e l'intersezione SS 67,17468,10,16260,1207,13535,3933,17468,0
2019/03,629,02/03/2019,6,SS 727 (tg Forli') tra intersezione SS 9 e l'intersezione SS 67,12967,00,12675,292,9600,3367,0,12967
2019/03,629,03/03/2019,7,SS 727 (tg Forli') tra intersezione SS 9 e l'intersezione SS 67,10693,00,10625,68,7962,2731,0,10693
2019/03,629,04/03/2019,1,SS 727 (tg Forli') tra intersezione SS 9 e l'intersezione SS 67,16636,00,15493,1143,13329,3307,16636,0
2019/03,629,05/03/2019,2,SS 727 (tg Forli') tra intersezione SS 9 e l'intersezione SS 67,16614,10,15412,1201,13246,3368,16614,0
2019/03,629,06/03/2019,3,SS 727 (tg Forli') tra intersezione SS 9 e l'intersezione SS 67,17088,00,15898,1190,13661,3427,17088,0
2019/03,629,07/03/2019,4,SS 727 (tg Forli') tra intersezione SS 9 e l'intersezione SS 67,17112,20,15872,1238,13610,3502,17112,0
2019/03,629,08/03/2019,5,SS 727 (tg Forli') tra intersezione SS 9 e l'intersezione SS 67,18057,00,16816,1241,13937,4120,18057,0
2019/03,629,09/03/2019,6,SS 727 (tg Forli') tra intersezione SS 9 e l'intersezione SS 67,12370,00,12079,291,8979,3391,0,12370
2019/03,629,10/03/2019,7,SS 727 (tg Forli') tra intersezione SS 9 e l'intersezione SS 67,10428,00,10360,68,7752,2676,0,10428
2019/03,629,11/03/2019,1,SS 727 (tg Forli') tra intersezione SS 9 e l'intersezione SS 67,16800,00,15610,1190,13549,3251,16800,0
2019/03,629,12/03/2019,2,SS 727 (tg Forli') tra intersezione SS 9 e l'intersezione SS 67,16808,10,15591,1216,13385,3423,16808,0
2019/03,629,13/03/2019,3,SS 727 (tg Forli') tra intersezione SS 9 e l'intersezione SS 67,17274,00,15992,1282,13667,3607,17274,0
2019/03,629,14/03/2019,4,SS 727 (tg Forli') tra intersezione SS 9 e l'intersezione SS 67,17460,00,16278,1182,13746,3714,17460,0
2019/03,630,01/03/2019,5,SS 726 (tg Cesena) tra intersezione ex SS 71BIS e l'intersezione SP 304R,,,,,,,,
2019/03,630,02/03/2019,6,SS 726 (tg Cesena) tra intersezione ex SS 71BIS e l'intersezione SP 304R,,,,,,,,
2019/03,630,03/03/2019,7,SS 726 (tg Cesena) tra intersezione ex SS 71BIS e l'intersezione SP 304R,,,,,,,,
2019/03,630,04/03/2019,1,SS 726 (tg Cesena) tra intersezione ex SS 71BIS e l'intersezione SP 304R,,,,,,,,
2019/03,630,05/03/2019,2,SS 726 (tg Cesena) tra intersezione ex SS 71BIS e l'intersezione SP 304R,,,,,,,,
2019/03,630,06/03/2019,3,SS 726 (tg Cesena) tra intersezione ex SS 71BIS e l'intersezione SP 304R,,,,,,,,
2019/03,630,07/03/2019,4,SS 726 (tg Cesena) tra intersezione ex SS 71BIS e l'intersezione SP 304R,,,,,,,,
2019/03,630,08/03/2019,5,SS 726 (tg Cesena) tra intersezione ex SS 71BIS e l'intersezione SP 304R,,,,,,,,
2019/03,630,09/03/2019,6,SS 726 (tg Cesena) tra intersezione ex SS 71BIS e l'intersezione SP 304R,,,,,,,,
2019/03,630,10/03/2019,7,SS 726 (tg Cesena) tra intersezione ex SS 71BIS e l'intersezione SP 304R,,,,,,,,
2019/03,630,11/03/2019,1,SS 726 (tg Cesena) tra intersezione ex SS 71BIS e l'intersezione SP 304R,,,,,,,,
2019/03,630,12/03/2019,2,SS 726 (tg Cesena) tra intersezione ex SS 71BIS e l'intersezione SP 304R,,,,,,,,
2019/03,630,13/03/2019,3,SS 726 (tg Cesena) tra intersezione ex SS 71BIS e l'intersezione SP 304R,,,,,,,,
2019/03,630,14/03/2019,4,SS 726 (tg Cesena) tra intersezione ex SS 71BIS e l'intersezione SP 304R,,,,,,,,
2019/03,631,01/03/2019,5,SS 3Bis/E 45 tra Sarsina e San Piero in Bagno,,,,,,,,
2019/03,631,02/03/2019,6,SS 3Bis/E 45 tra Sarsina e San Piero in Bagno,,,,,,,,
2019/03,631,03/03/2019,7,SS 3Bis/E 45 tra Sarsina e San Piero in Bagno,,,,,,,,
2019/03,631,04/03/2019,1,SS 3Bis/E 45 tra Sarsina e San Piero in Bagno,,,,,,,,
2019/03,631,05/03/2019,2,SS 3Bis/E 45 tra Sarsina e San Piero in Bagno,,,,,,,,
2019/03,631,06/03/2019,3,SS 3Bis/E 45 tra Sarsina e San Piero in Bagno,,,,,,,,
2019/03,631,07/03/2019,4,SS 3Bis/E 45 tra Sarsina e San Piero in Bagno,,,,,,,,
2019/03,631,08/03/2019,5,SS 3Bis/E 45 tra Sarsina e San Piero in Bagno,,,,,,,,
2019/03,631,09/03/2019,6,SS 3Bis/E 45 tra Sarsina e San Piero in Bagno,,,,,,,,
2019/03,631,10/03/2019,7,SS 3Bis/E 45 tra Sarsina e San Piero in Bagno,,,,,,,,
2019/03,631,11/03/2019,1,SS 3Bis/E 45 tra Sarsina e San Piero in Bagno,,,,,,,,
2019/03,631,12/03/2019,2,SS 3Bis/E 45 tra Sarsina e San Piero in Bagno,,,,,,,,
2019/03,631,13/03/2019,3,SS 3Bis/E 45 tra Sarsina e San Piero in Bagno,,,,,,,,
2019/03,631,14/03/2019,4,SS 3Bis/E 45 tra Sarsina e San Piero in Bagno,,,,,,,,
2019/03,632,01/03/2019,5,SS 724Dir/tangenziale complanare sud alla A 1 in direzione Reggio Emilia - tra intersezione Modena/Sassuolo e intersezione SS 12,8333,00,7900,433,6491,1842,8333,0
2019/03,632,02/03/2019,6,SS 724Dir/tangenziale complanare sud alla A 1 in direzione Reggio Emilia - tra intersezione Modena/Sassuolo e intersezione SS 12,6536,00,6404,132,4727,1809,0,6536
2019/03,632,03/03/2019,7,SS 724Dir/tangenziale complanare sud alla A 1 in direzione Reggio Emilia - tra intersezione Modena/Sassuolo e intersezione SS 12,5502,00,5437,65,4016,1486,0,5502
2019/03,632,04/03/2019,1,SS 724Dir/tangenziale complanare sud alla A 1 in direzione Reggio Emilia - tra intersezione Modena/Sassuolo e intersezione SS 12,8008,10,7480,527,6476,1532,8008,0
2019/03,632,05/03/2019,2,SS 724Dir/tangenziale complanare sud alla A 1 in direzione Reggio Emilia - tra intersezione Modena/Sassuolo e intersezione SS 12,8083,00,7633,450,6477,1606,8083,0
2019/03,632,06/03/2019,3,SS 724Dir/tangenziale complanare sud alla A 1 in direzione Reggio Emilia - tra intersezione Modena/Sassuolo e intersezione SS 12,8234,00,7657,577,6567,1667,8234,0
2019/03,632,07/03/2019,4,SS 724Dir/tangenziale complanare sud alla A 1 in direzione Reggio Emilia - tra intersezione Modena/Sassuolo e intersezione SS 12,8052,00,7593,459,6388,1664,8052,0
2019/03,632,08/03/2019,5,SS 724Dir/tangenziale complanare sud alla A 1 in direzione Reggio Emilia - tra intersezione Modena/Sassuolo e intersezione SS 12,8324,00,7748,576,6449,1875,8324,0
2019/03,632,09/03/2019,6,SS 724Dir/tangenziale complanare sud alla A 1 in direzione Reggio Emilia - tra intersezione Modena/Sassuolo e intersezione SS 12,6545,00,6361,184,4733,1812,0,6545
2019/03,632,10/03/2019,7,SS 724Dir/tangenziale complanare sud alla A 1 in direzione Reggio Emilia - tra intersezione Modena/Sassuolo e intersezione SS 12,5264,00,5207,57,3884,1380,0,5264
2019/03,632,11/03/2019,1,SS 724Dir/tangenziale complanare sud alla A 1 in direzione Reggio Emilia - tra intersezione Modena/Sassuolo e intersezione SS 12,7810,00,7282,528,6417,1393,7810,0
2019/03,632,12/03/2019,2,SS 724Dir/tangenziale complanare sud alla A 1 in direzione Reggio Emilia - tra intersezione Modena/Sassuolo e intersezione SS 12,,,,,,,,
2019/03,633,01/03/2019,5,SS 724Dir/tangenziale complanare sud alla A 1 in direzione Bologna - tra intersezione Modena/Sassuolo e intersezione SS12,8210,00,7695,515,6237,1973,8210,0
2019/03,633,02/03/2019,6,SS 724Dir/tangenziale complanare sud alla A 1 in direzione Bologna - tra intersezione Modena/Sassuolo e intersezione SS12,6474,00,6357,117,4539,1935,0,6474
2019/03,633,03/03/2019,7,SS 724Dir/tangenziale complanare sud alla A 1 in direzione Bologna - tra intersezione Modena/Sassuolo e intersezione SS12,5341,10,5301,39,3702,1639,0,5341
2019/03,633,04/03/2019,1,SS 724Dir/tangenziale complanare sud alla A 1 in direzione Bologna - tra intersezione Modena/Sassuolo e intersezione SS12,7769,00,7244,525,6042,1727,7769,0
2019/03,633,05/03/2019,2,SS 724Dir/tangenziale complanare sud alla A 1 in direzione Bologna - tra intersezione Modena/Sassuolo e intersezione SS12,8152,00,7659,493,6221,1931,8152,0
2019/03,633,06/03/2019,3,SS 724Dir/tangenziale complanare sud alla A 1 in direzione Bologna - tra intersezione Modena/Sassuolo e intersezione SS12,8446,00,7944,502,6370,2076,8446,0
2019/03,633,07/03/2019,4,SS 724Dir/tangenziale complanare sud alla A 1 in direzione Bologna - tra intersezione Modena/Sassuolo e intersezione SS12,8288,10,7738,549,6226,2062,8288,0
2019/03,633,08/03/2019,5,SS 724Dir/tangenziale complanare sud alla A 1 in direzione Bologna - tra intersezione Modena/Sassuolo e intersezione SS12,8404,00,7904,500,6304,2100,8404,0
2019/03,633,09/03/2019,6,SS 724Dir/tangenziale complanare sud alla A 1 in direzione Bologna - tra intersezione Modena/Sassuolo e intersezione SS12,6458,00,6349,109,4477,1981,0,6458
2019/03,633,10/03/2019,7,SS 724Dir/tangenziale complanare sud alla A 1 in direzione Bologna - tra intersezione Modena/Sassuolo e intersezione SS12,5091,00,5051,40,3514,1577,0,5091
2019/03,633,11/03/2019,1,SS 724Dir/tangenziale complanare sud alla A 1 in direzione Bologna - tra intersezione Modena/Sassuolo e intersezione SS12,7924,00,7434,490,6179,1745,7924,0
2019/03,633,12/03/2019,2,SS 724Dir/tangenziale complanare sud alla A 1 in direzione Bologna - tra intersezione Modena/Sassuolo e intersezione SS12,8122,00,7616,506,6301,1821,8122,0
2019/03,633,13/03/2019,3,SS 724Dir/tangenziale complanare sud alla A 1 in direzione Bologna - tra intersezione Modena/Sassuolo e intersezione SS12,8012,00,7534,478,6046,1966,8012,0
2019/03,633,14/03/2019,4,SS 724Dir/tangenziale complanare sud alla A 1 in direzione Bologna - tra intersezione Modena/Sassuolo e intersezione SS12,8132,00,7625,507,6147,1985,8132,0
2019/03,634,01/03/2019,5,SS 12 tra Pavullo e intersezione SP 31,,,,,,,,
2019/03,634,02/03/2019,6,SS 12 tra Pavullo e intersezione SP 31,,,,,,,,
2019/03,634,03/03/2019,7,SS 12 tra Pavullo e intersezione SP 31,,,,,,,,
2019/03,634,04/03/2019,1,SS 12 tra Pavullo e intersezione SP 31,,,,,,,,
2019/03,634,05/03/2019,2,SS 12 tra Pavullo e intersezione SP 31,,,,,,,,
2019/03,634,06/03/2019,3,SS 12 tra Pavullo e intersezione SP 31,,,,,,,,
2019/03,634,07/03/2019,4,SS 12 tra Pavullo e intersezione SP 31,,,,,,,,
2019/03,634,08/03/2019,5,SS 12 tra Pavullo e intersezione SP 31,,,,,,,,
2019/03,634,09/03/2019,6,SS 12 tra Pavullo e intersezione SP 31,,,,,,,,
2019/03,634,10/03/2019,7,SS 12 tra Pavullo e intersezione SP 31,,,,,,,,
2019/03,634,11/03/2019,1,SS 12 tra Pavullo e intersezione SP 31,,,,,,,,
2019/03,634,12/03/2019,2,SS 12 tra Pavullo e intersezione SP 31,,,,,,,,
2019/03,634,13/03/2019,3,SS 12 tra Pavullo e intersezione SP 31,,,,,,,,
2019/03,634,14/03/2019,4,SS 12 tra Pavullo e intersezione SP 31,,,,,,,,
2019/03,635,01/03/2019,5,SS 725 (tg sud Piacenza) tra intersezione SS 45 e l'intersezione SP 6,49267,20,46026,3239,38841,10426,49267,0
2019/03,635,02/03/2019,6,SS 725 (tg sud Piacenza) tra intersezione SS 45 e l'intersezione SP 6,41111,00,40165,946,31750,9361,0,41111
2019/03,635,03/03/2019,7,SS 725 (tg sud Piacenza) tra intersezione SS 45 e l'intersezione SP 6,34131,10,33896,234,26640,7491,0,34131
2019/03,635,04/03/2019,1,SS 725 (tg sud Piacenza) tra intersezione SS 45 e l'intersezione SP 6,45234,10,41826,3407,36694,8540,45234,0
2019/03,635,05/03/2019,2,SS 725 (tg sud Piacenza) tra intersezione SS 45 e l'intersezione SP 6,46033,20,42624,3407,37152,8881,46033,0
2019/03,635,06/03/2019,3,SS 725 (tg sud Piacenza) tra intersezione SS 45 e l'intersezione SP 6,46068,00,42732,3336,36988,9080,46068,0
2019/03,635,07/03/2019,4,SS 725 (tg sud Piacenza) tra intersezione SS 45 e l'intersezione SP 6,46951,20,43450,3499,37789,9162,46951,0
2019/03,635,08/03/2019,5,SS 725 (tg sud Piacenza) tra intersezione SS 45 e l'intersezione SP 6,49967,10,46496,3470,38910,11057,49967,0
2019/03,635,09/03/2019,6,SS 725 (tg sud Piacenza) tra intersezione SS 45 e l'intersezione SP 6,40922,00,39908,1014,31126,9796,0,40922
2019/03,635,10/03/2019,7,SS 725 (tg sud Piacenza) tra intersezione SS 45 e l'intersezione SP 6,33192,10,32961,230,25326,7866,0,33192
2019/03,635,11/03/2019,1,SS 725 (tg sud Piacenza) tra intersezione SS 45 e l'intersezione SP 6,45678,30,42063,3612,37067,8611,45678,0
2019/03,635,12/03/2019,2,SS 725 (tg sud Piacenza) tra intersezione SS 45 e l'intersezione SP 6,46226,20,42642,3582,37330,8896,46226,0
2019/03,635,13/03/2019,3,SS 725 (tg sud Piacenza) tra intersezione SS 45 e l'intersezione SP 6,46190,10,42770,3419,36906,9284,46190,0
2019/03,635,14/03/2019,4,SS 725 (tg sud Piacenza) tra intersezione SS 45 e l'intersezione SP 6,46522,10,43087,3434,37279,9243,46522,0
2019/03,636,01/03/2019,5,SS 9Var tra la tangenziale nord di Parma (intersezione SP 343R) e l'intersezione SP 62R,59263,90,55788,3466,46063,13200,59263,0
2019/03,636,02/03/2019,6,SS 9Var tra la tangenziale nord di Parma (intersezione SP 343R) e l'intersezione SP 62R,50303,10,49409,893,37158,13145,0,50303
2019/03,636,03/03/2019,7,SS 9Var tra la tangenziale nord di Parma (intersezione SP 343R) e l'intersezione SP 62R,39147,00,38860,287,28260,10887,0,39147
2019/03,636,04/03/2019,1,SS 9Var tra la tangenziale nord di Parma (intersezione SP 343R) e l'intersezione SP 62R,55320,50,51837,3478,44294,11026,55320,0
2019/03,636,05/03/2019,2,SS 9Var tra la tangenziale nord di Parma (intersezione SP 343R) e l'intersezione SP 62R,55453,90,51840,3604,43807,11646,55453,0
2019/03,636,06/03/2019,3,SS 9Var tra la tangenziale nord di Parma (intersezione SP 343R) e l'intersezione SP 62R,56061,190,52345,3697,44505,11556,56061,0
2019/03,636,07/03/2019,4,SS 9Var tra la tangenziale nord di Parma (intersezione SP 343R) e l'intersezione SP 62R,57066,50,53613,3448,45050,12016,57066,0
2019/03,636,08/03/2019,5,SS 9Var tra la tangenziale nord di Parma (intersezione SP 343R) e l'intersezione SP 62R,59992,90,56564,3419,46046,13946,59992,0
2019/03,636,09/03/2019,6,SS 9Var tra la tangenziale nord di Parma (intersezione SP 343R) e l'intersezione SP 62R,54127,40,53177,946,38457,15670,0,54127
2019/03,636,10/03/2019,7,SS 9Var tra la tangenziale nord di Parma (intersezione SP 343R) e l'intersezione SP 62R,39728,00,39391,337,28331,11397,0,39728
2019/03,636,11/03/2019,1,SS 9Var tra la tangenziale nord di Parma (intersezione SP 343R) e l'intersezione SP 62R,55042,130,51594,3435,44294,10748,55042,0
2019/03,636,12/03/2019,2,SS 9Var tra la tangenziale nord di Parma (intersezione SP 343R) e l'intersezione SP 62R,55612,20,51892,3718,44261,11351,55612,0
2019/03,636,13/03/2019,3,SS 9Var tra la tangenziale nord di Parma (intersezione SP 343R) e l'intersezione SP 62R,43495,70,40540,2948,35560,7935,43495,0
2019/03,636,14/03/2019,4,SS 9Var tra la tangenziale nord di Parma (intersezione SP 343R) e l'intersezione SP 62R,56591,40,52982,3605,44920,11671,56591,0
2019/03,637,01/03/2019,5,SS 62 tra Fornovo di Taro e Collecchio,14817,00,14027,790,11446,3371,14817,0
2019/03,637,02/03/2019,6,SS 62 tra Fornovo di Taro e Collecchio,12680,20,12453,225,9536,3144,0,12680
2019/03,637,03/03/2019,7,SS 62 tra Fornovo di Taro e Collecchio,11999,00,11934,65,8731,3268,0,11999
2019/03,637,04/03/2019,1,SS 62 tra Fornovo di Taro e Collecchio,13766,00,12892,874,10966,2800,13766,0
2019/03,637,05/03/2019,2,SS 62 tra Fornovo di Taro e Collecchio,13992,00,13113,879,11073,2919,13992,0
2019/03,637,06/03/2019,3,SS 62 tra Fornovo di Taro e Collecchio,14096,10,13191,904,11061,3035,14096,0
2019/03,637,07/03/2019,4,SS 62 tra Fornovo di Taro e Collecchio,14134,00,13252,882,10974,3160,14134,0
2019/03,637,08/03/2019,5,SS 62 tra Fornovo di Taro e Collecchio,15505,00,14627,878,11889,3616,15505,0
2019/03,637,09/03/2019,6,SS 62 tra Fornovo di Taro e Collecchio,12816,10,12566,249,9528,3288,0,12816
2019/03,637,10/03/2019,7,SS 62 tra Fornovo di Taro e Collecchio,10676,00,10594,82,7988,2688,0,10676
2019/03,637,11/03/2019,1,SS 62 tra Fornovo di Taro e Collecchio,13683,00,12820,863,10907,2776,13683,0
2019/03,637,12/03/2019,2,SS 62 tra Fornovo di Taro e Collecchio,14226,00,13319,907,11225,3001,14226,0
2019/03,637,13/03/2019,3,SS 62 tra Fornovo di Taro e Collecchio,14055,10,13196,858,11043,3012,14055,0
2019/03,637,14/03/2019,4,SS 62 tra Fornovo di Taro e Collecchio,14239,00,13396,843,11135,3104,14239,0
2019/03,638,01/03/2019,5,SS 9 tra la tangenziale nord di Reggio Emilia e Sant'Ilario d'Enza,20599,20,18940,1657,14707,5892,20599,0
2019/03,638,02/03/2019,6,SS 9 tra la tangenziale nord di Reggio Emilia e Sant'Ilario d'Enza,18915,00,18413,502,12765,6150,0,18915
2019/03,638,03/03/2019,7,SS 9 tra la tangenziale nord di Reggio Emilia e Sant'Ilario d'Enza,16480,00,16317,163,11152,5328,0,16480
2019/03,638,04/03/2019,1,SS 9 tra la tangenziale nord di Reggio Emilia e Sant'Ilario d'Enza,19014,40,17328,1682,14208,4806,19014,0
2019/03,638,05/03/2019,2,SS 9 tra la tangenziale nord di Reggio Emilia e Sant'Ilario d'Enza,19782,00,17992,1790,14650,5132,19782,0
2019/03,638,06/03/2019,3,SS 9 tra la tangenziale nord di Reggio Emilia e Sant'Ilario d'Enza,19693,00,17997,1696,14725,4968,19693,0
2019/03,638,07/03/2019,4,SS 9 tra la tangenziale nord di Reggio Emilia e Sant'Ilario d'Enza,20268,00,18519,1749,14815,5453,20268,0
2019/03,638,08/03/2019,5,SS 9 tra la tangenziale nord di Reggio Emilia e Sant'Ilario d'Enza,21164,00,19515,1649,14967,6197,21164,0
2019/03,638,09/03/2019,6,SS 9 tra la tangenziale nord di Reggio Emilia e Sant'Ilario d'Enza,18937,00,18469,468,12511,6426,0,18937
2019/03,638,10/03/2019,7,SS 9 tra la tangenziale nord di Reggio Emilia e Sant'Ilario d'Enza,16340,00,16175,165,11012,5328,0,16340
2019/03,638,11/03/2019,1,SS 9 tra la tangenziale nord di Reggio Emilia e Sant'Ilario d'Enza,19222,00,17562,1660,14464,4758,19222,0
2019/03,638,12/03/2019,2,SS 9 tra la tangenziale nord di Reggio Emilia e Sant'Ilario d'Enza,19618,00,17927,1691,14660,4958,19618,0
2019/03,638,13/03/2019,3,SS 9 tra la tangenziale nord di Reggio Emilia e Sant'Ilario d'Enza,19745,00,18120,1625,14549,5196,19745,0
2019/03,638,14/03/2019,4,SS 9 tra la tangenziale nord di Reggio Emilia e Sant'Ilario d'Enza,19957,00,18250,1707,14702,5255,19957,0
2019/03,639,01/03/2019,5,SS 63 località Casina (variante abitato),7165,00,6872,293,5353,1812,7165,0
2019/03,639,02/03/2019,6,SS 63 località Casina (variante abitato),6793,00,6644,149,5068,1725,0,6793
2019/03,639,03/03/2019,7,SS 63 località Casina (variante abitato),6668,00,6623,45,5093,1575,0,6668
2019/03,639,04/03/2019,1,SS 63 località Casina (variante abitato),6619,00,6314,305,5149,1470,6619,0
2019/03,639,05/03/2019,2,SS 63 località Casina (variante abitato),6528,00,6215,313,5050,1478,6528,0
2019/03,639,06/03/2019,3,SS 63 località Casina (variante abitato),6955,00,6636,319,5303,1652,6955,0
2019/03,639,07/03/2019,4,SS 63 località Casina (variante abitato),6589,00,6250,339,5083,1506,6589,0
2019/03,639,08/03/2019,5,SS 63 località Casina (variante abitato),7375,20,7061,312,5537,1838,7375,0
2019/03,639,09/03/2019,6,SS 63 località Casina (variante abitato),6950,00,6795,155,5190,1760,0,6950
2019/03,639,10/03/2019,7,SS 63 località Casina (variante abitato),6179,00,6127,52,4624,1555,0,6179
2019/03,639,11/03/2019,1,SS 63 località Casina (variante abitato),5460,00,5179,281,3973,1487,5460,0
2019/03,639,12/03/2019,2,SS 63 località Casina (variante abitato),6704,00,6424,280,5138,1566,6704,0
2019/03,639,13/03/2019,3,SS 63 località Casina (variante abitato),6834,00,6536,298,5236,1598,6834,0
2019/03,639,14/03/2019,4,SS 63 località Casina (variante abitato),6787,00,6476,311,5170,1617,6787,0
2019/03,651,01/03/2019,5,SS 9 da Imola a Castelbolognese (al confine provinciale),17344,00,16598,746,12637,4707,17344,0
2019/03,651,02/03/2019,6,SS 9 da Imola a Castelbolognese (al confine provinciale),17701,00,17491,210,12315,5386,0,17701
2019/03,651,03/03/2019,7,SS 9 da Imola a Castelbolognese (al confine provinciale),14344,00,14257,87,10227,4117,0,14344
2019/03,651,04/03/2019,1,SS 9 da Imola a Castelbolognese (al confine provinciale),16382,00,15687,695,12520,3862,16382,0
2019/03,651,05/03/2019,2,SS 9 da Imola a Castelbolognese (al confine provinciale),16827,00,16025,802,12532,4295,16827,0
2019/03,651,06/03/2019,3,SS 9 da Imola a Castelbolognese (al confine provinciale),16985,00,16168,817,12776,4209,16985,0
2019/03,651,07/03/2019,4,SS 9 da Imola a Castelbolognese (al confine provinciale),16789,00,15985,804,12612,4177,16789,0
2019/03,651,09/03/2019,6,SS 9 da Imola a Castelbolognese (al confine provinciale),16084,00,15858,226,11177,4907,0,16084
2019/03,651,10/03/2019,7,SS 9 da Imola a Castelbolognese (al confine provinciale),14222,00,14143,79,10318,3904,0,14222
2019/03,651,11/03/2019,1,SS 9 da Imola a Castelbolognese (al confine provinciale),16182,00,15389,793,12545,3637,16182,0
2019/03,651,12/03/2019,2,SS 9 da Imola a Castelbolognese (al confine provinciale),16864,00,16041,823,12847,4017,16864,0
2019/03,651,13/03/2019,3,SS 9 da Imola a Castelbolognese (al confine provinciale),17516,00,16708,808,13205,4311,17516,0
2019/03,651,14/03/2019,4,SS 9 da Imola a Castelbolognese (al confine provinciale),16945,00,16119,826,12894,4051,16945,0
2019/03,652,01/03/2019,5,SS 16 dal bivio SP 610R ad Argenta,13097,00,11809,1288,10281,2816,13097,0
2019/03,652,02/03/2019,6,SS 16 dal bivio SP 610R ad Argenta,10968,00,10654,314,8364,2604,0,10968
2019/03,652,03/03/2019,7,SS 16 dal bivio SP 610R ad Argenta,10400,00,10307,93,7816,2584,0,10400
2019/03,652,04/03/2019,1,SS 16 dal bivio SP 610R ad Argenta,12097,00,10779,1318,9817,2280,12097,0
2019/03,652,05/03/2019,2,SS 16 dal bivio SP 610R ad Argenta,12206,00,10855,1351,9691,2515,12206,0
2019/03,652,06/03/2019,3,SS 16 dal bivio SP 610R ad Argenta,12313,00,10897,1416,9886,2427,12313,0
2019/03,652,07/03/2019,4,SS 16 dal bivio SP 610R ad Argenta,12631,00,11218,1413,10136,2495,12631,0
2019/03,652,08/03/2019,5,SS 16 dal bivio SP 610R ad Argenta,13929,00,12517,1412,10757,3172,13929,0
2019/03,652,09/03/2019,6,SS 16 dal bivio SP 610R ad Argenta,10925,00,10602,323,8240,2685,0,10925
2019/03,652,10/03/2019,7,SS 16 dal bivio SP 610R ad Argenta,9665,00,9556,109,7089,2576,0,9665
2019/03,652,11/03/2019,1,SS 16 dal bivio SP 610R ad Argenta,12136,00,10791,1345,9803,2333,12136,0
2019/03,652,12/03/2019,2,SS 16 dal bivio SP 610R ad Argenta,12150,00,10810,1340,9682,2468,12150,0
2019/03,652,13/03/2019,3,SS 16 dal bivio SP 610R ad Argenta,12445,00,11055,1390,9945,2500,12445,0
2019/03,652,14/03/2019,4,SS 16 dal bivio SP 610R ad Argenta,12788,00,11400,1388,10120,2668,12788,0
2019/03,653,01/03/2019,5,SP 254R dal ponte sul fiume Savio alla SS 16,8911,00,8605,306,6966,1945,8911,0
2019/03,653,02/03/2019,6,SP 254R dal ponte sul fiume Savio alla SS 16,9535,00,9470,65,7079,2456,0,9535
2019/03,653,03/03/2019,7,SP 254R dal ponte sul fiume Savio alla SS 16,11999,00,11972,27,9795,2204,0,11999
2019/03,653,04/03/2019,1,SP 254R dal ponte sul fiume Savio alla SS 16,7783,00,7499,284,6362,1421,7783,0
2019/03,653,05/03/2019,2,SP 254R dal ponte sul fiume Savio alla SS 16,8013,00,7756,257,6609,1404,8013,0
2019/03,653,06/03/2019,3,SP 254R dal ponte sul fiume Savio alla SS 16,8466,00,8233,233,6925,1541,8466,0
2019/03,653,07/03/2019,4,SP 254R dal ponte sul fiume Savio alla SS 16,8762,00,8474,288,7004,1758,8762,0
2019/03,653,08/03/2019,5,SP 254R dal ponte sul fiume Savio alla SS 16,9121,00,8903,218,6877,2244,9121,0
2019/03,653,09/03/2019,6,SP 254R dal ponte sul fiume Savio alla SS 16,9600,00,9548,52,6936,2664,0,9600
2019/03,653,10/03/2019,7,SP 254R dal ponte sul fiume Savio alla SS 16,10387,00,10360,27,8476,1911,0,10387
2019/03,653,11/03/2019,1,SP 254R dal ponte sul fiume Savio alla SS 16,7898,00,7640,258,6513,1385,7898,0
2019/03,653,12/03/2019,2,SP 254R dal ponte sul fiume Savio alla SS 16,8346,00,8117,229,6755,1591,8346,0
2019/03,653,13/03/2019,3,SP 254R dal ponte sul fiume Savio alla SS 16,8011,00,7767,244,6438,1573,8011,0
2019/03,653,14/03/2019,4,SP 254R dal ponte sul fiume Savio alla SS 16,8749,00,8511,238,7087,1662,8749,0
2019/03,654,01/03/2019,5,SP 7IBisR dal bivio SSPP 32/33ter alla SS 16,12435,00,12055,380,9665,2770,12435,0
2019/03,654,02/03/2019,6,SP 7IBisR dal bivio SSPP 32/33ter alla SS 16,12488,00,12320,168,9002,3486,0,12488
2019/03,654,03/03/2019,7,SP 7IBisR dal bivio SSPP 32/33ter alla SS 16,13374,00,13324,50,10360,3014,0,13374
2019/03,654,04/03/2019,1,SP 7IBisR dal bivio SSPP 32/33ter alla SS 16,11186,00,10728,458,9103,2083,11186,0
2019/03,654,05/03/2019,2,SP 7IBisR dal bivio SSPP 32/33ter alla SS 16,11713,00,11214,499,9487,2226,11713,0
2019/03,654,06/03/2019,3,SP 7IBisR dal bivio SSPP 32/33ter alla SS 16,11706,00,11232,474,9578,2128,11706,0
2019/03,654,07/03/2019,4,SP 7IBisR dal bivio SSPP 32/33ter alla SS 16,12098,00,11603,495,9636,2462,12098,0
2019/03,654,08/03/2019,5,SP 7IBisR dal bivio SSPP 32/33ter alla SS 16,13231,00,12788,443,10094,3137,13231,0
2019/03,654,09/03/2019,6,SP 7IBisR dal bivio SSPP 32/33ter alla SS 16,12517,00,12378,139,8745,3772,0,12517
2019/03,654,10/03/2019,7,SP 7IBisR dal bivio SSPP 32/33ter alla SS 16,12722,00,12676,46,9904,2818,0,12722
2019/03,654,11/03/2019,1,SP 7IBisR dal bivio SSPP 32/33ter alla SS 16,11484,00,10995,489,9485,1999,11484,0
2019/03,654,12/03/2019,2,SP 7IBisR dal bivio SSPP 32/33ter alla SS 16,11730,00,11261,469,9482,2248,11730,0
2019/03,654,13/03/2019,3,SP 7IBisR dal bivio SSPP 32/33ter alla SS 16,11731,00,11206,525,9371,2360,11731,0
2019/03,654,14/03/2019,4,SP 7IBisR dal bivio SSPP 32/33ter alla SS 16,12238,00,11731,507,9859,2379,12238,0
2019/03,655,01/03/2019,5,SP 253R dal bivio SP 302R allo svincolo A 14dir a Fornace Zarattini,18470,00,17645,825,14446,4024,18470,0
2019/03,655,02/03/2019,6,SP 253R dal bivio SP 302R allo svincolo A 14dir a Fornace Zarattini,15329,00,15101,228,11376,3953,0,15329
2019/03,655,03/03/2019,7,SP 253R dal bivio SP 302R allo svincolo A 14dir a Fornace Zarattini,12361,00,12301,60,9422,2939,0,12361
2019/03,655,04/03/2019,1,SP 253R dal bivio SP 302R allo svincolo A 14dir a Fornace Zarattini,15928,00,15078,850,12527,3401,15928,0
2019/03,655,05/03/2019,2,SP 253R dal bivio SP 302R allo svincolo A 14dir a Fornace Zarattini,17896,00,16987,909,14475,3421,17896,0
2019/03,655,06/03/2019,3,SP 253R dal bivio SP 302R allo svincolo A 14dir a Fornace Zarattini,16549,00,15755,794,12760,3789,16549,0
2019/03,655,07/03/2019,4,SP 253R dal bivio SP 302R allo svincolo A 14dir a Fornace Zarattini,15976,00,15195,781,12096,3880,15976,0
2019/03,655,08/03/2019,5,SP 253R dal bivio SP 302R allo svincolo A 14dir a Fornace Zarattini,18646,00,17805,841,14260,4386,18646,0
2019/03,655,09/03/2019,6,SP 253R dal bivio SP 302R allo svincolo A 14dir a Fornace Zarattini,15299,00,15075,224,10925,4374,0,15299
2019/03,655,10/03/2019,7,SP 253R dal bivio SP 302R allo svincolo A 14dir a Fornace Zarattini,12135,00,12072,63,9303,2832,0,12135
2019/03,655,11/03/2019,1,SP 253R dal bivio SP 302R allo svincolo A 14dir a Fornace Zarattini,17206,00,16368,838,13960,3246,17206,0
2019/03,655,12/03/2019,2,SP 253R dal bivio SP 302R allo svincolo A 14dir a Fornace Zarattini,15485,00,14609,876,12767,2718,15485,0
2019/03,655,13/03/2019,3,SP 253R dal bivio SP 302R allo svincolo A 14dir a Fornace Zarattini,15825,00,15090,735,12010,3815,15825,0
2019/03,655,14/03/2019,4,SP 253R dal bivio SP 302R allo svincolo A 14dir a Fornace Zarattini,18046,00,17130,916,14213,3833,18046,0
2019/03,660,01/03/2019,5,SP 25 tra intersezione con SS 64 e confine provinciale,,,,,,,,
2019/03,660,02/03/2019,6,SP 25 tra intersezione con SS 64 e confine provinciale,,,,,,,,
2019/03,660,03/03/2019,7,SP 25 tra intersezione con SS 64 e confine provinciale,,,,,,,,
2019/03,660,04/03/2019,1,SP 25 tra intersezione con SS 64 e confine provinciale,,,,,,,,
2019/03,660,05/03/2019,2,SP 25 tra intersezione con SS 64 e confine provinciale,,,,,,,,
2019/03,660,06/03/2019,3,SP 25 tra intersezione con SS 64 e confine provinciale,,,,,,,,
2019/03,660,07/03/2019,4,SP 25 tra intersezione con SS 64 e confine provinciale,,,,,,,,
2019/03,660,08/03/2019,5,SP 25 tra intersezione con SS 64 e confine provinciale,,,,,,,,
2019/03,660,09/03/2019,6,SP 25 tra intersezione con SS 64 e confine provinciale,,,,,,,,
2019/03,660,10/03/2019,7,SP 25 tra intersezione con SS 64 e confine provinciale,,,,,,,,
2019/03,660,11/03/2019,1,SP 25 tra intersezione con SS 64 e confine provinciale,,,,,,,,
2019/03,660,12/03/2019,2,SP 25 tra intersezione con SS 64 e confine provinciale,,,,,,,,
2019/03,660,13/03/2019,3,SP 25 tra intersezione con SS 64 e confine provinciale,,,,,,,,
2019/03,660,14/03/2019,4,SP 25 tra intersezione con SS 64 e confine provinciale,,,,,,,,
2019/03,661,01/03/2019,5,SP 15 tra Tresigallo e Massa Fiscaglia,3570,00,3461,109,2781,789,3570,0
2019/03,661,02/03/2019,6,SP 15 tra Tresigallo e Massa Fiscaglia,3114,00,3074,40,2383,731,0,3114
2019/03,661,03/03/2019,7,SP 15 tra Tresigallo e Massa Fiscaglia,3953,00,3939,14,3294,659,0,3953
2019/03,661,04/03/2019,1,SP 15 tra Tresigallo e Massa Fiscaglia,3426,10,3333,92,2732,694,3426,0
2019/03,661,05/03/2019,2,SP 15 tra Tresigallo e Massa Fiscaglia,3485,00,3374,111,2797,688,3485,0
2019/03,661,06/03/2019,3,SP 15 tra Tresigallo e Massa Fiscaglia,3493,00,3379,114,2772,721,3493,0
2019/03,661,07/03/2019,4,SP 15 tra Tresigallo e Massa Fiscaglia,3459,00,3340,119,2794,665,3459,0
2019/03,661,08/03/2019,5,SP 15 tra Tresigallo e Massa Fiscaglia,3553,00,3428,125,2722,831,3553,0
2019/03,661,09/03/2019,6,SP 15 tra Tresigallo e Massa Fiscaglia,3187,00,3142,45,2351,836,0,3187
2019/03,661,10/03/2019,7,SP 15 tra Tresigallo e Massa Fiscaglia,3390,00,3375,15,2681,709,0,3390
2019/03,661,11/03/2019,1,SP 15 tra Tresigallo e Massa Fiscaglia,3521,30,3406,112,2816,705,3521,0
2019/03,661,12/03/2019,2,SP 15 tra Tresigallo e Massa Fiscaglia,3641,00,3514,127,2935,706,3641,0
2019/03,661,13/03/2019,3,SP 15 tra Tresigallo e Massa Fiscaglia,3700,10,3565,134,2952,748,3700,0
2019/03,661,14/03/2019,4,SP 15 tra Tresigallo e Massa Fiscaglia,3835,20,3691,142,3084,751,3835,0
2019/03,662,01/03/2019,5,SP 2 tra intersezione SP 14 e Copparo,14003,10,13402,600,11098,2905,14003,0
2019/03,662,02/03/2019,6,SP 2 tra intersezione SP 14 e Copparo,11131,00,10962,169,8316,2815,0,11131
2019/03,662,03/03/2019,7,SP 2 tra intersezione SP 14 e Copparo,8640,00,8596,44,6219,2421,0,8640
2019/03,662,04/03/2019,1,SP 2 tra intersezione SP 14 e Copparo,13429,00,12859,570,10898,2531,13429,0
2019/03,662,05/03/2019,2,SP 2 tra intersezione SP 14 e Copparo,13567,00,12965,602,10967,2600,13567,0
2019/03,662,06/03/2019,3,SP 2 tra intersezione SP 14 e Copparo,13478,00,12867,611,10774,2704,13478,0
2019/03,662,07/03/2019,4,SP 2 tra intersezione SP 14 e Copparo,13900,00,13303,597,11098,2802,13900,0
2019/03,662,08/03/2019,5,SP 2 tra intersezione SP 14 e Copparo,14904,00,14322,582,11663,3241,14904,0
2019/03,662,09/03/2019,6,SP 2 tra intersezione SP 14 e Copparo,11360,00,11201,159,8488,2872,0,11360
2019/03,662,10/03/2019,7,SP 2 tra intersezione SP 14 e Copparo,8309,00,8276,33,5982,2327,0,8309
2019/03,662,11/03/2019,1,SP 2 tra intersezione SP 14 e Copparo,13320,00,12738,582,10862,2458,13320,0
2019/03,662,12/03/2019,2,SP 2 tra intersezione SP 14 e Copparo,13758,00,13162,596,11130,2628,13758,0
2019/03,662,13/03/2019,3,SP 2 tra intersezione SP 14 e Copparo,13588,00,13023,565,10958,2630,13588,0
2019/03,662,14/03/2019,4,SP 2 tra intersezione SP 14 e Copparo,13535,00,12922,613,10914,2621,13535,0
2019/03,663,01/03/2019,5,SP 60 tra intersezione SP 68 e SP62,3309,00,2821,488,2544,765,3309,0
2019/03,663,02/03/2019,6,SP 60 tra intersezione SP 68 e SP62,2917,00,2750,167,2260,657,0,2917
2019/03,663,03/03/2019,7,SP 60 tra intersezione SP 68 e SP62,3656,00,3635,21,2977,679,0,3656
2019/03,663,04/03/2019,1,SP 60 tra intersezione SP 68 e SP62,3114,10,2664,449,2488,626,3114,0
2019/03,663,05/03/2019,2,SP 60 tra intersezione SP 68 e SP62,3146,10,2655,490,2459,687,3146,0
2019/03,663,06/03/2019,3,SP 60 tra intersezione SP 68 e SP62,3218,00,2738,480,2554,664,3218,0
2019/03,663,07/03/2019,4,SP 60 tra intersezione SP 68 e SP62,3122,00,2616,506,2424,698,3122,0
2019/03,663,08/03/2019,5,SP 60 tra intersezione SP 68 e SP62,3546,10,2984,561,2691,855,3546,0
2019/03,663,09/03/2019,6,SP 60 tra intersezione SP 68 e SP62,2953,00,2781,172,2172,781,0,2953
2019/03,663,10/03/2019,7,SP 60 tra intersezione SP 68 e SP62,3611,00,3573,38,2898,713,0,3611
2019/03,663,11/03/2019,1,SP 60 tra intersezione SP 68 e SP62,3164,20,2619,543,2508,656,3164,0
2019/03,663,12/03/2019,2,SP 60 tra intersezione SP 68 e SP62,3279,00,2798,481,2586,693,3279,0
2019/03,663,13/03/2019,3,SP 60 tra intersezione SP 68 e SP62,3326,00,2758,568,2643,683,3326,0
2019/03,663,14/03/2019,4,SP 60 tra intersezione SP 68 e SP62,3272,00,2773,499,2564,708,3272,0
2019/03,665,01/03/2019,5,SP 1 tra intersezione SP7 a Piacenza,12768,10,12130,637,10004,2764,12768,0
2019/03,665,02/03/2019,6,SP 1 tra intersezione SP7 a Piacenza,10013,10,9880,132,7428,2585,0,10013
2019/03,665,03/03/2019,7,SP 1 tra intersezione SP7 a Piacenza,7893,00,7851,42,5777,2116,0,7893
2019/03,665,04/03/2019,1,SP 1 tra intersezione SP7 a Piacenza,11867,00,11169,698,9533,2334,11867,0
2019/03,665,05/03/2019,2,SP 1 tra intersezione SP7 a Piacenza,12118,00,11311,807,9747,2371,12118,0
2019/03,665,06/03/2019,3,SP 1 tra intersezione SP7 a Piacenza,12392,00,11597,795,9982,2410,12392,0
2019/03,665,07/03/2019,4,SP 1 tra intersezione SP7 a Piacenza,12271,20,11555,714,9787,2484,12271,0
2019/03,665,08/03/2019,5,SP 1 tra intersezione SP7 a Piacenza,12966,00,12296,670,10085,2881,12966,0
2019/03,665,09/03/2019,6,SP 1 tra intersezione SP7 a Piacenza,10274,00,10120,154,7496,2778,0,10274
2019/03,665,10/03/2019,7,SP 1 tra intersezione SP7 a Piacenza,7814,00,7776,38,5650,2164,0,7814
2019/03,665,11/03/2019,1,SP 1 tra intersezione SP7 a Piacenza,11859,00,11100,759,9572,2287,11859,0
2019/03,665,12/03/2019,2,SP 1 tra intersezione SP7 a Piacenza,12447,00,11741,706,10010,2437,12447,0
2019/03,665,13/03/2019,3,SP 1 tra intersezione SP7 a Piacenza,12339,00,11572,767,9856,2483,12339,0
2019/03,665,14/03/2019,4,SP 1 tra intersezione SP7 a Piacenza,12673,30,11866,804,10107,2566,12673,0
2019/03,666,01/03/2019,5,SP 3 tra via Monda e via Caminate,8167,10,7689,477,6488,1679,8167,0
2019/03,666,02/03/2019,6,SP 3 tra via Monda e via Caminate,6535,10,6408,126,4806,1729,0,6535
2019/03,666,03/03/2019,7,SP 3 tra via Monda e via Caminate,5528,10,5509,18,4100,1428,0,5528
2019/03,666,04/03/2019,1,SP 3 tra via Monda e via Caminate,7764,00,7295,469,6171,1593,7764,0
2019/03,666,05/03/2019,2,SP 3 tra via Monda e via Caminate,7875,10,7425,449,6356,1519,7875,0
2019/03,666,06/03/2019,3,SP 3 tra via Monda e via Caminate,7910,00,7430,480,6383,1527,7910,0
2019/03,666,07/03/2019,4,SP 3 tra via Monda e via Caminate,7883,10,7403,479,6314,1569,7883,0
2019/03,666,08/03/2019,5,SP 3 tra via Monda e via Caminate,8521,00,8058,463,6610,1911,8521,0
2019/03,666,09/03/2019,6,SP 3 tra via Monda e via Caminate,6775,10,6673,101,4984,1791,0,6775
2019/03,666,10/03/2019,7,SP 3 tra via Monda e via Caminate,5639,00,5609,30,4248,1391,0,5639
2019/03,666,11/03/2019,1,SP 3 tra via Monda e via Caminate,7626,10,7136,489,6253,1373,7626,0
2019/03,666,12/03/2019,2,SP 3 tra via Monda e via Caminate,7848,10,7357,490,6283,1565,7848,0
2019/03,666,13/03/2019,3,SP 3 tra via Monda e via Caminate,7863,10,7379,483,6254,1609,7863,0
2019/03,666,14/03/2019,4,SP 3 tra via Monda e via Caminate,8198,10,7675,522,6483,1715,8198,0
2019/03,670,01/03/2019,5,SP 114 dalla rotatoria SP 114/viale Parisoli alla rotatoria SP467,17890,00,17136,754,14246,3644,17890,0
2019/03,670,02/03/2019,6,SP 114 dalla rotatoria SP 114/viale Parisoli alla rotatoria SP467,13889,10,13732,156,10289,3600,0,13889
2019/03,670,03/03/2019,7,SP 114 dalla rotatoria SP 114/viale Parisoli alla rotatoria SP467,10167,00,10095,72,7070,3097,0,10167
2019/03,670,04/03/2019,1,SP 114 dalla rotatoria SP 114/viale Parisoli alla rotatoria SP467,17122,10,16300,821,14044,3078,17122,0
2019/03,670,05/03/2019,2,SP 114 dalla rotatoria SP 114/viale Parisoli alla rotatoria SP467,17518,00,16646,872,14207,3311,17518,0
2019/03,670,06/03/2019,3,SP 114 dalla rotatoria SP 114/viale Parisoli alla rotatoria SP467,17447,00,16576,871,14170,3277,17447,0
2019/03,670,07/03/2019,4,SP 114 dalla rotatoria SP 114/viale Parisoli alla rotatoria SP467,17467,00,16566,901,13940,3527,17467,0
2019/03,670,08/03/2019,5,SP 114 dalla rotatoria SP 114/viale Parisoli alla rotatoria SP467,17299,30,16450,846,13520,3779,17299,0
2019/03,670,09/03/2019,6,SP 114 dalla rotatoria SP 114/viale Parisoli alla rotatoria SP467,13446,00,13258,188,9942,3504,0,13446
2019/03,670,10/03/2019,7,SP 114 dalla rotatoria SP 114/viale Parisoli alla rotatoria SP467,10254,00,10180,74,7354,2900,0,10254
2019/03,670,11/03/2019,1,SP 114 dalla rotatoria SP 114/viale Parisoli alla rotatoria SP467,16848,00,16013,835,13880,2968,16848,0
2019/03,670,12/03/2019,2,SP 114 dalla rotatoria SP 114/viale Parisoli alla rotatoria SP467,17246,00,16359,887,13916,3330,17246,0
2019/03,670,13/03/2019,3,SP 114 dalla rotatoria SP 114/viale Parisoli alla rotatoria SP467,16122,00,15381,741,12809,3313,16122,0
2019/03,670,14/03/2019,4,SP 114 dalla rotatoria SP 114/viale Parisoli alla rotatoria SP467,17267,40,16397,866,13802,3465,17267,0
2019/03,6,15/03/2019,5,SS 12 tra Fiumalbo e Abetone,2068,00,2011,57,1550,518,2068,0
2019/03,6,16/03/2019,6,SS 12 tra Fiumalbo e Abetone,2751,00,2727,24,2119,632,0,2751
2019/03,6,17/03/2019,7,SS 12 tra Fiumalbo e Abetone,2443,00,2437,6,2069,374,0,2443
2019/03,6,18/03/2019,1,SS 12 tra Fiumalbo e Abetone,1188,00,1149,39,1025,163,1188,0
2019/03,6,19/03/2019,2,SS 12 tra Fiumalbo e Abetone,1116,00,1070,46,956,160,1116,0
2019/03,6,20/03/2019,3,SS 12 tra Fiumalbo e Abetone,1200,00,1174,26,994,206,1200,0
2019/03,6,21/03/2019,4,SS 12 tra Fiumalbo e Abetone,1464,00,1413,51,1229,235,1464,0
2019/03,6,22/03/2019,5,SS 12 tra Fiumalbo e Abetone,1807,00,1752,55,1395,412,1807,0
2019/03,6,23/03/2019,6,SS 12 tra Fiumalbo e Abetone,2517,00,2502,15,1912,605,0,2517
2019/03,6,24/03/2019,7,SS 12 tra Fiumalbo e Abetone,2385,00,2380,5,1984,401,0,2385
2019/03,6,25/03/2019,1,SS 12 tra Fiumalbo e Abetone,1267,00,1206,61,1100,167,1267,0
2019/03,6,26/03/2019,2,SS 12 tra Fiumalbo e Abetone,1132,00,1090,42,960,172,1132,0
2019/03,6,27/03/2019,3,SS 12 tra Fiumalbo e Abetone,1209,00,1178,31,1025,184,1209,0
2019/03,6,28/03/2019,4,SS 12 tra Fiumalbo e Abetone,1433,00,1395,38,1172,261,1433,0
2019/03,7,15/03/2019,5,SS 64 tra Porretta Terme e Sambuca Pistoiese,7335,00,7114,221,5791,1544,7335,0
2019/03,7,16/03/2019,6,SS 64 tra Porretta Terme e Sambuca Pistoiese,7721,00,7637,84,6267,1454,0,7721
2019/03,7,17/03/2019,7,SS 64 tra Porretta Terme e Sambuca Pistoiese,6247,00,6215,32,5050,1197,0,6247
2019/03,7,18/03/2019,1,SS 64 tra Porretta Terme e Sambuca Pistoiese,6601,00,6397,204,5500,1101,6601,0
2019/03,7,19/03/2019,2,SS 64 tra Porretta Terme e Sambuca Pistoiese,6693,00,6520,173,5482,1211,6693,0
2019/03,7,20/03/2019,3,SS 64 tra Porretta Terme e Sambuca Pistoiese,6454,20,6229,223,5261,1193,6454,0
2019/03,7,21/03/2019,4,SS 64 tra Porretta Terme e Sambuca Pistoiese,6751,10,6557,193,5530,1221,6751,0
2019/03,7,22/03/2019,5,SS 64 tra Porretta Terme e Sambuca Pistoiese,7354,10,7128,225,5941,1413,7354,0
2019/03,7,23/03/2019,6,SS 64 tra Porretta Terme e Sambuca Pistoiese,7822,00,7709,113,6244,1578,0,7822
2019/03,7,24/03/2019,7,SS 64 tra Porretta Terme e Sambuca Pistoiese,6721,10,6693,27,5441,1280,0,6721
2019/03,7,25/03/2019,1,SS 64 tra Porretta Terme e Sambuca Pistoiese,6709,30,6501,205,5551,1158,6709,0
2019/03,7,26/03/2019,2,SS 64 tra Porretta Terme e Sambuca Pistoiese,6528,00,6333,195,5346,1182,6528,0
2019/03,7,27/03/2019,3,SS 64 tra Porretta Terme e Sambuca Pistoiese,6615,10,6382,232,5373,1242,6615,0
2019/03,7,28/03/2019,4,SS 64 tra Porretta Terme e Sambuca Pistoiese,6646,00,6424,222,5359,1287,6646,0
2019/03,9,15/03/2019,5,SS 67 tra Rocca San Casciano e Portico San Benedetto,1352,00,1262,90,1077,275,1352,0
2019/03,9,16/03/2019,6,SS 67 tra Rocca San Casciano e Portico San Benedetto,1292,00,1271,21,1027,265,0,1292
2019/03,9,17/03/2019,7,SS 67 tra Rocca San Casciano e Portico San Benedetto,1454,10,1446,7,1261,193,0,1454
2019/03,9,18/03/2019,1,SS 67 tra Rocca San Casciano e Portico San Benedetto,1133,00,1062,71,929,204,1133,0
2019/03,9,19/03/2019,2,SS 67 tra Rocca San Casciano e Portico San Benedetto,1109,00,1034,75,915,194,1109,0
2019/03,9,20/03/2019,3,SS 67 tra Rocca San Casciano e Portico San Benedetto,1183,00,1103,80,954,229,1183,0
2019/03,9,21/03/2019,4,SS 67 tra Rocca San Casciano e Portico San Benedetto,1248,00,1156,92,1016,232,1248,0
2019/03,9,22/03/2019,5,SS 67 tra Rocca San Casciano e Portico San Benedetto,1233,20,1149,82,997,236,1233,0
2019/03,9,23/03/2019,6,SS 67 tra Rocca San Casciano e Portico San Benedetto,1367,00,1328,39,1071,296,0,1367
2019/03,9,24/03/2019,7,SS 67 tra Rocca San Casciano e Portico San Benedetto,1512,00,1503,9,1264,248,0,1512
2019/03,9,25/03/2019,1,SS 67 tra Rocca San Casciano e Portico San Benedetto,1201,00,1120,81,988,213,1201,0
2019/03,9,26/03/2019,2,SS 67 tra Rocca San Casciano e Portico San Benedetto,1110,00,1033,77,905,205,1110,0
2019/03,9,27/03/2019,3,SS 67 tra Rocca San Casciano e Portico San Benedetto,1184,00,1123,61,965,219,1184,0
2019/03,9,28/03/2019,4,SS 67 tra Rocca San Casciano e Portico San Benedetto,1216,00,1155,61,986,230,1216,0
2019/03,12,15/03/2019,5,SS 16 al Confine regionale (Marche),17288,00,16601,687,13170,4118,17288,0
2019/03,12,16/03/2019,6,SS 16 al Confine regionale (Marche),16215,00,15954,261,11530,4685,0,16215
2019/03,12,17/03/2019,7,SS 16 al Confine regionale (Marche),15199,10,15090,108,11153,4046,0,15199
2019/03,12,18/03/2019,1,SS 16 al Confine regionale (Marche),15150,10,14483,666,12065,3085,15150,0
2019/03,12,19/03/2019,2,SS 16 al Confine regionale (Marche),15198,00,14556,642,12048,3150,15198,0
2019/03,12,20/03/2019,3,SS 16 al Confine regionale (Marche),15734,10,15038,695,12388,3346,15734,0
2019/03,12,21/03/2019,4,SS 16 al Confine regionale (Marche),16095,10,15345,749,12582,3513,16095,0
2019/03,12,22/03/2019,5,SS 16 al Confine regionale (Marche),16763,10,16056,706,12806,3957,16763,0
2019/03,12,23/03/2019,6,SS 16 al Confine regionale (Marche),15930,10,15668,261,11432,4498,0,15930
2019/03,12,24/03/2019,7,SS 16 al Confine regionale (Marche),15315,10,15244,70,11183,4132,0,15315
2019/03,12,25/03/2019,1,SS 16 al Confine regionale (Marche),15468,00,14811,657,12188,3280,15468,0
2019/03,12,26/03/2019,2,SS 16 al Confine regionale (Marche),15535,10,14784,750,12341,3194,15535,0
2019/03,12,27/03/2019,3,SS 16 al Confine regionale (Marche),15601,00,14884,717,12244,3357,15601,0
2019/03,12,28/03/2019,4,SS 16 al Confine regionale (Marche),16147,00,15445,702,12669,3478,16147,0
2019/03,16,15/03/2019,5,SP 69 in località Pilastri al Confine regionale,1590,00,1439,151,1285,305,1590,0
2019/03,16,16/03/2019,6,SP 69 in località Pilastri al Confine regionale,1356,00,1324,32,991,365,0,1356
2019/03,16,17/03/2019,7,SP 69 in località Pilastri al Confine regionale,1437,00,1422,15,1021,416,0,1437
2019/03,16,18/03/2019,1,SP 69 in località Pilastri al Confine regionale,1562,00,1396,166,1290,272,1562,0
2019/03,16,19/03/2019,2,SP 69 in località Pilastri al Confine regionale,1594,00,1403,191,1280,314,1594,0
2019/03,16,20/03/2019,3,SP 69 in località Pilastri al Confine regionale,1541,10,1385,155,1229,312,1541,0
2019/03,16,21/03/2019,4,SP 69 in località Pilastri al Confine regionale,1568,00,1434,134,1258,310,1568,0
2019/03,16,22/03/2019,5,SP 69 in località Pilastri al Confine regionale,1692,00,1530,162,1296,396,1692,0
2019/03,16,23/03/2019,6,SP 69 in località Pilastri al Confine regionale,1456,00,1415,41,1097,359,0,1456
2019/03,16,24/03/2019,7,SP 69 in località Pilastri al Confine regionale,1567,00,1555,12,1099,468,0,1567
2019/03,16,25/03/2019,1,SP 69 in località Pilastri al Confine regionale,1618,00,1460,158,1273,345,1618,0
2019/03,16,26/03/2019,2,SP 69 in località Pilastri al Confine regionale,1668,10,1461,206,1380,288,1668,0
2019/03,16,27/03/2019,3,SP 69 in località Pilastri al Confine regionale,1633,00,1479,154,1296,337,1633,0
2019/03,16,28/03/2019,4,SP 69 in località Pilastri al Confine regionale,1602,00,1431,171,1298,304,1602,0
2019/03,17,15/03/2019,5,SS 12 al Confine regionale (Lombardia),11338,00,10241,1097,8596,2742,11338,0
2019/03,17,16/03/2019,6,SS 12 al Confine regionale (Lombardia),9410,00,9205,205,6833,2577,0,9410
2019/03,17,17/03/2019,7,SS 12 al Confine regionale (Lombardia),6848,00,6783,65,4863,1985,0,6848
2019/03,17,18/03/2019,1,SS 12 al Confine regionale (Lombardia),10764,00,9662,1102,8617,2147,10764,0
2019/03,17,19/03/2019,2,SS 12 al Confine regionale (Lombardia),10988,00,9789,1199,8621,2367,10988,0
2019/03,17,20/03/2019,3,SS 12 al Confine regionale (Lombardia),10752,00,9668,1084,8406,2346,10752,0
2019/03,17,21/03/2019,4,SS 12 al Confine regionale (Lombardia),11141,00,10006,1135,8649,2492,11141,0
2019/03,17,22/03/2019,5,SS 12 al Confine regionale (Lombardia),11402,00,10251,1151,8611,2791,11402,0
2019/03,17,23/03/2019,6,SS 12 al Confine regionale (Lombardia),9583,00,9352,231,6715,2868,0,9583
2019/03,17,24/03/2019,7,SS 12 al Confine regionale (Lombardia),7243,00,7192,51,4889,2354,0,7243
2019/03,17,25/03/2019,1,SS 12 al Confine regionale (Lombardia),10822,00,9727,1095,8567,2255,10822,0
2019/03,17,26/03/2019,2,SS 12 al Confine regionale (Lombardia),11052,00,9881,1171,8679,2373,11052,0
2019/03,17,27/03/2019,3,SS 12 al Confine regionale (Lombardia),11076,00,9859,1217,8635,2441,11076,0
2019/03,17,28/03/2019,4,SS 12 al Confine regionale (Lombardia),10976,00,9889,1087,8417,2559,10976,0
2019/03,19,15/03/2019,5,SP 343R tra Colorno e Casalmaggiore,1054,00,942,112,843,211,1054,0
2019/03,19,16/03/2019,6,SP 343R tra Colorno e Casalmaggiore,799,00,782,17,644,155,0,799
2019/03,19,17/03/2019,7,SP 343R tra Colorno e Casalmaggiore,824,00,816,8,702,122,0,824
2019/03,19,18/03/2019,1,SP 343R tra Colorno e Casalmaggiore,1050,00,945,105,906,144,1050,0
2019/03,19,19/03/2019,2,SP 343R tra Colorno e Casalmaggiore,1004,00,862,142,828,176,1004,0
2019/03,19,20/03/2019,3,SP 343R tra Colorno e Casalmaggiore,1023,00,935,88,861,162,1023,0
2019/03,19,21/03/2019,4,SP 343R tra Colorno e Casalmaggiore,943,00,871,72,787,156,943,0
2019/03,19,22/03/2019,5,SP 343R tra Colorno e Casalmaggiore,1026,00,930,96,826,200,1026,0
2019/03,19,23/03/2019,6,SP 343R tra Colorno e Casalmaggiore,815,00,788,27,666,149,0,815
2019/03,19,24/03/2019,7,SP 343R tra Colorno e Casalmaggiore,707,00,699,8,585,122,0,707
2019/03,19,25/03/2019,1,SP 343R tra Colorno e Casalmaggiore,1036,00,948,88,856,180,1036,0
2019/03,19,26/03/2019,2,SP 343R tra Colorno e Casalmaggiore,914,00,842,72,751,163,914,0
2019/03,19,27/03/2019,3,SP 343R tra Colorno e Casalmaggiore,966,00,878,88,784,182,966,0
2019/03,19,28/03/2019,4,SP 343R tra Colorno e Casalmaggiore,1175,00,1043,132,969,206,1175,0
2019/03,25,15/03/2019,5,SS 9 tra San Prospero (Case Crostolo) e Sant'Ilario d'Enza,33417,40,31091,2322,23855,9562,33417,0
2019/03,25,16/03/2019,6,SS 9 tra San Prospero (Case Crostolo) e Sant'Ilario d'Enza,33792,20,32983,807,22459,11333,0,33792
2019/03,25,17/03/2019,7,SS 9 tra San Prospero (Case Crostolo) e Sant'Ilario d'Enza,29099,10,28835,263,19140,9959,0,29099
2019/03,25,18/03/2019,1,SS 9 tra San Prospero (Case Crostolo) e Sant'Ilario d'Enza,32874,130,29847,3014,24514,8360,32874,0
2019/03,25,19/03/2019,2,SS 9 tra San Prospero (Case Crostolo) e Sant'Ilario d'Enza,33428,70,30374,3047,24814,8614,33428,0
2019/03,25,20/03/2019,3,SS 9 tra San Prospero (Case Crostolo) e Sant'Ilario d'Enza,31594,160,28161,3417,22699,8895,31594,0
2019/03,25,21/03/2019,4,SS 9 tra San Prospero (Case Crostolo) e Sant'Ilario d'Enza,34223,70,31153,3063,24802,9421,34223,0
2019/03,25,22/03/2019,5,SS 9 tra San Prospero (Case Crostolo) e Sant'Ilario d'Enza,35137,130,32041,3083,25012,10125,35137,0
2019/03,25,23/03/2019,6,SS 9 tra San Prospero (Case Crostolo) e Sant'Ilario d'Enza,33186,20,32324,860,22540,10646,0,33186
2019/03,25,24/03/2019,7,SS 9 tra San Prospero (Case Crostolo) e Sant'Ilario d'Enza,27510,30,27301,206,18401,9109,0,27510
2019/03,25,25/03/2019,1,SS 9 tra San Prospero (Case Crostolo) e Sant'Ilario d'Enza,30642,40,28261,2377,23090,7552,30642,0
2019/03,25,26/03/2019,2,SS 9 tra San Prospero (Case Crostolo) e Sant'Ilario d'Enza,31011,80,28620,2383,23213,7798,31011,0
2019/03,25,27/03/2019,3,SS 9 tra San Prospero (Case Crostolo) e Sant'Ilario d'Enza,31310,00,29104,2206,23396,7914,31310,0
2019/03,25,28/03/2019,4,SS 9 tra San Prospero (Case Crostolo) e Sant'Ilario d'Enza,32949,120,30281,2656,24591,8358,32949,0
2019/03,29,15/03/2019,5,SS 9 tra Modena e Rubiera,26579,30,24120,2456,19111,7468,26579,0
2019/03,29,16/03/2019,6,SS 9 tra Modena e Rubiera,25488,00,24996,492,16897,8591,0,25488
2019/03,29,17/03/2019,7,SS 9 tra Modena e Rubiera,23618,00,23468,150,15823,7795,0,23618
2019/03,29,18/03/2019,1,SS 9 tra Modena e Rubiera,25767,30,23179,2585,19760,6007,25767,0
2019/03,29,19/03/2019,2,SS 9 tra Modena e Rubiera,25518,10,22896,2621,19138,6380,25518,0
2019/03,29,20/03/2019,3,SS 9 tra Modena e Rubiera,25766,10,23078,2687,19273,6493,25766,0
2019/03,29,21/03/2019,4,SS 9 tra Modena e Rubiera,25839,30,23103,2733,19240,6599,25839,0
2019/03,29,22/03/2019,5,SS 9 tra Modena e Rubiera,26124,50,23583,2536,18598,7526,26124,0
2019/03,29,23/03/2019,6,SS 9 tra Modena e Rubiera,24856,00,24429,427,16519,8337,0,24856
2019/03,29,24/03/2019,7,SS 9 tra Modena e Rubiera,23414,30,23263,148,15855,7559,0,23414
2019/03,29,25/03/2019,1,SS 9 tra Modena e Rubiera,24372,10,21899,2472,18332,6040,24372,0
2019/03,29,26/03/2019,2,SS 9 tra Modena e Rubiera,24843,40,22341,2498,19075,5768,24843,0
2019/03,29,27/03/2019,3,SS 9 tra Modena e Rubiera,24800,40,22189,2607,18456,6344,24800,0
2019/03,29,28/03/2019,4,SS 9 tra Modena e Rubiera,25726,30,23047,2676,18853,6873,25726,0
2019/03,52,15/03/2019,5,SP 253 tra Sesto Imolese e Medicina,6988,00,6241,747,5164,1824,6988,0
2019/03,52,16/03/2019,6,SP 253 tra Sesto Imolese e Medicina,5418,00,5251,167,3921,1497,0,5418
2019/03,52,17/03/2019,7,SP 253 tra Sesto Imolese e Medicina,5011,00,4961,50,3655,1356,0,5011
2019/03,52,18/03/2019,1,SP 253 tra Sesto Imolese e Medicina,6374,00,5686,688,4982,1392,6374,0
2019/03,52,19/03/2019,2,SP 253 tra Sesto Imolese e Medicina,6294,00,5635,659,4845,1449,6294,0
2019/03,52,20/03/2019,3,SP 253 tra Sesto Imolese e Medicina,6395,00,5722,673,4957,1438,6395,0
2019/03,52,21/03/2019,4,SP 253 tra Sesto Imolese e Medicina,6461,00,5747,714,5027,1434,6461,0
2019/03,52,22/03/2019,5,SP 253 tra Sesto Imolese e Medicina,6867,00,6126,741,5237,1630,6867,0
2019/03,52,23/03/2019,6,SP 253 tra Sesto Imolese e Medicina,5417,00,5258,159,4042,1375,0,5417
2019/03,52,24/03/2019,7,SP 253 tra Sesto Imolese e Medicina,5252,10,5201,50,3685,1567,0,5252
2019/03,52,25/03/2019,1,SP 253 tra Sesto Imolese e Medicina,6382,00,5691,691,4962,1420,6382,0
2019/03,52,26/03/2019,2,SP 253 tra Sesto Imolese e Medicina,6443,10,5760,682,5035,1408,6443,0
2019/03,52,27/03/2019,3,SP 253 tra Sesto Imolese e Medicina,6484,00,5829,655,5036,1448,6484,0
2019/03,52,28/03/2019,4,SP 253 tra Sesto Imolese e Medicina,6507,00,5719,788,5130,1377,6507,0
2019/03,53,15/03/2019,5,SS 309 a San Giuseppe di Comacchio,11089,10,7652,3436,8421,2668,11089,0
2019/03,53,16/03/2019,6,SS 309 a San Giuseppe di Comacchio,9232,00,8352,880,6757,2475,0,9232
2019/03,53,17/03/2019,7,SS 309 a San Giuseppe di Comacchio,10907,00,10534,373,8455,2452,0,10907
2019/03,53,18/03/2019,1,SS 309 a San Giuseppe di Comacchio,9692,00,6244,3448,7457,2235,9692,0
2019/03,53,19/03/2019,2,SS 309 a San Giuseppe di Comacchio,10261,00,6363,3898,7984,2277,10261,0
2019/03,53,20/03/2019,3,SS 309 a San Giuseppe di Comacchio,10176,00,6333,3843,7896,2280,10176,0
2019/03,53,21/03/2019,4,SS 309 a San Giuseppe di Comacchio,10442,10,6510,3931,8086,2356,10442,0
2019/03,53,22/03/2019,5,SS 309 a San Giuseppe di Comacchio,10754,10,7398,3355,8213,2541,10754,0
2019/03,53,23/03/2019,6,SS 309 a San Giuseppe di Comacchio,9319,00,8396,923,6780,2539,0,9319
2019/03,53,24/03/2019,7,SS 309 a San Giuseppe di Comacchio,11332,00,10962,370,8544,2788,0,11332
2019/03,53,25/03/2019,1,SS 309 a San Giuseppe di Comacchio,10172,00,6659,3513,7819,2353,10172,0
2019/03,53,26/03/2019,2,SS 309 a San Giuseppe di Comacchio,10438,00,6515,3923,8185,2253,10438,0
2019/03,53,27/03/2019,3,SS 309 a San Giuseppe di Comacchio,10511,20,6587,3922,8096,2415,10511,0
2019/03,53,28/03/2019,4,SS 309 a San Giuseppe di Comacchio,10736,00,7019,3717,8337,2399,10736,0
2019/03,95,15/03/2019,5,SP 10R tra Castel San Giovanni e Sarmato,,,,,,,,
2019/03,95,16/03/2019,6,SP 10R tra Castel San Giovanni e Sarmato,,,,,,,,
2019/03,95,17/03/2019,7,SP 10R tra Castel San Giovanni e Sarmato,,,,,,,,
2019/03,95,18/03/2019,1,SP 10R tra Castel San Giovanni e Sarmato,,,,,,,,
2019/03,95,19/03/2019,2,SP 10R tra Castel San Giovanni e Sarmato,,,,,,,,
2019/03,95,20/03/2019,3,SP 10R tra Castel San Giovanni e Sarmato,,,,,,,,
2019/03,95,21/03/2019,4,SP 10R tra Castel San Giovanni e Sarmato,,,,,,,,
2019/03,95,22/03/2019,5,SP 10R tra Castel San Giovanni e Sarmato,,,,,,,,
2019/03,95,23/03/2019,6,SP 10R tra Castel San Giovanni e Sarmato,,,,,,,,
2019/03,95,24/03/2019,7,SP 10R tra Castel San Giovanni e Sarmato,,,,,,,,
2019/03,95,25/03/2019,1,SP 10R tra Castel San Giovanni e Sarmato,,,,,,,,
2019/03,95,26/03/2019,2,SP 10R tra Castel San Giovanni e Sarmato,,,,,,,,
2019/03,95,27/03/2019,3,SP 10R tra Castel San Giovanni e Sarmato,,,,,,,,
2019/03,95,28/03/2019,4,SP 10R tra Castel San Giovanni e Sarmato,,,,,,,,
2019/03,98,15/03/2019,5,SP 302R tra Brisighella e Marradi,3324,00,3185,139,2501,823,3324,0
2019/03,98,16/03/2019,6,SP 302R tra Brisighella e Marradi,3238,00,3203,35,2424,814,0,3238
2019/03,98,17/03/2019,7,SP 302R tra Brisighella e Marradi,3445,00,3436,9,2781,664,0,3445
2019/03,98,18/03/2019,1,SP 302R tra Brisighella e Marradi,3058,00,2958,100,2416,642,3058,0
2019/03,98,19/03/2019,2,SP 302R tra Brisighella e Marradi,3159,00,3057,102,2502,657,3159,0
2019/03,98,20/03/2019,3,SP 302R tra Brisighella e Marradi,3068,00,2973,95,2400,668,3068,0
2019/03,98,21/03/2019,4,SP 302R tra Brisighella e Marradi,3041,00,2932,109,2312,729,3041,0
2019/03,98,22/03/2019,5,SP 302R tra Brisighella e Marradi,3341,00,3259,82,2504,837,3341,0
2019/03,98,23/03/2019,6,SP 302R tra Brisighella e Marradi,3229,10,3200,28,2418,811,0,3229
2019/03,98,24/03/2019,7,SP 302R tra Brisighella e Marradi,3391,00,3382,9,2701,690,0,3391
2019/03,98,25/03/2019,1,SP 302R tra Brisighella e Marradi,3070,20,2952,116,2406,664,3070,0
2019/03,98,26/03/2019,2,SP 302R tra Brisighella e Marradi,3103,00,2988,115,2425,678,3103,0
2019/03,98,27/03/2019,3,SP 302R tra Brisighella e Marradi,3189,00,3065,124,2449,740,3189,0
2019/03,98,28/03/2019,4,SP 302R tra Brisighella e Marradi,3142,00,3009,133,2433,709,3142,0
2019/03,100,15/03/2019,5,SP 258R tra Villa Verucchio ed ex Confine regionale (località Dogana),16331,00,14936,1395,12789,3542,16331,0
2019/03,100,16/03/2019,6,SP 258R tra Villa Verucchio ed ex Confine regionale (località Dogana),14629,00,14258,371,10931,3698,0,14629
2019/03,100,17/03/2019,7,SP 258R tra Villa Verucchio ed ex Confine regionale (località Dogana),13630,00,13543,87,10472,3158,0,13630
2019/03,100,18/03/2019,1,SP 258R tra Villa Verucchio ed ex Confine regionale (località Dogana),14768,00,13406,1362,11850,2918,14768,0
2019/03,100,19/03/2019,2,SP 258R tra Villa Verucchio ed ex Confine regionale (località Dogana),15101,00,13790,1311,12084,3017,15101,0
2019/03,100,20/03/2019,3,SP 258R tra Villa Verucchio ed ex Confine regionale (località Dogana),15556,00,14041,1515,12384,3172,15556,0
2019/03,100,21/03/2019,4,SP 258R tra Villa Verucchio ed ex Confine regionale (località Dogana),15464,00,14064,1400,12337,3127,15464,0
2019/03,100,22/03/2019,5,SP 258R tra Villa Verucchio ed ex Confine regionale (località Dogana),16195,10,14845,1349,12773,3422,16195,0
2019/03,100,23/03/2019,6,SP 258R tra Villa Verucchio ed ex Confine regionale (località Dogana),14211,00,13876,335,10632,3579,0,14211
2019/03,100,24/03/2019,7,SP 258R tra Villa Verucchio ed ex Confine regionale (località Dogana),13657,00,13569,88,10429,3228,0,13657
2019/03,100,25/03/2019,1,SP 258R tra Villa Verucchio ed ex Confine regionale (località Dogana),14676,00,13603,1073,11664,3012,14676,0
2019/03,100,26/03/2019,2,SP 258R tra Villa Verucchio ed ex Confine regionale (località Dogana),14726,00,13384,1342,11896,2830,14726,0
2019/03,100,27/03/2019,3,SP 258R tra Villa Verucchio ed ex Confine regionale (località Dogana),15530,00,14178,1352,12412,3118,15530,0
2019/03,100,28/03/2019,4,SP 258R tra Villa Verucchio ed ex Confine regionale (località Dogana),15464,00,13983,1481,12134,3330,15464,0
2019/03,104,15/03/2019,5,SP 10 nuovo ponte sul Po tra innesto variante Zibello e confine regionale (Lombardia),4886,00,3645,1241,3763,1123,4886,0
2019/03,104,16/03/2019,6,SP 10 nuovo ponte sul Po tra innesto variante Zibello e confine regionale (Lombardia),3860,00,3619,241,2865,995,0,3860
2019/03,104,17/03/2019,7,SP 10 nuovo ponte sul Po tra innesto variante Zibello e confine regionale (Lombardia),4093,00,4013,80,3070,1023,0,4093
2019/03,104,18/03/2019,1,SP 10 nuovo ponte sul Po tra innesto variante Zibello e confine regionale (Lombardia),4783,00,3515,1268,3811,972,4783,0
2019/03,104,19/03/2019,2,SP 10 nuovo ponte sul Po tra innesto variante Zibello e confine regionale (Lombardia),4740,10,3403,1336,3773,967,4740,0
2019/03,104,20/03/2019,3,SP 10 nuovo ponte sul Po tra innesto variante Zibello e confine regionale (Lombardia),4941,00,3531,1410,3936,1005,4941,0
2019/03,104,21/03/2019,4,SP 10 nuovo ponte sul Po tra innesto variante Zibello e confine regionale (Lombardia),4986,00,3610,1376,3933,1053,4986,0
2019/03,104,22/03/2019,5,SP 10 nuovo ponte sul Po tra innesto variante Zibello e confine regionale (Lombardia),5264,00,3969,1295,4026,1238,5264,0
2019/03,104,23/03/2019,6,SP 10 nuovo ponte sul Po tra innesto variante Zibello e confine regionale (Lombardia),3714,10,3432,281,2751,963,0,3714
2019/03,104,24/03/2019,7,SP 10 nuovo ponte sul Po tra innesto variante Zibello e confine regionale (Lombardia),4348,10,4276,71,3136,1212,0,4348
2019/03,104,25/03/2019,1,SP 10 nuovo ponte sul Po tra innesto variante Zibello e confine regionale (Lombardia),4691,00,3373,1318,3754,937,4691,0
2019/03,104,26/03/2019,2,SP 10 nuovo ponte sul Po tra innesto variante Zibello e confine regionale (Lombardia),4958,20,3505,1451,4012,946,4958,0
2019/03,104,27/03/2019,3,SP 10 nuovo ponte sul Po tra innesto variante Zibello e confine regionale (Lombardia),4755,00,3441,1314,3785,970,4755,0
2019/03,104,28/03/2019,4,SP 10 nuovo ponte sul Po tra innesto variante Zibello e confine regionale (Lombardia),5463,10,4120,1342,4459,1004,5463,0
2019/03,107,15/03/2019,5,SP 85 tra Rubiera e bivio SP 13MO (c/o Campogalliano),9684,00,8684,1000,7484,2200,9684,0
2019/03,107,16/03/2019,6,SP 85 tra Rubiera e bivio SP 13MO (c/o Campogalliano),8356,00,8217,139,5962,2394,0,8356
2019/03,107,17/03/2019,7,SP 85 tra Rubiera e bivio SP 13MO (c/o Campogalliano),7307,00,7268,39,5355,1952,0,7307
2019/03,107,18/03/2019,1,SP 85 tra Rubiera e bivio SP 13MO (c/o Campogalliano),9093,00,8103,990,7249,1844,9093,0
2019/03,107,19/03/2019,2,SP 85 tra Rubiera e bivio SP 13MO (c/o Campogalliano),9517,00,8426,1091,7516,2001,9517,0
2019/03,107,20/03/2019,3,SP 85 tra Rubiera e bivio SP 13MO (c/o Campogalliano),9301,00,8210,1091,7259,2042,9301,0
2019/03,107,21/03/2019,4,SP 85 tra Rubiera e bivio SP 13MO (c/o Campogalliano),9364,00,8335,1029,7223,2141,9364,0
2019/03,107,22/03/2019,5,SP 85 tra Rubiera e bivio SP 13MO (c/o Campogalliano),9726,00,8676,1050,7489,2237,9726,0
2019/03,107,23/03/2019,6,SP 85 tra Rubiera e bivio SP 13MO (c/o Campogalliano),8464,00,8290,174,6122,2342,0,8464
2019/03,107,24/03/2019,7,SP 85 tra Rubiera e bivio SP 13MO (c/o Campogalliano),7228,10,7170,57,5271,1957,0,7228
2019/03,107,25/03/2019,1,SP 85 tra Rubiera e bivio SP 13MO (c/o Campogalliano),8920,00,7975,945,7055,1865,8920,0
2019/03,107,26/03/2019,2,SP 85 tra Rubiera e bivio SP 13MO (c/o Campogalliano),9260,00,8297,963,7373,1887,9260,0
2019/03,107,27/03/2019,3,SP 85 tra Rubiera e bivio SP 13MO (c/o Campogalliano),9475,00,8331,1144,7444,2031,9475,0
2019/03,107,28/03/2019,4,SP 85 tra Rubiera e bivio SP 13MO (c/o Campogalliano),9885,10,8726,1158,7640,2245,9885,0
2019/03,108,15/03/2019,5,SP 412R tra Castel San Giovanni (Casello A 21) e ponte fiume Po,12724,20,12356,366,9462,3262,12724,0
2019/03,108,16/03/2019,6,SP 412R tra Castel San Giovanni (Casello A 21) e ponte fiume Po,11899,30,11746,150,9124,2775,0,11899
2019/03,108,17/03/2019,7,SP 412R tra Castel San Giovanni (Casello A 21) e ponte fiume Po,11324,00,11262,62,8798,2526,0,11324
2019/03,108,18/03/2019,1,SP 412R tra Castel San Giovanni (Casello A 21) e ponte fiume Po,11690,60,11348,336,8836,2854,11690,0
2019/03,108,19/03/2019,2,SP 412R tra Castel San Giovanni (Casello A 21) e ponte fiume Po,12172,170,11699,456,9090,3082,12172,0
2019/03,108,20/03/2019,3,SP 412R tra Castel San Giovanni (Casello A 21) e ponte fiume Po,12399,170,11962,420,9244,3155,12399,0
2019/03,108,21/03/2019,4,SP 412R tra Castel San Giovanni (Casello A 21) e ponte fiume Po,12400,140,11972,414,9273,3127,12400,0
2019/03,108,22/03/2019,5,SP 412R tra Castel San Giovanni (Casello A 21) e ponte fiume Po,13085,170,12709,359,9623,3462,13085,0
2019/03,108,23/03/2019,6,SP 412R tra Castel San Giovanni (Casello A 21) e ponte fiume Po,12304,70,12147,150,9307,2997,0,12304
2019/03,108,24/03/2019,7,SP 412R tra Castel San Giovanni (Casello A 21) e ponte fiume Po,13680,00,13625,55,10737,2943,0,13680
2019/03,108,25/03/2019,1,SP 412R tra Castel San Giovanni (Casello A 21) e ponte fiume Po,11692,60,11318,368,8695,2997,11692,0
2019/03,108,26/03/2019,2,SP 412R tra Castel San Giovanni (Casello A 21) e ponte fiume Po,12820,110,12348,461,9727,3093,12820,0
2019/03,108,27/03/2019,3,SP 412R tra Castel San Giovanni (Casello A 21) e ponte fiume Po,12499,90,12100,390,9397,3102,12499,0
2019/03,108,28/03/2019,4,SP 412R tra Castel San Giovanni (Casello A 21) e ponte fiume Po,12789,170,12362,410,9475,3314,12789,0
2019/03,112,15/03/2019,5,SP 111 tra Boretto e Viadana sul ponte Po,22246,80,19614,2624,16627,5619,22246,0
2019/03,112,16/03/2019,6,SP 111 tra Boretto e Viadana sul ponte Po,19784,10,19203,580,14478,5306,0,19784
2019/03,112,17/03/2019,7,SP 111 tra Boretto e Viadana sul ponte Po,16551,00,16383,168,12055,4496,0,16551
2019/03,112,18/03/2019,1,SP 111 tra Boretto e Viadana sul ponte Po,20451,10,17730,2720,15697,4754,20451,0
2019/03,112,19/03/2019,2,SP 111 tra Boretto e Viadana sul ponte Po,20471,10,17694,2776,15836,4635,20471,0
2019/03,112,20/03/2019,3,SP 111 tra Boretto e Viadana sul ponte Po,21015,50,18082,2928,16068,4947,21015,0
2019/03,112,21/03/2019,4,SP 111 tra Boretto e Viadana sul ponte Po,21205,10,18184,3020,16286,4919,21205,0
2019/03,112,22/03/2019,5,SP 111 tra Boretto e Viadana sul ponte Po,22447,30,19665,2779,17051,5396,22447,0
2019/03,112,23/03/2019,6,SP 111 tra Boretto e Viadana sul ponte Po,20007,10,19471,535,14555,5452,0,20007
2019/03,112,24/03/2019,7,SP 111 tra Boretto e Viadana sul ponte Po,17238,10,17048,189,12341,4897,0,17238
2019/03,112,25/03/2019,1,SP 111 tra Boretto e Viadana sul ponte Po,20216,60,17434,2776,15758,4458,20216,0
2019/03,112,26/03/2019,2,SP 111 tra Boretto e Viadana sul ponte Po,20781,30,17819,2959,16052,4729,20781,0
2019/03,112,27/03/2019,3,SP 111 tra Boretto e Viadana sul ponte Po,20859,40,18066,2789,16075,4784,20859,0
2019/03,112,28/03/2019,4,SP 111 tra Boretto e Viadana sul ponte Po,21495,30,18510,2982,16614,4881,21495,0
2019/03,115,15/03/2019,5,SP 68 ad Ariano Polesine al Confine regionale (Veneto),2928,00,2595,333,2253,675,2928,0
2019/03,115,16/03/2019,6,SP 68 ad Ariano Polesine al Confine regionale (Veneto),2660,00,2580,80,1956,704,0,2660
2019/03,115,17/03/2019,7,SP 68 ad Ariano Polesine al Confine regionale (Veneto),2386,00,2364,22,1713,673,0,2386
2019/03,115,18/03/2019,1,SP 68 ad Ariano Polesine al Confine regionale (Veneto),2726,00,2449,277,2181,545,2726,0
2019/03,115,19/03/2019,2,SP 68 ad Ariano Polesine al Confine regionale (Veneto),2628,00,2337,291,2044,584,2628,0
2019/03,115,20/03/2019,3,SP 68 ad Ariano Polesine al Confine regionale (Veneto),2805,00,2487,318,2214,591,2805,0
2019/03,115,21/03/2019,4,SP 68 ad Ariano Polesine al Confine regionale (Veneto),2909,00,2565,344,2250,659,2909,0
2019/03,115,22/03/2019,5,SP 68 ad Ariano Polesine al Confine regionale (Veneto),3043,00,2746,297,2339,704,3043,0
2019/03,115,23/03/2019,6,SP 68 ad Ariano Polesine al Confine regionale (Veneto),2664,00,2575,89,1986,678,0,2664
2019/03,115,24/03/2019,7,SP 68 ad Ariano Polesine al Confine regionale (Veneto),2592,10,2566,25,1858,734,0,2592
2019/03,115,25/03/2019,1,SP 68 ad Ariano Polesine al Confine regionale (Veneto),2950,00,2625,325,2348,602,2950,0
2019/03,115,26/03/2019,2,SP 68 ad Ariano Polesine al Confine regionale (Veneto),2804,10,2465,338,2197,607,2804,0
2019/03,115,27/03/2019,3,SP 68 ad Ariano Polesine al Confine regionale (Veneto),2843,00,2548,295,2244,599,2843,0
2019/03,115,28/03/2019,4,SP 68 ad Ariano Polesine al Confine regionale (Veneto),2911,00,2572,339,2277,634,2911,0
2019/03,116,15/03/2019,5,SP 138 tra SPiero in Bagno (E 45) e Bagno di Romagna,5603,00,5417,186,4507,1096,5603,0
2019/03,116,16/03/2019,6,SP 138 tra SPiero in Bagno (E 45) e Bagno di Romagna,5696,00,5578,118,4374,1322,0,5696
2019/03,116,17/03/2019,7,SP 138 tra SPiero in Bagno (E 45) e Bagno di Romagna,6016,00,5997,19,4957,1059,0,6016
2019/03,116,18/03/2019,1,SP 138 tra SPiero in Bagno (E 45) e Bagno di Romagna,4952,00,4794,158,4161,791,4952,0
2019/03,116,19/03/2019,2,SP 138 tra SPiero in Bagno (E 45) e Bagno di Romagna,5264,00,5090,174,4369,895,5264,0
2019/03,116,20/03/2019,3,SP 138 tra SPiero in Bagno (E 45) e Bagno di Romagna,5253,00,5087,166,4366,887,5253,0
2019/03,116,21/03/2019,4,SP 138 tra SPiero in Bagno (E 45) e Bagno di Romagna,5401,00,5212,189,4333,1068,5401,0
2019/03,116,22/03/2019,5,SP 138 tra SPiero in Bagno (E 45) e Bagno di Romagna,6135,00,5943,192,4819,1316,6135,0
2019/03,116,23/03/2019,6,SP 138 tra SPiero in Bagno (E 45) e Bagno di Romagna,6124,10,6013,110,4573,1551,0,6124
2019/03,116,24/03/2019,7,SP 138 tra SPiero in Bagno (E 45) e Bagno di Romagna,6124,00,6089,35,4912,1212,0,6124
2019/03,116,25/03/2019,1,SP 138 tra SPiero in Bagno (E 45) e Bagno di Romagna,5442,00,5235,207,4513,929,5442,0
2019/03,116,26/03/2019,2,SP 138 tra SPiero in Bagno (E 45) e Bagno di Romagna,5098,00,4907,191,4090,1008,5098,0
2019/03,116,27/03/2019,3,SP 138 tra SPiero in Bagno (E 45) e Bagno di Romagna,5547,00,5291,256,4592,955,5547,0
2019/03,116,28/03/2019,4,SP 138 tra SPiero in Bagno (E 45) e Bagno di Romagna,5546,20,5244,300,4542,1004,5546,0
2019/03,117,15/03/2019,5,SS 63 tra Collagna e Sassalbo (Passo del Cerreto),589,00,553,36,491,98,589,0
2019/03,117,16/03/2019,6,SS 63 tra Collagna e Sassalbo (Passo del Cerreto),752,00,736,16,658,94,0,752
2019/03,117,17/03/2019,7,SS 63 tra Collagna e Sassalbo (Passo del Cerreto),997,00,993,4,865,132,0,997
2019/03,117,18/03/2019,1,SS 63 tra Collagna e Sassalbo (Passo del Cerreto),475,00,439,36,410,65,475,0
2019/03,117,19/03/2019,2,SS 63 tra Collagna e Sassalbo (Passo del Cerreto),432,00,404,28,372,60,432,0
2019/03,117,20/03/2019,3,SS 63 tra Collagna e Sassalbo (Passo del Cerreto),385,00,367,18,329,56,385,0
2019/03,117,21/03/2019,4,SS 63 tra Collagna e Sassalbo (Passo del Cerreto),451,00,425,26,389,62,451,0
2019/03,117,22/03/2019,5,SS 63 tra Collagna e Sassalbo (Passo del Cerreto),500,00,473,27,409,91,500,0
2019/03,117,23/03/2019,6,SS 63 tra Collagna e Sassalbo (Passo del Cerreto),782,00,761,21,652,130,0,782
2019/03,117,24/03/2019,7,SS 63 tra Collagna e Sassalbo (Passo del Cerreto),1136,00,1130,6,895,241,0,1136
2019/03,117,25/03/2019,1,SS 63 tra Collagna e Sassalbo (Passo del Cerreto),466,00,421,45,389,77,466,0
2019/03,117,26/03/2019,2,SS 63 tra Collagna e Sassalbo (Passo del Cerreto),403,00,372,31,343,60,403,0
2019/03,117,27/03/2019,3,SS 63 tra Collagna e Sassalbo (Passo del Cerreto),424,00,401,23,370,54,424,0
2019/03,117,28/03/2019,4,SS 63 tra Collagna e Sassalbo (Passo del Cerreto),505,00,471,34,426,79,505,0
2019/03,118,17/03/2019,7,SS 45 tra Ottone e Gorreto,623,00,623,0,525,98,0,623
2019/03,123,15/03/2019,5,SP 28 tra Piacenza (Tangenziale Sud) e Gossolengo,18325,00,17740,585,14229,4096,18325,0
2019/03,123,16/03/2019,6,SP 28 tra Piacenza (Tangenziale Sud) e Gossolengo,17644,00,17407,237,13754,3890,0,17644
2019/03,123,17/03/2019,7,SP 28 tra Piacenza (Tangenziale Sud) e Gossolengo,12507,00,12463,44,9461,3046,0,12507
2019/03,123,18/03/2019,1,SP 28 tra Piacenza (Tangenziale Sud) e Gossolengo,17084,00,16567,517,13625,3459,17084,0
2019/03,123,19/03/2019,2,SP 28 tra Piacenza (Tangenziale Sud) e Gossolengo,17311,00,16742,569,13766,3545,17311,0
2019/03,123,20/03/2019,3,SP 28 tra Piacenza (Tangenziale Sud) e Gossolengo,17355,00,16855,500,13678,3677,17355,0
2019/03,123,21/03/2019,4,SP 28 tra Piacenza (Tangenziale Sud) e Gossolengo,17899,00,17389,510,14125,3774,17899,0
2019/03,123,22/03/2019,5,SP 28 tra Piacenza (Tangenziale Sud) e Gossolengo,18385,00,17904,481,14262,4123,18385,0
2019/03,123,23/03/2019,6,SP 28 tra Piacenza (Tangenziale Sud) e Gossolengo,17151,00,16948,203,13272,3879,0,17151
2019/03,123,24/03/2019,7,SP 28 tra Piacenza (Tangenziale Sud) e Gossolengo,14301,00,14254,47,11027,3274,0,14301
2019/03,123,25/03/2019,1,SP 28 tra Piacenza (Tangenziale Sud) e Gossolengo,16999,00,16504,495,13673,3326,16999,0
2019/03,123,26/03/2019,2,SP 28 tra Piacenza (Tangenziale Sud) e Gossolengo,17388,00,16842,546,13943,3445,17388,0
2019/03,123,27/03/2019,3,SP 28 tra Piacenza (Tangenziale Sud) e Gossolengo,17532,00,17058,474,13909,3623,17532,0
2019/03,123,28/03/2019,4,SP 28 tra Piacenza (Tangenziale Sud) e Gossolengo,17665,00,17183,482,14034,3631,17665,0
2019/03,124,15/03/2019,5,SS 45 tra Piacenza e Settima,18512,00,17807,705,13972,4540,18512,0
2019/03,124,16/03/2019,6,SS 45 tra Piacenza e Settima,17738,10,17480,257,12985,4753,0,17738
2019/03,124,17/03/2019,7,SS 45 tra Piacenza e Settima,14853,00,14804,49,11206,3647,0,14853
2019/03,124,18/03/2019,1,SS 45 tra Piacenza e Settima,17185,10,16211,973,13496,3689,17185,0
2019/03,124,19/03/2019,2,SS 45 tra Piacenza e Settima,17493,20,16498,993,13741,3752,17493,0
2019/03,124,20/03/2019,3,SS 45 tra Piacenza e Settima,17344,00,16450,894,13557,3787,17344,0
2019/03,124,21/03/2019,4,SS 45 tra Piacenza e Settima,17554,10,16675,878,13646,3908,17554,0
2019/03,124,22/03/2019,5,SS 45 tra Piacenza e Settima,18546,00,17665,881,13980,4566,18546,0
2019/03,124,23/03/2019,6,SS 45 tra Piacenza e Settima,18108,10,17858,249,13301,4807,0,18108
2019/03,124,24/03/2019,7,SS 45 tra Piacenza e Settima,16968,10,16917,50,12876,4092,0,16968
2019/03,124,25/03/2019,1,SS 45 tra Piacenza e Settima,17228,10,16294,933,13621,3607,17228,0
2019/03,124,26/03/2019,2,SS 45 tra Piacenza e Settima,16904,00,16068,836,13351,3553,16904,0
2019/03,124,27/03/2019,3,SS 45 tra Piacenza e Settima,17358,00,16436,922,13630,3728,17358,0
2019/03,124,28/03/2019,4,SS 45 tra Piacenza e Settima,17550,00,16590,960,13726,3824,17550,0
2019/03,125,15/03/2019,5,SP 654R tra Piacenza (Tangenziale Sud) e Turro,25500,10,24333,1166,20151,5349,25500,0
2019/03,125,16/03/2019,6,SP 654R tra Piacenza (Tangenziale Sud) e Turro,20786,10,20463,322,15585,5201,0,20786
2019/03,125,17/03/2019,7,SP 654R tra Piacenza (Tangenziale Sud) e Turro,16051,00,15953,98,12306,3745,0,16051
2019/03,125,18/03/2019,1,SP 654R tra Piacenza (Tangenziale Sud) e Turro,24305,10,23149,1155,19793,4512,24305,0
2019/03,125,19/03/2019,2,SP 654R tra Piacenza (Tangenziale Sud) e Turro,24504,00,23310,1194,19771,4733,24504,0
2019/03,125,20/03/2019,3,SP 654R tra Piacenza (Tangenziale Sud) e Turro,24672,00,23471,1201,19852,4820,24672,0
2019/03,125,21/03/2019,4,SP 654R tra Piacenza (Tangenziale Sud) e Turro,24242,00,23102,1140,19439,4803,24242,0
2019/03,125,22/03/2019,5,SP 654R tra Piacenza (Tangenziale Sud) e Turro,25963,10,24804,1158,20215,5748,25963,0
2019/03,125,23/03/2019,6,SP 654R tra Piacenza (Tangenziale Sud) e Turro,20521,20,20195,324,15453,5068,0,20521
2019/03,125,24/03/2019,7,SP 654R tra Piacenza (Tangenziale Sud) e Turro,15986,00,15911,75,12037,3949,0,15986
2019/03,125,25/03/2019,1,SP 654R tra Piacenza (Tangenziale Sud) e Turro,24556,10,23332,1223,20016,4540,24556,0
2019/03,125,26/03/2019,2,SP 654R tra Piacenza (Tangenziale Sud) e Turro,24216,20,23104,1110,19541,4675,24216,0
2019/03,125,27/03/2019,3,SP 654R tra Piacenza (Tangenziale Sud) e Turro,24917,00,23716,1201,20101,4816,24917,0
2019/03,125,28/03/2019,4,SP 654R tra Piacenza (Tangenziale Sud) e Turro,24437,00,23315,1122,19527,4910,24437,0
2019/03,126,15/03/2019,5,SP 6 tra Piacenza (Tangenziale Sud) e bivio SP 42/ponte fiume Nure in località San Giorgio Piacentino,17577,00,16895,682,13411,4166,17577,0
2019/03,126,16/03/2019,6,SP 6 tra Piacenza (Tangenziale Sud) e bivio SP 42/ponte fiume Nure in località San Giorgio Piacentino,16115,00,15842,273,11787,4328,0,16115
2019/03,126,17/03/2019,7,SP 6 tra Piacenza (Tangenziale Sud) e bivio SP 42/ponte fiume Nure in località San Giorgio Piacentino,12351,00,12296,55,9238,3113,0,12351
2019/03,126,18/03/2019,1,SP 6 tra Piacenza (Tangenziale Sud) e bivio SP 42/ponte fiume Nure in località San Giorgio Piacentino,16370,00,15672,698,12953,3417,16370,0
2019/03,126,19/03/2019,2,SP 6 tra Piacenza (Tangenziale Sud) e bivio SP 42/ponte fiume Nure in località San Giorgio Piacentino,16456,00,15660,796,13001,3455,16456,0
2019/03,126,20/03/2019,3,SP 6 tra Piacenza (Tangenziale Sud) e bivio SP 42/ponte fiume Nure in località San Giorgio Piacentino,16630,00,15855,775,13022,3608,16630,0
2019/03,126,21/03/2019,4,SP 6 tra Piacenza (Tangenziale Sud) e bivio SP 42/ponte fiume Nure in località San Giorgio Piacentino,16625,10,15920,704,12820,3805,16625,0
2019/03,126,22/03/2019,5,SP 6 tra Piacenza (Tangenziale Sud) e bivio SP 42/ponte fiume Nure in località San Giorgio Piacentino,17385,00,16615,770,13318,4067,17385,0
2019/03,126,23/03/2019,6,SP 6 tra Piacenza (Tangenziale Sud) e bivio SP 42/ponte fiume Nure in località San Giorgio Piacentino,15872,10,15597,274,11652,4220,0,15872
2019/03,126,24/03/2019,7,SP 6 tra Piacenza (Tangenziale Sud) e bivio SP 42/ponte fiume Nure in località San Giorgio Piacentino,12914,00,12860,54,9502,3412,0,12914
2019/03,126,25/03/2019,1,SP 6 tra Piacenza (Tangenziale Sud) e bivio SP 42/ponte fiume Nure in località San Giorgio Piacentino,16253,00,15544,709,12857,3396,16253,0
2019/03,126,26/03/2019,2,SP 6 tra Piacenza (Tangenziale Sud) e bivio SP 42/ponte fiume Nure in località San Giorgio Piacentino,16431,00,15682,749,13066,3365,16431,0
2019/03,126,27/03/2019,3,SP 6 tra Piacenza (Tangenziale Sud) e bivio SP 42/ponte fiume Nure in località San Giorgio Piacentino,16430,10,15758,671,12772,3658,16430,0
2019/03,126,28/03/2019,4,SP 6 tra Piacenza (Tangenziale Sud) e bivio SP 42/ponte fiume Nure in località San Giorgio Piacentino,16915,20,16114,799,13225,3690,16915,0
2019/03,127,15/03/2019,5,SS 9 tra Piacenza e Pontenure,26632,10,24685,1946,20258,6374,26632,0
2019/03,127,16/03/2019,6,SS 9 tra Piacenza e Pontenure,22194,10,21632,561,16088,6106,0,22194
2019/03,127,17/03/2019,7,SS 9 tra Piacenza e Pontenure,17108,00,16966,142,12308,4800,0,17108
2019/03,127,18/03/2019,1,SS 9 tra Piacenza e Pontenure,25362,00,23379,1983,19980,5382,25362,0
2019/03,127,19/03/2019,2,SS 9 tra Piacenza e Pontenure,25652,00,23630,2022,20254,5398,25652,0
2019/03,127,20/03/2019,3,SS 9 tra Piacenza e Pontenure,25676,10,23665,2010,20068,5608,25676,0
2019/03,127,21/03/2019,4,SS 9 tra Piacenza e Pontenure,25567,00,23602,1965,19860,5707,25567,0
2019/03,127,22/03/2019,5,SS 9 tra Piacenza e Pontenure,26583,20,24627,1954,20161,6422,26583,0
2019/03,127,23/03/2019,6,SS 9 tra Piacenza e Pontenure,22083,10,21466,616,15678,6405,0,22083
2019/03,127,24/03/2019,7,SS 9 tra Piacenza e Pontenure,16063,00,15937,126,11222,4841,0,16063
2019/03,127,25/03/2019,1,SS 9 tra Piacenza e Pontenure,24918,00,23112,1806,19454,5464,24918,0
2019/03,127,26/03/2019,2,SS 9 tra Piacenza e Pontenure,26450,10,24172,2277,21141,5309,26450,0
2019/03,127,27/03/2019,3,SS 9 tra Piacenza e Pontenure,25594,00,23668,1926,20095,5499,25594,0
2019/03,127,28/03/2019,4,SS 9 tra Piacenza e Pontenure,26307,10,24294,2012,20650,5657,26307,0
2019/03,128,15/03/2019,5,SP 10R tra Piacenza (Casello A 1/A 21) e il bivio SP 10R e SP 587R,18806,00,16748,2058,14049,4757,18806,0
2019/03,128,16/03/2019,6,SP 10R tra Piacenza (Casello A 1/A 21) e il bivio SP 10R e SP 587R,15459,00,15025,434,10737,4722,0,15459
2019/03,128,17/03/2019,7,SP 10R tra Piacenza (Casello A 1/A 21) e il bivio SP 10R e SP 587R,14480,00,14413,67,10850,3630,0,14480
2019/03,128,18/03/2019,1,SP 10R tra Piacenza (Casello A 1/A 21) e il bivio SP 10R e SP 587R,18022,00,15959,2063,14140,3882,18022,0
2019/03,128,19/03/2019,2,SP 10R tra Piacenza (Casello A 1/A 21) e il bivio SP 10R e SP 587R,18020,00,15840,2180,13890,4130,18020,0
2019/03,128,20/03/2019,3,SP 10R tra Piacenza (Casello A 1/A 21) e il bivio SP 10R e SP 587R,18183,00,15856,2327,13955,4228,18183,0
2019/03,128,21/03/2019,4,SP 10R tra Piacenza (Casello A 1/A 21) e il bivio SP 10R e SP 587R,18585,00,16307,2278,14074,4511,18585,0
2019/03,128,22/03/2019,5,SP 10R tra Piacenza (Casello A 1/A 21) e il bivio SP 10R e SP 587R,19399,00,17296,2103,14471,4928,19399,0
2019/03,128,23/03/2019,6,SP 10R tra Piacenza (Casello A 1/A 21) e il bivio SP 10R e SP 587R,14602,00,14105,497,10044,4558,0,14602
2019/03,128,24/03/2019,7,SP 10R tra Piacenza (Casello A 1/A 21) e il bivio SP 10R e SP 587R,12990,00,12926,64,9319,3671,0,12990
2019/03,128,25/03/2019,1,SP 10R tra Piacenza (Casello A 1/A 21) e il bivio SP 10R e SP 587R,17315,00,15417,1898,13608,3707,17315,0
2019/03,128,26/03/2019,2,SP 10R tra Piacenza (Casello A 1/A 21) e il bivio SP 10R e SP 587R,18369,00,16142,2227,14246,4123,18369,0
2019/03,128,27/03/2019,3,SP 10R tra Piacenza (Casello A 1/A 21) e il bivio SP 10R e SP 587R,18798,00,16495,2303,14445,4353,18798,0
2019/03,128,28/03/2019,4,SP 10R tra Piacenza (Casello A 1/A 21) e il bivio SP 10R e SP 587R,19268,00,17168,2100,14755,4513,19268,0
2019/03,129,15/03/2019,5,SS 9Var tra Parma e ponte fiume Taro (Tangenziale nord di Parma),,,,,,,,
2019/03,129,16/03/2019,6,SS 9Var tra Parma e ponte fiume Taro (Tangenziale nord di Parma),,,,,,,,
2019/03,129,17/03/2019,7,SS 9Var tra Parma e ponte fiume Taro (Tangenziale nord di Parma),,,,,,,,
2019/03,129,18/03/2019,1,SS 9Var tra Parma e ponte fiume Taro (Tangenziale nord di Parma),,,,,,,,
2019/03,129,19/03/2019,2,SS 9Var tra Parma e ponte fiume Taro (Tangenziale nord di Parma),,,,,,,,
2019/03,129,20/03/2019,3,SS 9Var tra Parma e ponte fiume Taro (Tangenziale nord di Parma),,,,,,,,
2019/03,129,21/03/2019,4,SS 9Var tra Parma e ponte fiume Taro (Tangenziale nord di Parma),,,,,,,,
2019/03,129,22/03/2019,5,SS 9Var tra Parma e ponte fiume Taro (Tangenziale nord di Parma),,,,,,,,
2019/03,129,23/03/2019,6,SS 9Var tra Parma e ponte fiume Taro (Tangenziale nord di Parma),,,,,,,,
2019/03,129,24/03/2019,7,SS 9Var tra Parma e ponte fiume Taro (Tangenziale nord di Parma),,,,,,,,
2019/03,129,25/03/2019,1,SS 9Var tra Parma e ponte fiume Taro (Tangenziale nord di Parma),,,,,,,,
2019/03,129,26/03/2019,2,SS 9Var tra Parma e ponte fiume Taro (Tangenziale nord di Parma),,,,,,,,
2019/03,129,27/03/2019,3,SS 9Var tra Parma e ponte fiume Taro (Tangenziale nord di Parma),,,,,,,,
2019/03,129,28/03/2019,4,SS 9Var tra Parma e ponte fiume Taro (Tangenziale nord di Parma),,,,,,,,
2019/03,130,15/03/2019,5,SS 62 tra Parma e Collecchio,23817,00,22403,1414,18092,5725,23817,0
2019/03,130,16/03/2019,6,SS 62 tra Parma e Collecchio,20423,00,20080,343,14566,5857,0,20423
2019/03,130,17/03/2019,7,SS 62 tra Parma e Collecchio,16607,30,16530,74,11802,4805,0,16607
2019/03,130,18/03/2019,1,SS 62 tra Parma e Collecchio,21515,30,20195,1317,16873,4642,21515,0
2019/03,130,19/03/2019,2,SS 62 tra Parma e Collecchio,22494,20,21105,1387,17385,5109,22494,0
2019/03,130,20/03/2019,3,SS 62 tra Parma e Collecchio,22411,10,21167,1243,17156,5255,22411,0
2019/03,130,21/03/2019,4,SS 62 tra Parma e Collecchio,22790,00,21482,1308,17462,5328,22790,0
2019/03,130,22/03/2019,5,SS 62 tra Parma e Collecchio,23568,00,22319,1249,17831,5737,23568,0
2019/03,130,23/03/2019,6,SS 62 tra Parma e Collecchio,20957,00,20606,351,15070,5887,0,20957
2019/03,130,24/03/2019,7,SS 62 tra Parma e Collecchio,17272,00,17173,99,11849,5423,0,17272
2019/03,130,25/03/2019,1,SS 62 tra Parma e Collecchio,21922,00,20581,1341,17145,4777,21922,0
2019/03,130,26/03/2019,2,SS 62 tra Parma e Collecchio,22534,00,21170,1364,17480,5054,22534,0
2019/03,130,27/03/2019,3,SS 62 tra Parma e Collecchio,22774,00,21507,1267,17521,5253,22774,0
2019/03,130,28/03/2019,4,SS 62 tra Parma e Collecchio,23317,20,21933,1382,17854,5463,23317,0
2019/03,131,15/03/2019,5,SP 665R tra Parma e Corcagnano,22431,10,21263,1167,17192,5239,22431,0
2019/03,131,16/03/2019,6,SP 665R tra Parma e Corcagnano,19911,10,19624,286,14386,5525,0,19911
2019/03,131,17/03/2019,7,SP 665R tra Parma e Corcagnano,15789,20,15695,92,11433,4356,0,15789
2019/03,131,18/03/2019,1,SP 665R tra Parma e Corcagnano,20684,10,19552,1131,16488,4196,20684,0
2019/03,131,19/03/2019,2,SP 665R tra Parma e Corcagnano,21859,40,20754,1101,17177,4682,21859,0
2019/03,131,20/03/2019,3,SP 665R tra Parma e Corcagnano,21455,10,20323,1131,16751,4704,21455,0
2019/03,131,21/03/2019,4,SP 665R tra Parma e Corcagnano,21748,10,20574,1173,16985,4763,21748,0
2019/03,131,22/03/2019,5,SP 665R tra Parma e Corcagnano,22138,40,20980,1154,17082,5056,22138,0
2019/03,131,23/03/2019,6,SP 665R tra Parma e Corcagnano,19888,20,19551,335,14376,5512,0,19888
2019/03,131,24/03/2019,7,SP 665R tra Parma e Corcagnano,16547,10,16458,88,11969,4578,0,16547
2019/03,131,25/03/2019,1,SP 665R tra Parma e Corcagnano,20899,40,19744,1151,16654,4245,20899,0
2019/03,131,26/03/2019,2,SP 665R tra Parma e Corcagnano,21728,10,20537,1190,16952,4776,21728,0
2019/03,131,27/03/2019,3,SP 665R tra Parma e Corcagnano,21576,20,20402,1172,16834,4742,21576,0
2019/03,131,28/03/2019,4,SP 665R tra Parma e Corcagnano,22010,30,20812,1195,17112,4898,22010,0
2019/03,132,15/03/2019,5,SP 513R tra Parma e Pilastrello,23194,00,22173,1021,17804,5390,23194,0
2019/03,132,16/03/2019,6,SP 513R tra Parma e Pilastrello,19590,10,19295,294,14222,5368,0,19590
2019/03,132,17/03/2019,7,SP 513R tra Parma e Pilastrello,16128,00,16062,66,11909,4219,0,16128
2019/03,132,18/03/2019,1,SP 513R tra Parma e Pilastrello,21685,00,20641,1044,17490,4195,21685,0
2019/03,132,19/03/2019,2,SP 513R tra Parma e Pilastrello,22561,10,21495,1065,17857,4704,22561,0
2019/03,132,20/03/2019,3,SP 513R tra Parma e Pilastrello,23057,00,21985,1072,18129,4928,23057,0
2019/03,132,21/03/2019,4,SP 513R tra Parma e Pilastrello,22498,00,21484,1014,17778,4720,22498,0
2019/03,132,22/03/2019,5,SP 513R tra Parma e Pilastrello,23008,10,21947,1060,17712,5296,23008,0
2019/03,132,23/03/2019,6,SP 513R tra Parma e Pilastrello,19336,00,19101,235,14215,5121,0,19336
2019/03,132,24/03/2019,7,SP 513R tra Parma e Pilastrello,16076,00,15996,80,11874,4202,0,16076
2019/03,132,25/03/2019,1,SP 513R tra Parma e Pilastrello,21376,10,20311,1064,17130,4246,21376,0
2019/03,132,26/03/2019,2,SP 513R tra Parma e Pilastrello,22504,00,21462,1042,17723,4781,22504,0
2019/03,132,27/03/2019,3,SP 513R tra Parma e Pilastrello,22318,40,21256,1058,17691,4627,22318,0
2019/03,132,28/03/2019,4,SP 513R tra Parma e Pilastrello,23115,00,21981,1134,18163,4952,23115,0
2019/03,133,15/03/2019,5,SP 62R tra Parma (viadotto A 1) e Sorbolo,20524,20,18322,2200,15151,5373,20524,0
2019/03,133,16/03/2019,6,SP 62R tra Parma (viadotto A 1) e Sorbolo,18831,00,18352,479,13196,5635,0,18831
2019/03,133,17/03/2019,7,SP 62R tra Parma (viadotto A 1) e Sorbolo,16811,00,16686,125,11833,4978,0,16811
2019/03,133,18/03/2019,1,SP 62R tra Parma (viadotto A 1) e Sorbolo,19443,10,17142,2300,15035,4408,19443,0
2019/03,133,19/03/2019,2,SP 62R tra Parma (viadotto A 1) e Sorbolo,19798,20,17420,2376,15247,4551,19798,0
2019/03,133,20/03/2019,3,SP 62R tra Parma (viadotto A 1) e Sorbolo,20166,50,17558,2603,15535,4631,20166,0
2019/03,133,21/03/2019,4,SP 62R tra Parma (viadotto A 1) e Sorbolo,20164,10,17675,2488,15320,4844,20164,0
2019/03,133,22/03/2019,5,SP 62R tra Parma (viadotto A 1) e Sorbolo,21007,20,18679,2326,15534,5473,21007,0
2019/03,133,23/03/2019,6,SP 62R tra Parma (viadotto A 1) e Sorbolo,18501,00,17977,524,12920,5581,0,18501
2019/03,133,24/03/2019,7,SP 62R tra Parma (viadotto A 1) e Sorbolo,16766,20,16629,135,11486,5280,0,16766
2019/03,133,25/03/2019,1,SP 62R tra Parma (viadotto A 1) e Sorbolo,19096,30,16778,2315,14840,4256,19096,0
2019/03,133,26/03/2019,2,SP 62R tra Parma (viadotto A 1) e Sorbolo,19646,00,17304,2342,14898,4748,19646,0
2019/03,133,27/03/2019,3,SP 62R tra Parma (viadotto A 1) e Sorbolo,19018,10,16782,2235,14509,4509,19018,0
2019/03,133,28/03/2019,4,SP 62R tra Parma (viadotto A 1) e Sorbolo,20716,00,18225,2491,15842,4874,20716,0
2019/03,134,15/03/2019,5,SP 343R tra Parma e San Polo,13988,00,11952,2036,12302,1686,13988,0
2019/03,134,17/03/2019,7,SP 343R tra Parma e San Polo,4764,00,4683,81,3593,1171,0,4764
2019/03,134,20/03/2019,3,SP 343R tra Parma e San Polo,20073,00,17764,2309,15398,4675,20073,0
2019/03,134,21/03/2019,4,SP 343R tra Parma e San Polo,12358,20,10530,1826,10768,1590,12358,0
2019/03,134,24/03/2019,7,SP 343R tra Parma e San Polo,11163,00,11024,139,7831,3332,0,11163
2019/03,134,25/03/2019,1,SP 343R tra Parma e San Polo,9172,00,7918,1254,7687,1485,9172,0
2019/03,135,15/03/2019,5,SP 10 tra Parma (Tangenziale) e Viarolo,,,,,,,,
2019/03,135,16/03/2019,6,SP 10 tra Parma (Tangenziale) e Viarolo,,,,,,,,
2019/03,135,17/03/2019,7,SP 10 tra Parma (Tangenziale) e Viarolo,,,,,,,,
2019/03,135,18/03/2019,1,SP 10 tra Parma (Tangenziale) e Viarolo,,,,,,,,
2019/03,135,19/03/2019,2,SP 10 tra Parma (Tangenziale) e Viarolo,,,,,,,,
2019/03,135,20/03/2019,3,SP 10 tra Parma (Tangenziale) e Viarolo,,,,,,,,
2019/03,135,21/03/2019,4,SP 10 tra Parma (Tangenziale) e Viarolo,,,,,,,,
2019/03,135,22/03/2019,5,SP 10 tra Parma (Tangenziale) e Viarolo,,,,,,,,
2019/03,135,23/03/2019,6,SP 10 tra Parma (Tangenziale) e Viarolo,,,,,,,,
2019/03,135,24/03/2019,7,SP 10 tra Parma (Tangenziale) e Viarolo,,,,,,,,
2019/03,135,25/03/2019,1,SP 10 tra Parma (Tangenziale) e Viarolo,,,,,,,,
2019/03,135,26/03/2019,2,SP 10 tra Parma (Tangenziale) e Viarolo,,,,,,,,
2019/03,135,27/03/2019,3,SP 10 tra Parma (Tangenziale) e Viarolo,,,,,,,,
2019/03,135,28/03/2019,4,SP 10 tra Parma (Tangenziale) e Viarolo,,,,,,,,
2019/03,137,15/03/2019,5,SP 28 tra Reggio Emilia (Tangenziale) e Cavriago,20922,00,20302,620,18077,2845,20922,0
2019/03,137,16/03/2019,6,SP 28 tra Reggio Emilia (Tangenziale) e Cavriago,18801,00,18534,267,13493,5308,0,18801
2019/03,137,17/03/2019,7,SP 28 tra Reggio Emilia (Tangenziale) e Cavriago,13935,10,13871,63,10101,3834,0,13935
2019/03,137,18/03/2019,1,SP 28 tra Reggio Emilia (Tangenziale) e Cavriago,22136,20,21502,632,17945,4191,22136,0
2019/03,137,19/03/2019,2,SP 28 tra Reggio Emilia (Tangenziale) e Cavriago,22644,30,21955,686,17954,4690,22644,0
2019/03,137,20/03/2019,3,SP 28 tra Reggio Emilia (Tangenziale) e Cavriago,22850,30,22210,637,17938,4912,22850,0
2019/03,137,21/03/2019,4,SP 28 tra Reggio Emilia (Tangenziale) e Cavriago,22477,20,21795,680,17528,4949,22477,0
2019/03,137,22/03/2019,5,SP 28 tra Reggio Emilia (Tangenziale) e Cavriago,23057,10,22430,626,17856,5201,23057,0
2019/03,137,23/03/2019,6,SP 28 tra Reggio Emilia (Tangenziale) e Cavriago,19121,10,18818,302,13883,5238,0,19121
2019/03,137,24/03/2019,7,SP 28 tra Reggio Emilia (Tangenziale) e Cavriago,13982,10,13903,78,9939,4043,0,13982
2019/03,137,25/03/2019,1,SP 28 tra Reggio Emilia (Tangenziale) e Cavriago,17329,00,16794,535,13912,3417,17329,0
2019/03,137,26/03/2019,2,SP 28 tra Reggio Emilia (Tangenziale) e Cavriago,22297,30,21622,672,17817,4480,22297,0
2019/03,137,27/03/2019,3,SP 28 tra Reggio Emilia (Tangenziale) e Cavriago,16103,10,15644,458,12460,3643,16103,0
2019/03,137,28/03/2019,4,SP 28 tra Reggio Emilia (Tangenziale) e Cavriago,18028,10,17503,524,14620,3408,18028,0
2019/03,138,15/03/2019,5,SS 63 tra Reggio Emilia e Puianello,13287,00,12808,479,9756,3531,13287,0
2019/03,138,16/03/2019,6,SS 63 tra Reggio Emilia e Puianello,14007,00,13824,183,10097,3910,0,14007
2019/03,138,17/03/2019,7,SS 63 tra Reggio Emilia e Puianello,11715,00,11663,52,8587,3128,0,11715
2019/03,138,18/03/2019,1,SS 63 tra Reggio Emilia e Puianello,11926,10,11475,450,9216,2710,11926,0
2019/03,138,19/03/2019,2,SS 63 tra Reggio Emilia e Puianello,12387,20,11851,534,9332,3055,12387,0
2019/03,138,20/03/2019,3,SS 63 tra Reggio Emilia e Puianello,12491,10,12007,483,9409,3082,12491,0
2019/03,138,21/03/2019,4,SS 63 tra Reggio Emilia e Puianello,12784,10,12286,497,9495,3289,12784,0
2019/03,138,22/03/2019,5,SS 63 tra Reggio Emilia e Puianello,13190,10,12644,545,9744,3446,13190,0
2019/03,138,23/03/2019,6,SS 63 tra Reggio Emilia e Puianello,13831,10,13667,163,10026,3805,0,13831
2019/03,138,24/03/2019,7,SS 63 tra Reggio Emilia e Puianello,12553,10,12492,60,9155,3398,0,12553
2019/03,138,25/03/2019,1,SS 63 tra Reggio Emilia e Puianello,11980,20,11532,446,9118,2862,11980,0
2019/03,138,26/03/2019,2,SS 63 tra Reggio Emilia e Puianello,12189,00,11754,435,9318,2871,12189,0
2019/03,138,27/03/2019,3,SS 63 tra Reggio Emilia e Puianello,12488,00,12084,404,9337,3151,12488,0
2019/03,138,28/03/2019,4,SS 63 tra Reggio Emilia e Puianello,12387,10,11943,443,9192,3195,12387,0
2019/03,139,15/03/2019,5,SP 467R tra Fogliano e località Pratissolo (c/o Scandiano),18512,00,17777,735,14269,4243,18512,0
2019/03,139,16/03/2019,6,SP 467R tra Fogliano e località Pratissolo (c/o Scandiano),16843,00,16665,178,12109,4734,0,16843
2019/03,139,17/03/2019,7,SP 467R tra Fogliano e località Pratissolo (c/o Scandiano),16175,00,16110,65,12137,4038,0,16175
2019/03,139,18/03/2019,1,SP 467R tra Fogliano e località Pratissolo (c/o Scandiano),18088,00,17367,721,14606,3482,18088,0
2019/03,139,19/03/2019,2,SP 467R tra Fogliano e località Pratissolo (c/o Scandiano),18425,00,17665,760,14675,3750,18425,0
2019/03,139,20/03/2019,3,SP 467R tra Fogliano e località Pratissolo (c/o Scandiano),18597,00,17830,767,14768,3829,18597,0
2019/03,139,21/03/2019,4,SP 467R tra Fogliano e località Pratissolo (c/o Scandiano),18659,10,17877,781,14610,4049,18659,0
2019/03,139,22/03/2019,5,SP 467R tra Fogliano e località Pratissolo (c/o Scandiano),18989,00,18181,808,14521,4468,18989,0
2019/03,139,23/03/2019,6,SP 467R tra Fogliano e località Pratissolo (c/o Scandiano),16380,00,16178,202,11584,4796,0,16380
2019/03,139,24/03/2019,7,SP 467R tra Fogliano e località Pratissolo (c/o Scandiano),14966,00,14898,68,10867,4099,0,14966
2019/03,139,25/03/2019,1,SP 467R tra Fogliano e località Pratissolo (c/o Scandiano),18312,00,17542,770,14599,3713,18312,0
2019/03,139,26/03/2019,2,SP 467R tra Fogliano e località Pratissolo (c/o Scandiano),18416,00,17614,802,14732,3684,18416,0
2019/03,139,27/03/2019,3,SP 467R tra Fogliano e località Pratissolo (c/o Scandiano),19091,00,18129,962,15094,3997,19091,0
2019/03,139,28/03/2019,4,SP 467R tra Fogliano e località Pratissolo (c/o Scandiano),18926,10,17979,946,14959,3967,18926,0
2019/03,140,15/03/2019,5,SS 9 tra Masone e Rubiera,28142,20,25089,3051,20093,8049,28142,0
2019/03,140,16/03/2019,6,SS 9 tra Masone e Rubiera,26803,30,26198,602,18150,8653,0,26803
2019/03,140,17/03/2019,7,SS 9 tra Masone e Rubiera,21253,00,21094,159,14092,7161,0,21253
2019/03,140,18/03/2019,1,SS 9 tra Masone e Rubiera,26883,10,23914,2968,20528,6355,26883,0
2019/03,140,19/03/2019,2,SS 9 tra Masone e Rubiera,26654,10,23666,2987,19994,6660,26654,0
2019/03,140,20/03/2019,3,SS 9 tra Masone e Rubiera,26598,10,23518,3079,19751,6847,26598,0
2019/03,140,21/03/2019,4,SS 9 tra Masone e Rubiera,26900,60,23789,3105,19723,7177,26900,0
2019/03,140,22/03/2019,5,SS 9 tra Masone e Rubiera,27335,20,24299,3034,19385,7950,27335,0
2019/03,140,23/03/2019,6,SS 9 tra Masone e Rubiera,25530,10,24937,592,16871,8659,0,25530
2019/03,140,24/03/2019,7,SS 9 tra Masone e Rubiera,21227,10,21085,141,14120,7107,0,21227
2019/03,140,25/03/2019,1,SS 9 tra Masone e Rubiera,25322,10,22514,2807,18976,6346,25322,0
2019/03,140,26/03/2019,2,SS 9 tra Masone e Rubiera,26382,00,23365,3017,19947,6435,26382,0
2019/03,140,27/03/2019,3,SS 9 tra Masone e Rubiera,21711,40,19206,2501,14743,6968,21711,0
2019/03,140,28/03/2019,4,SS 9 tra Masone e Rubiera,21352,70,18714,2631,13930,7422,21352,0
2019/03,143,15/03/2019,5,SP 63R tra Sesso e Cadelbosco di Sopra (bivio SP 358R),27223,10,25758,1464,20761,6462,27223,0
2019/03,143,16/03/2019,6,SP 63R tra Sesso e Cadelbosco di Sopra (bivio SP 358R),23693,00,23321,372,16877,6816,0,23693
2019/03,143,17/03/2019,7,SP 63R tra Sesso e Cadelbosco di Sopra (bivio SP 358R),18953,00,18849,104,13379,5574,0,18953
2019/03,143,18/03/2019,1,SP 63R tra Sesso e Cadelbosco di Sopra (bivio SP 358R),25494,00,24095,1399,20343,5151,25494,0
2019/03,143,19/03/2019,2,SP 63R tra Sesso e Cadelbosco di Sopra (bivio SP 358R),26342,00,24904,1438,20627,5715,26342,0
2019/03,143,20/03/2019,3,SP 63R tra Sesso e Cadelbosco di Sopra (bivio SP 358R),26753,00,25267,1486,20990,5763,26753,0
2019/03,143,21/03/2019,4,SP 63R tra Sesso e Cadelbosco di Sopra (bivio SP 358R),26549,00,25120,1429,20697,5852,26549,0
2019/03,143,22/03/2019,5,SP 63R tra Sesso e Cadelbosco di Sopra (bivio SP 358R),27152,10,25656,1495,20646,6506,27152,0
2019/03,143,23/03/2019,6,SP 63R tra Sesso e Cadelbosco di Sopra (bivio SP 358R),23264,00,22863,401,16450,6814,0,23264
2019/03,143,24/03/2019,7,SP 63R tra Sesso e Cadelbosco di Sopra (bivio SP 358R),18209,00,18120,89,12451,5758,0,18209
2019/03,143,25/03/2019,1,SP 63R tra Sesso e Cadelbosco di Sopra (bivio SP 358R),25377,00,23897,1480,20121,5256,25377,0
2019/03,143,26/03/2019,2,SP 63R tra Sesso e Cadelbosco di Sopra (bivio SP 358R),26376,10,24978,1397,20847,5529,26376,0
2019/03,143,27/03/2019,3,SP 63R tra Sesso e Cadelbosco di Sopra (bivio SP 358R),26449,00,24982,1467,20537,5912,26449,0
2019/03,143,28/03/2019,4,SP 63R tra Sesso e Cadelbosco di Sopra (bivio SP 358R),25589,30,24126,1460,19597,5992,25589,0
2019/03,146,15/03/2019,5,SS 12 tra Montale e Modena,23039,20,21677,1360,17325,5714,23039,0
2019/03,146,16/03/2019,6,SS 12 tra Montale e Modena,20424,10,20081,342,14127,6297,0,20424
2019/03,146,17/03/2019,7,SS 12 tra Montale e Modena,17692,00,17596,96,12838,4854,0,17692
2019/03,146,18/03/2019,1,SS 12 tra Montale e Modena,21202,10,19954,1247,16453,4749,21202,0
2019/03,146,19/03/2019,2,SS 12 tra Montale e Modena,21634,40,20222,1408,16563,5071,21634,0
2019/03,146,20/03/2019,3,SS 12 tra Montale e Modena,22974,40,21505,1465,17652,5322,22974,0
2019/03,146,21/03/2019,4,SS 12 tra Montale e Modena,22715,10,21312,1402,17240,5475,22715,0
2019/03,146,22/03/2019,5,SS 12 tra Montale e Modena,22849,30,21510,1336,17074,5775,22849,0
2019/03,146,23/03/2019,6,SS 12 tra Montale e Modena,20522,30,20163,356,14376,6146,0,20522
2019/03,146,24/03/2019,7,SS 12 tra Montale e Modena,17659,10,17561,97,12701,4958,0,17659
2019/03,146,25/03/2019,1,SS 12 tra Montale e Modena,21735,30,20422,1310,16899,4836,21735,0
2019/03,146,26/03/2019,2,SS 12 tra Montale e Modena,21697,00,20322,1375,16874,4823,21697,0
2019/03,146,27/03/2019,3,SS 12 tra Montale e Modena,22460,30,21070,1387,17183,5277,22460,0
2019/03,146,28/03/2019,4,SS 12 tra Montale e Modena,22621,50,21321,1295,17082,5539,22621,0
2019/03,147,15/03/2019,5,SP 623 tra Modena Sud/casello A 1 e Spilamberto,20883,00,17328,3555,15539,5344,20883,0
2019/03,147,16/03/2019,6,SP 623 tra Modena Sud/casello A 1 e Spilamberto,17143,10,16485,657,11821,5322,0,17143
2019/03,147,17/03/2019,7,SP 623 tra Modena Sud/casello A 1 e Spilamberto,16448,00,16275,173,11924,4524,0,16448
2019/03,147,18/03/2019,1,SP 623 tra Modena Sud/casello A 1 e Spilamberto,19778,00,16415,3363,15450,4328,19778,0
2019/03,147,19/03/2019,2,SP 623 tra Modena Sud/casello A 1 e Spilamberto,19869,20,16512,3355,15444,4425,19869,0
2019/03,147,20/03/2019,3,SP 623 tra Modena Sud/casello A 1 e Spilamberto,19956,10,16616,3339,15320,4636,19956,0
2019/03,147,21/03/2019,4,SP 623 tra Modena Sud/casello A 1 e Spilamberto,20313,00,16800,3513,15368,4945,20313,0
2019/03,147,22/03/2019,5,SP 623 tra Modena Sud/casello A 1 e Spilamberto,18925,00,15990,2935,14763,4162,18925,0
2019/03,147,23/03/2019,6,SP 623 tra Modena Sud/casello A 1 e Spilamberto,16537,00,15976,561,11412,5125,0,16537
2019/03,147,24/03/2019,7,SP 623 tra Modena Sud/casello A 1 e Spilamberto,15298,00,15146,152,10850,4448,0,15298
2019/03,147,25/03/2019,1,SP 623 tra Modena Sud/casello A 1 e Spilamberto,19377,10,16133,3243,14962,4415,19377,0
2019/03,147,26/03/2019,2,SP 623 tra Modena Sud/casello A 1 e Spilamberto,19458,10,16147,3310,15034,4424,19458,0
2019/03,147,27/03/2019,3,SP 623 tra Modena Sud/casello A 1 e Spilamberto,19681,10,16439,3241,15036,4645,19681,0
2019/03,147,28/03/2019,4,SP 623 tra Modena Sud/casello A 1 e Spilamberto,19908,00,16556,3352,14918,4990,19908,0
2019/03,148,15/03/2019,5,SS 9 tra Sant'Ambrogio e Castelfranco Emilia,30332,10,28429,1902,21710,8622,30332,0
2019/03,148,16/03/2019,6,SS 9 tra Sant'Ambrogio e Castelfranco Emilia,27375,00,26875,500,18570,8805,0,27375
2019/03,148,17/03/2019,7,SS 9 tra Sant'Ambrogio e Castelfranco Emilia,23051,00,22934,117,15807,7244,0,23051
2019/03,148,18/03/2019,1,SS 9 tra Sant'Ambrogio e Castelfranco Emilia,29385,20,27346,2037,22234,7151,29385,0
2019/03,148,19/03/2019,2,SS 9 tra Sant'Ambrogio e Castelfranco Emilia,29976,20,27922,2052,22304,7672,29976,0
2019/03,148,20/03/2019,3,SS 9 tra Sant'Ambrogio e Castelfranco Emilia,28661,10,26724,1936,21102,7559,28661,0
2019/03,148,21/03/2019,4,SS 9 tra Sant'Ambrogio e Castelfranco Emilia,29028,00,27121,1907,21242,7786,29028,0
2019/03,148,22/03/2019,5,SS 9 tra Sant'Ambrogio e Castelfranco Emilia,30462,10,28544,1917,21852,8610,30462,0
2019/03,148,23/03/2019,6,SS 9 tra Sant'Ambrogio e Castelfranco Emilia,27303,00,26829,474,18389,8914,0,27303
2019/03,148,24/03/2019,7,SS 9 tra Sant'Ambrogio e Castelfranco Emilia,23080,00,22965,115,15902,7178,0,23080
2019/03,149,15/03/2019,5,SP 255 tra Modena e Navicello,38625,450,35343,3237,28570,10055,38625,0
2019/03,149,16/03/2019,6,SP 255 tra Modena e Navicello,31389,10,30693,695,21487,9902,0,31389
2019/03,149,17/03/2019,7,SP 255 tra Modena e Navicello,26216,40,26063,149,18223,7993,0,26216
2019/03,149,18/03/2019,1,SP 255 tra Modena e Navicello,36281,510,32947,3283,28190,8091,36281,0
2019/03,149,19/03/2019,2,SP 255 tra Modena e Navicello,37585,420,34129,3414,28767,8818,37585,0
2019/03,149,20/03/2019,3,SP 255 tra Modena e Navicello,37299,350,33938,3326,28343,8956,37299,0
2019/03,149,21/03/2019,4,SP 255 tra Modena e Navicello,37587,440,34240,3303,28475,9112,37587,0
2019/03,149,22/03/2019,5,SP 255 tra Modena e Navicello,38677,440,35367,3266,28714,9963,38677,0
2019/03,149,23/03/2019,6,SP 255 tra Modena e Navicello,31626,20,30903,721,21809,9817,0,31626
2019/03,149,24/03/2019,7,SP 255 tra Modena e Navicello,25173,10,25010,162,17444,7729,0,25173
2019/03,149,25/03/2019,1,SP 255 tra Modena e Navicello,36374,440,33176,3154,28164,8210,36374,0
2019/03,149,26/03/2019,2,SP 255 tra Modena e Navicello,36807,400,33517,3250,28367,8440,36807,0
2019/03,149,27/03/2019,3,SP 255 tra Modena e Navicello,37538,350,34164,3339,28435,9103,37538,0
2019/03,149,28/03/2019,4,SP 255 tra Modena e Navicello,38297,470,34951,3299,28649,9648,38297,0
2019/03,150,15/03/2019,5,SS 12 tra Modena e Bastiglia,26323,00,24333,1990,19667,6656,26323,0
2019/03,150,16/03/2019,6,SS 12 tra Modena e Bastiglia,21394,10,21046,347,14471,6923,0,21394
2019/03,150,17/03/2019,7,SS 12 tra Modena e Bastiglia,17954,00,17859,95,12420,5534,0,17954
2019/03,150,18/03/2019,1,SS 12 tra Modena e Bastiglia,24546,20,22446,2098,19254,5292,24546,0
2019/03,150,19/03/2019,2,SS 12 tra Modena e Bastiglia,25390,30,23336,2051,19732,5658,25390,0
2019/03,150,20/03/2019,3,SS 12 tra Modena e Bastiglia,25756,00,23602,2154,19946,5810,25756,0
2019/03,150,21/03/2019,4,SS 12 tra Modena e Bastiglia,25710,10,23468,2241,19779,5931,25710,0
2019/03,150,22/03/2019,5,SS 12 tra Modena e Bastiglia,26104,10,23954,2149,19464,6640,26104,0
2019/03,150,23/03/2019,6,SS 12 tra Modena e Bastiglia,21167,00,20763,404,14447,6720,0,21167
2019/03,150,24/03/2019,7,SS 12 tra Modena e Bastiglia,17752,00,17665,87,12194,5558,0,17752
2019/03,150,25/03/2019,1,SS 12 tra Modena e Bastiglia,24842,20,22678,2162,19524,5318,24842,0
2019/03,150,26/03/2019,2,SS 12 tra Modena e Bastiglia,25046,10,22897,2148,19565,5481,25046,0
2019/03,150,27/03/2019,3,SS 12 tra Modena e Bastiglia,25598,00,23465,2133,19836,5762,25598,0
2019/03,150,28/03/2019,4,SS 12 tra Modena e Bastiglia,25790,10,23641,2148,19836,5954,25790,0
2019/03,151,15/03/2019,5,SP 413 tra Modena e Ganaceto,25709,20,24177,1530,18397,7312,25709,0
2019/03,151,16/03/2019,6,SP 413 tra Modena e Ganaceto,23093,00,22716,377,15618,7475,0,23093
2019/03,151,17/03/2019,7,SP 413 tra Modena e Ganaceto,19222,00,19120,102,13176,6046,0,19222
2019/03,151,18/03/2019,1,SP 413 tra Modena e Ganaceto,23580,10,21985,1594,18218,5362,23580,0
2019/03,151,19/03/2019,2,SP 413 tra Modena e Ganaceto,23949,00,22279,1670,18201,5748,23949,0
2019/03,151,20/03/2019,3,SP 413 tra Modena e Ganaceto,24600,00,23005,1595,18348,6252,24600,0
2019/03,151,21/03/2019,4,SP 413 tra Modena e Ganaceto,24815,10,23264,1550,18545,6270,24815,0
2019/03,151,22/03/2019,5,SP 413 tra Modena e Ganaceto,25386,00,23834,1552,18583,6803,25386,0
2019/03,151,23/03/2019,6,SP 413 tra Modena e Ganaceto,22975,00,22610,365,15581,7394,0,22975
2019/03,151,24/03/2019,7,SP 413 tra Modena e Ganaceto,18800,00,18695,105,12619,6181,0,18800
2019/03,151,25/03/2019,1,SP 413 tra Modena e Ganaceto,23644,00,22065,1579,18101,5543,23644,0
2019/03,151,26/03/2019,2,SP 413 tra Modena e Ganaceto,23399,40,21912,1483,17549,5850,23399,0
2019/03,151,27/03/2019,3,SP 413 tra Modena e Ganaceto,24878,00,23251,1627,18596,6282,24878,0
2019/03,151,28/03/2019,4,SP 413 tra Modena e Ganaceto,25151,00,23633,1518,18709,6442,25151,0
2019/03,152,15/03/2019,5,SP 569 tra Innesto tangenziale Bologna e uscita Zola Predosa (Gesso/Rivabella),69938,50,66932,3001,51721,18217,69938,0
2019/03,152,16/03/2019,6,SP 569 tra Innesto tangenziale Bologna e uscita Zola Predosa (Gesso/Rivabella),64622,30,63907,712,45663,18959,0,64622
2019/03,152,17/03/2019,7,SP 569 tra Innesto tangenziale Bologna e uscita Zola Predosa (Gesso/Rivabella),57041,20,56683,356,39858,17183,0,57041
2019/03,152,18/03/2019,1,SP 569 tra Innesto tangenziale Bologna e uscita Zola Predosa (Gesso/Rivabella),64780,20,61819,2959,51199,13581,64780,0
2019/03,152,19/03/2019,2,SP 569 tra Innesto tangenziale Bologna e uscita Zola Predosa (Gesso/Rivabella),66367,40,63201,3162,51611,14756,66367,0
2019/03,152,20/03/2019,3,SP 569 tra Innesto tangenziale Bologna e uscita Zola Predosa (Gesso/Rivabella),66119,70,63116,2996,51582,14537,66119,0
2019/03,152,21/03/2019,4,SP 569 tra Innesto tangenziale Bologna e uscita Zola Predosa (Gesso/Rivabella),69022,20,65949,3071,52278,16744,69022,0
2019/03,152,22/03/2019,5,SP 569 tra Innesto tangenziale Bologna e uscita Zola Predosa (Gesso/Rivabella),68644,40,65591,3049,52706,15938,68644,0
2019/03,152,23/03/2019,6,SP 569 tra Innesto tangenziale Bologna e uscita Zola Predosa (Gesso/Rivabella),60693,30,60030,660,40981,19712,0,60693
2019/03,152,24/03/2019,7,SP 569 tra Innesto tangenziale Bologna e uscita Zola Predosa (Gesso/Rivabella),51091,00,50887,204,37762,13329,0,51091
2019/03,152,25/03/2019,1,SP 569 tra Innesto tangenziale Bologna e uscita Zola Predosa (Gesso/Rivabella),63840,00,60899,2941,50429,13411,63840,0
2019/03,152,26/03/2019,2,SP 569 tra Innesto tangenziale Bologna e uscita Zola Predosa (Gesso/Rivabella),66277,20,63277,2998,52132,14145,66277,0
2019/03,152,27/03/2019,3,SP 569 tra Innesto tangenziale Bologna e uscita Zola Predosa (Gesso/Rivabella),67312,20,64242,3068,52334,14978,67312,0
2019/03,152,28/03/2019,4,SP 569 tra Innesto tangenziale Bologna e uscita Zola Predosa (Gesso/Rivabella),67352,30,64186,3163,52071,15281,67352,0
2019/03,153,15/03/2019,5,Via Porrettana (ex SS 64) tra Bologna e Pontecchio Marconi,12416,00,12163,253,9266,3150,12416,0
2019/03,153,16/03/2019,6,Via Porrettana (ex SS 64) tra Bologna e Pontecchio Marconi,11837,10,11719,117,8814,3023,0,11837
2019/03,153,17/03/2019,7,Via Porrettana (ex SS 64) tra Bologna e Pontecchio Marconi,9435,00,9406,29,7054,2381,0,9435
2019/03,153,18/03/2019,1,Via Porrettana (ex SS 64) tra Bologna e Pontecchio Marconi,11068,00,10817,251,8728,2340,11068,0
2019/03,153,19/03/2019,2,Via Porrettana (ex SS 64) tra Bologna e Pontecchio Marconi,11697,10,11422,274,9125,2572,11697,0
2019/03,153,20/03/2019,3,Via Porrettana (ex SS 64) tra Bologna e Pontecchio Marconi,11240,00,10982,258,8744,2496,11240,0
2019/03,153,21/03/2019,4,Via Porrettana (ex SS 64) tra Bologna e Pontecchio Marconi,11895,00,11648,247,9027,2868,11895,0
2019/03,153,22/03/2019,5,Via Porrettana (ex SS 64) tra Bologna e Pontecchio Marconi,12165,00,11900,265,9105,3060,12165,0
2019/03,153,23/03/2019,6,Via Porrettana (ex SS 64) tra Bologna e Pontecchio Marconi,11711,00,11586,125,8578,3133,0,11711
2019/03,153,24/03/2019,7,Via Porrettana (ex SS 64) tra Bologna e Pontecchio Marconi,9100,00,9075,25,6584,2516,0,9100
2019/03,153,25/03/2019,1,Via Porrettana (ex SS 64) tra Bologna e Pontecchio Marconi,11024,00,10758,266,8597,2427,11024,0
2019/03,153,26/03/2019,2,Via Porrettana (ex SS 64) tra Bologna e Pontecchio Marconi,11427,00,11190,237,8964,2463,11427,0
2019/03,153,27/03/2019,3,Via Porrettana (ex SS 64) tra Bologna e Pontecchio Marconi,11347,00,11087,260,8718,2629,11347,0
2019/03,153,28/03/2019,4,Via Porrettana (ex SS 64) tra Bologna e Pontecchio Marconi,11565,00,11310,255,8887,2678,11565,0
2019/03,154,15/03/2019,5,Tra Rastignano e Pian di Macina (SP85 Fondo Valle Savena),13407,30,13136,268,10249,3158,13407,0
2019/03,154,16/03/2019,6,Tra Rastignano e Pian di Macina (SP85 Fondo Valle Savena),11321,00,11229,92,8582,2739,0,11321
2019/03,154,17/03/2019,7,Tra Rastignano e Pian di Macina (SP85 Fondo Valle Savena),10300,30,10275,22,7921,2379,0,10300
2019/03,154,18/03/2019,1,Tra Rastignano e Pian di Macina (SP85 Fondo Valle Savena),11694,00,11446,248,9254,2440,11694,0
2019/03,154,19/03/2019,2,Tra Rastignano e Pian di Macina (SP85 Fondo Valle Savena),12189,30,11935,251,9404,2785,12189,0
2019/03,154,20/03/2019,3,Tra Rastignano e Pian di Macina (SP85 Fondo Valle Savena),12036,30,11762,271,9215,2821,12036,0
2019/03,154,21/03/2019,4,Tra Rastignano e Pian di Macina (SP85 Fondo Valle Savena),12567,20,12276,289,9787,2780,12567,0
2019/03,154,22/03/2019,5,Tra Rastignano e Pian di Macina (SP85 Fondo Valle Savena),12977,00,12679,298,9978,2999,12977,0
2019/03,154,23/03/2019,6,Tra Rastignano e Pian di Macina (SP85 Fondo Valle Savena),11362,30,11292,67,8472,2890,0,11362
2019/03,154,24/03/2019,7,Tra Rastignano e Pian di Macina (SP85 Fondo Valle Savena),10788,10,10763,24,8268,2520,0,10788
2019/03,154,25/03/2019,1,Tra Rastignano e Pian di Macina (SP85 Fondo Valle Savena),11806,20,11560,244,9330,2476,11806,0
2019/03,154,26/03/2019,2,Tra Rastignano e Pian di Macina (SP85 Fondo Valle Savena),12197,40,11945,248,9566,2631,12197,0
2019/03,154,27/03/2019,3,Tra Rastignano e Pian di Macina (SP85 Fondo Valle Savena),12429,00,12169,260,9703,2726,12429,0
2019/03,154,28/03/2019,4,Tra Rastignano e Pian di Macina (SP85 Fondo Valle Savena),12595,20,12338,255,9782,2813,12595,0
2019/03,155,15/03/2019,5,Via Emilia tra San Lazzaro e Idice,16354,00,15841,513,12565,3789,16354,0
2019/03,155,16/03/2019,6,Via Emilia tra San Lazzaro e Idice,14708,20,14438,268,10714,3994,0,14708
2019/03,155,17/03/2019,7,Via Emilia tra San Lazzaro e Idice,11423,00,11350,73,8279,3144,0,11423
2019/03,155,18/03/2019,1,Via Emilia tra San Lazzaro e Idice,14560,00,14080,480,11567,2993,14560,0
2019/03,155,19/03/2019,2,Via Emilia tra San Lazzaro e Idice,15073,00,14580,493,11855,3218,15073,0
2019/03,155,20/03/2019,3,Via Emilia tra San Lazzaro e Idice,15443,20,14918,523,11980,3463,15443,0
2019/03,155,21/03/2019,4,Via Emilia tra San Lazzaro e Idice,15417,00,14916,501,11911,3506,15417,0
2019/03,155,22/03/2019,5,Via Emilia tra San Lazzaro e Idice,15896,20,15396,498,12088,3808,15896,0
2019/03,155,23/03/2019,6,Via Emilia tra San Lazzaro e Idice,14728,00,14457,271,10856,3872,0,14728
2019/03,155,24/03/2019,7,Via Emilia tra San Lazzaro e Idice,11655,00,11587,68,8326,3329,0,11655
2019/03,155,25/03/2019,1,Via Emilia tra San Lazzaro e Idice,14345,00,13879,466,11311,3034,14345,0
2019/03,155,26/03/2019,2,Via Emilia tra San Lazzaro e Idice,14862,00,14401,461,11659,3203,14862,0
2019/03,155,27/03/2019,3,Via Emilia tra San Lazzaro e Idice,15363,00,14882,481,12034,3329,15363,0
2019/03,155,28/03/2019,4,Via Emilia tra San Lazzaro e Idice,15272,10,14768,503,11792,3480,15272,0
2019/03,156,15/03/2019,5,SP 253 tra la località Villanova e inizio variante Castenaso,23167,00,22448,719,17902,5265,23167,0
2019/03,156,16/03/2019,6,SP 253 tra la località Villanova e inizio variante Castenaso,19861,00,19698,163,14644,5217,0,19861
2019/03,156,17/03/2019,7,SP 253 tra la località Villanova e inizio variante Castenaso,14792,20,14746,44,10901,3891,0,14792
2019/03,156,18/03/2019,1,SP 253 tra la località Villanova e inizio variante Castenaso,21414,10,20677,736,17111,4303,21414,0
2019/03,156,19/03/2019,2,SP 253 tra la località Villanova e inizio variante Castenaso,21882,00,21161,721,17254,4628,21882,0
2019/03,156,20/03/2019,3,SP 253 tra la località Villanova e inizio variante Castenaso,21416,00,20659,757,17316,4100,21416,0
2019/03,157,15/03/2019,5,Via San Donato (ex SP 5) tra Granarolo dell'Emilia e Quarto Inferiore,12378,00,12098,280,9359,3019,12378,0
2019/03,157,16/03/2019,6,Via San Donato (ex SP 5) tra Granarolo dell'Emilia e Quarto Inferiore,11295,10,11154,140,8372,2923,0,11295
2019/03,157,17/03/2019,7,Via San Donato (ex SP 5) tra Granarolo dell'Emilia e Quarto Inferiore,9155,10,9110,44,6582,2573,0,9155
2019/03,157,18/03/2019,1,Via San Donato (ex SP 5) tra Granarolo dell'Emilia e Quarto Inferiore,11628,00,11346,282,9249,2379,11628,0
2019/03,157,19/03/2019,2,Via San Donato (ex SP 5) tra Granarolo dell'Emilia e Quarto Inferiore,12199,10,11884,314,9512,2687,12199,0
2019/03,157,20/03/2019,3,Via San Donato (ex SP 5) tra Granarolo dell'Emilia e Quarto Inferiore,12130,00,11823,307,9464,2666,12130,0
2019/03,157,21/03/2019,4,Via San Donato (ex SP 5) tra Granarolo dell'Emilia e Quarto Inferiore,11997,20,11710,285,9196,2801,11997,0
2019/03,157,22/03/2019,5,Via San Donato (ex SP 5) tra Granarolo dell'Emilia e Quarto Inferiore,12587,10,12280,306,9681,2906,12587,0
2019/03,157,23/03/2019,6,Via San Donato (ex SP 5) tra Granarolo dell'Emilia e Quarto Inferiore,11481,00,11338,143,8472,3009,0,11481
2019/03,157,24/03/2019,7,Via San Donato (ex SP 5) tra Granarolo dell'Emilia e Quarto Inferiore,8778,10,8732,45,6302,2476,0,8778
2019/03,157,25/03/2019,1,Via San Donato (ex SP 5) tra Granarolo dell'Emilia e Quarto Inferiore,11701,00,11391,310,9299,2402,11701,0
2019/03,157,26/03/2019,2,Via San Donato (ex SP 5) tra Granarolo dell'Emilia e Quarto Inferiore,12030,00,11727,303,9459,2571,12030,0
2019/03,157,27/03/2019,3,Via San Donato (ex SP 5) tra Granarolo dell'Emilia e Quarto Inferiore,12109,10,11797,311,9418,2691,12109,0
2019/03,157,28/03/2019,4,Via San Donato (ex SP 5) tra Granarolo dell'Emilia e Quarto Inferiore,12066,00,11793,273,9397,2669,12066,0
2019/03,158,15/03/2019,5,SS 64 tra Bologna e Lovoleto,13550,30,12774,773,10131,3419,13550,0
2019/03,158,16/03/2019,6,SS 64 tra Bologna e Lovoleto,9806,00,9631,175,7069,2737,0,9806
2019/03,158,17/03/2019,7,SS 64 tra Bologna e Lovoleto,8187,00,8102,85,5760,2427,0,8187
2019/03,158,18/03/2019,1,SS 64 tra Bologna e Lovoleto,12120,30,11421,696,9503,2617,12120,0
2019/03,158,19/03/2019,2,SS 64 tra Bologna e Lovoleto,12861,00,11922,939,9375,3486,12861,0
2019/03,158,20/03/2019,3,SS 64 tra Bologna e Lovoleto,12215,00,11513,702,9390,2825,12215,0
2019/03,158,21/03/2019,4,SS 64 tra Bologna e Lovoleto,12298,10,11567,730,9360,2938,12298,0
2019/03,158,22/03/2019,5,SS 64 tra Bologna e Lovoleto,12342,10,11609,732,9308,3034,12342,0
2019/03,158,23/03/2019,6,SS 64 tra Bologna e Lovoleto,9563,00,9380,183,6815,2748,0,9563
2019/03,158,24/03/2019,7,SS 64 tra Bologna e Lovoleto,7590,00,7541,49,5351,2239,0,7590
2019/03,158,25/03/2019,1,SS 64 tra Bologna e Lovoleto,11777,00,11092,685,9263,2514,11777,0
2019/03,158,26/03/2019,2,SS 64 tra Bologna e Lovoleto,12400,00,11601,799,9632,2768,12400,0
2019/03,158,27/03/2019,3,SS 64 tra Bologna e Lovoleto,11986,10,11223,762,9153,2833,11986,0
2019/03,158,28/03/2019,4,SS 64 tra Bologna e Lovoleto,12371,10,11620,750,9317,3054,12371,0
2019/03,160,15/03/2019,5,SP 18 tra Bargellino e Calderara di Reno (c/o Variante SP18),20527,00,18652,1875,15833,4694,20527,0
2019/03,160,16/03/2019,6,SP 18 tra Bargellino e Calderara di Reno (c/o Variante SP18),13362,00,12961,401,9678,3684,0,13362
2019/03,160,17/03/2019,7,SP 18 tra Bargellino e Calderara di Reno (c/o Variante SP18),9373,00,9325,48,6774,2599,0,9373
2019/03,160,18/03/2019,1,SP 18 tra Bargellino e Calderara di Reno (c/o Variante SP18),18148,00,16664,1484,14576,3572,18148,0
2019/03,160,19/03/2019,2,SP 18 tra Bargellino e Calderara di Reno (c/o Variante SP18),19625,40,17728,1893,15289,4336,19625,0
2019/03,160,20/03/2019,3,SP 18 tra Bargellino e Calderara di Reno (c/o Variante SP18),18747,20,17110,1635,14768,3979,18747,0
2019/03,160,21/03/2019,4,SP 18 tra Bargellino e Calderara di Reno (c/o Variante SP18),19284,10,17501,1782,15072,4212,19284,0
2019/03,160,22/03/2019,5,SP 18 tra Bargellino e Calderara di Reno (c/o Variante SP18),19233,10,17546,1686,15027,4206,19233,0
2019/03,160,23/03/2019,6,SP 18 tra Bargellino e Calderara di Reno (c/o Variante SP18),13708,00,13322,386,9832,3876,0,13708
2019/03,160,24/03/2019,7,SP 18 tra Bargellino e Calderara di Reno (c/o Variante SP18),10794,00,10740,54,7967,2827,0,10794
2019/03,160,25/03/2019,1,SP 18 tra Bargellino e Calderara di Reno (c/o Variante SP18),19489,00,17812,1677,15926,3563,19489,0
2019/03,160,26/03/2019,2,SP 18 tra Bargellino e Calderara di Reno (c/o Variante SP18),18867,10,17161,1705,14832,4035,18867,0
2019/03,160,27/03/2019,3,SP 18 tra Bargellino e Calderara di Reno (c/o Variante SP18),18512,00,16843,1669,14622,3890,18512,0
2019/03,160,28/03/2019,4,SP 18 tra Bargellino e Calderara di Reno (c/o Variante SP18),19179,20,17429,1748,14967,4212,19179,0
2019/03,161,15/03/2019,5,SP 568 da Tavernelle all'intersezione della SP3,20382,00,19289,1093,14674,5708,20382,0
2019/03,161,16/03/2019,6,SP 568 da Tavernelle all'intersezione della SP3,18030,00,17779,251,11967,6063,0,18030
2019/03,161,17/03/2019,7,SP 568 da Tavernelle all'intersezione della SP3,14829,00,14761,68,10032,4797,0,14829
2019/03,161,18/03/2019,1,SP 568 da Tavernelle all'intersezione della SP3,18954,00,17922,1032,14572,4382,18954,0
2019/03,161,19/03/2019,2,SP 568 da Tavernelle all'intersezione della SP3,19234,00,18079,1155,14601,4633,19234,0
2019/03,161,20/03/2019,3,SP 568 da Tavernelle all'intersezione della SP3,19397,10,18306,1090,14702,4695,19397,0
2019/03,161,21/03/2019,4,SP 568 da Tavernelle all'intersezione della SP3,19668,00,18617,1051,14501,5167,19668,0
2019/03,161,22/03/2019,5,SP 568 da Tavernelle all'intersezione della SP3,20425,00,19344,1081,14862,5563,20425,0
2019/03,161,23/03/2019,6,SP 568 da Tavernelle all'intersezione della SP3,17524,00,17269,255,11886,5638,0,17524
2019/03,161,24/03/2019,7,SP 568 da Tavernelle all'intersezione della SP3,15295,00,15225,70,10502,4793,0,15295
2019/03,161,25/03/2019,1,SP 568 da Tavernelle all'intersezione della SP3,18150,00,17207,943,13703,4447,18150,0
2019/03,161,26/03/2019,2,SP 568 da Tavernelle all'intersezione della SP3,19006,00,17905,1101,14592,4414,19006,0
2019/03,161,27/03/2019,3,SP 568 da Tavernelle all'intersezione della SP3,19712,00,18615,1097,14864,4848,19712,0
2019/03,161,28/03/2019,4,SP 568 da Tavernelle all'intersezione della SP3,19706,10,18600,1105,14786,4920,19706,0
2019/03,162,15/03/2019,5,SS 9 località Cavazzona,19179,20,17417,1760,12957,6222,19179,0
2019/03,162,16/03/2019,6,SS 9 località Cavazzona,16892,30,16464,425,10862,6030,0,16892
2019/03,162,17/03/2019,7,SS 9 località Cavazzona,14929,10,14811,117,9528,5401,0,14929
2019/03,162,18/03/2019,1,SS 9 località Cavazzona,18649,40,16773,1872,13647,5002,18649,0
2019/03,162,19/03/2019,2,SS 9 località Cavazzona,18243,30,16399,1841,13108,5135,18243,0
2019/03,162,20/03/2019,3,SS 9 località Cavazzona,17828,10,16063,1764,12536,5292,17828,0
2019/03,162,21/03/2019,4,SS 9 località Cavazzona,17793,50,16039,1749,12475,5318,17793,0
2019/03,162,22/03/2019,5,SS 9 località Cavazzona,18919,70,17157,1755,12862,6057,18919,0
2019/03,162,23/03/2019,6,SS 9 località Cavazzona,16537,40,16108,425,10502,6035,0,16537
2019/03,162,24/03/2019,7,SS 9 località Cavazzona,14587,20,14463,122,9420,5167,0,14587
2019/03,162,25/03/2019,1,SS 9 località Cavazzona,17634,40,15987,1643,12513,5121,17634,0
2019/03,162,26/03/2019,2,SS 9 località Cavazzona,17371,20,15689,1680,12577,4794,17371,0
2019/03,162,27/03/2019,3,SS 9 località Cavazzona,17945,00,16132,1813,12594,5351,17945,0
2019/03,162,28/03/2019,4,SS 9 località Cavazzona,18795,50,16818,1972,13050,5745,18795,0
2019/03,170,15/03/2019,5,SS 67 tra Rovere e Forlì,10204,00,9687,517,7901,2303,10204,0
2019/03,170,16/03/2019,6,SS 67 tra Rovere e Forlì,9113,10,8932,180,6741,2372,0,9113
2019/03,170,17/03/2019,7,SS 67 tra Rovere e Forlì,7481,00,7444,37,5733,1748,0,7481
2019/03,170,18/03/2019,1,SS 67 tra Rovere e Forlì,9272,00,8800,472,7442,1830,9272,0
2019/03,170,19/03/2019,2,SS 67 tra Rovere e Forlì,9634,00,9156,478,7566,2068,9634,0
2019/03,170,20/03/2019,3,SS 67 tra Rovere e Forlì,9670,00,9190,480,7574,2096,9670,0
2019/03,170,21/03/2019,4,SS 67 tra Rovere e Forlì,9605,00,9170,435,7444,2161,9605,0
2019/03,170,22/03/2019,5,SS 67 tra Rovere e Forlì,10150,00,9644,506,7851,2299,10150,0
2019/03,170,23/03/2019,6,SS 67 tra Rovere e Forlì,8813,00,8622,191,6470,2343,0,8813
2019/03,170,24/03/2019,7,SS 67 tra Rovere e Forlì,7666,00,7619,47,5789,1877,0,7666
2019/03,170,25/03/2019,1,SS 67 tra Rovere e Forlì,9582,00,9049,533,7664,1918,9582,0
2019/03,170,26/03/2019,2,SS 67 tra Rovere e Forlì,9609,00,9149,460,7586,2023,9609,0
2019/03,170,27/03/2019,3,SS 67 tra Rovere e Forlì,9477,00,9042,435,7403,2074,9477,0
2019/03,170,28/03/2019,4,SS 67 tra Rovere e Forlì,9852,00,9421,431,7615,2237,9852,0
2019/03,171,15/03/2019,5,SP 56 tra Forlì e bivio SS67 (Castrocaro Terme),7607,00,7379,228,5857,1750,7607,0
2019/03,171,16/03/2019,6,SP 56 tra Forlì e bivio SS67 (Castrocaro Terme),7160,00,7082,78,5298,1862,0,7160
2019/03,171,17/03/2019,7,SP 56 tra Forlì e bivio SS67 (Castrocaro Terme),5826,00,5811,15,4473,1353,0,5826
2019/03,171,18/03/2019,1,SP 56 tra Forlì e bivio SS67 (Castrocaro Terme),7265,10,7067,197,5958,1307,7265,0
2019/03,171,19/03/2019,2,SP 56 tra Forlì e bivio SS67 (Castrocaro Terme),7173,00,6994,179,5622,1551,7173,0
2019/03,171,20/03/2019,3,SP 56 tra Forlì e bivio SS67 (Castrocaro Terme),7264,00,7047,217,5694,1570,7264,0
2019/03,171,21/03/2019,4,SP 56 tra Forlì e bivio SS67 (Castrocaro Terme),7398,00,7178,220,5802,1596,7398,0
2019/03,171,22/03/2019,5,SP 56 tra Forlì e bivio SS67 (Castrocaro Terme),7569,00,7393,176,5784,1785,7569,0
2019/03,171,23/03/2019,6,SP 56 tra Forlì e bivio SS67 (Castrocaro Terme),7092,10,7007,84,5210,1882,0,7092
2019/03,171,24/03/2019,7,SP 56 tra Forlì e bivio SS67 (Castrocaro Terme),5926,00,5902,24,4493,1433,0,5926
2019/03,171,25/03/2019,1,SP 56 tra Forlì e bivio SS67 (Castrocaro Terme),7202,00,6971,231,5746,1456,7202,0
2019/03,171,26/03/2019,2,SP 56 tra Forlì e bivio SS67 (Castrocaro Terme),7278,00,7062,216,5788,1490,7278,0
2019/03,171,27/03/2019,3,SP 56 tra Forlì e bivio SS67 (Castrocaro Terme),7430,00,7201,229,5862,1568,7430,0
2019/03,171,28/03/2019,4,SP 56 tra Forlì e bivio SS67 (Castrocaro Terme),7576,00,7383,193,5913,1663,7576,0
2019/03,173,15/03/2019,5,SP 4 tra Ronco (SS9) e bivio SP 72 (Para),8633,20,8123,508,6709,1924,8633,0
2019/03,173,16/03/2019,6,SP 4 tra Ronco (SS9) e bivio SP 72 (Para),6570,10,6407,162,4866,1704,0,6570
2019/03,173,17/03/2019,7,SP 4 tra Ronco (SS9) e bivio SP 72 (Para),5160,00,5123,37,3836,1324,0,5160
2019/03,173,18/03/2019,1,SP 4 tra Ronco (SS9) e bivio SP 72 (Para),8136,10,7663,472,6644,1492,8136,0
2019/03,173,19/03/2019,2,SP 4 tra Ronco (SS9) e bivio SP 72 (Para),8168,00,7736,432,6533,1635,8168,0
2019/03,173,20/03/2019,3,SP 4 tra Ronco (SS9) e bivio SP 72 (Para),8310,00,7804,506,6616,1694,8310,0
2019/03,173,21/03/2019,4,SP 4 tra Ronco (SS9) e bivio SP 72 (Para),8365,10,7820,544,6657,1708,8365,0
2019/03,173,22/03/2019,5,SP 4 tra Ronco (SS9) e bivio SP 72 (Para),8606,20,8141,463,6669,1937,8606,0
2019/03,173,23/03/2019,6,SP 4 tra Ronco (SS9) e bivio SP 72 (Para),6553,00,6394,159,4764,1789,0,6553
2019/03,173,24/03/2019,7,SP 4 tra Ronco (SS9) e bivio SP 72 (Para),5415,10,5374,40,4023,1392,0,5415
2019/03,173,25/03/2019,1,SP 4 tra Ronco (SS9) e bivio SP 72 (Para),8254,10,7730,523,6647,1607,8254,0
2019/03,173,26/03/2019,2,SP 4 tra Ronco (SS9) e bivio SP 72 (Para),8102,00,7633,469,6498,1604,8102,0
2019/03,173,27/03/2019,3,SP 4 tra Ronco (SS9) e bivio SP 72 (Para),8190,10,7643,546,6580,1610,8190,0
2019/03,173,28/03/2019,4,SP 4 tra Ronco (SS9) e bivio SP 72 (Para),8179,00,7726,453,6470,1709,8179,0
2019/03,174,15/03/2019,5,SS 9 tra Ronco e Forlimpopoli,,,,,,,,
2019/03,174,16/03/2019,6,SS 9 tra Ronco e Forlimpopoli,,,,,,,,
2019/03,174,17/03/2019,7,SS 9 tra Ronco e Forlimpopoli,,,,,,,,
2019/03,174,18/03/2019,1,SS 9 tra Ronco e Forlimpopoli,,,,,,,,
2019/03,174,19/03/2019,2,SS 9 tra Ronco e Forlimpopoli,,,,,,,,
2019/03,174,20/03/2019,3,SS 9 tra Ronco e Forlimpopoli,,,,,,,,
2019/03,174,21/03/2019,4,SS 9 tra Ronco e Forlimpopoli,,,,,,,,
2019/03,174,22/03/2019,5,SS 9 tra Ronco e Forlimpopoli,,,,,,,,
2019/03,174,23/03/2019,6,SS 9 tra Ronco e Forlimpopoli,,,,,,,,
2019/03,174,24/03/2019,7,SS 9 tra Ronco e Forlimpopoli,,,,,,,,
2019/03,174,25/03/2019,1,SS 9 tra Ronco e Forlimpopoli,,,,,,,,
2019/03,174,26/03/2019,2,SS 9 tra Ronco e Forlimpopoli,,,,,,,,
2019/03,174,27/03/2019,3,SS 9 tra Ronco e Forlimpopoli,,,,,,,,
2019/03,174,28/03/2019,4,SS 9 tra Ronco e Forlimpopoli,,,,,,,,
2019/03,176,15/03/2019,5,SP 2 in località La Caserma al Confine Provinciale,9511,00,8734,777,7301,2210,9511,0
2019/03,176,16/03/2019,6,SP 2 in località La Caserma al Confine Provinciale,10613,10,10450,162,7757,2856,0,10613
2019/03,176,17/03/2019,7,SP 2 in località La Caserma al Confine Provinciale,13091,00,13055,36,10639,2452,0,13091
2019/03,176,18/03/2019,1,SP 2 in località La Caserma al Confine Provinciale,7957,10,7275,681,6382,1575,7957,0
2019/03,176,19/03/2019,2,SP 2 in località La Caserma al Confine Provinciale,8256,00,7601,655,6592,1664,8256,0
2019/03,176,20/03/2019,3,SP 2 in località La Caserma al Confine Provinciale,8745,00,8056,689,7029,1716,8745,0
2019/03,176,21/03/2019,4,SP 2 in località La Caserma al Confine Provinciale,9304,00,8509,795,7407,1897,9304,0
2019/03,176,22/03/2019,5,SP 2 in località La Caserma al Confine Provinciale,9807,00,9047,760,7390,2417,9807,0
2019/03,176,23/03/2019,6,SP 2 in località La Caserma al Confine Provinciale,10938,00,10719,219,7852,3086,0,10938
2019/03,176,24/03/2019,7,SP 2 in località La Caserma al Confine Provinciale,13798,00,13759,39,10900,2898,0,13798
2019/03,176,25/03/2019,1,SP 2 in località La Caserma al Confine Provinciale,8864,00,8078,786,7201,1663,8864,0
2019/03,176,26/03/2019,2,SP 2 in località La Caserma al Confine Provinciale,8668,20,7911,755,6979,1689,8668,0
2019/03,176,27/03/2019,3,SP 2 in località La Caserma al Confine Provinciale,9039,00,8337,702,7227,1812,9039,0
2019/03,176,28/03/2019,4,SP 2 in località La Caserma al Confine Provinciale,9770,10,8991,778,7756,2014,9770,0
2019/03,177,15/03/2019,5,NSA 313 - Prosecuzione tangenziale di Bologna complanare sud alla A 14 nel tratto San Lazzaro/Idice,17927,10,17111,815,13139,4788,17927,0
2019/03,177,16/03/2019,6,NSA 313 - Prosecuzione tangenziale di Bologna complanare sud alla A 14 nel tratto San Lazzaro/Idice,13670,00,13474,196,9303,4367,0,13670
2019/03,177,17/03/2019,7,NSA 313 - Prosecuzione tangenziale di Bologna complanare sud alla A 14 nel tratto San Lazzaro/Idice,11956,10,11896,59,7924,4032,0,11956
2019/03,177,18/03/2019,1,NSA 313 - Prosecuzione tangenziale di Bologna complanare sud alla A 14 nel tratto San Lazzaro/Idice,16415,00,15642,773,12503,3912,16415,0
2019/03,177,19/03/2019,2,NSA 313 - Prosecuzione tangenziale di Bologna complanare sud alla A 14 nel tratto San Lazzaro/Idice,16807,10,15997,809,12639,4168,16807,0
2019/03,177,20/03/2019,3,NSA 313 - Prosecuzione tangenziale di Bologna complanare sud alla A 14 nel tratto San Lazzaro/Idice,17465,00,16548,917,13115,4350,17465,0
2019/03,177,21/03/2019,4,NSA 313 - Prosecuzione tangenziale di Bologna complanare sud alla A 14 nel tratto San Lazzaro/Idice,17321,10,16509,811,12962,4359,17321,0
2019/03,177,22/03/2019,5,NSA 313 - Prosecuzione tangenziale di Bologna complanare sud alla A 14 nel tratto San Lazzaro/Idice,17513,00,16690,823,13142,4371,17513,0
2019/03,177,23/03/2019,6,NSA 313 - Prosecuzione tangenziale di Bologna complanare sud alla A 14 nel tratto San Lazzaro/Idice,14168,10,13962,205,9977,4191,0,14168
2019/03,177,24/03/2019,7,NSA 313 - Prosecuzione tangenziale di Bologna complanare sud alla A 14 nel tratto San Lazzaro/Idice,11793,10,11735,57,7927,3866,0,11793
2019/03,177,25/03/2019,1,NSA 313 - Prosecuzione tangenziale di Bologna complanare sud alla A 14 nel tratto San Lazzaro/Idice,16576,00,15758,818,12659,3917,16576,0
2019/03,177,26/03/2019,2,NSA 313 - Prosecuzione tangenziale di Bologna complanare sud alla A 14 nel tratto San Lazzaro/Idice,16895,00,16080,815,12836,4059,16895,0
2019/03,177,27/03/2019,3,NSA 313 - Prosecuzione tangenziale di Bologna complanare sud alla A 14 nel tratto San Lazzaro/Idice,17281,10,16452,828,12995,4286,17281,0
2019/03,177,28/03/2019,4,NSA 313 - Prosecuzione tangenziale di Bologna complanare sud alla A 14 nel tratto San Lazzaro/Idice,17308,00,16508,800,12802,4506,17308,0
2019/03,182,15/03/2019,5,SP 258R tra Rimini e A 14,17844,00,17140,704,13196,4648,17844,0
2019/03,182,16/03/2019,6,SP 258R tra Rimini e A 14,16513,10,16255,257,11612,4901,0,16513
2019/03,182,17/03/2019,7,SP 258R tra Rimini e A 14,14598,20,14537,59,10511,4087,0,14598
2019/03,182,18/03/2019,1,SP 258R tra Rimini e A 14,16346,30,15635,708,12759,3587,16346,0
2019/03,182,19/03/2019,2,SP 258R tra Rimini e A 14,17009,20,16309,698,13250,3759,17009,0
2019/03,182,20/03/2019,3,SP 258R tra Rimini e A 14,16988,10,16245,742,13186,3802,16988,0
2019/03,182,21/03/2019,4,SP 258R tra Rimini e A 14,17285,10,16560,724,13232,4053,17285,0
2019/03,182,22/03/2019,5,SP 258R tra Rimini e A 14,17824,00,17129,695,13388,4436,17824,0
2019/03,182,23/03/2019,6,SP 258R tra Rimini e A 14,16573,10,16312,260,11676,4897,0,16573
2019/03,182,24/03/2019,7,SP 258R tra Rimini e A 14,15132,10,15071,60,10869,4263,0,15132
2019/03,182,25/03/2019,1,SP 258R tra Rimini e A 14,17088,20,16365,721,13313,3775,17088,0
2019/03,182,26/03/2019,2,SP 258R tra Rimini e A 14,16938,10,16248,689,13171,3767,16938,0
2019/03,182,27/03/2019,3,SP 258R tra Rimini e A 14,17125,30,16436,686,13261,3864,17125,0
2019/03,182,28/03/2019,4,SP 258R tra Rimini e A 14,17358,00,16605,753,13289,4069,17358,0
2019/03,186,15/03/2019,5,SS 16 tra Rimini e Igea Marina-Viserba,30448,10,29042,1405,23206,7242,30448,0
2019/03,186,16/03/2019,6,SS 16 tra Rimini e Igea Marina-Viserba,28225,30,27733,489,20171,8054,0,28225
2019/03,186,17/03/2019,7,SS 16 tra Rimini e Igea Marina-Viserba,25907,10,25739,167,18745,7162,0,25907
2019/03,186,18/03/2019,1,SS 16 tra Rimini e Igea Marina-Viserba,27594,00,26238,1356,21856,5738,27594,0
2019/03,186,19/03/2019,2,SS 16 tra Rimini e Igea Marina-Viserba,28726,20,27399,1325,22423,6303,28726,0
2019/03,186,20/03/2019,3,SS 16 tra Rimini e Igea Marina-Viserba,29305,00,27934,1371,22611,6694,29305,0
2019/03,186,21/03/2019,4,SS 16 tra Rimini e Igea Marina-Viserba,29713,10,28332,1380,22625,7088,29713,0
2019/03,186,22/03/2019,5,SS 16 tra Rimini e Igea Marina-Viserba,31692,40,30302,1386,24259,7433,31692,0
2019/03,186,23/03/2019,6,SS 16 tra Rimini e Igea Marina-Viserba,29724,40,29157,563,21435,8289,0,29724
2019/03,186,24/03/2019,7,SS 16 tra Rimini e Igea Marina-Viserba,26385,10,26162,222,18604,7781,0,26385
2019/03,186,25/03/2019,1,SS 16 tra Rimini e Igea Marina-Viserba,29477,20,28085,1390,23100,6377,29477,0
2019/03,186,26/03/2019,2,SS 16 tra Rimini e Igea Marina-Viserba,28893,10,27390,1502,22767,6126,28893,0
2019/03,186,27/03/2019,3,SS 16 tra Rimini e Igea Marina-Viserba,28788,00,27348,1440,22410,6378,28788,0
2019/03,186,28/03/2019,4,SS 16 tra Rimini e Igea Marina-Viserba,29445,40,27986,1455,22628,6817,29445,0
2019/03,188,15/03/2019,5,SS 9 tra Rimini e Santa Giustina,29909,40,28654,1251,22832,7077,29909,0
2019/03,188,16/03/2019,6,SS 9 tra Rimini e Santa Giustina,24783,10,24264,518,17414,7369,0,24783
2019/03,188,17/03/2019,7,SS 9 tra Rimini e Santa Giustina,19851,00,19678,173,14215,5636,0,19851
2019/03,188,18/03/2019,1,SS 9 tra Rimini e Santa Giustina,27738,00,26526,1212,22048,5690,27738,0
2019/03,188,19/03/2019,2,SS 9 tra Rimini e Santa Giustina,28196,20,27045,1149,22151,6045,28196,0
2019/03,188,20/03/2019,3,SS 9 tra Rimini e Santa Giustina,28734,10,27599,1134,22012,6722,28734,0
2019/03,188,21/03/2019,4,SS 9 tra Rimini e Santa Giustina,28836,10,27615,1220,22109,6727,28836,0
2019/03,188,22/03/2019,5,SS 9 tra Rimini e Santa Giustina,29561,10,28430,1130,22296,7265,29561,0
2019/03,188,23/03/2019,6,SS 9 tra Rimini e Santa Giustina,25099,30,24559,537,17780,7319,0,25099
2019/03,188,24/03/2019,7,SS 9 tra Rimini e Santa Giustina,20598,20,20442,154,14368,6230,0,20598
2019/03,188,25/03/2019,1,SS 9 tra Rimini e Santa Giustina,28107,20,26892,1213,22006,6101,28107,0
2019/03,188,26/03/2019,2,SS 9 tra Rimini e Santa Giustina,28205,10,26938,1266,22036,6169,28205,0
2019/03,188,27/03/2019,3,SS 9 tra Rimini e Santa Giustina,28631,00,27317,1314,22134,6497,28631,0
2019/03,188,28/03/2019,4,SS 9 tra Rimini e Santa Giustina,28918,50,27834,1079,22172,6746,28918,0
2019/03,215,15/03/2019,5,SP 3_1 tra accesso interporto Bologna e viadotto A 13,31213,60,23957,7250,22374,8839,31213,0
2019/03,215,16/03/2019,6,SP 3_1 tra accesso interporto Bologna e viadotto A 13,17260,00,15581,1679,11814,5446,0,17260
2019/03,215,17/03/2019,7,SP 3_1 tra accesso interporto Bologna e viadotto A 13,14180,00,13974,206,10471,3709,0,14180
2019/03,215,18/03/2019,1,SP 3_1 tra accesso interporto Bologna e viadotto A 13,27901,60,21903,5992,21481,6420,27901,0
2019/03,215,19/03/2019,2,SP 3_1 tra accesso interporto Bologna e viadotto A 13,30304,100,22930,7364,21881,8423,30304,0
2019/03,215,20/03/2019,3,SP 3_1 tra accesso interporto Bologna e viadotto A 13,29510,180,22346,7146,21496,8014,29510,0
2019/03,215,21/03/2019,4,SP 3_1 tra accesso interporto Bologna e viadotto A 13,29806,90,22497,7300,21798,8008,29806,0
2019/03,215,22/03/2019,5,SP 3_1 tra accesso interporto Bologna e viadotto A 13,30497,30,23214,7280,22194,8303,30497,0
2019/03,215,23/03/2019,6,SP 3_1 tra accesso interporto Bologna e viadotto A 13,16732,40,15138,1590,11300,5432,0,16732
2019/03,215,24/03/2019,7,SP 3_1 tra accesso interporto Bologna e viadotto A 13,13425,10,13273,151,9574,3851,0,13425
2019/03,215,25/03/2019,1,SP 3_1 tra accesso interporto Bologna e viadotto A 13,27707,30,21655,6049,21232,6475,27707,0
2019/03,215,26/03/2019,2,SP 3_1 tra accesso interporto Bologna e viadotto A 13,29371,60,22242,7123,21748,7623,29371,0
2019/03,215,27/03/2019,3,SP 3_1 tra accesso interporto Bologna e viadotto A 13,29619,120,22240,7367,21678,7941,29619,0
2019/03,215,28/03/2019,4,SP 3_1 tra accesso interporto Bologna e viadotto A 13,30100,80,22719,7373,21822,8278,30100,0
2019/03,218,15/03/2019,5,SP 10 tra Polesine e Roccabianca su variante Zibello,2659,00,2206,453,2075,584,2659,0
2019/03,218,16/03/2019,6,SP 10 tra Polesine e Roccabianca su variante Zibello,2068,00,1957,111,1543,525,0,2068
2019/03,218,17/03/2019,7,SP 10 tra Polesine e Roccabianca su variante Zibello,2119,10,2079,39,1689,430,0,2119
2019/03,218,18/03/2019,1,SP 10 tra Polesine e Roccabianca su variante Zibello,2407,00,2040,367,1967,440,2407,0
2019/03,218,19/03/2019,2,SP 10 tra Polesine e Roccabianca su variante Zibello,2448,00,2102,346,1961,487,2448,0
2019/03,218,20/03/2019,3,SP 10 tra Polesine e Roccabianca su variante Zibello,2540,10,2122,417,2036,504,2540,0
2019/03,218,21/03/2019,4,SP 10 tra Polesine e Roccabianca su variante Zibello,2620,10,2213,406,2068,552,2620,0
2019/03,218,22/03/2019,5,SP 10 tra Polesine e Roccabianca su variante Zibello,2733,00,2309,424,2145,588,2733,0
2019/03,218,23/03/2019,6,SP 10 tra Polesine e Roccabianca su variante Zibello,1997,00,1903,94,1444,553,0,1997
2019/03,218,24/03/2019,7,SP 10 tra Polesine e Roccabianca su variante Zibello,1937,00,1903,34,1505,432,0,1937
2019/03,218,25/03/2019,1,SP 10 tra Polesine e Roccabianca su variante Zibello,2488,00,2074,414,2039,449,2488,0
2019/03,218,26/03/2019,2,SP 10 tra Polesine e Roccabianca su variante Zibello,2830,00,2350,480,2302,528,2830,0
2019/03,218,27/03/2019,3,SP 10 tra Polesine e Roccabianca su variante Zibello,2446,00,2057,389,1956,490,2446,0
2019/03,218,28/03/2019,4,SP 10 tra Polesine e Roccabianca su variante Zibello,3124,00,2676,448,2546,578,3124,0
2019/03,219,19/03/2019,2,SS 9 tra Fiorenzuola d'Arda e Pontenure,16349,70,15035,1307,13695,2654,16349,0
2019/03,220,15/03/2019,5,SS 9 tra Fiorenzuola d'Arda e Fidenza al confine provinciale,,,,,,,,
2019/03,220,16/03/2019,6,SS 9 tra Fiorenzuola d'Arda e Fidenza al confine provinciale,,,,,,,,
2019/03,220,17/03/2019,7,SS 9 tra Fiorenzuola d'Arda e Fidenza al confine provinciale,,,,,,,,
2019/03,220,18/03/2019,1,SS 9 tra Fiorenzuola d'Arda e Fidenza al confine provinciale,,,,,,,,
2019/03,220,19/03/2019,2,SS 9 tra Fiorenzuola d'Arda e Fidenza al confine provinciale,14198,00,12617,1581,11256,2942,14198,0
2019/03,220,20/03/2019,3,SS 9 tra Fiorenzuola d'Arda e Fidenza al confine provinciale,14360,00,12601,1759,11251,3109,14360,0
2019/03,220,21/03/2019,4,SS 9 tra Fiorenzuola d'Arda e Fidenza al confine provinciale,14266,00,12570,1696,11084,3182,14266,0
2019/03,220,22/03/2019,5,SS 9 tra Fiorenzuola d'Arda e Fidenza al confine provinciale,15322,00,13502,1820,11666,3656,15322,0
2019/03,220,23/03/2019,6,SS 9 tra Fiorenzuola d'Arda e Fidenza al confine provinciale,14201,10,13738,462,10138,4063,0,14201
2019/03,220,24/03/2019,7,SS 9 tra Fiorenzuola d'Arda e Fidenza al confine provinciale,13148,00,13055,93,9961,3187,0,13148
2019/03,220,25/03/2019,1,SS 9 tra Fiorenzuola d'Arda e Fidenza al confine provinciale,13509,2220,11573,1714,10709,2800,13509,0
2019/03,220,26/03/2019,2,SS 9 tra Fiorenzuola d'Arda e Fidenza al confine provinciale,15572,50,13152,2415,12831,2741,15572,0
2019/03,220,27/03/2019,3,SS 9 tra Fiorenzuola d'Arda e Fidenza al confine provinciale,14649,10,12780,1868,11586,3063,14649,0
2019/03,220,28/03/2019,4,SS 9 tra Fiorenzuola d'Arda e Fidenza al confine provinciale,16959,20,14881,2076,13636,3323,16959,0
2019/03,222,15/03/2019,5,SP 359R tra Fidenza e Salsomaggiore Terme,17251,150,16784,452,12774,4477,17251,0
2019/03,222,16/03/2019,6,SP 359R tra Fidenza e Salsomaggiore Terme,15914,130,15641,260,11068,4846,0,15914
2019/03,222,17/03/2019,7,SP 359R tra Fidenza e Salsomaggiore Terme,12417,00,12367,50,8707,3710,0,12417
2019/03,222,18/03/2019,1,SP 359R tra Fidenza e Salsomaggiore Terme,16289,80,15835,446,12672,3617,16289,0
2019/03,222,19/03/2019,2,SP 359R tra Fidenza e Salsomaggiore Terme,16979,130,16454,512,13011,3968,16979,0
2019/03,222,20/03/2019,3,SP 359R tra Fidenza e Salsomaggiore Terme,16729,40,16279,446,12652,4077,16729,0
2019/03,222,21/03/2019,4,SP 359R tra Fidenza e Salsomaggiore Terme,16748,110,16290,447,12756,3992,16748,0
2019/03,222,22/03/2019,5,SP 359R tra Fidenza e Salsomaggiore Terme,17276,80,16819,449,12834,4442,17276,0
2019/03,222,23/03/2019,6,SP 359R tra Fidenza e Salsomaggiore Terme,15854,30,15590,261,11161,4693,0,15854
2019/03,222,24/03/2019,7,SP 359R tra Fidenza e Salsomaggiore Terme,12895,00,12840,55,9039,3856,0,12895
2019/03,222,25/03/2019,1,SP 359R tra Fidenza e Salsomaggiore Terme,16231,90,15800,422,12636,3595,16231,0
2019/03,222,26/03/2019,2,SP 359R tra Fidenza e Salsomaggiore Terme,16768,120,16299,457,12910,3858,16768,0
2019/03,222,27/03/2019,3,SP 359R tra Fidenza e Salsomaggiore Terme,16812,80,16305,499,12746,4066,16812,0
2019/03,222,28/03/2019,4,SP 359R tra Fidenza e Salsomaggiore Terme,17423,50,16911,507,13051,4372,17423,0
2019/03,223,15/03/2019,5,SP 357R tra SS 9 e Noceto,11053,10,9683,1369,8456,2597,11053,0
2019/03,223,16/03/2019,6,SP 357R tra SS 9 e Noceto,9212,00,8846,366,6640,2572,0,9212
2019/03,223,17/03/2019,7,SP 357R tra SS 9 e Noceto,7351,00,7267,84,5393,1958,0,7351
2019/03,223,18/03/2019,1,SP 357R tra SS 9 e Noceto,10728,00,9364,1364,8409,2319,10728,0
2019/03,223,19/03/2019,2,SP 357R tra SS 9 e Noceto,11026,10,9732,1293,8624,2402,11026,0
2019/03,223,20/03/2019,3,SP 357R tra SS 9 e Noceto,10909,10,9560,1348,8443,2466,10909,0
2019/03,223,21/03/2019,4,SP 357R tra SS 9 e Noceto,10823,00,9479,1344,8359,2464,10823,0
2019/03,223,22/03/2019,5,SP 357R tra SS 9 e Noceto,11193,10,9859,1333,8480,2713,11193,0
2019/03,223,23/03/2019,6,SP 357R tra SS 9 e Noceto,9190,00,8828,362,6565,2625,0,9190
2019/03,223,24/03/2019,7,SP 357R tra SS 9 e Noceto,7233,10,7126,106,5182,2051,0,7233
2019/03,223,25/03/2019,1,SP 357R tra SS 9 e Noceto,10872,00,9518,1354,8581,2291,10872,0
2019/03,223,26/03/2019,2,SP 357R tra SS 9 e Noceto,11060,00,9638,1422,8783,2277,11060,0
2019/03,223,27/03/2019,3,SP 357R tra SS 9 e Noceto,11017,00,9652,1365,8542,2475,11017,0
2019/03,223,28/03/2019,4,SP 357R tra SS 9 e Noceto,11384,00,10056,1328,8845,2539,11384,0
2019/03,226,15/03/2019,5,SP 32 dal bivio SP 16 (per Langhirano) al bivio SP 665R,12474,20,11549,923,9642,2832,12474,0
2019/03,226,16/03/2019,6,SP 32 dal bivio SP 16 (per Langhirano) al bivio SP 665R,9890,10,9612,277,7194,2696,0,9890
2019/03,226,17/03/2019,7,SP 32 dal bivio SP 16 (per Langhirano) al bivio SP 665R,8675,10,8566,108,6637,2038,0,8675
2019/03,226,18/03/2019,1,SP 32 dal bivio SP 16 (per Langhirano) al bivio SP 665R,11482,10,10641,840,9330,2152,11482,0
2019/03,226,19/03/2019,2,SP 32 dal bivio SP 16 (per Langhirano) al bivio SP 665R,12223,00,11356,867,9818,2405,12223,0
2019/03,226,20/03/2019,3,SP 32 dal bivio SP 16 (per Langhirano) al bivio SP 665R,12343,00,11396,947,9895,2448,12343,0
2019/03,226,21/03/2019,4,SP 32 dal bivio SP 16 (per Langhirano) al bivio SP 665R,12249,10,11334,914,9745,2504,12249,0
2019/03,226,22/03/2019,5,SP 32 dal bivio SP 16 (per Langhirano) al bivio SP 665R,12653,10,11713,939,9843,2810,12653,0
2019/03,226,23/03/2019,6,SP 32 dal bivio SP 16 (per Langhirano) al bivio SP 665R,9952,00,9699,253,7245,2707,0,9952
2019/03,226,24/03/2019,7,SP 32 dal bivio SP 16 (per Langhirano) al bivio SP 665R,9361,10,9258,102,7153,2208,0,9361
2019/03,226,25/03/2019,1,SP 32 dal bivio SP 16 (per Langhirano) al bivio SP 665R,11590,10,10742,847,9303,2287,11590,0
2019/03,226,26/03/2019,2,SP 32 dal bivio SP 16 (per Langhirano) al bivio SP 665R,12128,10,11309,818,9748,2380,12128,0
2019/03,226,27/03/2019,3,SP 32 dal bivio SP 16 (per Langhirano) al bivio SP 665R,11932,00,11092,840,9525,2407,11932,0
2019/03,226,28/03/2019,4,SP 32 dal bivio SP 16 (per Langhirano) al bivio SP 665R,12197,40,11266,927,9661,2536,12197,0
2019/03,227,15/03/2019,5,SP 34 da Colorno al bivio SP 60 (al confine provinciale),6153,10,5948,204,4808,1345,6153,0
2019/03,227,16/03/2019,6,SP 34 da Colorno al bivio SP 60 (al confine provinciale),5205,10,5109,95,3923,1282,0,5205
2019/03,227,17/03/2019,7,SP 34 da Colorno al bivio SP 60 (al confine provinciale),3724,00,3690,34,2807,917,0,3724
2019/03,227,18/03/2019,1,SP 34 da Colorno al bivio SP 60 (al confine provinciale),6031,00,5803,228,4886,1145,6031,0
2019/03,227,19/03/2019,2,SP 34 da Colorno al bivio SP 60 (al confine provinciale),6344,10,6119,224,5057,1287,6344,0
2019/03,227,20/03/2019,3,SP 34 da Colorno al bivio SP 60 (al confine provinciale),6395,00,6163,232,5105,1290,6395,0
2019/03,227,21/03/2019,4,SP 34 da Colorno al bivio SP 60 (al confine provinciale),6242,00,6030,212,4934,1308,6242,0
2019/03,227,22/03/2019,5,SP 34 da Colorno al bivio SP 60 (al confine provinciale),6298,00,6091,207,4906,1392,6298,0
2019/03,227,23/03/2019,6,SP 34 da Colorno al bivio SP 60 (al confine provinciale),5145,00,5039,106,3864,1281,0,5145
2019/03,227,24/03/2019,7,SP 34 da Colorno al bivio SP 60 (al confine provinciale),4390,00,4365,25,3319,1071,0,4390
2019/03,227,25/03/2019,1,SP 34 da Colorno al bivio SP 60 (al confine provinciale),5882,10,5667,214,4719,1163,5882,0
2019/03,227,26/03/2019,2,SP 34 da Colorno al bivio SP 60 (al confine provinciale),6085,10,5873,211,4868,1217,6085,0
2019/03,227,27/03/2019,3,SP 34 da Colorno al bivio SP 60 (al confine provinciale),6184,00,5909,275,4837,1347,6184,0
2019/03,227,28/03/2019,4,SP 34 da Colorno al bivio SP 60 (al confine provinciale),6563,00,6332,231,5197,1366,6563,0
2019/03,228,15/03/2019,5,SP 62R tra Brescello (bivio SP 41) e Sorbolo (bivio SP 20),12242,10,10329,1912,9366,2876,12242,0
2019/03,228,16/03/2019,6,SP 62R tra Brescello (bivio SP 41) e Sorbolo (bivio SP 20),10428,10,10039,388,7665,2763,0,10428
2019/03,228,17/03/2019,7,SP 62R tra Brescello (bivio SP 41) e Sorbolo (bivio SP 20),10205,00,10105,100,7243,2962,0,10205
2019/03,228,18/03/2019,1,SP 62R tra Brescello (bivio SP 41) e Sorbolo (bivio SP 20),11462,20,9419,2041,9068,2394,11462,0
2019/03,228,19/03/2019,2,SP 62R tra Brescello (bivio SP 41) e Sorbolo (bivio SP 20),11398,30,9308,2087,9058,2340,11398,0
2019/03,228,20/03/2019,3,SP 62R tra Brescello (bivio SP 41) e Sorbolo (bivio SP 20),11497,50,9413,2079,9043,2454,11497,0
2019/03,228,21/03/2019,4,SP 62R tra Brescello (bivio SP 41) e Sorbolo (bivio SP 20),12060,20,9877,2181,9536,2524,12060,0
2019/03,228,22/03/2019,5,SP 62R tra Brescello (bivio SP 41) e Sorbolo (bivio SP 20),12258,10,10305,1952,9436,2822,12258,0
2019/03,228,23/03/2019,6,SP 62R tra Brescello (bivio SP 41) e Sorbolo (bivio SP 20),10382,10,9974,407,7476,2906,0,10382
2019/03,228,24/03/2019,7,SP 62R tra Brescello (bivio SP 41) e Sorbolo (bivio SP 20),10138,20,10028,108,7057,3081,0,10138
2019/03,228,25/03/2019,1,SP 62R tra Brescello (bivio SP 41) e Sorbolo (bivio SP 20),11112,20,9154,1956,8835,2277,11112,0
2019/03,228,26/03/2019,2,SP 62R tra Brescello (bivio SP 41) e Sorbolo (bivio SP 20),10822,10,8769,2052,8996,1826,10822,0
2019/03,228,27/03/2019,3,SP 62R tra Brescello (bivio SP 41) e Sorbolo (bivio SP 20),8822,20,7380,1440,7250,1572,8822,0
2019/03,228,28/03/2019,4,SP 62R tra Brescello (bivio SP 41) e Sorbolo (bivio SP 20),12227,00,10046,2181,9575,2652,12227,0
2019/03,229,15/03/2019,5,SP 111 tra bivio SP 1 (a nord di Poviglio) e Boretto (innesto variante),,,,,,,,
2019/03,229,16/03/2019,6,SP 111 tra bivio SP 1 (a nord di Poviglio) e Boretto (innesto variante),,,,,,,,
2019/03,229,17/03/2019,7,SP 111 tra bivio SP 1 (a nord di Poviglio) e Boretto (innesto variante),,,,,,,,
2019/03,229,18/03/2019,1,SP 111 tra bivio SP 1 (a nord di Poviglio) e Boretto (innesto variante),,,,,,,,
2019/03,229,19/03/2019,2,SP 111 tra bivio SP 1 (a nord di Poviglio) e Boretto (innesto variante),,,,,,,,
2019/03,229,20/03/2019,3,SP 111 tra bivio SP 1 (a nord di Poviglio) e Boretto (innesto variante),,,,,,,,
2019/03,229,21/03/2019,4,SP 111 tra bivio SP 1 (a nord di Poviglio) e Boretto (innesto variante),,,,,,,,
2019/03,229,22/03/2019,5,SP 111 tra bivio SP 1 (a nord di Poviglio) e Boretto (innesto variante),,,,,,,,
2019/03,229,23/03/2019,6,SP 111 tra bivio SP 1 (a nord di Poviglio) e Boretto (innesto variante),,,,,,,,
2019/03,229,24/03/2019,7,SP 111 tra bivio SP 1 (a nord di Poviglio) e Boretto (innesto variante),,,,,,,,
2019/03,229,25/03/2019,1,SP 111 tra bivio SP 1 (a nord di Poviglio) e Boretto (innesto variante),,,,,,,,
2019/03,229,26/03/2019,2,SP 111 tra bivio SP 1 (a nord di Poviglio) e Boretto (innesto variante),,,,,,,,
2019/03,229,27/03/2019,3,SP 111 tra bivio SP 1 (a nord di Poviglio) e Boretto (innesto variante),,,,,,,,
2019/03,229,28/03/2019,4,SP 111 tra bivio SP 1 (a nord di Poviglio) e Boretto (innesto variante),,,,,,,,
2019/03,230,15/03/2019,5,SP 62RVar Cispadana da Boretto (bivio Variante SP 358R) a Gualtieri (bivio SP 63R),12316,00,9714,2602,9467,2849,12316,0
2019/03,230,16/03/2019,6,SP 62RVar Cispadana da Boretto (bivio Variante SP 358R) a Gualtieri (bivio SP 63R),9277,00,8816,461,6758,2519,0,9277
2019/03,230,17/03/2019,7,SP 62RVar Cispadana da Boretto (bivio Variante SP 358R) a Gualtieri (bivio SP 63R),8962,00,8833,129,6406,2556,0,8962
2019/03,230,18/03/2019,1,SP 62RVar Cispadana da Boretto (bivio Variante SP 358R) a Gualtieri (bivio SP 63R),11516,10,8879,2636,9188,2328,11516,0
2019/03,230,19/03/2019,2,SP 62RVar Cispadana da Boretto (bivio Variante SP 358R) a Gualtieri (bivio SP 63R),11673,00,8937,2736,9333,2340,11673,0
2019/03,230,20/03/2019,3,SP 62RVar Cispadana da Boretto (bivio Variante SP 358R) a Gualtieri (bivio SP 63R),11785,00,9025,2760,9347,2438,11785,0
2019/03,230,21/03/2019,4,SP 62RVar Cispadana da Boretto (bivio Variante SP 358R) a Gualtieri (bivio SP 63R),12116,00,9286,2830,9629,2487,12116,0
2019/03,230,22/03/2019,5,SP 62RVar Cispadana da Boretto (bivio Variante SP 358R) a Gualtieri (bivio SP 63R),12102,00,9548,2554,9362,2740,12102,0
2019/03,230,23/03/2019,6,SP 62RVar Cispadana da Boretto (bivio Variante SP 358R) a Gualtieri (bivio SP 63R),9118,10,8636,481,6635,2483,0,9118
2019/03,230,24/03/2019,7,SP 62RVar Cispadana da Boretto (bivio Variante SP 358R) a Gualtieri (bivio SP 63R),9770,00,9638,132,6834,2936,0,9770
2019/03,230,25/03/2019,1,SP 62RVar Cispadana da Boretto (bivio Variante SP 358R) a Gualtieri (bivio SP 63R),11358,00,8696,2662,9071,2287,11358,0
2019/03,230,26/03/2019,2,SP 62RVar Cispadana da Boretto (bivio Variante SP 358R) a Gualtieri (bivio SP 63R),11647,00,8859,2788,9281,2366,11647,0
2019/03,230,27/03/2019,3,SP 62RVar Cispadana da Boretto (bivio Variante SP 358R) a Gualtieri (bivio SP 63R),11920,00,9098,2822,9490,2430,11920,0
2019/03,230,28/03/2019,4,SP 62RVar Cispadana da Boretto (bivio Variante SP 358R) a Gualtieri (bivio SP 63R),12676,10,9815,2860,10083,2593,12676,0
2019/03,231,15/03/2019,5,SP 63R tra la località Santa Vittoria (c/o bivio SP 81) e la Cispadana,7591,00,7077,514,6019,1572,7591,0
2019/03,231,16/03/2019,6,SP 63R tra la località Santa Vittoria (c/o bivio SP 81) e la Cispadana,6419,00,6298,121,4866,1553,0,6419
2019/03,231,17/03/2019,7,SP 63R tra la località Santa Vittoria (c/o bivio SP 81) e la Cispadana,5172,00,5158,14,3851,1321,0,5172
2019/03,231,18/03/2019,1,SP 63R tra la località Santa Vittoria (c/o bivio SP 81) e la Cispadana,6985,00,6534,451,5742,1243,6985,0
2019/03,231,19/03/2019,2,SP 63R tra la località Santa Vittoria (c/o bivio SP 81) e la Cispadana,7236,10,6754,481,5846,1390,7236,0
2019/03,231,20/03/2019,3,SP 63R tra la località Santa Vittoria (c/o bivio SP 81) e la Cispadana,7154,10,6642,511,5724,1430,7154,0
2019/03,231,21/03/2019,4,SP 63R tra la località Santa Vittoria (c/o bivio SP 81) e la Cispadana,7279,40,6798,477,5898,1381,7279,0
2019/03,231,22/03/2019,5,SP 63R tra la località Santa Vittoria (c/o bivio SP 81) e la Cispadana,7505,10,7005,499,5921,1584,7505,0
2019/03,231,23/03/2019,6,SP 63R tra la località Santa Vittoria (c/o bivio SP 81) e la Cispadana,6550,00,6421,129,4904,1646,0,6550
2019/03,231,24/03/2019,7,SP 63R tra la località Santa Vittoria (c/o bivio SP 81) e la Cispadana,5384,00,5361,23,3890,1494,0,5384
2019/03,231,25/03/2019,1,SP 63R tra la località Santa Vittoria (c/o bivio SP 81) e la Cispadana,6926,00,6433,493,5666,1260,6926,0
2019/03,231,26/03/2019,2,SP 63R tra la località Santa Vittoria (c/o bivio SP 81) e la Cispadana,7320,20,6793,525,5927,1393,7320,0
2019/03,231,27/03/2019,3,SP 63R tra la località Santa Vittoria (c/o bivio SP 81) e la Cispadana,7326,10,6822,503,5853,1473,7326,0
2019/03,231,28/03/2019,4,SP 63R tra la località Santa Vittoria (c/o bivio SP 81) e la Cispadana,7162,20,6658,502,5797,1365,7162,0
2019/03,236,15/03/2019,5,SP 468 tra Casumaro e Reno Centese,5955,00,5288,667,4551,1404,5955,0
2019/03,236,16/03/2019,6,SP 468 tra Casumaro e Reno Centese,5391,00,5250,141,3980,1411,0,5391
2019/03,236,17/03/2019,7,SP 468 tra Casumaro e Reno Centese,4253,00,4229,24,3177,1076,0,4253
2019/03,236,18/03/2019,1,SP 468 tra Casumaro e Reno Centese,5467,00,4863,604,4364,1103,5467,0
2019/03,236,19/03/2019,2,SP 468 tra Casumaro e Reno Centese,5541,00,4925,616,4439,1102,5541,0
2019/03,236,20/03/2019,3,SP 468 tra Casumaro e Reno Centese,5587,00,4970,617,4485,1102,5587,0
2019/03,236,21/03/2019,4,SP 468 tra Casumaro e Reno Centese,5619,00,5013,606,4417,1202,5619,0
2019/03,236,22/03/2019,5,SP 468 tra Casumaro e Reno Centese,6140,00,5495,645,4675,1465,6140,0
2019/03,236,23/03/2019,6,SP 468 tra Casumaro e Reno Centese,5371,00,5205,166,3961,1410,0,5371
2019/03,236,24/03/2019,7,SP 468 tra Casumaro e Reno Centese,4629,00,4595,34,3399,1230,0,4629
2019/03,236,25/03/2019,1,SP 468 tra Casumaro e Reno Centese,5316,00,4694,622,4239,1077,5316,0
2019/03,236,26/03/2019,2,SP 468 tra Casumaro e Reno Centese,5428,00,4812,616,4357,1071,5428,0
2019/03,236,27/03/2019,3,SP 468 tra Casumaro e Reno Centese,5632,00,5017,615,4496,1136,5632,0
2019/03,236,28/03/2019,4,SP 468 tra Casumaro e Reno Centese,5718,00,5050,668,4517,1201,5718,0
2019/03,237,15/03/2019,5,SP 23 tra Quattro Castella e la Variante di Montecavolo (c/o bivio SP 21),16168,20,15353,813,12424,3744,16168,0
2019/03,237,16/03/2019,6,SP 23 tra Quattro Castella e la Variante di Montecavolo (c/o bivio SP 21),14452,00,14237,215,10597,3855,0,14452
2019/03,237,17/03/2019,7,SP 23 tra Quattro Castella e la Variante di Montecavolo (c/o bivio SP 21),12715,10,12666,48,9592,3123,0,12715
2019/03,237,18/03/2019,1,SP 23 tra Quattro Castella e la Variante di Montecavolo (c/o bivio SP 21),14821,00,14036,785,11986,2835,14821,0
2019/03,237,19/03/2019,2,SP 23 tra Quattro Castella e la Variante di Montecavolo (c/o bivio SP 21),15656,00,14918,738,12437,3219,15656,0
2019/03,237,20/03/2019,3,SP 23 tra Quattro Castella e la Variante di Montecavolo (c/o bivio SP 21),16066,00,15292,774,12590,3476,16066,0
2019/03,237,21/03/2019,4,SP 23 tra Quattro Castella e la Variante di Montecavolo (c/o bivio SP 21),15665,00,14899,766,12281,3384,15665,0
2019/03,237,22/03/2019,5,SP 23 tra Quattro Castella e la Variante di Montecavolo (c/o bivio SP 21),16166,10,15383,782,12495,3671,16166,0
2019/03,237,23/03/2019,6,SP 23 tra Quattro Castella e la Variante di Montecavolo (c/o bivio SP 21),14186,10,13986,199,10518,3668,0,14186
2019/03,237,24/03/2019,7,SP 23 tra Quattro Castella e la Variante di Montecavolo (c/o bivio SP 21),13670,00,13621,49,10526,3144,0,13670
2019/03,237,25/03/2019,1,SP 23 tra Quattro Castella e la Variante di Montecavolo (c/o bivio SP 21),15018,00,14277,741,12064,2954,15018,0
2019/03,237,26/03/2019,2,SP 23 tra Quattro Castella e la Variante di Montecavolo (c/o bivio SP 21),15271,00,14482,789,12152,3119,15271,0
2019/03,237,27/03/2019,3,SP 23 tra Quattro Castella e la Variante di Montecavolo (c/o bivio SP 21),15868,00,15102,766,12419,3449,15868,0
2019/03,237,28/03/2019,4,SP 23 tra Quattro Castella e la Variante di Montecavolo (c/o bivio SP 21),16180,00,15330,850,12695,3485,16180,0
2019/03,238,15/03/2019,5,SP 37 fra Albinea e Scandiano (bivio SP 7),12277,00,11616,661,9428,2849,12277,0
2019/03,238,16/03/2019,6,SP 37 fra Albinea e Scandiano (bivio SP 7),10786,00,10634,152,7704,3082,0,10786
2019/03,238,17/03/2019,7,SP 37 fra Albinea e Scandiano (bivio SP 7),11420,00,11368,52,8972,2448,0,11420
2019/03,238,18/03/2019,1,SP 37 fra Albinea e Scandiano (bivio SP 7),11471,10,10890,580,9301,2170,11471,0
2019/03,238,19/03/2019,2,SP 37 fra Albinea e Scandiano (bivio SP 7),12245,00,11631,614,9779,2466,12245,0
2019/03,238,20/03/2019,3,SP 37 fra Albinea e Scandiano (bivio SP 7),11387,00,10821,566,8902,2485,11387,0
2019/03,238,21/03/2019,4,SP 37 fra Albinea e Scandiano (bivio SP 7),11894,00,11304,590,9257,2637,11894,0
2019/03,238,22/03/2019,5,SP 37 fra Albinea e Scandiano (bivio SP 7),12391,00,11763,628,9467,2924,12391,0
2019/03,238,23/03/2019,6,SP 37 fra Albinea e Scandiano (bivio SP 7),10730,00,10564,166,7572,3158,0,10730
2019/03,238,24/03/2019,7,SP 37 fra Albinea e Scandiano (bivio SP 7),10826,20,10784,40,8293,2533,0,10826
2019/03,238,25/03/2019,1,SP 37 fra Albinea e Scandiano (bivio SP 7),11969,00,11384,585,9584,2385,11969,0
2019/03,238,26/03/2019,2,SP 37 fra Albinea e Scandiano (bivio SP 7),11478,00,10855,623,9132,2346,11478,0
2019/03,238,27/03/2019,3,SP 37 fra Albinea e Scandiano (bivio SP 7),12036,00,11393,643,9490,2546,12036,0
2019/03,238,28/03/2019,4,SP 37 fra Albinea e Scandiano (bivio SP 7),11921,10,11272,648,9286,2635,11921,0
2019/03,239,15/03/2019,5,SP 486R fra Sassuolo e Castellarano,29047,00,25318,3729,22660,6387,29047,0
2019/03,239,16/03/2019,6,SP 486R fra Sassuolo e Castellarano,24905,30,24405,497,18688,6217,0,24905
2019/03,239,17/03/2019,7,SP 486R fra Sassuolo e Castellarano,19105,00,18975,130,14038,5067,0,19105
2019/03,239,18/03/2019,1,SP 486R fra Sassuolo e Castellarano,27361,20,24080,3279,21927,5434,27361,0
2019/03,239,19/03/2019,2,SP 486R fra Sassuolo e Castellarano,27949,30,24360,3586,22252,5697,27949,0
2019/03,239,20/03/2019,3,SP 486R fra Sassuolo e Castellarano,27875,30,23994,3878,21856,6019,27875,0
2019/03,239,21/03/2019,4,SP 486R fra Sassuolo e Castellarano,28742,40,24696,4042,22597,6145,28742,0
2019/03,239,22/03/2019,5,SP 486R fra Sassuolo e Castellarano,29186,00,25424,3762,22665,6521,29186,0
2019/03,239,23/03/2019,6,SP 486R fra Sassuolo e Castellarano,22294,20,21798,494,15979,6315,0,22294
2019/03,239,24/03/2019,7,SP 486R fra Sassuolo e Castellarano,19868,20,19741,125,14338,5530,0,19868
2019/03,239,25/03/2019,1,SP 486R fra Sassuolo e Castellarano,27412,10,24156,3255,21903,5509,27412,0
2019/03,239,26/03/2019,2,SP 486R fra Sassuolo e Castellarano,27740,10,24212,3527,22187,5553,27740,0
2019/03,239,27/03/2019,3,SP 486R fra Sassuolo e Castellarano,28272,00,24269,4003,22426,5846,28272,0
2019/03,239,28/03/2019,4,SP 486R fra Sassuolo e Castellarano,28416,30,24476,3937,22272,6144,28416,0
2019/03,242,15/03/2019,5,SS 12 tra Maranello e Pavullo nel Frignano,16809,10,15288,1520,12705,4104,16809,0
2019/03,242,16/03/2019,6,SS 12 tra Maranello e Pavullo nel Frignano,16178,00,15811,367,11862,4316,0,16178
2019/03,242,17/03/2019,7,SS 12 tra Maranello e Pavullo nel Frignano,15151,10,15072,78,11517,3634,0,15151
2019/03,242,18/03/2019,1,SS 12 tra Maranello e Pavullo nel Frignano,15001,00,13807,1194,11770,3231,15001,0
2019/03,242,19/03/2019,2,SS 12 tra Maranello e Pavullo nel Frignano,15361,00,13962,1399,11872,3489,15361,0
2019/03,242,20/03/2019,3,SS 12 tra Maranello e Pavullo nel Frignano,16128,00,14776,1352,12383,3745,16128,0
2019/03,242,21/03/2019,4,SS 12 tra Maranello e Pavullo nel Frignano,15919,00,14484,1435,12148,3771,15919,0
2019/03,242,22/03/2019,5,SS 12 tra Maranello e Pavullo nel Frignano,16855,30,15308,1544,12576,4279,16855,0
2019/03,242,23/03/2019,6,SS 12 tra Maranello e Pavullo nel Frignano,16112,00,15840,272,11521,4591,0,16112
2019/03,242,24/03/2019,7,SS 12 tra Maranello e Pavullo nel Frignano,16450,20,16371,77,12555,3895,0,16450
2019/03,242,25/03/2019,1,SS 12 tra Maranello e Pavullo nel Frignano,15332,00,13997,1335,11827,3505,15332,0
2019/03,242,26/03/2019,2,SS 12 tra Maranello e Pavullo nel Frignano,14998,20,13606,1390,11604,3394,14998,0
2019/03,242,27/03/2019,3,SS 12 tra Maranello e Pavullo nel Frignano,16013,20,14637,1374,12244,3769,16013,0
2019/03,242,28/03/2019,4,SS 12 tra Maranello e Pavullo nel Frignano,15958,10,14509,1448,12087,3871,15958,0
2019/03,243,15/03/2019,5,SP 27 tra Ponte Samoggia e Muffa,11685,00,10920,765,8967,2718,11685,0
2019/03,243,16/03/2019,6,SP 27 tra Ponte Samoggia e Muffa,9489,00,9303,186,6982,2507,0,9489
2019/03,243,17/03/2019,7,SP 27 tra Ponte Samoggia e Muffa,7251,10,7202,48,5358,1893,0,7251
2019/03,243,18/03/2019,1,SP 27 tra Ponte Samoggia e Muffa,11029,00,10296,733,8860,2169,11029,0
2019/03,243,19/03/2019,2,SP 27 tra Ponte Samoggia e Muffa,11124,00,10412,712,8793,2331,11124,0
2019/03,243,20/03/2019,3,SP 27 tra Ponte Samoggia e Muffa,11254,10,10499,754,8792,2462,11254,0
2019/03,243,21/03/2019,4,SP 27 tra Ponte Samoggia e Muffa,11017,10,10278,738,8584,2433,11017,0
2019/03,243,22/03/2019,5,SP 27 tra Ponte Samoggia e Muffa,11479,10,10707,771,8865,2614,11479,0
2019/03,243,23/03/2019,6,SP 27 tra Ponte Samoggia e Muffa,9207,00,9019,188,6777,2430,0,9207
2019/03,243,24/03/2019,7,SP 27 tra Ponte Samoggia e Muffa,6928,00,6888,40,5125,1803,0,6928
2019/03,243,25/03/2019,1,SP 27 tra Ponte Samoggia e Muffa,10747,00,10048,699,8627,2120,10747,0
2019/03,243,26/03/2019,2,SP 27 tra Ponte Samoggia e Muffa,11212,00,10440,772,8905,2307,11212,0
2019/03,243,27/03/2019,3,SP 27 tra Ponte Samoggia e Muffa,11069,00,10338,731,8678,2391,11069,0
2019/03,243,28/03/2019,4,SP 27 tra Ponte Samoggia e Muffa,11362,10,10585,776,8923,2439,11362,0
2019/03,244,15/03/2019,5,SP 569 tra Pragatto e innesto variante Ponte Ronca,10773,10,10263,509,8190,2583,10773,0
2019/03,244,16/03/2019,6,SP 569 tra Pragatto e innesto variante Ponte Ronca,10558,00,10382,176,7939,2619,0,10558
2019/03,244,17/03/2019,7,SP 569 tra Pragatto e innesto variante Ponte Ronca,8829,10,8776,52,6881,1948,0,8829
2019/03,244,18/03/2019,1,SP 569 tra Pragatto e innesto variante Ponte Ronca,9602,00,9073,529,7766,1836,9602,0
2019/03,244,19/03/2019,2,SP 569 tra Pragatto e innesto variante Ponte Ronca,9933,00,9418,515,7938,1995,9933,0
2019/03,244,20/03/2019,3,SP 569 tra Pragatto e innesto variante Ponte Ronca,9615,00,9103,512,7703,1912,9615,0
2019/03,244,21/03/2019,4,SP 569 tra Pragatto e innesto variante Ponte Ronca,9650,00,9145,505,7655,1995,9650,0
2019/03,244,22/03/2019,5,SP 569 tra Pragatto e innesto variante Ponte Ronca,9767,00,9306,461,7527,2240,9767,0
2019/03,244,23/03/2019,6,SP 569 tra Pragatto e innesto variante Ponte Ronca,9335,00,9181,154,7073,2262,0,9335
2019/03,244,24/03/2019,7,SP 569 tra Pragatto e innesto variante Ponte Ronca,7420,00,7388,32,5777,1643,0,7420
2019/03,244,25/03/2019,1,SP 569 tra Pragatto e innesto variante Ponte Ronca,9008,00,8582,426,7289,1719,9008,0
2019/03,244,26/03/2019,2,SP 569 tra Pragatto e innesto variante Ponte Ronca,9100,00,8683,417,7248,1852,9100,0
2019/03,244,27/03/2019,3,SP 569 tra Pragatto e innesto variante Ponte Ronca,9221,10,8766,454,7350,1871,9221,0
2019/03,244,28/03/2019,4,SP 569 tra Pragatto e innesto variante Ponte Ronca,9207,10,8769,437,7384,1823,9207,0
2019/03,245,15/03/2019,5,SP 569 da intersezione Pedemontana a Savignano sul Panaro,8035,00,7603,432,5948,2087,8035,0
2019/03,245,16/03/2019,6,SP 569 da intersezione Pedemontana a Savignano sul Panaro,8312,00,8118,194,5987,2325,0,8312
2019/03,245,17/03/2019,7,SP 569 da intersezione Pedemontana a Savignano sul Panaro,7559,00,7492,67,5543,2016,0,7559
2019/03,245,18/03/2019,1,SP 569 da intersezione Pedemontana a Savignano sul Panaro,7147,00,6728,419,5595,1552,7147,0
2019/03,245,19/03/2019,2,SP 569 da intersezione Pedemontana a Savignano sul Panaro,7201,10,6713,487,5495,1706,7201,0
2019/03,245,20/03/2019,3,SP 569 da intersezione Pedemontana a Savignano sul Panaro,7478,00,7052,426,5742,1736,7478,0
2019/03,245,21/03/2019,4,SP 569 da intersezione Pedemontana a Savignano sul Panaro,7576,00,7109,467,5722,1854,7576,0
2019/03,245,22/03/2019,5,SP 569 da intersezione Pedemontana a Savignano sul Panaro,8008,00,7571,437,5916,2092,8008,0
2019/03,245,23/03/2019,6,SP 569 da intersezione Pedemontana a Savignano sul Panaro,8097,10,7935,161,5889,2208,0,8097
2019/03,245,24/03/2019,7,SP 569 da intersezione Pedemontana a Savignano sul Panaro,7303,00,7255,48,5410,1893,0,7303
2019/03,245,25/03/2019,1,SP 569 da intersezione Pedemontana a Savignano sul Panaro,7055,10,6609,445,5454,1601,7055,0
2019/03,245,26/03/2019,2,SP 569 da intersezione Pedemontana a Savignano sul Panaro,7337,00,6847,490,5694,1643,7337,0
2019/03,245,27/03/2019,3,SP 569 da intersezione Pedemontana a Savignano sul Panaro,7325,10,6933,391,5580,1745,7325,0
2019/03,245,28/03/2019,4,SP 569 da intersezione Pedemontana a Savignano sul Panaro,7406,20,6983,421,5648,1758,7406,0
2019/03,246,15/03/2019,5,SP 255 da Decima a San Giovanni in Persiceto,15683,00,14590,1093,11782,3901,15683,0
2019/03,246,16/03/2019,6,SP 255 da Decima a San Giovanni in Persiceto,11916,00,11736,180,8349,3567,0,11916
2019/03,246,17/03/2019,7,SP 255 da Decima a San Giovanni in Persiceto,9535,00,9485,50,6606,2929,0,9535
2019/03,246,18/03/2019,1,SP 255 da Decima a San Giovanni in Persiceto,14547,00,13531,1016,11444,3103,14547,0
2019/03,246,19/03/2019,2,SP 255 da Decima a San Giovanni in Persiceto,15310,00,14141,1169,11753,3557,15310,0
2019/03,246,20/03/2019,3,SP 255 da Decima a San Giovanni in Persiceto,15457,00,14304,1153,11984,3473,15457,0
2019/03,246,21/03/2019,4,SP 255 da Decima a San Giovanni in Persiceto,15164,00,14125,1039,11619,3545,15164,0
2019/03,246,22/03/2019,5,SP 255 da Decima a San Giovanni in Persiceto,15742,00,14663,1079,11889,3853,15742,0
2019/03,246,23/03/2019,6,SP 255 da Decima a San Giovanni in Persiceto,12608,00,12382,226,8810,3798,0,12608
2019/03,246,24/03/2019,7,SP 255 da Decima a San Giovanni in Persiceto,10174,00,10120,54,7139,3035,0,10174
2019/03,246,25/03/2019,1,SP 255 da Decima a San Giovanni in Persiceto,14726,00,13665,1061,11503,3223,14726,0
2019/03,246,26/03/2019,2,SP 255 da Decima a San Giovanni in Persiceto,14893,00,13750,1143,11696,3197,14893,0
2019/03,246,27/03/2019,3,SP 255 da Decima a San Giovanni in Persiceto,15412,20,14288,1122,11904,3508,15412,0
2019/03,246,28/03/2019,4,SP 255 da Decima a San Giovanni in Persiceto,15514,00,14444,1070,11875,3639,15514,0
2019/03,247,15/03/2019,5,SP 255 fra Nonantola e Sant'Agata Bolognese,11377,10,9801,1575,8523,2854,11377,0
2019/03,247,16/03/2019,6,SP 255 fra Nonantola e Sant'Agata Bolognese,7848,00,7559,289,5302,2546,0,7848
2019/03,247,17/03/2019,7,SP 255 fra Nonantola e Sant'Agata Bolognese,7243,00,7200,43,4920,2323,0,7243
2019/03,247,18/03/2019,1,SP 255 fra Nonantola e Sant'Agata Bolognese,10432,00,8857,1575,8202,2230,10432,0
2019/03,247,19/03/2019,2,SP 255 fra Nonantola e Sant'Agata Bolognese,11085,00,9445,1640,8616,2469,11085,0
2019/03,247,20/03/2019,3,SP 255 fra Nonantola e Sant'Agata Bolognese,10426,00,8992,1434,7924,2502,10426,0
2019/03,247,21/03/2019,4,SP 255 fra Nonantola e Sant'Agata Bolognese,10840,00,9331,1509,8153,2687,10840,0
2019/03,247,22/03/2019,5,SP 255 fra Nonantola e Sant'Agata Bolognese,11318,00,9827,1491,8555,2763,11318,0
2019/03,247,23/03/2019,6,SP 255 fra Nonantola e Sant'Agata Bolognese,7659,00,7399,260,5190,2469,0,7659
2019/03,247,24/03/2019,7,SP 255 fra Nonantola e Sant'Agata Bolognese,7208,00,7171,37,4944,2264,0,7208
2019/03,247,25/03/2019,1,SP 255 fra Nonantola e Sant'Agata Bolognese,10231,00,8796,1435,8032,2199,10231,0
2019/03,247,26/03/2019,2,SP 255 fra Nonantola e Sant'Agata Bolognese,10406,00,8954,1452,8144,2262,10406,0
2019/03,247,27/03/2019,3,SP 255 fra Nonantola e Sant'Agata Bolognese,10874,00,9284,1590,8335,2539,10874,0
2019/03,247,28/03/2019,4,SP 255 fra Nonantola e Sant'Agata Bolognese,11388,00,9785,1603,8353,3035,11388,0
2019/03,251,15/03/2019,5,SP 610 tra Imola e Casalfiumanese in località Ca' Miseria,14107,10,13369,737,10725,3382,14107,0
2019/03,251,16/03/2019,6,SP 610 tra Imola e Casalfiumanese in località Ca' Miseria,12867,10,12669,197,9498,3369,0,12867
2019/03,251,17/03/2019,7,SP 610 tra Imola e Casalfiumanese in località Ca' Miseria,11497,20,11440,55,8753,2744,0,11497
2019/03,251,18/03/2019,1,SP 610 tra Imola e Casalfiumanese in località Ca' Miseria,12549,00,11888,661,9904,2645,12549,0
2019/03,251,19/03/2019,2,SP 610 tra Imola e Casalfiumanese in località Ca' Miseria,13054,00,12439,615,10023,3031,13054,0
2019/03,251,20/03/2019,3,SP 610 tra Imola e Casalfiumanese in località Ca' Miseria,13392,00,12658,734,10221,3171,13392,0
2019/03,251,21/03/2019,4,SP 610 tra Imola e Casalfiumanese in località Ca' Miseria,13541,00,12817,724,10338,3203,13541,0
2019/03,251,22/03/2019,5,SP 610 tra Imola e Casalfiumanese in località Ca' Miseria,13891,10,13223,667,10509,3382,13891,0
2019/03,251,23/03/2019,6,SP 610 tra Imola e Casalfiumanese in località Ca' Miseria,13622,20,13404,216,9703,3919,0,13622
2019/03,251,24/03/2019,7,SP 610 tra Imola e Casalfiumanese in località Ca' Miseria,13483,10,13429,53,10509,2974,0,13483
2019/03,251,25/03/2019,1,SP 610 tra Imola e Casalfiumanese in località Ca' Miseria,12859,00,12087,772,10038,2821,12859,0
2019/03,251,26/03/2019,2,SP 610 tra Imola e Casalfiumanese in località Ca' Miseria,13064,10,12405,658,10052,3012,13064,0
2019/03,251,27/03/2019,3,SP 610 tra Imola e Casalfiumanese in località Ca' Miseria,13620,00,12883,737,10327,3293,13620,0
2019/03,251,28/03/2019,4,SP 610 tra Imola e Casalfiumanese in località Ca' Miseria,13788,00,13104,684,10479,3309,13788,0
2019/03,252,15/03/2019,5,SP 3_2 tra Budrio e bivio SP 29 per Medicina,10675,10,9710,964,8255,2420,10675,0
2019/03,252,16/03/2019,6,SP 3_2 tra Budrio e bivio SP 29 per Medicina,7762,20,7583,177,5761,2001,0,7762
2019/03,252,17/03/2019,7,SP 3_2 tra Budrio e bivio SP 29 per Medicina,7379,10,7341,37,5585,1794,0,7379
2019/03,252,18/03/2019,1,SP 3_2 tra Budrio e bivio SP 29 per Medicina,9275,10,8484,790,7508,1767,9275,0
2019/03,252,19/03/2019,2,SP 3_2 tra Budrio e bivio SP 29 per Medicina,9932,00,8990,942,7765,2167,9932,0
2019/03,252,20/03/2019,3,SP 3_2 tra Budrio e bivio SP 29 per Medicina,9486,00,8610,876,7562,1924,9486,0
2019/03,252,21/03/2019,4,SP 3_2 tra Budrio e bivio SP 29 per Medicina,9414,30,8504,907,7349,2065,9414,0
2019/03,252,22/03/2019,5,SP 3_2 tra Budrio e bivio SP 29 per Medicina,10080,00,9186,894,7929,2151,10080,0
2019/03,252,23/03/2019,6,SP 3_2 tra Budrio e bivio SP 29 per Medicina,7516,10,7372,143,5615,1901,0,7516
2019/03,252,24/03/2019,7,SP 3_2 tra Budrio e bivio SP 29 per Medicina,7450,00,7417,33,5434,2016,0,7450
2019/03,252,25/03/2019,1,SP 3_2 tra Budrio e bivio SP 29 per Medicina,9334,00,8537,797,7423,1911,9334,0
2019/03,252,26/03/2019,2,SP 3_2 tra Budrio e bivio SP 29 per Medicina,9604,00,8768,836,7759,1845,9604,0
2019/03,252,27/03/2019,3,SP 3_2 tra Budrio e bivio SP 29 per Medicina,9429,20,8629,798,7448,1981,9429,0
2019/03,252,28/03/2019,4,SP 3_2 tra Budrio e bivio SP 29 per Medicina,9786,00,8878,908,7722,2064,9786,0
2019/03,254,15/03/2019,5,SS 9 tra Ozzano Emilia e Castel San Pietro,17971,00,17284,687,13598,4373,17971,0
2019/03,254,16/03/2019,6,SS 9 tra Ozzano Emilia e Castel San Pietro,15262,00,14987,275,10936,4326,0,15262
2019/03,254,17/03/2019,7,SS 9 tra Ozzano Emilia e Castel San Pietro,12486,00,12417,69,9000,3486,0,12486
2019/03,254,18/03/2019,1,SS 9 tra Ozzano Emilia e Castel San Pietro,16127,10,15531,595,12716,3411,16127,0
2019/03,254,19/03/2019,2,SS 9 tra Ozzano Emilia e Castel San Pietro,16680,00,16042,638,13008,3672,16680,0
2019/03,254,20/03/2019,3,SS 9 tra Ozzano Emilia e Castel San Pietro,16922,10,16239,682,13133,3789,16922,0
2019/03,254,21/03/2019,4,SS 9 tra Ozzano Emilia e Castel San Pietro,16945,10,16288,656,13070,3875,16945,0
2019/03,254,22/03/2019,5,SS 9 tra Ozzano Emilia e Castel San Pietro,17467,10,16822,644,13205,4262,17467,0
2019/03,254,23/03/2019,6,SS 9 tra Ozzano Emilia e Castel San Pietro,15429,30,15162,264,11124,4305,0,15429
2019/03,254,24/03/2019,7,SS 9 tra Ozzano Emilia e Castel San Pietro,13343,00,13279,64,9585,3758,0,13343
2019/03,254,25/03/2019,1,SS 9 tra Ozzano Emilia e Castel San Pietro,16565,10,15986,578,12943,3622,16565,0
2019/03,254,26/03/2019,2,SS 9 tra Ozzano Emilia e Castel San Pietro,16807,00,16168,639,13125,3682,16807,0
2019/03,254,27/03/2019,3,SS 9 tra Ozzano Emilia e Castel San Pietro,17203,10,16532,670,13290,3913,17203,0
2019/03,254,28/03/2019,4,SS 9 tra Ozzano Emilia e Castel San Pietro,17046,20,16403,641,13015,4031,17046,0
2019/03,255,15/03/2019,5,SS 9 tra Castel San Pietro e Imola,21228,80,20401,819,16096,5132,21228,0
2019/03,255,16/03/2019,6,SS 9 tra Castel San Pietro e Imola,19125,10,18851,273,14426,4699,0,19125
2019/03,255,17/03/2019,7,SS 9 tra Castel San Pietro e Imola,15616,20,15531,83,11688,3928,0,15616
2019/03,255,18/03/2019,1,SS 9 tra Castel San Pietro e Imola,19459,10,18681,777,15530,3929,19459,0
2019/03,255,19/03/2019,2,SS 9 tra Castel San Pietro e Imola,19717,20,18950,765,15590,4127,19717,0
2019/03,255,20/03/2019,3,SS 9 tra Castel San Pietro e Imola,20348,30,19540,805,15656,4692,20348,0
2019/03,255,21/03/2019,4,SS 9 tra Castel San Pietro e Imola,20465,00,19618,847,15874,4591,20465,0
2019/03,255,22/03/2019,5,SS 9 tra Castel San Pietro e Imola,20968,40,20165,799,16136,4832,20968,0
2019/03,255,23/03/2019,6,SS 9 tra Castel San Pietro e Imola,19486,20,19243,241,14703,4783,0,19486
2019/03,255,24/03/2019,7,SS 9 tra Castel San Pietro e Imola,15290,20,15211,77,10812,4478,0,15290
2019/03,255,25/03/2019,1,SS 9 tra Castel San Pietro e Imola,19777,30,19015,759,15477,4300,19777,0
2019/03,255,26/03/2019,2,SS 9 tra Castel San Pietro e Imola,20377,80,19518,851,16030,4347,20377,0
2019/03,255,27/03/2019,3,SS 9 tra Castel San Pietro e Imola,20440,40,19666,770,16103,4337,20440,0
2019/03,255,28/03/2019,4,SS 9 tra Castel San Pietro e Imola,20401,40,19577,820,15839,4562,20401,0
2019/03,256,15/03/2019,5,SP 302R tra Faenza (bivio SP 66) e Brisighella,8869,00,8610,259,6746,2123,8869,0
2019/03,256,16/03/2019,6,SP 302R tra Faenza (bivio SP 66) e Brisighella,9109,10,9023,85,6870,2239,0,9109
2019/03,256,17/03/2019,7,SP 302R tra Faenza (bivio SP 66) e Brisighella,9247,10,9226,20,7440,1807,0,9247
2019/03,256,18/03/2019,1,SP 302R tra Faenza (bivio SP 66) e Brisighella,8065,00,7822,243,6411,1654,8065,0
2019/03,256,19/03/2019,2,SP 302R tra Faenza (bivio SP 66) e Brisighella,8045,00,7801,244,6310,1735,8045,0
2019/03,256,20/03/2019,3,SP 302R tra Faenza (bivio SP 66) e Brisighella,8303,00,8092,211,6394,1909,8303,0
2019/03,256,21/03/2019,4,SP 302R tra Faenza (bivio SP 66) e Brisighella,8535,10,8272,262,6554,1981,8535,0
2019/03,256,22/03/2019,5,SP 302R tra Faenza (bivio SP 66) e Brisighella,8884,10,8623,260,6695,2189,8884,0
2019/03,256,23/03/2019,6,SP 302R tra Faenza (bivio SP 66) e Brisighella,8985,00,8875,110,6673,2312,0,8985
2019/03,256,24/03/2019,7,SP 302R tra Faenza (bivio SP 66) e Brisighella,9346,00,9305,41,7430,1916,0,9346
2019/03,256,25/03/2019,1,SP 302R tra Faenza (bivio SP 66) e Brisighella,8285,00,8039,246,6482,1803,8285,0
2019/03,256,26/03/2019,2,SP 302R tra Faenza (bivio SP 66) e Brisighella,8145,10,7899,245,6418,1727,8145,0
2019/03,256,27/03/2019,3,SP 302R tra Faenza (bivio SP 66) e Brisighella,8598,00,8205,393,6732,1866,8598,0
2019/03,256,28/03/2019,4,SP 302R tra Faenza (bivio SP 66) e Brisighella,8615,00,8188,427,6757,1858,8615,0
2019/03,257,15/03/2019,5,SP 302R tra Faenza e il bivio SP 4 (a sud di Russi),6679,00,6503,176,5087,1592,6679,0
2019/03,257,16/03/2019,6,SP 302R tra Faenza e il bivio SP 4 (a sud di Russi),5992,00,5908,84,4346,1646,0,5992
2019/03,257,17/03/2019,7,SP 302R tra Faenza e il bivio SP 4 (a sud di Russi),5458,00,5430,28,4035,1423,0,5458
2019/03,257,18/03/2019,1,SP 302R tra Faenza e il bivio SP 4 (a sud di Russi),6408,00,6163,245,5033,1375,6408,0
2019/03,257,19/03/2019,2,SP 302R tra Faenza e il bivio SP 4 (a sud di Russi),6505,00,6319,186,5069,1436,6505,0
2019/03,257,20/03/2019,3,SP 302R tra Faenza e il bivio SP 4 (a sud di Russi),6628,00,6445,183,5133,1495,6628,0
2019/03,257,21/03/2019,4,SP 302R tra Faenza e il bivio SP 4 (a sud di Russi),6490,10,6279,210,5035,1455,6490,0
2019/03,257,22/03/2019,5,SP 302R tra Faenza e il bivio SP 4 (a sud di Russi),6872,00,6664,208,5201,1671,6872,0
2019/03,257,23/03/2019,6,SP 302R tra Faenza e il bivio SP 4 (a sud di Russi),6581,00,6474,107,4624,1957,0,6581
2019/03,257,24/03/2019,7,SP 302R tra Faenza e il bivio SP 4 (a sud di Russi),6437,00,6413,24,4769,1668,0,6437
2019/03,257,25/03/2019,1,SP 302R tra Faenza e il bivio SP 4 (a sud di Russi),6382,00,6181,201,4966,1416,6382,0
2019/03,257,26/03/2019,2,SP 302R tra Faenza e il bivio SP 4 (a sud di Russi),6847,00,6622,225,5378,1469,6847,0
2019/03,257,27/03/2019,3,SP 302R tra Faenza e il bivio SP 4 (a sud di Russi),6655,00,6450,205,5118,1537,6655,0
2019/03,257,28/03/2019,4,SP 302R tra Faenza e il bivio SP 4 (a sud di Russi),6655,00,6445,210,5055,1600,6655,0
2019/03,258,15/03/2019,5,SS 9 tra Forlimpopoli e Cesena,26497,60,24305,2186,20047,6450,26497,0
2019/03,258,16/03/2019,6,SS 9 tra Forlimpopoli e Cesena,22367,00,21553,814,15953,6414,0,22367
2019/03,258,17/03/2019,7,SS 9 tra Forlimpopoli e Cesena,17664,10,17477,186,12625,5039,0,17664
2019/03,258,18/03/2019,1,SS 9 tra Forlimpopoli e Cesena,24954,50,22971,1978,19215,5739,24954,0
2019/03,258,19/03/2019,2,SS 9 tra Forlimpopoli e Cesena,25316,40,23199,2113,19731,5585,25316,0
2019/03,258,20/03/2019,3,SS 9 tra Forlimpopoli e Cesena,25439,90,23366,2064,19684,5755,25439,0
2019/03,258,21/03/2019,4,SS 9 tra Forlimpopoli e Cesena,25859,60,23765,2088,19828,6031,25859,0
2019/03,258,22/03/2019,5,SS 9 tra Forlimpopoli e Cesena,26374,20,24170,2202,19808,6566,26374,0
2019/03,258,23/03/2019,6,SS 9 tra Forlimpopoli e Cesena,22518,00,21623,895,15625,6893,0,22518
2019/03,258,24/03/2019,7,SS 9 tra Forlimpopoli e Cesena,18723,00,18517,206,13259,5464,0,18723
2019/03,258,25/03/2019,1,SS 9 tra Forlimpopoli e Cesena,24416,50,22287,2124,19008,5408,24416,0
2019/03,258,26/03/2019,2,SS 9 tra Forlimpopoli e Cesena,25198,20,23011,2185,19495,5703,25198,0
2019/03,258,27/03/2019,3,SS 9 tra Forlimpopoli e Cesena,25823,50,23674,2144,19952,5871,25823,0
2019/03,258,28/03/2019,4,SS 9 tra Forlimpopoli e Cesena,26207,110,23975,2221,19920,6287,26207,0
2019/03,259,15/03/2019,5,SP 7 in località Calabrina al Confine Provinciale,8506,00,8117,389,6267,2239,8506,0
2019/03,259,16/03/2019,6,SP 7 in località Calabrina al Confine Provinciale,8981,00,8840,141,6100,2881,0,8981
2019/03,259,17/03/2019,7,SP 7 in località Calabrina al Confine Provinciale,7759,00,7677,82,5468,2291,0,7759
2019/03,259,18/03/2019,1,SP 7 in località Calabrina al Confine Provinciale,6862,00,6474,388,5395,1467,6862,0
2019/03,259,19/03/2019,2,SP 7 in località Calabrina al Confine Provinciale,6970,00,6603,367,5324,1646,6970,0
2019/03,259,20/03/2019,3,SP 7 in località Calabrina al Confine Provinciale,7453,00,7038,415,5661,1792,7453,0
2019/03,259,21/03/2019,4,SP 7 in località Calabrina al Confine Provinciale,7991,00,7570,421,5978,2013,7991,0
2019/03,259,22/03/2019,5,SP 7 in località Calabrina al Confine Provinciale,8665,00,8244,421,6233,2432,8665,0
2019/03,259,23/03/2019,6,SP 7 in località Calabrina al Confine Provinciale,9167,00,8999,168,6138,3029,0,9167
2019/03,259,24/03/2019,7,SP 7 in località Calabrina al Confine Provinciale,8420,00,8326,94,5710,2710,0,8420
2019/03,259,25/03/2019,1,SP 7 in località Calabrina al Confine Provinciale,7608,00,7172,436,5953,1655,7608,0
2019/03,259,26/03/2019,2,SP 7 in località Calabrina al Confine Provinciale,7212,00,6779,433,5538,1674,7212,0
2019/03,259,27/03/2019,3,SP 7 in località Calabrina al Confine Provinciale,7630,00,7194,436,5855,1775,7630,0
2019/03,259,28/03/2019,4,SP 7 in località Calabrina al Confine Provinciale,7925,00,7517,408,5887,2038,7925,0
2019/03,260,15/03/2019,5,SP 8 tra Cesena e A 14,12483,00,12097,386,9792,2691,12483,0
2019/03,260,16/03/2019,6,SP 8 tra Cesena e A 14,11911,10,11768,142,8762,3149,0,11911
2019/03,260,17/03/2019,7,SP 8 tra Cesena e A 14,11136,00,11111,25,8469,2667,0,11136
2019/03,260,18/03/2019,1,SP 8 tra Cesena e A 14,11142,00,10824,318,9158,1984,11142,0
2019/03,260,19/03/2019,2,SP 8 tra Cesena e A 14,11472,00,11120,352,9216,2256,11472,0
2019/03,260,20/03/2019,3,SP 8 tra Cesena e A 14,11770,00,11443,327,9319,2451,11770,0
2019/03,260,21/03/2019,4,SP 8 tra Cesena e A 14,11581,10,11239,341,9137,2444,11581,0
2019/03,260,22/03/2019,5,SP 8 tra Cesena e A 14,12297,00,11941,356,9495,2802,12297,0
2019/03,260,23/03/2019,6,SP 8 tra Cesena e A 14,11937,00,11810,127,8643,3294,0,11937
2019/03,260,24/03/2019,7,SP 8 tra Cesena e A 14,11167,10,11141,25,8544,2623,0,11167
2019/03,260,25/03/2019,1,SP 8 tra Cesena e A 14,11656,00,11311,345,9459,2197,11656,0
2019/03,260,26/03/2019,2,SP 8 tra Cesena e A 14,11577,00,11217,360,9290,2287,11577,0
2019/03,260,27/03/2019,3,SP 8 tra Cesena e A 14,11815,00,11471,344,9370,2445,11815,0
2019/03,260,28/03/2019,4,SP 8 tra Cesena e A 14,11677,00,11332,345,9234,2443,11677,0
2019/03,261,15/03/2019,5,SS 9 tra Cesena e Savignano sul Rubicone,30437,10,28006,2430,23130,7307,30437,0
2019/03,261,16/03/2019,6,SS 9 tra Cesena e Savignano sul Rubicone,23570,00,22700,870,16643,6927,0,23570
2019/03,261,17/03/2019,7,SS 9 tra Cesena e Savignano sul Rubicone,16702,10,16565,136,11621,5081,0,16702
2019/03,261,18/03/2019,1,SS 9 tra Cesena e Savignano sul Rubicone,28573,00,26290,2283,22691,5882,28573,0
2019/03,261,19/03/2019,2,SS 9 tra Cesena e Savignano sul Rubicone,29384,00,27091,2293,23176,6208,29384,0
2019/03,261,20/03/2019,3,SS 9 tra Cesena e Savignano sul Rubicone,29751,00,27289,2462,23215,6536,29751,0
2019/03,261,21/03/2019,4,SS 9 tra Cesena e Savignano sul Rubicone,29648,00,27370,2278,23077,6571,29648,0
2019/03,261,22/03/2019,5,SS 9 tra Cesena e Savignano sul Rubicone,30019,10,27672,2346,22873,7146,30019,0
2019/03,261,23/03/2019,6,SS 9 tra Cesena e Savignano sul Rubicone,23338,10,22481,856,16380,6958,0,23338
2019/03,261,24/03/2019,7,SS 9 tra Cesena e Savignano sul Rubicone,17981,00,17786,195,12411,5570,0,17981
2019/03,261,25/03/2019,1,SS 9 tra Cesena e Savignano sul Rubicone,28581,00,26384,2197,22714,5867,28581,0
2019/03,261,26/03/2019,2,SS 9 tra Cesena e Savignano sul Rubicone,29627,10,27268,2358,23344,6283,29627,0
2019/03,261,27/03/2019,3,SS 9 tra Cesena e Savignano sul Rubicone,29402,10,27101,2300,23089,6313,29402,0
2019/03,261,28/03/2019,4,SS 9 tra Cesena e Savignano sul Rubicone,29927,20,27535,2390,23175,6752,29927,0
2019/03,262,15/03/2019,5,SS 9 tra Savignano sul Rubicone e Santarcangelo di Romagna,,,,,,,,
2019/03,262,16/03/2019,6,SS 9 tra Savignano sul Rubicone e Santarcangelo di Romagna,,,,,,,,
2019/03,262,17/03/2019,7,SS 9 tra Savignano sul Rubicone e Santarcangelo di Romagna,,,,,,,,
2019/03,262,18/03/2019,1,SS 9 tra Savignano sul Rubicone e Santarcangelo di Romagna,,,,,,,,
2019/03,262,19/03/2019,2,SS 9 tra Savignano sul Rubicone e Santarcangelo di Romagna,,,,,,,,
2019/03,262,20/03/2019,3,SS 9 tra Savignano sul Rubicone e Santarcangelo di Romagna,,,,,,,,
2019/03,262,21/03/2019,4,SS 9 tra Savignano sul Rubicone e Santarcangelo di Romagna,,,,,,,,
2019/03,262,22/03/2019,5,SS 9 tra Savignano sul Rubicone e Santarcangelo di Romagna,,,,,,,,
2019/03,262,23/03/2019,6,SS 9 tra Savignano sul Rubicone e Santarcangelo di Romagna,,,,,,,,
2019/03,262,24/03/2019,7,SS 9 tra Savignano sul Rubicone e Santarcangelo di Romagna,,,,,,,,
2019/03,262,25/03/2019,1,SS 9 tra Savignano sul Rubicone e Santarcangelo di Romagna,,,,,,,,
2019/03,262,26/03/2019,2,SS 9 tra Savignano sul Rubicone e Santarcangelo di Romagna,,,,,,,,
2019/03,262,27/03/2019,3,SS 9 tra Savignano sul Rubicone e Santarcangelo di Romagna,,,,,,,,
2019/03,262,28/03/2019,4,SS 9 tra Savignano sul Rubicone e Santarcangelo di Romagna,,,,,,,,
2019/03,263,15/03/2019,5,Via Adriatica (ex SS 16) tra Riccione e Misano Adriatico,17726,00,17238,488,13240,4486,17726,0
2019/03,263,16/03/2019,6,Via Adriatica (ex SS 16) tra Riccione e Misano Adriatico,17401,20,17244,155,11739,5662,0,17401
2019/03,263,17/03/2019,7,Via Adriatica (ex SS 16) tra Riccione e Misano Adriatico,15015,00,14947,68,10136,4879,0,15015
2019/03,263,18/03/2019,1,Via Adriatica (ex SS 16) tra Riccione e Misano Adriatico,16202,00,15749,453,12870,3332,16202,0
2019/03,263,19/03/2019,2,Via Adriatica (ex SS 16) tra Riccione e Misano Adriatico,16921,00,16448,473,13329,3592,16921,0
2019/03,263,20/03/2019,3,Via Adriatica (ex SS 16) tra Riccione e Misano Adriatico,16846,10,16417,428,13098,3748,16846,0
2019/03,263,21/03/2019,4,Via Adriatica (ex SS 16) tra Riccione e Misano Adriatico,16969,20,16476,491,13061,3908,16969,0
2019/03,263,22/03/2019,5,Via Adriatica (ex SS 16) tra Riccione e Misano Adriatico,17787,00,17327,460,13194,4593,17787,0
2019/03,263,23/03/2019,6,Via Adriatica (ex SS 16) tra Riccione e Misano Adriatico,17558,00,17351,207,11975,5583,0,17558
2019/03,263,24/03/2019,7,Via Adriatica (ex SS 16) tra Riccione e Misano Adriatico,15614,00,15559,55,10555,5059,0,15614
2019/03,263,25/03/2019,1,Via Adriatica (ex SS 16) tra Riccione e Misano Adriatico,16730,10,16260,469,13110,3620,16730,0
2019/03,263,26/03/2019,2,Via Adriatica (ex SS 16) tra Riccione e Misano Adriatico,16718,10,16241,476,13108,3610,16718,0
2019/03,263,27/03/2019,3,Via Adriatica (ex SS 16) tra Riccione e Misano Adriatico,16866,00,16379,487,13108,3758,16866,0
2019/03,263,28/03/2019,4,Via Adriatica (ex SS 16) tra Riccione e Misano Adriatico,17159,00,16732,427,13199,3960,17159,0
2019/03,269,15/03/2019,5,SS 12 a Medolla,21102,20,19192,1908,16314,4788,21102,0
2019/03,269,16/03/2019,6,SS 12 a Medolla,15727,00,15385,342,11069,4658,0,15727
2019/03,269,17/03/2019,7,SS 12 a Medolla,12860,00,12774,86,9164,3696,0,12860
2019/03,269,18/03/2019,1,SS 12 a Medolla,19842,20,17824,2016,15987,3855,19842,0
2019/03,269,19/03/2019,2,SS 12 a Medolla,20471,00,18512,1959,16397,4074,20471,0
2019/03,269,20/03/2019,3,SS 12 a Medolla,20432,00,18463,1969,16239,4193,20432,0
2019/03,269,21/03/2019,4,SS 12 a Medolla,20921,00,18751,2170,16692,4229,20921,0
2019/03,269,22/03/2019,5,SS 12 a Medolla,20170,00,18190,1980,15493,4677,20170,0
2019/03,269,23/03/2019,6,SS 12 a Medolla,15952,10,15599,352,11270,4682,0,15952
2019/03,269,24/03/2019,7,SS 12 a Medolla,12844,00,12757,87,9102,3742,0,12844
2019/03,269,25/03/2019,1,SS 12 a Medolla,19955,10,17947,2007,16029,3926,19955,0
2019/03,269,26/03/2019,2,SS 12 a Medolla,20547,10,18458,2088,16540,4007,20547,0
2019/03,269,27/03/2019,3,SS 12 a Medolla,20961,00,18822,2139,16673,4288,20961,0
2019/03,269,28/03/2019,4,SS 12 a Medolla,20928,00,18911,2017,16555,4373,20928,0
2019/03,275,15/03/2019,5,SP 5 dall'intersezione SP 3 a intersezione per Ca' de Fabbri,12050,00,11565,485,9413,2637,12050,0
2019/03,275,16/03/2019,6,SP 5 dall'intersezione SP 3 a intersezione per Ca' de Fabbri,8977,00,8801,176,6552,2425,0,8977
2019/03,275,17/03/2019,7,SP 5 dall'intersezione SP 3 a intersezione per Ca' de Fabbri,6900,00,6848,52,4914,1986,0,6900
2019/03,275,18/03/2019,1,SP 5 dall'intersezione SP 3 a intersezione per Ca' de Fabbri,11129,00,10634,495,8959,2170,11129,0
2019/03,275,19/03/2019,2,SP 5 dall'intersezione SP 3 a intersezione per Ca' de Fabbri,11417,10,10866,550,9015,2402,11417,0
2019/03,275,20/03/2019,3,SP 5 dall'intersezione SP 3 a intersezione per Ca' de Fabbri,11463,00,10948,515,9108,2355,11463,0
2019/03,275,21/03/2019,4,SP 5 dall'intersezione SP 3 a intersezione per Ca' de Fabbri,11135,00,10599,536,8722,2413,11135,0
2019/03,275,22/03/2019,5,SP 5 dall'intersezione SP 3 a intersezione per Ca' de Fabbri,11431,20,10947,482,8867,2564,11431,0
2019/03,275,23/03/2019,6,SP 5 dall'intersezione SP 3 a intersezione per Ca' de Fabbri,8832,10,8653,178,6471,2361,0,8832
2019/03,275,24/03/2019,7,SP 5 dall'intersezione SP 3 a intersezione per Ca' de Fabbri,6793,00,6747,46,4783,2010,0,6793
2019/03,275,25/03/2019,1,SP 5 dall'intersezione SP 3 a intersezione per Ca' de Fabbri,11040,00,10517,523,8857,2183,11040,0
2019/03,275,26/03/2019,2,SP 5 dall'intersezione SP 3 a intersezione per Ca' de Fabbri,11140,00,10658,482,8880,2260,11140,0
2019/03,275,27/03/2019,3,SP 5 dall'intersezione SP 3 a intersezione per Ca' de Fabbri,11829,00,11301,528,9333,2496,11829,0
2019/03,275,28/03/2019,4,SP 5 dall'intersezione SP 3 a intersezione per Ca' de Fabbri,11094,00,10607,487,8707,2387,11094,0
2019/03,276,15/03/2019,5,SP 3_2 tra intersezione SP 5 e ponte torrente Idice,14019,00,12715,1304,11002,3017,14019,0
2019/03,276,16/03/2019,6,SP 3_2 tra intersezione SP 5 e ponte torrente Idice,8653,00,8449,204,6296,2357,0,8653
2019/03,276,17/03/2019,7,SP 3_2 tra intersezione SP 5 e ponte torrente Idice,9156,00,9086,70,6874,2282,0,9156
2019/03,276,18/03/2019,1,SP 3_2 tra intersezione SP 5 e ponte torrente Idice,12616,00,11510,1106,10174,2442,12616,0
2019/03,276,19/03/2019,2,SP 3_2 tra intersezione SP 5 e ponte torrente Idice,13671,00,12359,1312,10633,3038,13671,0
2019/03,276,20/03/2019,3,SP 3_2 tra intersezione SP 5 e ponte torrente Idice,12864,00,11758,1106,10136,2728,12864,0
2019/03,276,21/03/2019,4,SP 3_2 tra intersezione SP 5 e ponte torrente Idice,12897,00,11707,1190,10176,2721,12897,0
2019/03,276,22/03/2019,5,SP 3_2 tra intersezione SP 5 e ponte torrente Idice,13460,00,12224,1236,10576,2884,13460,0
2019/03,276,23/03/2019,6,SP 3_2 tra intersezione SP 5 e ponte torrente Idice,8454,00,8243,211,6117,2337,0,8454
2019/03,276,24/03/2019,7,SP 3_2 tra intersezione SP 5 e ponte torrente Idice,7562,00,7510,52,5345,2217,0,7562
2019/03,276,25/03/2019,1,SP 3_2 tra intersezione SP 5 e ponte torrente Idice,12122,00,11034,1088,9655,2467,12122,0
2019/03,276,26/03/2019,2,SP 3_2 tra intersezione SP 5 e ponte torrente Idice,12497,00,11345,1152,9906,2591,12497,0
2019/03,276,27/03/2019,3,SP 3_2 tra intersezione SP 5 e ponte torrente Idice,12936,00,11791,1145,10259,2677,12936,0
2019/03,276,28/03/2019,4,SP 3_2 tra intersezione SP 5 e ponte torrente Idice,13097,00,11888,1209,10338,2759,13097,0
2019/03,277,15/03/2019,5,SP 6 tra Budrio e San Martino in Argine,8089,00,7591,498,6223,1866,8089,0
2019/03,277,16/03/2019,6,SP 6 tra Budrio e San Martino in Argine,6172,10,6039,132,4467,1705,0,6172
2019/03,277,17/03/2019,7,SP 6 tra Budrio e San Martino in Argine,5062,00,5018,44,3696,1366,0,5062
2019/03,277,18/03/2019,1,SP 6 tra Budrio e San Martino in Argine,7731,00,7300,431,6125,1606,7731,0
2019/03,277,19/03/2019,2,SP 6 tra Budrio e San Martino in Argine,7995,00,7527,468,6223,1772,7995,0
2019/03,277,20/03/2019,3,SP 6 tra Budrio e San Martino in Argine,7980,00,7504,476,6208,1772,7980,0
2019/03,277,21/03/2019,4,SP 6 tra Budrio e San Martino in Argine,8083,00,7578,505,6239,1844,8083,0
2019/03,277,22/03/2019,5,SP 6 tra Budrio e San Martino in Argine,8260,00,7755,505,6284,1976,8260,0
2019/03,277,23/03/2019,6,SP 6 tra Budrio e San Martino in Argine,6778,00,6626,152,5057,1721,0,6778
2019/03,277,24/03/2019,7,SP 6 tra Budrio e San Martino in Argine,5026,10,4997,28,3646,1380,0,5026
2019/03,277,25/03/2019,1,SP 6 tra Budrio e San Martino in Argine,7748,00,7263,485,6047,1701,7748,0
2019/03,277,26/03/2019,2,SP 6 tra Budrio e San Martino in Argine,8021,00,7593,428,6294,1727,8021,0
2019/03,277,27/03/2019,3,SP 6 tra Budrio e San Martino in Argine,8183,00,7675,508,6387,1796,8183,0
2019/03,277,28/03/2019,4,SP 6 tra Budrio e San Martino in Argine,8132,00,7675,457,6316,1816,8132,0
2019/03,278,15/03/2019,5,SP 6 tra Budrio e bivio SP 253,14809,10,14003,805,11492,3317,14809,0
2019/03,278,16/03/2019,6,SP 6 tra Budrio e bivio SP 253,11715,00,11510,205,8634,3081,0,11715
2019/03,278,17/03/2019,7,SP 6 tra Budrio e bivio SP 253,9522,00,9469,53,6992,2530,0,9522
2019/03,278,18/03/2019,1,SP 6 tra Budrio e bivio SP 253,14000,00,13288,712,11216,2784,14000,0
2019/03,278,19/03/2019,2,SP 6 tra Budrio e bivio SP 253,14501,00,13732,769,11495,3006,14501,0
2019/03,278,20/03/2019,3,SP 6 tra Budrio e bivio SP 253,14365,00,13558,807,11300,3065,14365,0
2019/03,278,21/03/2019,4,SP 6 tra Budrio e bivio SP 253,14905,00,14048,857,11614,3291,14905,0
2019/03,278,22/03/2019,5,SP 6 tra Budrio e bivio SP 253,14942,00,14170,772,11555,3387,14942,0
2019/03,278,23/03/2019,6,SP 6 tra Budrio e bivio SP 253,11918,00,11752,166,8735,3183,0,11918
2019/03,278,24/03/2019,7,SP 6 tra Budrio e bivio SP 253,8798,00,8758,40,6341,2457,0,8798
2019/03,278,25/03/2019,1,SP 6 tra Budrio e bivio SP 253,13961,00,13203,758,11164,2797,13961,0
2019/03,278,26/03/2019,2,SP 6 tra Budrio e bivio SP 253,14586,10,13821,764,11675,2911,14586,0
2019/03,278,27/03/2019,3,SP 6 tra Budrio e bivio SP 253,14507,00,13751,756,11446,3061,14507,0
2019/03,278,28/03/2019,4,SP 6 tra Budrio e bivio SP 253,14508,00,13694,814,11311,3197,14508,0
2019/03,279,15/03/2019,5,SP 31 dal bivio SP 28 per Castenaso a Ponte Rizzoli,15964,00,14846,1118,13039,2925,15964,0
2019/03,279,16/03/2019,6,SP 31 dal bivio SP 28 per Castenaso a Ponte Rizzoli,10485,00,10285,200,8035,2450,0,10485
2019/03,279,17/03/2019,7,SP 31 dal bivio SP 28 per Castenaso a Ponte Rizzoli,8612,00,8547,65,6614,1998,0,8612
2019/03,279,18/03/2019,1,SP 31 dal bivio SP 28 per Castenaso a Ponte Rizzoli,14280,20,13324,954,11991,2289,14280,0
2019/03,279,19/03/2019,2,SP 31 dal bivio SP 28 per Castenaso a Ponte Rizzoli,14503,10,13527,975,11954,2549,14503,0
2019/03,279,20/03/2019,3,SP 31 dal bivio SP 28 per Castenaso a Ponte Rizzoli,14529,10,13523,1005,11966,2563,14529,0
2019/03,279,21/03/2019,4,SP 31 dal bivio SP 28 per Castenaso a Ponte Rizzoli,14646,00,13664,982,12002,2644,14646,0
2019/03,279,22/03/2019,5,SP 31 dal bivio SP 28 per Castenaso a Ponte Rizzoli,15056,00,14148,908,12237,2819,15056,0
2019/03,279,23/03/2019,6,SP 31 dal bivio SP 28 per Castenaso a Ponte Rizzoli,10164,10,10001,162,7854,2310,0,10164
2019/03,279,24/03/2019,7,SP 31 dal bivio SP 28 per Castenaso a Ponte Rizzoli,8848,10,8792,55,6695,2153,0,8848
2019/03,279,25/03/2019,1,SP 31 dal bivio SP 28 per Castenaso a Ponte Rizzoli,14395,30,13357,1035,12026,2369,14395,0
2019/03,279,26/03/2019,2,SP 31 dal bivio SP 28 per Castenaso a Ponte Rizzoli,14289,10,13349,939,11922,2367,14289,0
2019/03,279,27/03/2019,3,SP 31 dal bivio SP 28 per Castenaso a Ponte Rizzoli,14384,00,13455,929,11902,2482,14384,0
2019/03,279,28/03/2019,4,SP 31 dal bivio SP 28 per Castenaso a Ponte Rizzoli,14611,00,13624,987,12092,2519,14611,0
2019/03,280,15/03/2019,5,SP 26 tra Gesso e Ponte Rivabella,21289,10,20751,537,15528,5761,21289,0
2019/03,280,16/03/2019,6,SP 26 tra Gesso e Ponte Rivabella,20234,10,20047,186,14730,5504,0,20234
2019/03,280,17/03/2019,7,SP 26 tra Gesso e Ponte Rivabella,16227,00,16168,59,12028,4199,0,16227
2019/03,280,18/03/2019,1,SP 26 tra Gesso e Ponte Rivabella,20968,10,20473,494,16387,4581,20968,0
2019/03,280,19/03/2019,2,SP 26 tra Gesso e Ponte Rivabella,21537,00,21045,492,16402,5135,21537,0
2019/03,280,20/03/2019,3,SP 26 tra Gesso e Ponte Rivabella,21436,00,20915,521,16491,4945,21436,0
2019/03,280,21/03/2019,4,SP 26 tra Gesso e Ponte Rivabella,21738,00,21277,461,16536,5202,21738,0
2019/03,280,22/03/2019,5,SP 26 tra Gesso e Ponte Rivabella,22267,00,21777,490,16852,5415,22267,0
2019/03,280,23/03/2019,6,SP 26 tra Gesso e Ponte Rivabella,20130,00,19935,195,14491,5639,0,20130
2019/03,280,24/03/2019,7,SP 26 tra Gesso e Ponte Rivabella,16226,10,16185,40,12028,4198,0,16226
2019/03,280,25/03/2019,1,SP 26 tra Gesso e Ponte Rivabella,20928,10,20448,479,16291,4637,20928,0
2019/03,280,26/03/2019,2,SP 26 tra Gesso e Ponte Rivabella,20960,00,20449,511,16191,4769,20960,0
2019/03,280,27/03/2019,3,SP 26 tra Gesso e Ponte Rivabella,21265,20,20740,523,16198,5067,21265,0
2019/03,280,28/03/2019,4,SP 26 tra Gesso e Ponte Rivabella,21936,00,21433,503,16627,5309,21936,0
2019/03,281,15/03/2019,5,SP 78_1 tra Bazzano e Intersezione SP 27 a Monteveglio,7515,20,7252,261,5764,1751,7515,0
2019/03,281,16/03/2019,6,SP 78_1 tra Bazzano e Intersezione SP 27 a Monteveglio,7053,00,6951,102,5225,1828,0,7053
2019/03,281,17/03/2019,7,SP 78_1 tra Bazzano e Intersezione SP 27 a Monteveglio,5503,10,5460,42,4231,1272,0,5503
2019/03,281,18/03/2019,1,SP 78_1 tra Bazzano e Intersezione SP 27 a Monteveglio,6974,20,6750,222,5601,1373,6974,0
2019/03,281,19/03/2019,2,SP 78_1 tra Bazzano e Intersezione SP 27 a Monteveglio,7028,00,6800,228,5571,1457,7028,0
2019/03,281,20/03/2019,3,SP 78_1 tra Bazzano e Intersezione SP 27 a Monteveglio,6799,10,6570,228,5384,1415,6799,0
2019/03,281,21/03/2019,4,SP 78_1 tra Bazzano e Intersezione SP 27 a Monteveglio,6816,10,6581,234,5328,1488,6816,0
2019/03,281,22/03/2019,5,SP 78_1 tra Bazzano e Intersezione SP 27 a Monteveglio,7256,00,7014,242,5544,1712,7256,0
2019/03,281,23/03/2019,6,SP 78_1 tra Bazzano e Intersezione SP 27 a Monteveglio,6786,00,6670,116,5096,1690,0,6786
2019/03,281,24/03/2019,7,SP 78_1 tra Bazzano e Intersezione SP 27 a Monteveglio,4862,10,4817,44,3570,1292,0,4862
2019/03,281,25/03/2019,1,SP 78_1 tra Bazzano e Intersezione SP 27 a Monteveglio,7074,00,6830,244,5664,1410,7074,0
2019/03,281,26/03/2019,2,SP 78_1 tra Bazzano e Intersezione SP 27 a Monteveglio,7010,20,6756,252,5554,1456,7010,0
2019/03,281,27/03/2019,3,SP 78_1 tra Bazzano e Intersezione SP 27 a Monteveglio,6845,10,6621,223,5367,1478,6845,0
2019/03,281,28/03/2019,4,SP 78_1 tra Bazzano e Intersezione SP 27 a Monteveglio,6984,10,6759,224,5435,1549,6984,0
2019/03,282,15/03/2019,5,SS 9 tra Anzola dell'Emilia e Bologna,25461,00,23082,2379,18538,6923,25461,0
2019/03,282,16/03/2019,6,SS 9 tra Anzola dell'Emilia e Bologna,19077,00,18521,556,12965,6112,0,19077
2019/03,282,17/03/2019,7,SS 9 tra Anzola dell'Emilia e Bologna,15753,00,15608,145,10778,4975,0,15753
2019/03,282,18/03/2019,1,SS 9 tra Anzola dell'Emilia e Bologna,24642,00,22287,2355,18791,5851,24642,0
2019/03,282,19/03/2019,2,SS 9 tra Anzola dell'Emilia e Bologna,25394,10,22926,2467,18784,6610,25394,0
2019/03,282,20/03/2019,3,SS 9 tra Anzola dell'Emilia e Bologna,24610,10,22282,2327,18418,6192,24610,0
2019/03,282,21/03/2019,4,SS 9 tra Anzola dell'Emilia e Bologna,24294,00,21956,2338,18054,6240,24294,0
2019/03,282,22/03/2019,5,SS 9 tra Anzola dell'Emilia e Bologna,24842,10,22476,2365,18344,6498,24842,0
2019/03,282,23/03/2019,6,SS 9 tra Anzola dell'Emilia e Bologna,18796,10,18189,606,13060,5736,0,18796
2019/03,282,24/03/2019,7,SS 9 tra Anzola dell'Emilia e Bologna,15183,00,15040,143,10458,4725,0,15183
2019/03,282,25/03/2019,1,SS 9 tra Anzola dell'Emilia e Bologna,23806,10,21533,2272,18095,5711,23806,0
2019/03,282,26/03/2019,2,SS 9 tra Anzola dell'Emilia e Bologna,23960,00,21734,2226,18109,5851,23960,0
2019/03,282,27/03/2019,3,SS 9 tra Anzola dell'Emilia e Bologna,24430,00,22064,2366,18213,6217,24430,0
2019/03,282,28/03/2019,4,SS 9 tra Anzola dell'Emilia e Bologna,24659,10,22308,2350,18376,6283,24659,0
2019/03,285,15/03/2019,5,SP 1 fra Crevalcore e Decima,6628,00,6198,430,5002,1626,6628,0
2019/03,285,16/03/2019,6,SP 1 fra Crevalcore e Decima,5543,00,5403,140,3872,1671,0,5543
2019/03,287,15/03/2019,5,SP 6 fra Cento e Pilastrello,8406,00,7921,485,6571,1835,8406,0
2019/03,287,16/03/2019,6,SP 6 fra Cento e Pilastrello,7384,00,7271,113,5232,2152,0,7384
2019/03,287,17/03/2019,7,SP 6 fra Cento e Pilastrello,5750,00,5733,17,4161,1589,0,5750
2019/03,287,18/03/2019,1,SP 6 fra Cento e Pilastrello,8039,10,7534,504,6543,1496,8039,0
2019/03,287,19/03/2019,2,SP 6 fra Cento e Pilastrello,8152,00,7595,557,6558,1594,8152,0
2019/03,287,20/03/2019,3,SP 6 fra Cento e Pilastrello,8309,00,7804,505,6672,1637,8309,0
2019/03,287,21/03/2019,4,SP 6 fra Cento e Pilastrello,8464,00,7913,551,6772,1692,8464,0
2019/03,287,22/03/2019,5,SP 6 fra Cento e Pilastrello,8419,00,7933,486,6460,1959,8419,0
2019/03,287,23/03/2019,6,SP 6 fra Cento e Pilastrello,7461,00,7345,116,5167,2294,0,7461
2019/03,287,24/03/2019,7,SP 6 fra Cento e Pilastrello,6176,00,6149,27,4511,1665,0,6176
2019/03,287,25/03/2019,1,SP 6 fra Cento e Pilastrello,7980,00,7509,471,6522,1458,7980,0
2019/03,287,26/03/2019,2,SP 6 fra Cento e Pilastrello,8222,00,7697,525,6602,1620,8222,0
2019/03,287,27/03/2019,3,SP 6 fra Cento e Pilastrello,8049,00,7515,534,6407,1642,8049,0
2019/03,287,28/03/2019,4,SP 6 fra Cento e Pilastrello,8152,00,7652,500,6481,1671,8152,0
2019/03,288,15/03/2019,5,SP 42 fra Pieve di Cento e Castello d'Argile,20183,10,19286,896,15123,5060,20183,0
2019/03,288,16/03/2019,6,SP 42 fra Pieve di Cento e Castello d'Argile,15046,00,14802,244,10639,4407,0,15046
2019/03,288,17/03/2019,7,SP 42 fra Pieve di Cento e Castello d'Argile,11527,00,11453,74,7912,3615,0,11527
2019/03,288,18/03/2019,1,SP 42 fra Pieve di Cento e Castello d'Argile,18779,00,17930,849,14617,4162,18779,0
2019/03,288,19/03/2019,2,SP 42 fra Pieve di Cento e Castello d'Argile,19323,00,18394,929,14763,4560,19323,0
2019/03,288,20/03/2019,3,SP 42 fra Pieve di Cento e Castello d'Argile,19615,00,18737,878,15033,4582,19615,0
2019/03,288,21/03/2019,4,SP 42 fra Pieve di Cento e Castello d'Argile,20043,10,19204,838,15252,4791,20043,0
2019/03,288,22/03/2019,5,SP 42 fra Pieve di Cento e Castello d'Argile,20481,00,19658,823,15495,4986,20481,0
2019/03,288,23/03/2019,6,SP 42 fra Pieve di Cento e Castello d'Argile,15569,00,15348,221,10989,4580,0,15569
2019/03,288,24/03/2019,7,SP 42 fra Pieve di Cento e Castello d'Argile,13353,00,13280,73,9500,3853,0,13353
2019/03,288,25/03/2019,1,SP 42 fra Pieve di Cento e Castello d'Argile,18421,10,17583,837,14248,4173,18421,0
2019/03,288,26/03/2019,2,SP 42 fra Pieve di Cento e Castello d'Argile,19139,00,18258,881,14889,4250,19139,0
2019/03,288,27/03/2019,3,SP 42 fra Pieve di Cento e Castello d'Argile,18878,00,17994,884,14482,4396,18878,0
2019/03,288,28/03/2019,4,SP 42 fra Pieve di Cento e Castello d'Argile,19076,00,18272,804,14514,4562,19076,0
2019/03,289,15/03/2019,5,SP 66 fra Cento e Sant'Agostino,15099,10,14268,830,11863,3236,15099,0
2019/03,289,16/03/2019,6,SP 66 fra Cento e Sant'Agostino,13075,00,12873,202,9550,3525,0,13075
2019/03,289,17/03/2019,7,SP 66 fra Cento e Sant'Agostino,10176,10,10120,55,7353,2823,0,10176
2019/03,289,18/03/2019,1,SP 66 fra Cento e Sant'Agostino,14772,00,13982,790,12151,2621,14772,0
2019/03,289,19/03/2019,2,SP 66 fra Cento e Sant'Agostino,15169,00,14354,815,12104,3065,15169,0
2019/03,289,20/03/2019,3,SP 66 fra Cento e Sant'Agostino,15131,00,14265,866,12049,3082,15131,0
2019/03,289,21/03/2019,4,SP 66 fra Cento e Sant'Agostino,14831,00,14044,787,11773,3058,14831,0
2019/03,289,22/03/2019,5,SP 66 fra Cento e Sant'Agostino,15478,00,14574,904,12070,3408,15478,0
2019/03,289,23/03/2019,6,SP 66 fra Cento e Sant'Agostino,13321,00,13109,212,9648,3673,0,13321
2019/03,289,24/03/2019,7,SP 66 fra Cento e Sant'Agostino,10348,00,10290,58,7278,3070,0,10348
2019/03,289,25/03/2019,1,SP 66 fra Cento e Sant'Agostino,14488,00,13676,812,11747,2741,14488,0
2019/03,289,26/03/2019,2,SP 66 fra Cento e Sant'Agostino,14999,00,14160,839,12052,2947,14999,0
2019/03,289,27/03/2019,3,SP 66 fra Cento e Sant'Agostino,15238,00,14434,804,12148,3090,15238,0
2019/03,289,28/03/2019,4,SP 66 fra Cento e Sant'Agostino,15439,00,14681,758,12304,3135,15439,0
2019/03,290,15/03/2019,5,SP 11 fra Pieve di Cento e San Pietro in Casale,6904,00,6537,367,5266,1638,6904,0
2019/03,290,16/03/2019,6,SP 11 fra Pieve di Cento e San Pietro in Casale,6199,00,6085,114,4274,1925,0,6199
2019/03,290,17/03/2019,7,SP 11 fra Pieve di Cento e San Pietro in Casale,4455,00,4435,20,2963,1492,0,4455
2019/03,290,18/03/2019,1,SP 11 fra Pieve di Cento e San Pietro in Casale,6467,00,6127,340,5273,1194,6467,0
2019/03,290,19/03/2019,2,SP 11 fra Pieve di Cento e San Pietro in Casale,6679,00,6263,416,5265,1414,6679,0
2019/03,290,20/03/2019,3,SP 11 fra Pieve di Cento e San Pietro in Casale,6700,00,6318,382,5284,1416,6700,0
2019/03,290,21/03/2019,4,SP 11 fra Pieve di Cento e San Pietro in Casale,7108,00,6700,408,5620,1488,7108,0
2019/03,290,22/03/2019,5,SP 11 fra Pieve di Cento e San Pietro in Casale,7393,00,7044,349,5559,1834,7393,0
2019/03,290,23/03/2019,6,SP 11 fra Pieve di Cento e San Pietro in Casale,6381,00,6247,134,4318,2063,0,6381
2019/03,290,24/03/2019,7,SP 11 fra Pieve di Cento e San Pietro in Casale,5466,00,5436,30,3861,1605,0,5466
2019/03,290,25/03/2019,1,SP 11 fra Pieve di Cento e San Pietro in Casale,6349,00,6017,332,5110,1239,6349,0
2019/03,290,26/03/2019,2,SP 11 fra Pieve di Cento e San Pietro in Casale,6661,00,6267,394,5356,1305,6661,0
2019/03,290,27/03/2019,3,SP 11 fra Pieve di Cento e San Pietro in Casale,6487,10,6077,409,5176,1311,6487,0
2019/03,290,28/03/2019,4,SP 11 fra Pieve di Cento e San Pietro in Casale,6592,00,6207,385,5228,1364,6592,0
2019/03,291,15/03/2019,5,SP 4 tra San Pietro in Casale e San Vincenzo/San Venanzio,11133,10,10739,393,8278,2855,11133,0
2019/03,291,16/03/2019,6,SP 4 tra San Pietro in Casale e San Vincenzo/San Venanzio,9273,00,9173,100,6646,2627,0,9273
2019/03,291,17/03/2019,7,SP 4 tra San Pietro in Casale e San Vincenzo/San Venanzio,7294,00,7270,24,5397,1897,0,7294
2019/03,291,18/03/2019,1,SP 4 tra San Pietro in Casale e San Vincenzo/San Venanzio,10364,00,9945,419,8105,2259,10364,0
2019/03,291,19/03/2019,2,SP 4 tra San Pietro in Casale e San Vincenzo/San Venanzio,10659,00,10289,370,8164,2495,10659,0
2019/03,291,20/03/2019,3,SP 4 tra San Pietro in Casale e San Vincenzo/San Venanzio,10583,00,10214,369,8022,2561,10583,0
2019/03,291,21/03/2019,4,SP 4 tra San Pietro in Casale e San Vincenzo/San Venanzio,10835,00,10400,435,8240,2595,10835,0
2019/03,291,22/03/2019,5,SP 4 tra San Pietro in Casale e San Vincenzo/San Venanzio,11031,00,10579,452,8234,2797,11031,0
2019/03,291,23/03/2019,6,SP 4 tra San Pietro in Casale e San Vincenzo/San Venanzio,9220,00,9106,114,6613,2607,0,9220
2019/03,291,24/03/2019,7,SP 4 tra San Pietro in Casale e San Vincenzo/San Venanzio,7339,00,7302,37,5300,2039,0,7339
2019/03,291,25/03/2019,1,SP 4 tra San Pietro in Casale e San Vincenzo/San Venanzio,10360,00,9920,440,8016,2344,10360,0
2019/03,291,26/03/2019,2,SP 4 tra San Pietro in Casale e San Vincenzo/San Venanzio,10446,00,10016,430,8093,2353,10446,0
2019/03,291,27/03/2019,3,SP 4 tra San Pietro in Casale e San Vincenzo/San Venanzio,10871,00,10390,481,8205,2666,10871,0
2019/03,291,28/03/2019,4,SP 4 tra San Pietro in Casale e San Vincenzo/San Venanzio,10749,00,10363,386,8120,2629,10749,0
2019/03,292,15/03/2019,5,SP 4 tra San Giorgio di Piano e Intersezione SP 11 c/o San Pietro in Casale,19735,00,18983,752,14544,5191,19735,0
2019/03,292,16/03/2019,6,SP 4 tra San Giorgio di Piano e Intersezione SP 11 c/o San Pietro in Casale,15055,10,14829,225,10530,4525,0,15055
2019/03,292,17/03/2019,7,SP 4 tra San Giorgio di Piano e Intersezione SP 11 c/o San Pietro in Casale,11562,00,11513,49,8174,3388,0,11562
2019/03,292,18/03/2019,1,SP 4 tra San Giorgio di Piano e Intersezione SP 11 c/o San Pietro in Casale,17543,00,16935,608,13553,3990,17543,0
2019/03,292,19/03/2019,2,SP 4 tra San Giorgio di Piano e Intersezione SP 11 c/o San Pietro in Casale,18275,00,17594,681,13887,4388,18275,0
2019/03,292,20/03/2019,3,SP 4 tra San Giorgio di Piano e Intersezione SP 11 c/o San Pietro in Casale,18019,00,17360,659,13643,4376,18019,0
2019/03,292,21/03/2019,4,SP 4 tra San Giorgio di Piano e Intersezione SP 11 c/o San Pietro in Casale,18441,20,17748,691,13993,4448,18441,0
2019/03,292,22/03/2019,5,SP 4 tra San Giorgio di Piano e Intersezione SP 11 c/o San Pietro in Casale,18990,00,18278,712,13993,4997,18990,0
2019/03,292,23/03/2019,6,SP 4 tra San Giorgio di Piano e Intersezione SP 11 c/o San Pietro in Casale,15270,00,15063,207,10607,4663,0,15270
2019/03,292,24/03/2019,7,SP 4 tra San Giorgio di Piano e Intersezione SP 11 c/o San Pietro in Casale,11594,00,11551,43,8237,3357,0,11594
2019/03,292,25/03/2019,1,SP 4 tra San Giorgio di Piano e Intersezione SP 11 c/o San Pietro in Casale,17862,00,17202,660,13721,4141,17862,0
2019/03,292,26/03/2019,2,SP 4 tra San Giorgio di Piano e Intersezione SP 11 c/o San Pietro in Casale,18248,00,17598,650,14012,4236,18248,0
2019/03,292,27/03/2019,3,SP 4 tra San Giorgio di Piano e Intersezione SP 11 c/o San Pietro in Casale,18156,00,17490,666,13750,4406,18156,0
2019/03,292,28/03/2019,4,SP 4 tra San Giorgio di Piano e Intersezione SP 11 c/o San Pietro in Casale,18250,00,17577,673,13830,4420,18250,0
2019/03,295,15/03/2019,5,SP 9 fra Colorno e Torrile centro abitato di Bezze,6987,00,6504,483,5584,1403,6987,0
2019/03,295,16/03/2019,6,SP 9 fra Colorno e Torrile centro abitato di Bezze,5066,00,4913,153,3862,1204,0,5066
2019/03,295,17/03/2019,7,SP 9 fra Colorno e Torrile centro abitato di Bezze,3773,10,3699,73,2772,1001,0,3773
2019/03,295,18/03/2019,1,SP 9 fra Colorno e Torrile centro abitato di Bezze,6730,10,6229,500,5506,1224,6730,0
2019/03,295,19/03/2019,2,SP 9 fra Colorno e Torrile centro abitato di Bezze,7215,00,6704,511,5798,1417,7215,0
2019/03,295,20/03/2019,3,SP 9 fra Colorno e Torrile centro abitato di Bezze,7152,10,6659,492,5774,1378,7152,0
2019/03,295,21/03/2019,4,SP 9 fra Colorno e Torrile centro abitato di Bezze,7076,00,6575,501,5645,1431,7076,0
2019/03,295,22/03/2019,5,SP 9 fra Colorno e Torrile centro abitato di Bezze,7185,20,6715,468,5737,1448,7185,0
2019/03,295,23/03/2019,6,SP 9 fra Colorno e Torrile centro abitato di Bezze,5178,00,5024,154,3945,1233,0,5178
2019/03,295,24/03/2019,7,SP 9 fra Colorno e Torrile centro abitato di Bezze,4039,00,3963,76,2969,1070,0,4039
2019/03,295,25/03/2019,1,SP 9 fra Colorno e Torrile centro abitato di Bezze,6931,20,6400,529,5662,1269,6931,0
2019/03,295,26/03/2019,2,SP 9 fra Colorno e Torrile centro abitato di Bezze,6983,10,6425,557,5647,1336,6983,0
2019/03,295,27/03/2019,3,SP 9 fra Colorno e Torrile centro abitato di Bezze,7198,00,6674,524,5727,1471,7198,0
2019/03,295,28/03/2019,4,SP 9 fra Colorno e Torrile centro abitato di Bezze,8092,00,7566,526,6386,1706,8092,0
2019/03,298,15/03/2019,5,SP 588R da Castione Marchesi (A 1) a Busseto,3315,10,3106,208,2588,727,3315,0
2019/03,298,16/03/2019,6,SP 588R da Castione Marchesi (A 1) a Busseto,2625,10,2551,73,1879,746,0,2625
2019/03,298,17/03/2019,7,SP 588R da Castione Marchesi (A 1) a Busseto,2117,00,2089,28,1570,547,0,2117
2019/03,298,18/03/2019,1,SP 588R da Castione Marchesi (A 1) a Busseto,2875,00,2677,198,2334,541,2875,0
2019/03,298,19/03/2019,2,SP 588R da Castione Marchesi (A 1) a Busseto,3055,00,2843,212,2481,574,3055,0
2019/03,298,20/03/2019,3,SP 588R da Castione Marchesi (A 1) a Busseto,3192,00,2971,221,2495,697,3192,0
2019/03,298,21/03/2019,4,SP 588R da Castione Marchesi (A 1) a Busseto,3192,00,2982,210,2512,680,3192,0
2019/03,298,22/03/2019,5,SP 588R da Castione Marchesi (A 1) a Busseto,3285,20,3091,192,2520,765,3285,0
2019/03,298,23/03/2019,6,SP 588R da Castione Marchesi (A 1) a Busseto,2727,00,2660,67,1972,755,0,2727
2019/03,298,24/03/2019,7,SP 588R da Castione Marchesi (A 1) a Busseto,2571,00,2550,21,1922,649,0,2571
2019/03,298,25/03/2019,1,SP 588R da Castione Marchesi (A 1) a Busseto,2881,10,2686,194,2294,587,2881,0
2019/03,298,26/03/2019,2,SP 588R da Castione Marchesi (A 1) a Busseto,3642,60,3272,364,3059,583,3642,0
2019/03,298,27/03/2019,3,SP 588R da Castione Marchesi (A 1) a Busseto,3018,10,2777,240,2439,579,3018,0
2019/03,298,28/03/2019,4,SP 588R da Castione Marchesi (A 1) a Busseto,3432,00,3169,263,2841,591,3432,0
2019/03,300,15/03/2019,5,SP 462R fra Fiorenzuola d'Arda e Cortemaggiore,9102,40,7899,1199,6991,2111,9102,0
2019/03,300,16/03/2019,6,SP 462R fra Fiorenzuola d'Arda e Cortemaggiore,8297,00,7955,342,5978,2319,0,8297
2019/03,300,17/03/2019,7,SP 462R fra Fiorenzuola d'Arda e Cortemaggiore,10963,00,10881,82,8968,1995,0,10963
2019/03,300,18/03/2019,1,SP 462R fra Fiorenzuola d'Arda e Cortemaggiore,8290,00,7173,1117,6708,1582,8290,0
2019/03,300,19/03/2019,2,SP 462R fra Fiorenzuola d'Arda e Cortemaggiore,8480,60,7391,1083,6831,1649,8480,0
2019/03,300,20/03/2019,3,SP 462R fra Fiorenzuola d'Arda e Cortemaggiore,8713,00,7609,1104,6942,1771,8713,0
2019/03,300,21/03/2019,4,SP 462R fra Fiorenzuola d'Arda e Cortemaggiore,8730,30,7648,1079,7002,1728,8730,0
2019/03,300,22/03/2019,5,SP 462R fra Fiorenzuola d'Arda e Cortemaggiore,8829,00,7646,1183,6924,1905,8829,0
2019/03,300,23/03/2019,6,SP 462R fra Fiorenzuola d'Arda e Cortemaggiore,7161,00,6799,362,5287,1874,0,7161
2019/03,300,24/03/2019,7,SP 462R fra Fiorenzuola d'Arda e Cortemaggiore,6173,00,6095,78,4675,1498,0,6173
2019/03,300,25/03/2019,1,SP 462R fra Fiorenzuola d'Arda e Cortemaggiore,8434,30,7331,1100,6789,1645,8434,0
2019/03,300,26/03/2019,2,SP 462R fra Fiorenzuola d'Arda e Cortemaggiore,9153,20,7900,1251,7522,1631,9153,0
2019/03,300,27/03/2019,3,SP 462R fra Fiorenzuola d'Arda e Cortemaggiore,8781,20,7684,1095,7039,1742,8781,0
2019/03,300,28/03/2019,4,SP 462R fra Fiorenzuola d'Arda e Cortemaggiore,9617,20,8530,1085,7757,1860,9617,0
2019/03,301,15/03/2019,5,SP 4 tra Fiorenzuola d'Arda (Tg Sud) e Castell'Arquato,8927,10,8342,584,6953,1974,8927,0
2019/03,301,16/03/2019,6,SP 4 tra Fiorenzuola d'Arda (Tg Sud) e Castell'Arquato,8312,00,8149,163,6267,2045,0,8312
2019/03,301,17/03/2019,7,SP 4 tra Fiorenzuola d'Arda (Tg Sud) e Castell'Arquato,6845,00,6817,28,5178,1667,0,6845
2019/03,301,18/03/2019,1,SP 4 tra Fiorenzuola d'Arda (Tg Sud) e Castell'Arquato,8297,10,7790,506,6699,1598,8297,0
2019/03,301,19/03/2019,2,SP 4 tra Fiorenzuola d'Arda (Tg Sud) e Castell'Arquato,8520,00,7974,546,6812,1708,8520,0
2019/03,301,20/03/2019,3,SP 4 tra Fiorenzuola d'Arda (Tg Sud) e Castell'Arquato,8567,00,8067,500,6736,1831,8567,0
2019/03,301,21/03/2019,4,SP 4 tra Fiorenzuola d'Arda (Tg Sud) e Castell'Arquato,8836,00,8205,631,6889,1947,8836,0
2019/03,301,22/03/2019,5,SP 4 tra Fiorenzuola d'Arda (Tg Sud) e Castell'Arquato,9119,20,8518,599,7041,2078,9119,0
2019/03,301,23/03/2019,6,SP 4 tra Fiorenzuola d'Arda (Tg Sud) e Castell'Arquato,8245,00,8121,124,6306,1939,0,8245
2019/03,301,24/03/2019,7,SP 4 tra Fiorenzuola d'Arda (Tg Sud) e Castell'Arquato,7216,00,7179,37,5481,1735,0,7216
2019/03,301,25/03/2019,1,SP 4 tra Fiorenzuola d'Arda (Tg Sud) e Castell'Arquato,8590,00,7911,679,6942,1648,8590,0
2019/03,301,26/03/2019,2,SP 4 tra Fiorenzuola d'Arda (Tg Sud) e Castell'Arquato,8967,10,8302,664,7262,1705,8967,0
2019/03,301,27/03/2019,3,SP 4 tra Fiorenzuola d'Arda (Tg Sud) e Castell'Arquato,8786,00,8096,690,6898,1888,8786,0
2019/03,301,28/03/2019,4,SP 4 tra Fiorenzuola d'Arda (Tg Sud) e Castell'Arquato,9183,00,8498,685,7251,1932,9183,0
2019/03,302,19/03/2019,2,SP 12 da Fidenza (Casello A 1) a Soragna,7773,00,6788,985,6285,1488,7773,0
2019/03,302,20/03/2019,3,SP 12 da Fidenza (Casello A 1) a Soragna,7973,10,6935,1037,6405,1568,7973,0
2019/03,302,21/03/2019,4,SP 12 da Fidenza (Casello A 1) a Soragna,8082,10,6980,1101,6547,1535,8082,0
2019/03,302,22/03/2019,5,SP 12 da Fidenza (Casello A 1) a Soragna,8183,10,7157,1025,6402,1781,8183,0
2019/03,302,23/03/2019,6,SP 12 da Fidenza (Casello A 1) a Soragna,7295,00,7071,224,5336,1959,0,7295
2019/03,302,24/03/2019,7,SP 12 da Fidenza (Casello A 1) a Soragna,6961,10,6883,77,5133,1828,0,6961
2019/03,302,25/03/2019,1,SP 12 da Fidenza (Casello A 1) a Soragna,7773,00,6795,978,6334,1439,7773,0
2019/03,302,26/03/2019,2,SP 12 da Fidenza (Casello A 1) a Soragna,8600,00,7438,1162,7104,1496,8600,0
2019/03,302,27/03/2019,3,SP 12 da Fidenza (Casello A 1) a Soragna,8139,00,7098,1041,6566,1573,8139,0
2019/03,302,28/03/2019,4,SP 12 da Fidenza (Casello A 1) a Soragna,8346,10,7342,1003,6764,1582,8346,0
2019/03,303,15/03/2019,5,SP 11 fra Borgonovo e Gragnano,10082,00,9579,503,7867,2215,10082,0
2019/03,303,16/03/2019,6,SP 11 fra Borgonovo e Gragnano,9214,00,9062,152,6886,2328,0,9214
2019/03,303,17/03/2019,7,SP 11 fra Borgonovo e Gragnano,7255,00,7215,40,5484,1771,0,7255
2019/03,303,18/03/2019,1,SP 11 fra Borgonovo e Gragnano,9566,10,8966,599,7778,1788,9566,0
2019/03,303,19/03/2019,2,SP 11 fra Borgonovo e Gragnano,9746,00,9112,634,7804,1942,9746,0
2019/03,303,20/03/2019,3,SP 11 fra Borgonovo e Gragnano,9808,00,9199,609,7760,2048,9808,0
2019/03,303,21/03/2019,4,SP 11 fra Borgonovo e Gragnano,9875,00,9357,518,7762,2113,9875,0
2019/03,303,22/03/2019,5,SP 11 fra Borgonovo e Gragnano,9903,00,9414,489,7665,2238,9903,0
2019/03,303,23/03/2019,6,SP 11 fra Borgonovo e Gragnano,8822,00,8636,186,6573,2249,0,8822
2019/03,303,24/03/2019,7,SP 11 fra Borgonovo e Gragnano,7797,00,7754,43,5902,1895,0,7797
2019/03,303,25/03/2019,1,SP 11 fra Borgonovo e Gragnano,9602,00,9116,486,7711,1891,9602,0
2019/03,303,26/03/2019,2,SP 11 fra Borgonovo e Gragnano,9760,10,9246,513,7820,1940,9760,0
2019/03,303,27/03/2019,3,SP 11 fra Borgonovo e Gragnano,9781,00,9243,538,7792,1989,9781,0
2019/03,303,28/03/2019,4,SP 11 fra Borgonovo e Gragnano,9939,10,9394,544,7868,2071,9939,0
2019/03,304,15/03/2019,5,SP 42 fra Podenzano e bivio SP 6/ponte fiume Nure in località San Giorgio Piacentino,7307,00,6849,458,5655,1652,7307,0
2019/03,304,16/03/2019,6,SP 42 fra Podenzano e bivio SP 6/ponte fiume Nure in località San Giorgio Piacentino,6071,00,5966,105,4297,1774,0,6071
2019/03,304,17/03/2019,7,SP 42 fra Podenzano e bivio SP 6/ponte fiume Nure in località San Giorgio Piacentino,5470,00,5442,28,4194,1276,0,5470
2019/03,304,18/03/2019,1,SP 42 fra Podenzano e bivio SP 6/ponte fiume Nure in località San Giorgio Piacentino,6898,00,6472,426,5451,1447,6898,0
2019/03,304,19/03/2019,2,SP 42 fra Podenzano e bivio SP 6/ponte fiume Nure in località San Giorgio Piacentino,7133,00,6687,446,5651,1482,7133,0
2019/03,304,20/03/2019,3,SP 42 fra Podenzano e bivio SP 6/ponte fiume Nure in località San Giorgio Piacentino,7303,00,6819,484,5773,1530,7303,0
2019/03,304,21/03/2019,4,SP 42 fra Podenzano e bivio SP 6/ponte fiume Nure in località San Giorgio Piacentino,7131,10,6659,471,5648,1483,7131,0
2019/03,304,22/03/2019,5,SP 42 fra Podenzano e bivio SP 6/ponte fiume Nure in località San Giorgio Piacentino,7569,10,7175,393,5727,1842,7569,0
2019/03,304,23/03/2019,6,SP 42 fra Podenzano e bivio SP 6/ponte fiume Nure in località San Giorgio Piacentino,6086,10,5984,101,4416,1670,0,6086
2019/03,304,24/03/2019,7,SP 42 fra Podenzano e bivio SP 6/ponte fiume Nure in località San Giorgio Piacentino,5896,10,5865,30,4586,1310,0,5896
2019/03,304,25/03/2019,1,SP 42 fra Podenzano e bivio SP 6/ponte fiume Nure in località San Giorgio Piacentino,6969,00,6501,468,5553,1416,6969,0
2019/03,304,26/03/2019,2,SP 42 fra Podenzano e bivio SP 6/ponte fiume Nure in località San Giorgio Piacentino,7289,00,6834,455,5754,1535,7289,0
2019/03,304,27/03/2019,3,SP 42 fra Podenzano e bivio SP 6/ponte fiume Nure in località San Giorgio Piacentino,7614,10,7109,504,6049,1565,7614,0
2019/03,304,28/03/2019,4,SP 42 fra Podenzano e bivio SP 6/ponte fiume Nure in località San Giorgio Piacentino,7257,00,6827,430,5702,1555,7257,0
2019/03,305,15/03/2019,5,SP 6Bis fra Carpaneto e Castell'Arquato,4732,00,4454,278,3639,1093,4732,0
2019/03,305,16/03/2019,6,SP 6Bis fra Carpaneto e Castell'Arquato,4697,10,4562,134,3444,1253,0,4697
2019/03,305,17/03/2019,7,SP 6Bis fra Carpaneto e Castell'Arquato,4238,00,4193,45,3322,916,0,4238
2019/03,305,18/03/2019,1,SP 6Bis fra Carpaneto e Castell'Arquato,4106,00,3826,280,3283,823,4106,0
2019/03,305,19/03/2019,2,SP 6Bis fra Carpaneto e Castell'Arquato,4366,00,4054,312,3497,869,4366,0
2019/03,305,20/03/2019,3,SP 6Bis fra Carpaneto e Castell'Arquato,4399,00,4130,269,3501,898,4399,0
2019/03,305,21/03/2019,4,SP 6Bis fra Carpaneto e Castell'Arquato,4633,10,4183,449,3633,1000,4633,0
2019/03,305,22/03/2019,5,SP 6Bis fra Carpaneto e Castell'Arquato,4886,00,4468,418,3683,1203,4886,0
2019/03,305,23/03/2019,6,SP 6Bis fra Carpaneto e Castell'Arquato,4927,00,4785,142,3610,1317,0,4927
2019/03,305,24/03/2019,7,SP 6Bis fra Carpaneto e Castell'Arquato,4670,00,4643,27,3680,990,0,4670
2019/03,305,25/03/2019,1,SP 6Bis fra Carpaneto e Castell'Arquato,4325,00,3915,410,3435,890,4325,0
2019/03,305,26/03/2019,2,SP 6Bis fra Carpaneto e Castell'Arquato,4374,00,4111,263,3469,905,4374,0
2019/03,305,27/03/2019,3,SP 6Bis fra Carpaneto e Castell'Arquato,4617,00,4212,405,3606,1011,4617,0
2019/03,305,28/03/2019,4,SP 6Bis fra Carpaneto e Castell'Arquato,4687,00,4255,432,3671,1016,4687,0
2019/03,306,15/03/2019,5,SP 654R fra Ponte dell'Olio e Bettola,4767,00,4599,168,3671,1096,4767,0
2019/03,306,16/03/2019,6,SP 654R fra Ponte dell'Olio e Bettola,4693,00,4604,89,3626,1067,0,4693
2019/03,306,17/03/2019,7,SP 654R fra Ponte dell'Olio e Bettola,4694,00,4678,16,3700,994,0,4694
2019/03,306,18/03/2019,1,SP 654R fra Ponte dell'Olio e Bettola,4838,10,4668,169,3986,852,4838,0
2019/03,306,19/03/2019,2,SP 654R fra Ponte dell'Olio e Bettola,4327,00,4174,153,3421,906,4327,0
2019/03,306,20/03/2019,3,SP 654R fra Ponte dell'Olio e Bettola,4477,10,4330,146,3558,919,4477,0
2019/03,306,21/03/2019,4,SP 654R fra Ponte dell'Olio e Bettola,4541,20,4353,186,3617,924,4541,0
2019/03,306,22/03/2019,5,SP 654R fra Ponte dell'Olio e Bettola,4724,00,4560,164,3602,1122,4724,0
2019/03,306,23/03/2019,6,SP 654R fra Ponte dell'Olio e Bettola,4944,10,4860,83,3797,1147,0,4944
2019/03,306,24/03/2019,7,SP 654R fra Ponte dell'Olio e Bettola,6021,10,5993,27,4756,1265,0,6021
2019/03,306,25/03/2019,1,SP 654R fra Ponte dell'Olio e Bettola,4947,10,4725,221,4050,897,4947,0
2019/03,306,26/03/2019,2,SP 654R fra Ponte dell'Olio e Bettola,4393,10,4198,194,3537,856,4393,0
2019/03,306,27/03/2019,3,SP 654R fra Ponte dell'Olio e Bettola,4438,10,4245,192,3522,916,4438,0
2019/03,306,28/03/2019,4,SP 654R fra Ponte dell'Olio e Bettola,4562,10,4383,178,3525,1037,4562,0
2019/03,307,15/03/2019,5,SS 45 tra Rivergaro e Perino,4831,00,4605,226,3699,1132,4831,0
2019/03,307,16/03/2019,6,SS 45 tra Rivergaro e Perino,6134,00,6000,134,4809,1325,0,6134
2019/03,307,17/03/2019,7,SS 45 tra Rivergaro e Perino,5751,00,5732,19,4647,1104,0,5751
2019/03,307,18/03/2019,1,SS 45 tra Rivergaro e Perino,4117,00,3905,212,3245,872,4117,0
2019/03,307,19/03/2019,2,SS 45 tra Rivergaro e Perino,4290,00,4066,224,3481,809,4290,0
2019/03,307,20/03/2019,3,SS 45 tra Rivergaro e Perino,4327,00,4124,203,3467,860,4327,0
2019/03,307,21/03/2019,4,SS 45 tra Rivergaro e Perino,4369,00,4157,212,3494,875,4369,0
2019/03,307,22/03/2019,5,SS 45 tra Rivergaro e Perino,4994,10,4758,235,3763,1231,4994,0
2019/03,307,23/03/2019,6,SS 45 tra Rivergaro e Perino,6174,00,6058,116,4858,1316,0,6174
2019/03,307,24/03/2019,7,SS 45 tra Rivergaro e Perino,8099,00,8073,26,6746,1353,0,8099
2019/03,307,25/03/2019,1,SS 45 tra Rivergaro e Perino,4286,00,4078,208,3380,906,4286,0
2019/03,307,26/03/2019,2,SS 45 tra Rivergaro e Perino,4207,00,4012,195,3350,857,4207,0
2019/03,307,27/03/2019,3,SS 45 tra Rivergaro e Perino,4418,00,4214,204,3543,875,4418,0
2019/03,307,28/03/2019,4,SS 45 tra Rivergaro e Perino,4433,10,4204,228,3518,915,4433,0
2019/03,308,15/03/2019,5,SP 412R fra Pianello Val Tidone e Borgonovo Val Tidone,7302,20,6938,362,5740,1562,7302,0
2019/03,308,16/03/2019,6,SP 412R fra Pianello Val Tidone e Borgonovo Val Tidone,7499,00,7350,149,5883,1616,0,7499
2019/03,308,17/03/2019,7,SP 412R fra Pianello Val Tidone e Borgonovo Val Tidone,6420,00,6379,41,5112,1308,0,6420
2019/03,308,18/03/2019,1,SP 412R fra Pianello Val Tidone e Borgonovo Val Tidone,6683,00,6384,299,5431,1252,6683,0
2019/03,308,19/03/2019,2,SP 412R fra Pianello Val Tidone e Borgonovo Val Tidone,6659,00,6374,285,5328,1331,6659,0
2019/03,308,20/03/2019,3,SP 412R fra Pianello Val Tidone e Borgonovo Val Tidone,7203,00,6855,348,5801,1402,7203,0
2019/03,308,21/03/2019,4,SP 412R fra Pianello Val Tidone e Borgonovo Val Tidone,6837,00,6468,369,5416,1421,6837,0
2019/03,308,22/03/2019,5,SP 412R fra Pianello Val Tidone e Borgonovo Val Tidone,7416,10,7088,327,5850,1566,7416,0
2019/03,308,23/03/2019,6,SP 412R fra Pianello Val Tidone e Borgonovo Val Tidone,7697,10,7535,161,5968,1729,0,7697
2019/03,308,24/03/2019,7,SP 412R fra Pianello Val Tidone e Borgonovo Val Tidone,8046,00,8005,41,6604,1442,0,8046
2019/03,308,25/03/2019,1,SP 412R fra Pianello Val Tidone e Borgonovo Val Tidone,6694,20,6370,322,5376,1318,6694,0
2019/03,308,26/03/2019,2,SP 412R fra Pianello Val Tidone e Borgonovo Val Tidone,6793,00,6496,297,5384,1409,6793,0
2019/03,308,27/03/2019,3,SP 412R fra Pianello Val Tidone e Borgonovo Val Tidone,7384,00,7064,320,5966,1418,7384,0
2019/03,308,28/03/2019,4,SP 412R fra Pianello Val Tidone e Borgonovo Val Tidone,6892,10,6545,346,5482,1410,6892,0
2019/03,309,15/03/2019,5,SP 10R fra Castelvetro Piacentino e Monticelli d'Ongina,12283,10,11753,529,9478,2805,12283,0
2019/03,309,16/03/2019,6,SP 10R fra Castelvetro Piacentino e Monticelli d'Ongina,11410,10,11210,199,8354,3056,0,11410
2019/03,309,17/03/2019,7,SP 10R fra Castelvetro Piacentino e Monticelli d'Ongina,9904,00,9848,56,7568,2336,0,9904
2019/03,309,18/03/2019,1,SP 10R fra Castelvetro Piacentino e Monticelli d'Ongina,11307,00,10787,520,9025,2282,11307,0
2019/03,309,19/03/2019,2,SP 10R fra Castelvetro Piacentino e Monticelli d'Ongina,11460,30,10918,539,9081,2379,11460,0
2019/03,309,20/03/2019,3,SP 10R fra Castelvetro Piacentino e Monticelli d'Ongina,11334,00,10779,555,8883,2451,11334,0
2019/03,309,21/03/2019,4,SP 10R fra Castelvetro Piacentino e Monticelli d'Ongina,11570,00,10940,630,9116,2454,11570,0
2019/03,309,22/03/2019,5,SP 10R fra Castelvetro Piacentino e Monticelli d'Ongina,12191,00,11637,554,9391,2800,12191,0
2019/03,309,23/03/2019,6,SP 10R fra Castelvetro Piacentino e Monticelli d'Ongina,11300,00,11116,184,8218,3082,0,11300
2019/03,309,24/03/2019,7,SP 10R fra Castelvetro Piacentino e Monticelli d'Ongina,10935,00,10874,61,8544,2391,0,10935
2019/03,309,25/03/2019,1,SP 10R fra Castelvetro Piacentino e Monticelli d'Ongina,11062,10,10539,522,8766,2296,11062,0
2019/03,309,26/03/2019,2,SP 10R fra Castelvetro Piacentino e Monticelli d'Ongina,11360,00,10793,567,9000,2360,11360,0
2019/03,309,27/03/2019,3,SP 10R fra Castelvetro Piacentino e Monticelli d'Ongina,11728,00,11201,527,9275,2453,11728,0
2019/03,309,28/03/2019,4,SP 10R fra Castelvetro Piacentino e Monticelli d'Ongina,11690,20,11183,505,9204,2486,11690,0
2019/03,311,15/03/2019,5,SP 62RVar tra la località San Giacomo (bivio SP 42) ed SP 2 (c/o Tagliata),12423,20,9787,2634,9716,2707,12423,0
2019/03,311,16/03/2019,6,SP 62RVar tra la località San Giacomo (bivio SP 42) ed SP 2 (c/o Tagliata),9063,00,8610,453,6617,2446,0,9063
2019/03,311,17/03/2019,7,SP 62RVar tra la località San Giacomo (bivio SP 42) ed SP 2 (c/o Tagliata),8905,10,8785,119,6427,2478,0,8905
2019/03,311,18/03/2019,1,SP 62RVar tra la località San Giacomo (bivio SP 42) ed SP 2 (c/o Tagliata),11856,00,9074,2782,9511,2345,11856,0
2019/03,311,19/03/2019,2,SP 62RVar tra la località San Giacomo (bivio SP 42) ed SP 2 (c/o Tagliata),11906,00,9097,2809,9533,2373,11906,0
2019/03,311,20/03/2019,3,SP 62RVar tra la località San Giacomo (bivio SP 42) ed SP 2 (c/o Tagliata),12044,00,9222,2822,9572,2472,12044,0
2019/03,311,21/03/2019,4,SP 62RVar tra la località San Giacomo (bivio SP 42) ed SP 2 (c/o Tagliata),12264,00,9381,2883,9736,2528,12264,0
2019/03,311,22/03/2019,5,SP 62RVar tra la località San Giacomo (bivio SP 42) ed SP 2 (c/o Tagliata),12520,10,9879,2640,9765,2755,12520,0
2019/03,311,23/03/2019,6,SP 62RVar tra la località San Giacomo (bivio SP 42) ed SP 2 (c/o Tagliata),8721,30,8253,465,6223,2498,0,8721
2019/03,311,24/03/2019,7,SP 62RVar tra la località San Giacomo (bivio SP 42) ed SP 2 (c/o Tagliata),9517,00,9383,134,6728,2789,0,9517
2019/03,311,25/03/2019,1,SP 62RVar tra la località San Giacomo (bivio SP 42) ed SP 2 (c/o Tagliata),11731,20,8990,2739,9467,2264,11731,0
2019/03,311,26/03/2019,2,SP 62RVar tra la località San Giacomo (bivio SP 42) ed SP 2 (c/o Tagliata),11722,00,8869,2853,9440,2282,11722,0
2019/03,311,27/03/2019,3,SP 62RVar tra la località San Giacomo (bivio SP 42) ed SP 2 (c/o Tagliata),12127,00,9192,2935,9677,2450,12127,0
2019/03,311,28/03/2019,4,SP 62RVar tra la località San Giacomo (bivio SP 42) ed SP 2 (c/o Tagliata),12665,20,9784,2879,10178,2487,12665,0
2019/03,312,15/03/2019,5,SP 42 fra Novellara e San Giacomo (SP 62R),14848,00,13469,1379,11377,3471,14848,0
2019/03,312,16/03/2019,6,SP 42 fra Novellara e San Giacomo (SP 62R),12224,00,11977,247,8695,3529,0,12224
2019/03,312,17/03/2019,7,SP 42 fra Novellara e San Giacomo (SP 62R),10342,00,10270,72,7149,3193,0,10342
2019/03,312,18/03/2019,1,SP 42 fra Novellara e San Giacomo (SP 62R),13920,00,12587,1333,11114,2806,13920,0
2019/03,312,19/03/2019,2,SP 42 fra Novellara e San Giacomo (SP 62R),14325,00,12957,1368,11509,2816,14325,0
2019/03,312,20/03/2019,3,SP 42 fra Novellara e San Giacomo (SP 62R),14510,00,13085,1425,11493,3017,14510,0
2019/03,312,21/03/2019,4,SP 42 fra Novellara e San Giacomo (SP 62R),14656,00,13251,1405,11723,2933,14656,0
2019/03,312,22/03/2019,5,SP 42 fra Novellara e San Giacomo (SP 62R),14817,10,13458,1358,11314,3503,14817,0
2019/03,312,23/03/2019,6,SP 42 fra Novellara e San Giacomo (SP 62R),12122,6340,11273,215,8547,3575,0,12122
2019/03,312,24/03/2019,7,SP 42 fra Novellara e San Giacomo (SP 62R),11545,00,11459,86,7944,3601,0,11545
2019/03,312,25/03/2019,1,SP 42 fra Novellara e San Giacomo (SP 62R),13591,00,12264,1327,10847,2744,13591,0
2019/03,312,26/03/2019,2,SP 42 fra Novellara e San Giacomo (SP 62R),14437,00,13080,1357,11617,2820,14437,0
2019/03,312,27/03/2019,3,SP 42 fra Novellara e San Giacomo (SP 62R),14452,10,13030,1421,11429,3023,14452,0
2019/03,312,28/03/2019,4,SP 42 fra Novellara e San Giacomo (SP 62R),14778,00,13385,1393,11726,3052,14778,0
2019/03,314,15/03/2019,5,SP 2 fra Reggiolo (bivio SP 2) e località Villarotta (SP 84),9770,00,9302,468,7520,2250,9770,0
2019/03,314,16/03/2019,6,SP 2 fra Reggiolo (bivio SP 2) e località Villarotta (SP 84),8223,10,8075,147,5884,2339,0,8223
2019/03,314,17/03/2019,7,SP 2 fra Reggiolo (bivio SP 2) e località Villarotta (SP 84),7380,00,7319,61,5270,2110,0,7380
2019/03,314,18/03/2019,1,SP 2 fra Reggiolo (bivio SP 2) e località Villarotta (SP 84),8905,10,8496,408,7087,1818,8905,0
2019/03,314,19/03/2019,2,SP 2 fra Reggiolo (bivio SP 2) e località Villarotta (SP 84),9069,00,8669,400,7218,1851,9069,0
2019/03,314,20/03/2019,3,SP 2 fra Reggiolo (bivio SP 2) e località Villarotta (SP 84),9064,00,8694,370,7123,1941,9064,0
2019/03,314,21/03/2019,4,SP 2 fra Reggiolo (bivio SP 2) e località Villarotta (SP 84),9009,00,8590,419,7035,1974,9009,0
2019/03,314,22/03/2019,5,SP 2 fra Reggiolo (bivio SP 2) e località Villarotta (SP 84),9606,00,9180,426,7384,2222,9606,0
2019/03,314,23/03/2019,6,SP 2 fra Reggiolo (bivio SP 2) e località Villarotta (SP 84),7784,00,7631,153,5499,2285,0,7784
2019/03,314,24/03/2019,7,SP 2 fra Reggiolo (bivio SP 2) e località Villarotta (SP 84),7632,00,7582,50,5173,2459,0,7632
2019/03,314,25/03/2019,1,SP 2 fra Reggiolo (bivio SP 2) e località Villarotta (SP 84),8752,00,8350,402,6988,1764,8752,0
2019/03,314,26/03/2019,2,SP 2 fra Reggiolo (bivio SP 2) e località Villarotta (SP 84),9137,00,8711,426,7276,1861,9137,0
2019/03,314,27/03/2019,3,SP 2 fra Reggiolo (bivio SP 2) e località Villarotta (SP 84),9198,00,8774,424,7191,2007,9198,0
2019/03,314,28/03/2019,4,SP 2 fra Reggiolo (bivio SP 2) e località Villarotta (SP 84),9423,00,8994,429,7328,2095,9423,0
2019/03,318,15/03/2019,5,SP 51 fra Sassuolo (bivio SP 467R) e Rubiera,12184,10,9116,3067,9542,2642,12184,0
2019/03,318,16/03/2019,6,SP 51 fra Sassuolo (bivio SP 467R) e Rubiera,9032,00,8751,281,6275,2757,0,9032
2019/03,318,17/03/2019,7,SP 51 fra Sassuolo (bivio SP 467R) e Rubiera,7044,00,6970,74,4974,2070,0,7044
2019/03,318,18/03/2019,1,SP 51 fra Sassuolo (bivio SP 467R) e Rubiera,11135,20,8401,2732,9074,2061,11135,0
2019/03,318,19/03/2019,2,SP 51 fra Sassuolo (bivio SP 467R) e Rubiera,11543,30,8603,2937,9321,2222,11543,0
2019/03,318,20/03/2019,3,SP 51 fra Sassuolo (bivio SP 467R) e Rubiera,11879,30,8698,3178,9571,2308,11879,0
2019/03,318,21/03/2019,4,SP 51 fra Sassuolo (bivio SP 467R) e Rubiera,11991,20,8692,3297,9698,2293,11991,0
2019/03,318,22/03/2019,5,SP 51 fra Sassuolo (bivio SP 467R) e Rubiera,12260,10,9283,2976,9608,2652,12260,0
2019/03,318,23/03/2019,6,SP 51 fra Sassuolo (bivio SP 467R) e Rubiera,8489,20,8210,277,5842,2647,0,8489
2019/03,318,24/03/2019,7,SP 51 fra Sassuolo (bivio SP 467R) e Rubiera,7085,00,7016,69,4952,2133,0,7085
2019/03,318,25/03/2019,1,SP 51 fra Sassuolo (bivio SP 467R) e Rubiera,11342,20,8476,2864,9233,2109,11342,0
2019/03,318,26/03/2019,2,SP 51 fra Sassuolo (bivio SP 467R) e Rubiera,11868,10,8753,3114,9602,2266,11868,0
2019/03,318,27/03/2019,3,SP 51 fra Sassuolo (bivio SP 467R) e Rubiera,11758,20,8633,3123,9473,2285,11758,0
2019/03,318,28/03/2019,4,SP 51 fra Sassuolo (bivio SP 467R) e Rubiera,11903,10,8717,3185,9444,2459,11903,0
2019/03,319,15/03/2019,5,SP 15 tra Sassuolo e Magreta,7430,00,7111,319,6032,1398,7430,0
2019/03,319,16/03/2019,6,SP 15 tra Sassuolo e Magreta,,,,,,,,
2019/03,319,17/03/2019,7,SP 15 tra Sassuolo e Magreta,,,,,,,,
2019/03,319,18/03/2019,1,SP 15 tra Sassuolo e Magreta,,,,,,,,
2019/03,319,19/03/2019,2,SP 15 tra Sassuolo e Magreta,,,,,,,,
2019/03,319,20/03/2019,3,SP 15 tra Sassuolo e Magreta,,,,,,,,
2019/03,319,21/03/2019,4,SP 15 tra Sassuolo e Magreta,,,,,,,,
2019/03,319,22/03/2019,5,SP 15 tra Sassuolo e Magreta,,,,,,,,
2019/03,319,23/03/2019,6,SP 15 tra Sassuolo e Magreta,,,,,,,,
2019/03,319,24/03/2019,7,SP 15 tra Sassuolo e Magreta,,,,,,,,
2019/03,319,25/03/2019,1,SP 15 tra Sassuolo e Magreta,,,,,,,,
2019/03,319,26/03/2019,2,SP 15 tra Sassuolo e Magreta,,,,,,,,
2019/03,319,27/03/2019,3,SP 15 tra Sassuolo e Magreta,,,,,,,,
2019/03,319,28/03/2019,4,SP 15 tra Sassuolo e Magreta,,,,,,,,
2019/03,321,15/03/2019,5,SP 467 tra SP 486 e confine provinciale,,,,,,,,
2019/03,321,16/03/2019,6,SP 467 tra SP 486 e confine provinciale,,,,,,,,
2019/03,321,17/03/2019,7,SP 467 tra SP 486 e confine provinciale,,,,,,,,
2019/03,321,18/03/2019,1,SP 467 tra SP 486 e confine provinciale,,,,,,,,
2019/03,321,19/03/2019,2,SP 467 tra SP 486 e confine provinciale,,,,,,,,
2019/03,321,20/03/2019,3,SP 467 tra SP 486 e confine provinciale,,,,,,,,
2019/03,321,21/03/2019,4,SP 467 tra SP 486 e confine provinciale,,,,,,,,
2019/03,321,22/03/2019,5,SP 467 tra SP 486 e confine provinciale,,,,,,,,
2019/03,321,23/03/2019,6,SP 467 tra SP 486 e confine provinciale,,,,,,,,
2019/03,321,24/03/2019,7,SP 467 tra SP 486 e confine provinciale,,,,,,,,
2019/03,321,25/03/2019,1,SP 467 tra SP 486 e confine provinciale,,,,,,,,
2019/03,321,26/03/2019,2,SP 467 tra SP 486 e confine provinciale,,,,,,,,
2019/03,321,27/03/2019,3,SP 467 tra SP 486 e confine provinciale,,,,,,,,
2019/03,321,28/03/2019,4,SP 467 tra SP 486 e confine provinciale,,,,,,,,
2019/03,323,15/03/2019,5,SP 467 fra SP 3 e SS 12,28563,10,24535,4027,22063,6500,28563,0
2019/03,323,16/03/2019,6,SP 467 fra SP 3 e SS 12,18943,00,18263,680,13250,5693,0,18943
2019/03,323,17/03/2019,7,SP 467 fra SP 3 e SS 12,15092,10,14964,127,11018,4074,0,15092
2019/03,323,18/03/2019,1,SP 467 fra SP 3 e SS 12,26718,00,23033,3685,21186,5532,26718,0
2019/03,323,19/03/2019,2,SP 467 fra SP 3 e SS 12,27280,20,23407,3871,21374,5906,27280,0
2019/03,323,20/03/2019,3,SP 467 fra SP 3 e SS 12,27655,20,23743,3910,21480,6175,27655,0
2019/03,323,21/03/2019,4,SP 467 fra SP 3 e SS 12,27863,00,23760,4103,21595,6268,27863,0
2019/03,323,22/03/2019,5,SP 467 fra SP 3 e SS 12,28515,10,24673,3841,22061,6454,28515,0
2019/03,323,23/03/2019,6,SP 467 fra SP 3 e SS 12,18879,10,18258,620,13461,5418,0,18879
2019/03,323,24/03/2019,7,SP 467 fra SP 3 e SS 12,15926,10,15806,119,11692,4234,0,15926
2019/03,323,25/03/2019,1,SP 467 fra SP 3 e SS 12,26672,00,23081,3591,20969,5703,26672,0
2019/03,323,26/03/2019,2,SP 467 fra SP 3 e SS 12,27058,00,23204,3854,21238,5820,27058,0
2019/03,323,27/03/2019,3,SP 467 fra SP 3 e SS 12,27297,10,23462,3834,21250,6047,27297,0
2019/03,323,28/03/2019,4,SP 467 fra SP 3 e SS 12,27987,00,23909,4078,21938,6049,27987,0
2019/03,328,15/03/2019,5,SP 486 tra Modena e Baggiovara,26253,10,25675,577,19906,6347,26253,0
2019/03,328,16/03/2019,6,SP 486 tra Modena e Baggiovara,23587,10,23312,274,16463,7124,0,23587
2019/03,328,17/03/2019,7,SP 486 tra Modena e Baggiovara,17162,10,17050,111,11902,5260,0,17162
2019/03,328,18/03/2019,1,SP 486 tra Modena e Baggiovara,24886,30,24306,577,19768,5118,24886,0
2019/03,328,19/03/2019,2,SP 486 tra Modena e Baggiovara,25639,100,25019,610,19894,5745,25639,0
2019/03,328,20/03/2019,3,SP 486 tra Modena e Baggiovara,26838,40,26219,615,20892,5946,26838,0
2019/03,328,21/03/2019,4,SP 486 tra Modena e Baggiovara,25794,40,25203,587,19773,6021,25794,0
2019/03,328,22/03/2019,5,SP 486 tra Modena e Baggiovara,26108,60,25526,576,19902,6206,26108,0
2019/03,328,23/03/2019,6,SP 486 tra Modena e Baggiovara,23447,40,23170,273,16497,6950,0,23447
2019/03,328,24/03/2019,7,SP 486 tra Modena e Baggiovara,17752,00,17624,128,12291,5461,0,17752
2019/03,328,25/03/2019,1,SP 486 tra Modena e Baggiovara,24785,40,24239,542,19457,5328,24785,0
2019/03,328,26/03/2019,2,SP 486 tra Modena e Baggiovara,25323,30,24746,574,19826,5497,25323,0
2019/03,328,27/03/2019,3,SP 486 tra Modena e Baggiovara,26291,40,25677,610,20274,6017,26291,0
2019/03,328,28/03/2019,4,SP 486 tra Modena e Baggiovara,25698,30,25098,597,19657,6041,25698,0
2019/03,330,15/03/2019,5,SS 64 tra Sasso Marconi e Marzabotto,13794,00,13157,637,10378,3416,13794,0
2019/03,330,16/03/2019,6,SS 64 tra Sasso Marconi e Marzabotto,12784,00,12635,149,9661,3123,0,12784
2019/03,330,17/03/2019,7,SS 64 tra Sasso Marconi e Marzabotto,11619,00,11585,34,8867,2752,0,11619
2019/03,330,18/03/2019,1,SS 64 tra Sasso Marconi e Marzabotto,12534,00,11876,658,9818,2716,12534,0
2019/03,330,19/03/2019,2,SS 64 tra Sasso Marconi e Marzabotto,12423,00,11761,662,9711,2712,12423,0
2019/03,330,20/03/2019,3,SS 64 tra Sasso Marconi e Marzabotto,12214,00,11565,649,9420,2794,12214,0
2019/03,330,21/03/2019,4,SS 64 tra Sasso Marconi e Marzabotto,13164,10,12490,673,10238,2926,13164,0
2019/03,330,22/03/2019,5,SS 64 tra Sasso Marconi e Marzabotto,13932,00,13319,613,10603,3329,13932,0
2019/03,330,23/03/2019,6,SS 64 tra Sasso Marconi e Marzabotto,12980,00,12789,191,9736,3244,0,12980
2019/03,330,24/03/2019,7,SS 64 tra Sasso Marconi e Marzabotto,12099,10,12064,34,9259,2840,0,12099
2019/03,330,25/03/2019,1,SS 64 tra Sasso Marconi e Marzabotto,12629,00,11976,653,9764,2865,12629,0
2019/03,330,26/03/2019,2,SS 64 tra Sasso Marconi e Marzabotto,13039,00,12369,670,10371,2668,13039,0
2019/03,330,27/03/2019,3,SS 64 tra Sasso Marconi e Marzabotto,12895,20,12200,693,10093,2802,12895,0
2019/03,330,28/03/2019,4,SS 64 tra Sasso Marconi e Marzabotto,7406,00,6906,500,6385,1021,7406,0
2019/03,331,15/03/2019,5,SP 325 tra Casello A 1 (Sasso Marconi) e Vado,8084,00,7634,450,6039,2045,8084,0
2019/03,331,16/03/2019,6,SP 325 tra Casello A 1 (Sasso Marconi) e Vado,7255,00,7106,149,5433,1822,0,7255
2019/03,331,17/03/2019,7,SP 325 tra Casello A 1 (Sasso Marconi) e Vado,5702,00,5671,31,4286,1416,0,5702
2019/03,331,18/03/2019,1,SP 325 tra Casello A 1 (Sasso Marconi) e Vado,7595,00,7246,349,5977,1618,7595,0
2019/03,331,19/03/2019,2,SP 325 tra Casello A 1 (Sasso Marconi) e Vado,7460,10,7136,323,5701,1759,7460,0
2019/03,331,20/03/2019,3,SP 325 tra Casello A 1 (Sasso Marconi) e Vado,7692,00,7216,476,5947,1745,7692,0
2019/03,331,21/03/2019,4,SP 325 tra Casello A 1 (Sasso Marconi) e Vado,7786,00,7305,481,5945,1841,7786,0
2019/03,331,22/03/2019,5,SP 325 tra Casello A 1 (Sasso Marconi) e Vado,7841,00,7414,427,5949,1892,7841,0
2019/03,331,23/03/2019,6,SP 325 tra Casello A 1 (Sasso Marconi) e Vado,7063,00,6965,98,5242,1821,0,7063
2019/03,331,24/03/2019,7,SP 325 tra Casello A 1 (Sasso Marconi) e Vado,5915,20,5890,23,4364,1551,0,5915
2019/03,331,25/03/2019,1,SP 325 tra Casello A 1 (Sasso Marconi) e Vado,7452,00,7058,394,5792,1660,7452,0
2019/03,331,26/03/2019,2,SP 325 tra Casello A 1 (Sasso Marconi) e Vado,7668,00,7308,360,5903,1765,7668,0
2019/03,331,27/03/2019,3,SP 325 tra Casello A 1 (Sasso Marconi) e Vado,7565,00,7149,416,5830,1735,7565,0
2019/03,331,28/03/2019,4,SP 325 tra Casello A 1 (Sasso Marconi) e Vado,7916,00,7495,421,6069,1847,7916,0
2019/03,332,15/03/2019,5,SP 306R fra Castel Bolognese e Riolo Terme,9264,00,8696,568,7042,2222,9264,0
2019/03,332,16/03/2019,6,SP 306R fra Castel Bolognese e Riolo Terme,8378,20,8215,161,6097,2281,0,8378
2019/03,332,17/03/2019,7,SP 306R fra Castel Bolognese e Riolo Terme,7136,00,7100,36,5429,1707,0,7136
2019/03,332,18/03/2019,1,SP 306R fra Castel Bolognese e Riolo Terme,8433,00,7953,480,6673,1760,8433,0
2019/03,332,19/03/2019,2,SP 306R fra Castel Bolognese e Riolo Terme,8519,00,8033,486,6645,1874,8519,0
2019/03,332,20/03/2019,3,SP 306R fra Castel Bolognese e Riolo Terme,8495,20,8001,492,6572,1923,8495,0
2019/03,332,21/03/2019,4,SP 306R fra Castel Bolognese e Riolo Terme,8869,10,8343,525,6829,2040,8869,0
2019/03,332,22/03/2019,5,SP 306R fra Castel Bolognese e Riolo Terme,9145,10,8585,559,7001,2144,9145,0
2019/03,332,23/03/2019,6,SP 306R fra Castel Bolognese e Riolo Terme,8452,00,8275,177,5909,2543,0,8452
2019/03,332,24/03/2019,7,SP 306R fra Castel Bolognese e Riolo Terme,7443,00,7377,66,5463,1980,0,7443
2019/03,332,25/03/2019,1,SP 306R fra Castel Bolognese e Riolo Terme,8313,20,7825,486,6475,1838,8313,0
2019/03,332,26/03/2019,2,SP 306R fra Castel Bolognese e Riolo Terme,8663,00,8150,513,6819,1844,8663,0
2019/03,332,27/03/2019,3,SP 306R fra Castel Bolognese e Riolo Terme,8704,10,8196,507,6764,1940,8704,0
2019/03,332,28/03/2019,4,SP 306R fra Castel Bolognese e Riolo Terme,8963,10,8432,530,6993,1970,8963,0
2019/03,333,15/03/2019,5,SS 9 tra Castel Bolognese e Faenza,24353,10,23411,941,17634,6719,24353,0
2019/03,333,16/03/2019,6,SS 9 tra Castel Bolognese e Faenza,21994,00,21721,273,14699,7295,0,21994
2019/03,333,17/03/2019,7,SS 9 tra Castel Bolognese e Faenza,19212,00,19123,89,13262,5950,0,19212
2019/03,333,18/03/2019,1,SS 9 tra Castel Bolognese e Faenza,22431,00,21585,846,17430,5001,22431,0
2019/03,333,19/03/2019,2,SS 9 tra Castel Bolognese e Faenza,23319,10,22446,872,17712,5607,23319,0
2019/03,333,20/03/2019,3,SS 9 tra Castel Bolognese e Faenza,23297,00,22428,869,17529,5768,23297,0
2019/03,333,21/03/2019,4,SS 9 tra Castel Bolognese e Faenza,23467,00,22591,876,17641,5826,23467,0
2019/03,333,22/03/2019,5,SS 9 tra Castel Bolognese e Faenza,24815,00,23848,967,18125,6690,24815,0
2019/03,333,23/03/2019,6,SS 9 tra Castel Bolognese e Faenza,23281,00,22959,322,15402,7879,0,23281
2019/03,333,24/03/2019,7,SS 9 tra Castel Bolognese e Faenza,20997,10,20884,112,14431,6566,0,20997
2019/03,333,25/03/2019,1,SS 9 tra Castel Bolognese e Faenza,22508,00,21630,878,17340,5168,22508,0
2019/03,333,26/03/2019,2,SS 9 tra Castel Bolognese e Faenza,23216,00,22366,850,17769,5447,23216,0
2019/03,333,27/03/2019,3,SS 9 tra Castel Bolognese e Faenza,23488,00,22496,992,17628,5860,23488,0
2019/03,333,28/03/2019,4,SS 9 tra Castel Bolognese e Faenza,23409,10,22420,988,17715,5694,23409,0
2019/03,334,15/03/2019,5,SP 8 dal Casello A 1 (Faenza) a Cotignola,15852,00,15003,849,12076,3776,15852,0
2019/03,334,16/03/2019,6,SP 8 dal Casello A 1 (Faenza) a Cotignola,14650,00,14418,232,10460,4190,0,14650
2019/03,334,17/03/2019,7,SP 8 dal Casello A 1 (Faenza) a Cotignola,13084,00,13043,41,9891,3193,0,13084
2019/03,334,18/03/2019,1,SP 8 dal Casello A 1 (Faenza) a Cotignola,15118,00,14214,904,12177,2941,15118,0
2019/03,334,19/03/2019,2,SP 8 dal Casello A 1 (Faenza) a Cotignola,15382,00,14470,912,12274,3108,15382,0
2019/03,334,20/03/2019,3,SP 8 dal Casello A 1 (Faenza) a Cotignola,15244,00,14342,902,11977,3267,15244,0
2019/03,334,21/03/2019,4,SP 8 dal Casello A 1 (Faenza) a Cotignola,15309,00,14386,923,11934,3375,15309,0
2019/03,334,22/03/2019,5,SP 8 dal Casello A 1 (Faenza) a Cotignola,15523,00,14640,883,11731,3792,15523,0
2019/03,334,23/03/2019,6,SP 8 dal Casello A 1 (Faenza) a Cotignola,15296,00,15064,232,10861,4435,0,15296
2019/03,334,24/03/2019,7,SP 8 dal Casello A 1 (Faenza) a Cotignola,14286,00,14231,55,10697,3589,0,14286
2019/03,334,25/03/2019,1,SP 8 dal Casello A 1 (Faenza) a Cotignola,14471,00,13429,1042,11545,2926,14471,0
2019/03,334,26/03/2019,2,SP 8 dal Casello A 1 (Faenza) a Cotignola,14838,00,13861,977,11836,3002,14838,0
2019/03,334,27/03/2019,3,SP 8 dal Casello A 1 (Faenza) a Cotignola,15225,00,14204,1021,11998,3227,15225,0
2019/03,334,28/03/2019,4,SP 8 dal Casello A 1 (Faenza) a Cotignola,15592,00,14633,959,12174,3418,15592,0
2019/03,335,15/03/2019,5,SP 7 tra l'A 14 (bivio SP 29) e l'A 14dir (Barbiano),7966,10,7372,593,6232,1734,7966,0
2019/03,335,16/03/2019,6,SP 7 tra l'A 14 (bivio SP 29) e l'A 14dir (Barbiano),6376,10,6270,105,4590,1786,0,6376
2019/03,335,17/03/2019,7,SP 7 tra l'A 14 (bivio SP 29) e l'A 14dir (Barbiano),5724,00,5690,34,4229,1495,0,5724
2019/03,335,18/03/2019,1,SP 7 tra l'A 14 (bivio SP 29) e l'A 14dir (Barbiano),7591,00,6974,617,6117,1474,7591,0
2019/03,335,19/03/2019,2,SP 7 tra l'A 14 (bivio SP 29) e l'A 14dir (Barbiano),7791,00,7265,526,6257,1534,7791,0
2019/03,335,20/03/2019,3,SP 7 tra l'A 14 (bivio SP 29) e l'A 14dir (Barbiano),8089,00,7534,555,6476,1613,8089,0
2019/03,335,21/03/2019,4,SP 7 tra l'A 14 (bivio SP 29) e l'A 14dir (Barbiano),8101,00,7515,586,6355,1746,8101,0
2019/03,335,22/03/2019,5,SP 7 tra l'A 14 (bivio SP 29) e l'A 14dir (Barbiano),7961,00,7412,549,6136,1825,7961,0
2019/03,335,23/03/2019,6,SP 7 tra l'A 14 (bivio SP 29) e l'A 14dir (Barbiano),6562,00,6438,124,4601,1961,0,6562
2019/03,335,24/03/2019,7,SP 7 tra l'A 14 (bivio SP 29) e l'A 14dir (Barbiano),6275,00,6248,27,4590,1685,0,6275
2019/03,335,25/03/2019,1,SP 7 tra l'A 14 (bivio SP 29) e l'A 14dir (Barbiano),7724,00,7042,682,6262,1462,7724,0
2019/03,335,26/03/2019,2,SP 7 tra l'A 14 (bivio SP 29) e l'A 14dir (Barbiano),7868,00,7255,613,6338,1530,7868,0
2019/03,335,27/03/2019,3,SP 7 tra l'A 14 (bivio SP 29) e l'A 14dir (Barbiano),8303,00,7655,648,6713,1590,8303,0
2019/03,335,28/03/2019,4,SP 7 tra l'A 14 (bivio SP 29) e l'A 14dir (Barbiano),8270,10,7573,696,6569,1701,8270,0
2019/03,336,15/03/2019,5,SP 253R tra Lugo (ponte fiume Senio) e Bagnacavallo,12040,00,11342,698,9430,2610,12040,0
2019/03,336,16/03/2019,6,SP 253R tra Lugo (ponte fiume Senio) e Bagnacavallo,10243,00,10048,195,7652,2591,0,10243
2019/03,336,17/03/2019,7,SP 253R tra Lugo (ponte fiume Senio) e Bagnacavallo,7463,10,7416,46,5482,1981,0,7463
2019/03,336,18/03/2019,1,SP 253R tra Lugo (ponte fiume Senio) e Bagnacavallo,11547,10,10899,647,9402,2145,11547,0
2019/03,336,19/03/2019,2,SP 253R tra Lugo (ponte fiume Senio) e Bagnacavallo,11624,00,10956,668,9291,2333,11624,0
2019/03,336,20/03/2019,3,SP 253R tra Lugo (ponte fiume Senio) e Bagnacavallo,11891,00,11204,687,9458,2433,11891,0
2019/03,336,21/03/2019,4,SP 253R tra Lugo (ponte fiume Senio) e Bagnacavallo,11692,00,11045,647,9328,2364,11692,0
2019/03,336,22/03/2019,5,SP 253R tra Lugo (ponte fiume Senio) e Bagnacavallo,12448,10,11717,730,9782,2666,12448,0
2019/03,336,23/03/2019,6,SP 253R tra Lugo (ponte fiume Senio) e Bagnacavallo,10146,00,9979,167,7590,2556,0,10146
2019/03,336,24/03/2019,7,SP 253R tra Lugo (ponte fiume Senio) e Bagnacavallo,7574,00,7530,44,5612,1962,0,7574
2019/03,336,25/03/2019,1,SP 253R tra Lugo (ponte fiume Senio) e Bagnacavallo,11530,10,10798,731,9383,2147,11530,0
2019/03,336,26/03/2019,2,SP 253R tra Lugo (ponte fiume Senio) e Bagnacavallo,11839,00,11136,703,9458,2381,11839,0
2019/03,336,27/03/2019,3,SP 253R tra Lugo (ponte fiume Senio) e Bagnacavallo,12012,00,11274,738,9566,2446,12012,0
2019/03,336,28/03/2019,4,SP 253R tra Lugo (ponte fiume Senio) e Bagnacavallo,12017,00,11309,708,9429,2588,12017,0
2019/03,337,15/03/2019,5,SP 14 fra Lugo (bivio SSPP 41/46) e Fusignano,12450,20,11863,585,9805,2645,12450,0
2019/03,337,16/03/2019,6,SP 14 fra Lugo (bivio SSPP 41/46) e Fusignano,10514,00,10339,175,7807,2707,0,10514
2019/03,337,17/03/2019,7,SP 14 fra Lugo (bivio SSPP 41/46) e Fusignano,7094,00,7068,26,5024,2070,0,7094
2019/03,337,18/03/2019,1,SP 14 fra Lugo (bivio SSPP 41/46) e Fusignano,11867,10,11306,560,9626,2241,11867,0
2019/03,337,19/03/2019,2,SP 14 fra Lugo (bivio SSPP 41/46) e Fusignano,12142,10,11524,617,9792,2350,12142,0
2019/03,337,20/03/2019,3,SP 14 fra Lugo (bivio SSPP 41/46) e Fusignano,12566,10,11939,626,10129,2437,12566,0
2019/03,337,21/03/2019,4,SP 14 fra Lugo (bivio SSPP 41/46) e Fusignano,12144,20,11578,564,9702,2442,12144,0
2019/03,337,22/03/2019,5,SP 14 fra Lugo (bivio SSPP 41/46) e Fusignano,12424,00,11845,579,9843,2581,12424,0
2019/03,337,23/03/2019,6,SP 14 fra Lugo (bivio SSPP 41/46) e Fusignano,10251,00,10074,177,7709,2542,0,10251
2019/03,337,24/03/2019,7,SP 14 fra Lugo (bivio SSPP 41/46) e Fusignano,6929,00,6903,26,4935,1994,0,6929
2019/03,337,25/03/2019,1,SP 14 fra Lugo (bivio SSPP 41/46) e Fusignano,12058,10,11387,670,9736,2322,12058,0
2019/03,337,26/03/2019,2,SP 14 fra Lugo (bivio SSPP 41/46) e Fusignano,12203,00,11544,659,9897,2306,12203,0
2019/03,337,27/03/2019,3,SP 14 fra Lugo (bivio SSPP 41/46) e Fusignano,12324,20,11672,650,9875,2449,12324,0
2019/03,337,28/03/2019,4,SP 14 fra Lugo (bivio SSPP 41/46) e Fusignano,12102,10,11508,593,9636,2466,12102,0
2019/03,339,15/03/2019,5,SP 3 tra San Lorenzo in Noceto e Predappio,8031,00,7657,374,6278,1753,8031,0
2019/03,339,16/03/2019,6,SP 3 tra San Lorenzo in Noceto e Predappio,7204,00,7099,105,5288,1916,0,7204
2019/03,339,17/03/2019,7,SP 3 tra San Lorenzo in Noceto e Predappio,6300,00,6288,12,4887,1413,0,6300
2019/03,339,18/03/2019,1,SP 3 tra San Lorenzo in Noceto e Predappio,7501,00,7164,337,6060,1441,7501,0
2019/03,339,19/03/2019,2,SP 3 tra San Lorenzo in Noceto e Predappio,7749,00,7365,384,6144,1605,7749,0
2019/03,339,20/03/2019,3,SP 3 tra San Lorenzo in Noceto e Predappio,7798,00,7443,355,6196,1602,7798,0
2019/03,339,21/03/2019,4,SP 3 tra San Lorenzo in Noceto e Predappio,8035,00,7638,397,6342,1693,8035,0
2019/03,339,22/03/2019,5,SP 3 tra San Lorenzo in Noceto e Predappio,8057,00,7651,406,6314,1743,8057,0
2019/03,339,23/03/2019,6,SP 3 tra San Lorenzo in Noceto e Predappio,7473,00,7352,121,5407,2066,0,7473
2019/03,339,24/03/2019,7,SP 3 tra San Lorenzo in Noceto e Predappio,6624,00,6607,17,5169,1455,0,6624
2019/03,339,25/03/2019,1,SP 3 tra San Lorenzo in Noceto e Predappio,7476,00,7119,357,6044,1432,7476,0
2019/03,339,26/03/2019,2,SP 3 tra San Lorenzo in Noceto e Predappio,7609,00,7238,371,6030,1579,7609,0
2019/03,339,27/03/2019,3,SP 3 tra San Lorenzo in Noceto e Predappio,7741,00,7359,382,6134,1607,7741,0
2019/03,339,28/03/2019,4,SP 3 tra San Lorenzo in Noceto e Predappio,8097,20,7666,429,6394,1703,8097,0
2019/03,340,15/03/2019,5,SP 72 tra San Martino in Strada e bivio ex SS 310R (Meldola),10779,00,10331,448,8398,2381,10779,0
2019/03,340,16/03/2019,6,SP 72 tra San Martino in Strada e bivio ex SS 310R (Meldola),8760,00,8581,179,6426,2334,0,8760
2019/03,340,17/03/2019,7,SP 72 tra San Martino in Strada e bivio ex SS 310R (Meldola),7549,00,7528,21,5607,1942,0,7549
2019/03,340,18/03/2019,1,SP 72 tra San Martino in Strada e bivio ex SS 310R (Meldola),9880,10,9433,446,7980,1900,9880,0
2019/03,340,19/03/2019,2,SP 72 tra San Martino in Strada e bivio ex SS 310R (Meldola),10129,00,9738,391,8034,2095,10129,0
2019/03,340,20/03/2019,3,SP 72 tra San Martino in Strada e bivio ex SS 310R (Meldola),10524,00,10092,432,8343,2181,10524,0
2019/03,340,21/03/2019,4,SP 72 tra San Martino in Strada e bivio ex SS 310R (Meldola),10497,00,10097,400,8165,2332,10497,0
2019/03,340,22/03/2019,5,SP 72 tra San Martino in Strada e bivio ex SS 310R (Meldola),10989,00,10543,446,8489,2500,10989,0
2019/03,340,23/03/2019,6,SP 72 tra San Martino in Strada e bivio ex SS 310R (Meldola),9030,00,8851,179,6528,2502,0,9030
2019/03,340,24/03/2019,7,SP 72 tra San Martino in Strada e bivio ex SS 310R (Meldola),8150,10,8115,34,5954,2196,0,8150
2019/03,340,25/03/2019,1,SP 72 tra San Martino in Strada e bivio ex SS 310R (Meldola),10194,00,9734,460,8164,2030,10194,0
2019/03,340,26/03/2019,2,SP 72 tra San Martino in Strada e bivio ex SS 310R (Meldola),10191,00,9779,412,8165,2026,10191,0
2019/03,340,27/03/2019,3,SP 72 tra San Martino in Strada e bivio ex SS 310R (Meldola),10660,00,10205,455,8392,2268,10660,0
2019/03,340,28/03/2019,4,SP 72 tra San Martino in Strada e bivio ex SS 310R (Meldola),10523,00,10088,435,8186,2337,10523,0
2019/03,342,15/03/2019,5,SP 33 in località Gatteo,19238,00,17453,1785,14906,4332,19238,0
2019/03,342,16/03/2019,6,SP 33 in località Gatteo,15843,00,15379,464,11567,4276,0,15843
2019/03,342,17/03/2019,7,SP 33 in località Gatteo,12982,00,12865,117,9599,3383,0,12982
2019/03,342,18/03/2019,1,SP 33 in località Gatteo,17524,30,15727,1794,14142,3382,17524,0
2019/03,342,19/03/2019,2,SP 33 in località Gatteo,18020,00,16350,1670,14492,3528,18020,0
2019/03,342,20/03/2019,3,SP 33 in località Gatteo,18004,10,16316,1687,14299,3705,18004,0
2019/03,342,21/03/2019,4,SP 33 in località Gatteo,18414,20,16584,1828,14451,3963,18414,0
2019/03,342,22/03/2019,5,SP 33 in località Gatteo,19242,00,17526,1716,14829,4413,19242,0
2019/03,342,23/03/2019,6,SP 33 in località Gatteo,15712,00,15216,496,11293,4419,0,15712
2019/03,342,24/03/2019,7,SP 33 in località Gatteo,12707,10,12602,104,9153,3554,0,12707
2019/03,342,25/03/2019,1,SP 33 in località Gatteo,17920,10,16188,1731,14393,3527,17920,0
2019/03,342,26/03/2019,2,SP 33 in località Gatteo,17944,20,16196,1746,14441,3503,17944,0
2019/03,342,27/03/2019,3,SP 33 in località Gatteo,15119,20,13723,1394,11358,3761,15119,0
2019/03,342,28/03/2019,4,SP 33 in località Gatteo,18618,00,16831,1787,14692,3926,18618,0
2019/03,343,15/03/2019,5,SP 4 tra Galeata e Santa Sofia,5832,00,5489,343,4473,1359,5832,0
2019/03,343,16/03/2019,6,SP 4 tra Galeata e Santa Sofia,5371,00,5199,172,3971,1400,0,5371
2019/03,343,17/03/2019,7,SP 4 tra Galeata e Santa Sofia,5352,00,5323,29,4325,1027,0,5352
2019/03,343,18/03/2019,1,SP 4 tra Galeata e Santa Sofia,5376,00,5030,346,4206,1170,5376,0
2019/03,343,19/03/2019,2,SP 4 tra Galeata e Santa Sofia,5757,00,5430,327,4521,1236,5757,0
2019/03,343,20/03/2019,3,SP 4 tra Galeata e Santa Sofia,5767,00,5419,348,4521,1246,5767,0
2019/03,343,21/03/2019,4,SP 4 tra Galeata e Santa Sofia,5788,00,5441,347,4453,1335,5788,0
2019/03,343,22/03/2019,5,SP 4 tra Galeata e Santa Sofia,5939,20,5582,355,4491,1448,5939,0
2019/03,343,23/03/2019,6,SP 4 tra Galeata e Santa Sofia,5621,00,5470,151,4222,1399,0,5621
2019/03,343,24/03/2019,7,SP 4 tra Galeata e Santa Sofia,5494,00,5470,24,4410,1084,0,5494
2019/03,343,25/03/2019,1,SP 4 tra Galeata e Santa Sofia,5730,00,5341,389,4541,1189,5730,0
2019/03,343,26/03/2019,2,SP 4 tra Galeata e Santa Sofia,5699,00,5354,345,4443,1256,5699,0
2019/03,343,27/03/2019,3,SP 4 tra Galeata e Santa Sofia,5626,00,5292,334,4308,1318,5626,0
2019/03,343,28/03/2019,4,SP 4 tra Galeata e Santa Sofia,5614,10,5259,354,4268,1346,5614,0
2019/03,344,15/03/2019,5,SS 3Bis/E 45 tra Borello e Mercato Saraceno,18139,00,16835,1304,14020,4119,18139,0
2019/03,344,16/03/2019,6,SS 3Bis/E 45 tra Borello e Mercato Saraceno,15880,00,15457,423,12051,3829,0,15880
2019/03,344,17/03/2019,7,SS 3Bis/E 45 tra Borello e Mercato Saraceno,18206,10,17995,210,14099,4107,0,18206
2019/03,344,18/03/2019,1,SS 3Bis/E 45 tra Borello e Mercato Saraceno,15581,00,14540,1041,12336,3245,15581,0
2019/03,344,19/03/2019,2,SS 3Bis/E 45 tra Borello e Mercato Saraceno,14817,30,13816,998,11770,3047,14817,0
2019/03,344,20/03/2019,3,SS 3Bis/E 45 tra Borello e Mercato Saraceno,15436,00,14247,1189,12168,3268,15436,0
2019/03,344,21/03/2019,4,SS 3Bis/E 45 tra Borello e Mercato Saraceno,16368,10,15147,1220,12843,3525,16368,0
2019/03,344,22/03/2019,5,SS 3Bis/E 45 tra Borello e Mercato Saraceno,18162,00,17002,1160,13984,4178,18162,0
2019/03,344,23/03/2019,6,SS 3Bis/E 45 tra Borello e Mercato Saraceno,15990,00,15578,412,12083,3907,0,15990
2019/03,344,24/03/2019,7,SS 3Bis/E 45 tra Borello e Mercato Saraceno,19295,00,19098,197,14836,4459,0,19295
2019/03,344,25/03/2019,1,SS 3Bis/E 45 tra Borello e Mercato Saraceno,15964,10,14947,1016,12533,3431,15964,0
2019/03,344,26/03/2019,2,SS 3Bis/E 45 tra Borello e Mercato Saraceno,14973,10,13943,1029,11822,3151,14973,0
2019/03,344,27/03/2019,3,SS 3Bis/E 45 tra Borello e Mercato Saraceno,15423,00,14331,1092,12134,3289,15423,0
2019/03,344,28/03/2019,4,SS 3Bis/E 45 tra Borello e Mercato Saraceno,16543,10,15381,1161,12822,3721,16543,0
2019/03,348,15/03/2019,5,SP 10 dal bivio con SP 89 (San Mauro Pascoli) c/o A 14  al bivio SS 16 (San Mauro Mare),,,,,,,,
2019/03,348,16/03/2019,6,SP 10 dal bivio con SP 89 (San Mauro Pascoli) c/o A 14  al bivio SS 16 (San Mauro Mare),,,,,,,,
2019/03,348,17/03/2019,7,SP 10 dal bivio con SP 89 (San Mauro Pascoli) c/o A 14  al bivio SS 16 (San Mauro Mare),,,,,,,,
2019/03,348,18/03/2019,1,SP 10 dal bivio con SP 89 (San Mauro Pascoli) c/o A 14  al bivio SS 16 (San Mauro Mare),,,,,,,,
2019/03,348,19/03/2019,2,SP 10 dal bivio con SP 89 (San Mauro Pascoli) c/o A 14  al bivio SS 16 (San Mauro Mare),,,,,,,,
2019/03,348,20/03/2019,3,SP 10 dal bivio con SP 89 (San Mauro Pascoli) c/o A 14  al bivio SS 16 (San Mauro Mare),,,,,,,,
2019/03,348,21/03/2019,4,SP 10 dal bivio con SP 89 (San Mauro Pascoli) c/o A 14  al bivio SS 16 (San Mauro Mare),,,,,,,,
2019/03,348,22/03/2019,5,SP 10 dal bivio con SP 89 (San Mauro Pascoli) c/o A 14  al bivio SS 16 (San Mauro Mare),,,,,,,,
2019/03,348,23/03/2019,6,SP 10 dal bivio con SP 89 (San Mauro Pascoli) c/o A 14  al bivio SS 16 (San Mauro Mare),,,,,,,,
2019/03,348,24/03/2019,7,SP 10 dal bivio con SP 89 (San Mauro Pascoli) c/o A 14  al bivio SS 16 (San Mauro Mare),,,,,,,,
2019/03,348,25/03/2019,1,SP 10 dal bivio con SP 89 (San Mauro Pascoli) c/o A 14  al bivio SS 16 (San Mauro Mare),,,,,,,,
2019/03,348,26/03/2019,2,SP 10 dal bivio con SP 89 (San Mauro Pascoli) c/o A 14  al bivio SS 16 (San Mauro Mare),,,,,,,,
2019/03,348,27/03/2019,3,SP 10 dal bivio con SP 89 (San Mauro Pascoli) c/o A 14  al bivio SS 16 (San Mauro Mare),,,,,,,,
2019/03,348,28/03/2019,4,SP 10 dal bivio con SP 89 (San Mauro Pascoli) c/o A 14  al bivio SS 16 (San Mauro Mare),,,,,,,,
2019/03,349,15/03/2019,5,SS 16 tra Cervia e Cesenatico,23448,00,20975,2473,17720,5728,23448,0
2019/03,349,16/03/2019,6,SS 16 tra Cervia e Cesenatico,24046,50,23434,607,16943,7103,0,24046
2019/03,349,17/03/2019,7,SS 16 tra Cervia e Cesenatico,26454,10,26258,195,20244,6210,0,26454
2019/03,349,18/03/2019,1,SS 16 tra Cervia e Cesenatico,20639,10,18215,2423,16373,4266,20639,0
2019/03,349,19/03/2019,2,SS 16 tra Cervia e Cesenatico,20567,10,18214,2352,16197,4370,20567,0
2019/03,349,20/03/2019,3,SS 16 tra Cervia e Cesenatico,21635,00,19177,2458,16920,4715,21635,0
2019/03,349,21/03/2019,4,SS 16 tra Cervia e Cesenatico,22802,10,20296,2505,17545,5257,22802,0
2019/03,349,22/03/2019,5,SS 16 tra Cervia e Cesenatico,24249,20,21789,2458,18106,6143,24249,0
2019/03,349,23/03/2019,6,SS 16 tra Cervia e Cesenatico,24958,10,24361,596,17180,7778,0,24958
2019/03,349,24/03/2019,7,SS 16 tra Cervia e Cesenatico,25953,60,25726,221,19427,6526,0,25953
2019/03,349,25/03/2019,1,SS 16 tra Cervia e Cesenatico,21681,20,19300,2379,16971,4710,21681,0
2019/03,349,26/03/2019,2,SS 16 tra Cervia e Cesenatico,21059,20,18505,2552,16667,4392,21059,0
2019/03,349,27/03/2019,3,SS 16 tra Cervia e Cesenatico,21651,20,19259,2390,16837,4814,21651,0
2019/03,349,28/03/2019,4,SS 16 tra Cervia e Cesenatico,22622,20,20246,2374,17504,5118,22622,0
2019/03,350,15/03/2019,5,SP 41 tra Rimini (viadotto A 14) e bivio SP 49 (località Ospedaletto),9528,00,9181,347,7331,2197,9528,0
2019/03,350,16/03/2019,6,SP 41 tra Rimini (viadotto A 14) e bivio SP 49 (località Ospedaletto),9030,10,8881,148,6679,2351,0,9030
2019/03,350,17/03/2019,7,SP 41 tra Rimini (viadotto A 14) e bivio SP 49 (località Ospedaletto),7219,10,7189,29,5204,2015,0,7219
2019/03,350,18/03/2019,1,SP 41 tra Rimini (viadotto A 14) e bivio SP 49 (località Ospedaletto),9159,00,8824,335,7351,1808,9159,0
2019/03,350,19/03/2019,2,SP 41 tra Rimini (viadotto A 14) e bivio SP 49 (località Ospedaletto),9297,00,8958,339,7389,1908,9297,0
2019/03,350,20/03/2019,3,SP 41 tra Rimini (viadotto A 14) e bivio SP 49 (località Ospedaletto),8475,00,8166,309,6620,1855,8475,0
2019/03,350,21/03/2019,4,SP 41 tra Rimini (viadotto A 14) e bivio SP 49 (località Ospedaletto),9523,00,9184,339,7357,2166,9523,0
2019/03,350,22/03/2019,5,SP 41 tra Rimini (viadotto A 14) e bivio SP 49 (località Ospedaletto),9830,00,9426,404,7638,2192,9830,0
2019/03,350,23/03/2019,6,SP 41 tra Rimini (viadotto A 14) e bivio SP 49 (località Ospedaletto),8843,10,8676,166,6482,2361,0,8843
2019/03,350,24/03/2019,7,SP 41 tra Rimini (viadotto A 14) e bivio SP 49 (località Ospedaletto),7480,00,7439,41,5329,2151,0,7480
2019/03,350,25/03/2019,1,SP 41 tra Rimini (viadotto A 14) e bivio SP 49 (località Ospedaletto),9304,10,9010,293,7472,1832,9304,0
2019/03,350,26/03/2019,2,SP 41 tra Rimini (viadotto A 14) e bivio SP 49 (località Ospedaletto),9129,10,8755,373,7190,1939,9129,0
2019/03,350,27/03/2019,3,SP 41 tra Rimini (viadotto A 14) e bivio SP 49 (località Ospedaletto),9408,00,9049,359,7380,2028,9408,0
2019/03,350,28/03/2019,4,SP 41 tra Rimini (viadotto A 14) e bivio SP 49 (località Ospedaletto),9351,20,8935,414,7291,2060,9351,0
2019/03,351,15/03/2019,5,SS 72 tra Rimini e  San Marino,,,,,,,,
2019/03,351,16/03/2019,6,SS 72 tra Rimini e  San Marino,,,,,,,,
2019/03,351,17/03/2019,7,SS 72 tra Rimini e  San Marino,,,,,,,,
2019/03,351,18/03/2019,1,SS 72 tra Rimini e  San Marino,,,,,,,,
2019/03,351,19/03/2019,2,SS 72 tra Rimini e  San Marino,,,,,,,,
2019/03,351,20/03/2019,3,SS 72 tra Rimini e  San Marino,,,,,,,,
2019/03,351,21/03/2019,4,SS 72 tra Rimini e  San Marino,,,,,,,,
2019/03,351,22/03/2019,5,SS 72 tra Rimini e  San Marino,,,,,,,,
2019/03,351,23/03/2019,6,SS 72 tra Rimini e  San Marino,,,,,,,,
2019/03,351,24/03/2019,7,SS 72 tra Rimini e  San Marino,,,,,,,,
2019/03,351,25/03/2019,1,SS 72 tra Rimini e  San Marino,,,,,,,,
2019/03,351,26/03/2019,2,SS 72 tra Rimini e  San Marino,,,,,,,,
2019/03,351,27/03/2019,3,SS 72 tra Rimini e  San Marino,,,,,,,,
2019/03,351,28/03/2019,4,SS 72 tra Rimini e  San Marino,,,,,,,,
2019/03,354,15/03/2019,5,SP 31 tra Viadotto A 14 e Coriano,13308,20,12917,389,10256,3052,13308,0
2019/03,354,16/03/2019,6,SP 31 tra Viadotto A 14 e Coriano,11957,00,11812,145,8569,3388,0,11957
2019/03,354,17/03/2019,7,SP 31 tra Viadotto A 14 e Coriano,10540,30,10482,55,7611,2929,0,10540
2019/03,354,18/03/2019,1,SP 31 tra Viadotto A 14 e Coriano,12348,10,12026,321,10036,2312,12348,0
2019/03,354,19/03/2019,2,SP 31 tra Viadotto A 14 e Coriano,12365,20,12067,296,9797,2568,12365,0
2019/03,354,20/03/2019,3,SP 31 tra Viadotto A 14 e Coriano,12560,20,12221,337,9896,2664,12560,0
2019/03,354,21/03/2019,4,SP 31 tra Viadotto A 14 e Coriano,12816,20,12434,380,10002,2814,12816,0
2019/03,354,22/03/2019,5,SP 31 tra Viadotto A 14 e Coriano,13255,10,12897,357,10199,3056,13255,0
2019/03,354,23/03/2019,6,SP 31 tra Viadotto A 14 e Coriano,12235,30,12060,172,8720,3515,0,12235
2019/03,354,24/03/2019,7,SP 31 tra Viadotto A 14 e Coriano,10380,10,10345,34,7487,2893,0,10380
2019/03,354,25/03/2019,1,SP 31 tra Viadotto A 14 e Coriano,12849,10,12487,361,10284,2565,12849,0
2019/03,354,26/03/2019,2,SP 31 tra Viadotto A 14 e Coriano,12296,40,11978,314,9733,2563,12296,0
2019/03,354,27/03/2019,3,SP 31 tra Viadotto A 14 e Coriano,12736,40,12365,367,10008,2728,12736,0
2019/03,354,28/03/2019,4,SP 31 tra Viadotto A 14 e Coriano,13029,30,12674,352,10163,2866,13029,0
2019/03,355,15/03/2019,5,SP 17V tra San Giovanni in Marignano e Morciano di Romagna (variante),17811,00,17063,748,13836,3975,17811,0
2019/03,355,16/03/2019,6,SP 17V tra San Giovanni in Marignano e Morciano di Romagna (variante),17204,00,17050,154,12490,4714,0,17204
2019/03,355,17/03/2019,7,SP 17V tra San Giovanni in Marignano e Morciano di Romagna (variante),16118,00,16066,52,12253,3865,0,16118
2019/03,355,18/03/2019,1,SP 17V tra San Giovanni in Marignano e Morciano di Romagna (variante),16209,00,15469,740,13228,2981,16209,0
2019/03,355,19/03/2019,2,SP 17V tra San Giovanni in Marignano e Morciano di Romagna (variante),16177,00,15405,772,12989,3188,16177,0
2019/03,355,20/03/2019,3,SP 17V tra San Giovanni in Marignano e Morciano di Romagna (variante),15902,00,15206,696,12610,3292,15902,0
2019/03,355,21/03/2019,4,SP 17V tra San Giovanni in Marignano e Morciano di Romagna (variante),16973,00,16112,861,13531,3442,16973,0
2019/03,355,22/03/2019,5,SP 17V tra San Giovanni in Marignano e Morciano di Romagna (variante),16690,00,15905,785,13067,3623,16690,0
2019/03,355,23/03/2019,6,SP 17V tra San Giovanni in Marignano e Morciano di Romagna (variante),14050,00,13895,155,10547,3503,0,14050
2019/03,355,24/03/2019,7,SP 17V tra San Giovanni in Marignano e Morciano di Romagna (variante),11701,00,11650,51,8779,2922,0,11701
2019/03,355,25/03/2019,1,SP 17V tra San Giovanni in Marignano e Morciano di Romagna (variante),16167,00,15420,747,13026,3141,16167,0
2019/03,355,26/03/2019,2,SP 17V tra San Giovanni in Marignano e Morciano di Romagna (variante),16225,00,15474,751,13104,3121,16225,0
2019/03,355,27/03/2019,3,SP 17V tra San Giovanni in Marignano e Morciano di Romagna (variante),15771,00,15033,738,12843,2928,15771,0
2019/03,355,28/03/2019,4,SP 17V tra San Giovanni in Marignano e Morciano di Romagna (variante),16445,00,15675,770,13347,3098,16445,0
2019/03,356,15/03/2019,5,SP 2 fra Reggiolo c/o bivio variante nord e confine regionale,8683,00,7694,989,6756,1927,8683,0
2019/03,356,16/03/2019,6,SP 2 fra Reggiolo c/o bivio variante nord e confine regionale,7465,00,7256,209,5442,2023,0,7465
2019/03,356,17/03/2019,7,SP 2 fra Reggiolo c/o bivio variante nord e confine regionale,6144,00,6073,71,4527,1617,0,6144
2019/03,356,18/03/2019,1,SP 2 fra Reggiolo c/o bivio variante nord e confine regionale,7231,00,6298,933,5689,1542,7231,0
2019/03,356,19/03/2019,2,SP 2 fra Reggiolo c/o bivio variante nord e confine regionale,7815,00,6786,1029,6150,1665,7815,0
2019/03,356,20/03/2019,3,SP 2 fra Reggiolo c/o bivio variante nord e confine regionale,7885,10,6884,1000,6217,1668,7885,0
2019/03,356,21/03/2019,4,SP 2 fra Reggiolo c/o bivio variante nord e confine regionale,7712,00,6727,985,6091,1621,7712,0
2019/03,356,22/03/2019,5,SP 2 fra Reggiolo c/o bivio variante nord e confine regionale,8188,00,7158,1030,6268,1920,8188,0
2019/03,356,23/03/2019,6,SP 2 fra Reggiolo c/o bivio variante nord e confine regionale,6936,00,6740,196,4824,2112,0,6936
2019/03,356,24/03/2019,7,SP 2 fra Reggiolo c/o bivio variante nord e confine regionale,7945,00,7866,79,5812,2133,0,7945
2019/03,356,25/03/2019,1,SP 2 fra Reggiolo c/o bivio variante nord e confine regionale,7539,00,6608,931,6049,1490,7539,0
2019/03,356,26/03/2019,2,SP 2 fra Reggiolo c/o bivio variante nord e confine regionale,7629,00,6625,1004,6022,1607,7629,0
2019/03,356,27/03/2019,3,SP 2 fra Reggiolo c/o bivio variante nord e confine regionale,8037,00,7001,1036,6341,1696,8037,0
2019/03,356,28/03/2019,4,SP 2 fra Reggiolo c/o bivio variante nord e confine regionale,7721,10,6760,960,5999,1722,7721,0
2019/03,357,15/03/2019,5,SP 306R fra Casola Valsenio e bivio SP 65 c/o località Isola,3691,00,3325,366,2934,757,3691,0
2019/03,357,16/03/2019,6,SP 306R fra Casola Valsenio e bivio SP 65 c/o località Isola,3379,00,3274,105,2559,820,0,3379
2019/03,357,17/03/2019,7,SP 306R fra Casola Valsenio e bivio SP 65 c/o località Isola,3392,10,3371,20,2752,640,0,3392
2019/03,357,18/03/2019,1,SP 306R fra Casola Valsenio e bivio SP 65 c/o località Isola,3286,00,2985,301,2692,594,3286,0
2019/03,357,19/03/2019,2,SP 306R fra Casola Valsenio e bivio SP 65 c/o località Isola,3511,00,3164,347,2872,639,3511,0
2019/03,357,20/03/2019,3,SP 306R fra Casola Valsenio e bivio SP 65 c/o località Isola,3542,10,3153,388,2846,696,3542,0
2019/03,357,21/03/2019,4,SP 306R fra Casola Valsenio e bivio SP 65 c/o località Isola,3487,00,3193,294,2766,721,3487,0
2019/03,357,22/03/2019,5,SP 306R fra Casola Valsenio e bivio SP 65 c/o località Isola,3742,10,3385,356,2930,812,3742,0
2019/03,357,23/03/2019,6,SP 306R fra Casola Valsenio e bivio SP 65 c/o località Isola,3365,20,3280,83,2513,852,0,3365
2019/03,357,24/03/2019,7,SP 306R fra Casola Valsenio e bivio SP 65 c/o località Isola,3355,10,3335,19,2662,693,0,3355
2019/03,357,25/03/2019,1,SP 306R fra Casola Valsenio e bivio SP 65 c/o località Isola,3295,00,2965,330,2654,641,3295,0
2019/03,357,26/03/2019,2,SP 306R fra Casola Valsenio e bivio SP 65 c/o località Isola,3603,10,3292,310,2928,675,3603,0
2019/03,357,27/03/2019,3,SP 306R fra Casola Valsenio e bivio SP 65 c/o località Isola,3493,00,3197,296,2782,711,3493,0
2019/03,357,28/03/2019,4,SP 306R fra Casola Valsenio e bivio SP 65 c/o località Isola,3492,20,3178,312,2782,710,3492,0
2019/03,376,15/03/2019,5,SP 68 tra Portomaggiore e la Superstrada Ferrara-Mare,3549,00,3393,156,2786,763,3549,0
2019/03,376,16/03/2019,6,SP 68 tra Portomaggiore e la Superstrada Ferrara-Mare,2859,00,2783,76,2170,689,0,2859
2019/03,376,17/03/2019,7,SP 68 tra Portomaggiore e la Superstrada Ferrara-Mare,2621,00,2611,10,2009,612,0,2621
2019/03,376,18/03/2019,1,SP 68 tra Portomaggiore e la Superstrada Ferrara-Mare,3131,00,2959,172,2507,624,3131,0
2019/03,376,19/03/2019,2,SP 68 tra Portomaggiore e la Superstrada Ferrara-Mare,3312,00,3136,176,2671,641,3312,0
2019/03,376,20/03/2019,3,SP 68 tra Portomaggiore e la Superstrada Ferrara-Mare,3239,00,3052,187,2629,610,3239,0
2019/03,376,21/03/2019,4,SP 68 tra Portomaggiore e la Superstrada Ferrara-Mare,3334,20,3151,181,2690,644,3334,0
2019/03,376,22/03/2019,5,SP 68 tra Portomaggiore e la Superstrada Ferrara-Mare,3561,10,3385,175,2781,780,3561,0
2019/03,376,23/03/2019,6,SP 68 tra Portomaggiore e la Superstrada Ferrara-Mare,3007,00,2935,72,2169,838,0,3007
2019/03,376,24/03/2019,7,SP 68 tra Portomaggiore e la Superstrada Ferrara-Mare,2740,20,2729,9,1996,744,0,2740
2019/03,376,25/03/2019,1,SP 68 tra Portomaggiore e la Superstrada Ferrara-Mare,3214,00,3042,172,2575,639,3214,0
2019/03,376,26/03/2019,2,SP 68 tra Portomaggiore e la Superstrada Ferrara-Mare,3357,00,3173,184,2667,690,3357,0
2019/03,376,27/03/2019,3,SP 68 tra Portomaggiore e la Superstrada Ferrara-Mare,3262,00,3063,199,2627,635,3262,0
2019/03,376,28/03/2019,4,SP 68 tra Portomaggiore e la Superstrada Ferrara-Mare,3441,00,3254,187,2749,692,3441,0
2019/03,377,15/03/2019,5,SP 18 tra Bondeno e il confine regionale (Lombardia),5401,00,4976,425,4214,1187,5401,0
2019/03,377,16/03/2019,6,SP 18 tra Bondeno e il confine regionale (Lombardia),4346,00,4208,138,3161,1185,0,4346
2019/03,377,17/03/2019,7,SP 18 tra Bondeno e il confine regionale (Lombardia),3546,00,3518,28,2630,916,0,3546
2019/03,377,18/03/2019,1,SP 18 tra Bondeno e il confine regionale (Lombardia),5078,00,4644,434,4126,952,5078,0
2019/03,377,19/03/2019,2,SP 18 tra Bondeno e il confine regionale (Lombardia),5202,00,4693,509,4185,1017,5202,0
2019/03,377,20/03/2019,3,SP 18 tra Bondeno e il confine regionale (Lombardia),4869,00,4435,434,3855,1014,4869,0
2019/03,377,21/03/2019,4,SP 18 tra Bondeno e il confine regionale (Lombardia),5264,10,4804,459,4169,1095,5264,0
2019/03,377,22/03/2019,5,SP 18 tra Bondeno e il confine regionale (Lombardia),5408,10,4905,502,4233,1175,5408,0
2019/03,377,23/03/2019,6,SP 18 tra Bondeno e il confine regionale (Lombardia),4547,00,4442,105,3309,1238,0,4547
2019/03,377,24/03/2019,7,SP 18 tra Bondeno e il confine regionale (Lombardia),3977,00,3949,28,2787,1190,0,3977
2019/03,377,25/03/2019,1,SP 18 tra Bondeno e il confine regionale (Lombardia),5055,10,4674,380,4067,988,5055,0
2019/03,377,26/03/2019,2,SP 18 tra Bondeno e il confine regionale (Lombardia),5200,00,4765,435,4218,982,5200,0
2019/03,377,27/03/2019,3,SP 18 tra Bondeno e il confine regionale (Lombardia),5157,00,4720,437,4086,1071,5157,0
2019/03,377,28/03/2019,4,SP 18 tra Bondeno e il confine regionale (Lombardia),5078,00,4659,419,4053,1025,5078,0
2019/03,383,15/03/2019,5,SS 722 Tangenziale nord di Reggio Emilia,35519,70,31270,4242,27439,8080,35519,0
2019/03,383,16/03/2019,6,SS 722 Tangenziale nord di Reggio Emilia,27435,10,26640,794,19823,7612,0,27435
2019/03,383,17/03/2019,7,SS 722 Tangenziale nord di Reggio Emilia,21220,30,20997,220,14828,6392,0,21220
2019/03,383,18/03/2019,1,SS 722 Tangenziale nord di Reggio Emilia,34744,80,30539,4197,28073,6671,34744,0
2019/03,383,19/03/2019,2,SS 722 Tangenziale nord di Reggio Emilia,34270,60,30187,4077,27369,6901,34270,0
2019/03,383,20/03/2019,3,SS 722 Tangenziale nord di Reggio Emilia,34664,60,30508,4150,27387,7277,34664,0
2019/03,383,21/03/2019,4,SS 722 Tangenziale nord di Reggio Emilia,34445,60,30232,4207,27153,7292,34445,0
2019/03,383,22/03/2019,5,SS 722 Tangenziale nord di Reggio Emilia,35338,70,31208,4123,27488,7850,35338,0
2019/03,383,23/03/2019,6,SS 722 Tangenziale nord di Reggio Emilia,25617,50,24787,825,18019,7598,0,25617
2019/03,383,24/03/2019,7,SS 722 Tangenziale nord di Reggio Emilia,20201,40,20015,182,13890,6311,0,20201
2019/03,383,25/03/2019,1,SS 722 Tangenziale nord di Reggio Emilia,33058,10,29047,4010,26308,6750,33058,0
2019/03,383,26/03/2019,2,SS 722 Tangenziale nord di Reggio Emilia,34245,110,30046,4188,27287,6958,34245,0
2019/03,383,27/03/2019,3,SS 722 Tangenziale nord di Reggio Emilia,33285,90,29248,4028,25847,7438,33285,0
2019/03,383,28/03/2019,4,SS 722 Tangenziale nord di Reggio Emilia,36105,60,31752,4347,28458,7647,36105,0
2019/03,385,15/03/2019,5,SP 10R fra Castel San Giovanni e Confine regionale (Lombardia),13513,10,12060,1452,10245,3268,13513,0
2019/03,385,16/03/2019,6,SP 10R fra Castel San Giovanni e Confine regionale (Lombardia),10989,00,10663,326,7939,3050,0,10989
2019/03,385,17/03/2019,7,SP 10R fra Castel San Giovanni e Confine regionale (Lombardia),9061,00,8968,93,6675,2386,0,9061
2019/03,385,18/03/2019,1,SP 10R fra Castel San Giovanni e Confine regionale (Lombardia),12574,00,11117,1457,9893,2681,12574,0
2019/03,385,19/03/2019,2,SP 10R fra Castel San Giovanni e Confine regionale (Lombardia),12937,00,11477,1460,10081,2856,12937,0
2019/03,385,20/03/2019,3,SP 10R fra Castel San Giovanni e Confine regionale (Lombardia),13125,00,11672,1453,10218,2907,13125,0
2019/03,385,21/03/2019,4,SP 10R fra Castel San Giovanni e Confine regionale (Lombardia),13086,00,11651,1435,10103,2983,13086,0
2019/03,385,22/03/2019,5,SP 10R fra Castel San Giovanni e Confine regionale (Lombardia),13385,10,11949,1435,10100,3285,13385,0
2019/03,385,23/03/2019,6,SP 10R fra Castel San Giovanni e Confine regionale (Lombardia),10993,10,10697,295,7997,2996,0,10993
2019/03,385,24/03/2019,7,SP 10R fra Castel San Giovanni e Confine regionale (Lombardia),9456,00,9356,100,6974,2482,0,9456
2019/03,385,25/03/2019,1,SP 10R fra Castel San Giovanni e Confine regionale (Lombardia),12446,00,11063,1383,9719,2727,12446,0
2019/03,385,26/03/2019,2,SP 10R fra Castel San Giovanni e Confine regionale (Lombardia),13140,00,11644,1496,10214,2926,13140,0
2019/03,385,27/03/2019,3,SP 10R fra Castel San Giovanni e Confine regionale (Lombardia),13057,10,11538,1518,10190,2867,13057,0
2019/03,385,28/03/2019,4,SP 10R fra Castel San Giovanni e Confine regionale (Lombardia),13124,00,11658,1466,10195,2929,13124,0
2019/03,388,15/03/2019,5,SP 31 fra bivio SP 12 in località Castelnuovo Fogliani e il confine provinciale,5006,00,4854,152,3903,1103,5006,0
2019/03,388,16/03/2019,6,SP 31 fra bivio SP 12 in località Castelnuovo Fogliani e il confine provinciale,5190,00,5110,80,3829,1361,0,5190
2019/03,388,17/03/2019,7,SP 31 fra bivio SP 12 in località Castelnuovo Fogliani e il confine provinciale,4778,10,4750,27,3656,1122,0,4778
2019/03,388,18/03/2019,1,SP 31 fra bivio SP 12 in località Castelnuovo Fogliani e il confine provinciale,4589,00,4461,128,3765,824,4589,0
2019/03,388,19/03/2019,2,SP 31 fra bivio SP 12 in località Castelnuovo Fogliani e il confine provinciale,4664,00,4518,146,3717,947,4664,0
2019/03,388,20/03/2019,3,SP 31 fra bivio SP 12 in località Castelnuovo Fogliani e il confine provinciale,4588,00,4452,136,3654,934,4588,0
2019/03,388,21/03/2019,4,SP 31 fra bivio SP 12 in località Castelnuovo Fogliani e il confine provinciale,4687,00,4538,149,3772,915,4687,0
2019/03,388,22/03/2019,5,SP 31 fra bivio SP 12 in località Castelnuovo Fogliani e il confine provinciale,5052,10,4884,167,3916,1136,5052,0
2019/03,388,23/03/2019,6,SP 31 fra bivio SP 12 in località Castelnuovo Fogliani e il confine provinciale,5429,00,5352,77,3765,1664,0,5429
2019/03,388,24/03/2019,7,SP 31 fra bivio SP 12 in località Castelnuovo Fogliani e il confine provinciale,4958,00,4933,25,3853,1105,0,4958
2019/03,388,25/03/2019,1,SP 31 fra bivio SP 12 in località Castelnuovo Fogliani e il confine provinciale,4466,00,4319,147,3600,866,4466,0
2019/03,388,26/03/2019,2,SP 31 fra bivio SP 12 in località Castelnuovo Fogliani e il confine provinciale,4805,00,4667,138,3893,912,4805,0
2019/03,388,27/03/2019,3,SP 31 fra bivio SP 12 in località Castelnuovo Fogliani e il confine provinciale,4702,00,4538,164,3674,1028,4702,0
2019/03,388,28/03/2019,4,SP 31 fra bivio SP 12 in località Castelnuovo Fogliani e il confine provinciale,4870,00,4720,150,3838,1032,4870,0
2019/03,389,15/03/2019,5,SP 588R fra Villanova d’Arda e confine provinciale,4440,00,4025,415,3437,1003,4440,0
2019/03,389,16/03/2019,6,SP 588R fra Villanova d’Arda e confine provinciale,3812,00,3720,92,2860,952,0,3812
2019/03,389,17/03/2019,7,SP 588R fra Villanova d’Arda e confine provinciale,3601,10,3552,48,2790,811,0,3601
2019/03,389,18/03/2019,1,SP 588R fra Villanova d’Arda e confine provinciale,3865,00,3508,357,3150,715,3865,0
2019/03,389,19/03/2019,2,SP 588R fra Villanova d’Arda e confine provinciale,4121,00,3749,372,3349,772,4121,0
2019/03,389,20/03/2019,3,SP 588R fra Villanova d’Arda e confine provinciale,3868,10,3518,349,3042,826,3868,0
2019/03,389,21/03/2019,4,SP 588R fra Villanova d’Arda e confine provinciale,4221,10,3815,405,3335,886,4221,0
2019/03,389,22/03/2019,5,SP 588R fra Villanova d’Arda e confine provinciale,4371,00,3959,412,3418,953,4371,0
2019/03,389,23/03/2019,6,SP 588R fra Villanova d’Arda e confine provinciale,3946,20,3837,107,2931,1015,0,3946
2019/03,389,24/03/2019,7,SP 588R fra Villanova d’Arda e confine provinciale,3807,00,3749,58,2918,889,0,3807
2019/03,389,25/03/2019,1,SP 588R fra Villanova d’Arda e confine provinciale,3981,00,3592,389,3204,777,3981,0
2019/03,389,26/03/2019,2,SP 588R fra Villanova d’Arda e confine provinciale,4665,00,4139,526,3814,851,4665,0
2019/03,389,27/03/2019,3,SP 588R fra Villanova d’Arda e confine provinciale,4100,00,3713,387,3313,787,4100,0
2019/03,389,28/03/2019,4,SP 588R fra Villanova d’Arda e confine provinciale,4819,00,4387,432,3899,920,4819,0
2019/03,390,15/03/2019,5,SP 462R dal bivio SP 10R in località Monticelli a Cortemaggiore,3151,00,2956,195,2447,704,3151,0
2019/03,390,16/03/2019,6,SP 462R dal bivio SP 10R in località Monticelli a Cortemaggiore,3175,00,3119,56,2261,914,0,3175
2019/03,390,17/03/2019,7,SP 462R dal bivio SP 10R in località Monticelli a Cortemaggiore,3736,00,3715,21,2967,769,0,3736
2019/03,390,18/03/2019,1,SP 462R dal bivio SP 10R in località Monticelli a Cortemaggiore,2834,00,2685,149,2256,578,2834,0
2019/03,390,19/03/2019,2,SP 462R dal bivio SP 10R in località Monticelli a Cortemaggiore,3085,00,2898,187,2455,630,3085,0
2019/03,390,20/03/2019,3,SP 462R dal bivio SP 10R in località Monticelli a Cortemaggiore,3096,10,2905,190,2441,655,3096,0
2019/03,390,21/03/2019,4,SP 462R dal bivio SP 10R in località Monticelli a Cortemaggiore,2976,00,2821,155,2360,616,2976,0
2019/03,390,22/03/2019,5,SP 462R dal bivio SP 10R in località Monticelli a Cortemaggiore,3181,00,3017,164,2447,734,3181,0
2019/03,390,23/03/2019,6,SP 462R dal bivio SP 10R in località Monticelli a Cortemaggiore,3124,00,3042,82,2273,851,0,3124
2019/03,390,24/03/2019,7,SP 462R dal bivio SP 10R in località Monticelli a Cortemaggiore,3145,00,3110,35,2443,702,0,3145
2019/03,390,25/03/2019,1,SP 462R dal bivio SP 10R in località Monticelli a Cortemaggiore,2871,00,2700,171,2344,527,2871,0
2019/03,390,26/03/2019,2,SP 462R dal bivio SP 10R in località Monticelli a Cortemaggiore,3047,00,2875,172,2490,557,3047,0
2019/03,390,27/03/2019,3,SP 462R dal bivio SP 10R in località Monticelli a Cortemaggiore,3088,00,2935,153,2471,617,3088,0
2019/03,390,28/03/2019,4,SP 462R dal bivio SP 10R in località Monticelli a Cortemaggiore,3014,00,2883,131,2380,634,3014,0
2019/03,391,15/03/2019,5,SP 10R fra Castelvetro Piacentino e confine regionale (Lombardia),22770,00,22218,552,17123,5647,22770,0
2019/03,391,16/03/2019,6,SP 10R fra Castelvetro Piacentino e confine regionale (Lombardia),22394,00,22159,235,15664,6730,0,22394
2019/03,391,17/03/2019,7,SP 10R fra Castelvetro Piacentino e confine regionale (Lombardia),19588,00,19509,79,14326,5262,0,19588
2019/03,391,18/03/2019,1,SP 10R fra Castelvetro Piacentino e confine regionale (Lombardia),20206,10,19669,536,15854,4352,20206,0
2019/03,391,19/03/2019,2,SP 10R fra Castelvetro Piacentino e confine regionale (Lombardia),20533,00,20024,509,16125,4408,20533,0
2019/03,391,20/03/2019,3,SP 10R fra Castelvetro Piacentino e confine regionale (Lombardia),20825,00,20268,557,16044,4781,20825,0
2019/03,391,21/03/2019,4,SP 10R fra Castelvetro Piacentino e confine regionale (Lombardia),20730,00,20187,543,16089,4641,20730,0
2019/03,391,22/03/2019,5,SP 10R fra Castelvetro Piacentino e confine regionale (Lombardia),22132,00,21587,545,16567,5565,22132,0
2019/03,391,23/03/2019,6,SP 10R fra Castelvetro Piacentino e confine regionale (Lombardia),21890,00,21639,251,15393,6497,0,21890
2019/03,391,24/03/2019,7,SP 10R fra Castelvetro Piacentino e confine regionale (Lombardia),20950,10,20814,135,15543,5407,0,20950
2019/03,391,25/03/2019,1,SP 10R fra Castelvetro Piacentino e confine regionale (Lombardia),19942,00,19434,508,15648,4294,19942,0
2019/03,391,26/03/2019,2,SP 10R fra Castelvetro Piacentino e confine regionale (Lombardia),20715,00,20123,592,16289,4426,20715,0
2019/03,391,27/03/2019,3,SP 10R fra Castelvetro Piacentino e confine regionale (Lombardia),20983,00,20404,579,16384,4599,20983,0
2019/03,391,28/03/2019,4,SP 10R fra Castelvetro Piacentino e confine regionale (Lombardia),21116,10,20564,551,16327,4789,21116,0
2019/03,393,15/03/2019,5,SP 10R fra Caorso e Roncaglia,12515,00,10858,1657,9401,3114,12515,0
2019/03,393,16/03/2019,6,SP 10R fra Caorso e Roncaglia,9472,00,9164,308,6708,2764,0,9472
2019/03,393,17/03/2019,7,SP 10R fra Caorso e Roncaglia,7379,00,7324,55,5429,1950,0,7379
2019/03,393,18/03/2019,1,SP 10R fra Caorso e Roncaglia,11680,10,10036,1643,9186,2494,11680,0
2019/03,393,19/03/2019,2,SP 10R fra Caorso e Roncaglia,11523,00,9852,1671,8927,2596,11523,0
2019/03,393,20/03/2019,3,SP 10R fra Caorso e Roncaglia,11965,10,10117,1847,9313,2652,11965,0
2019/03,393,21/03/2019,4,SP 10R fra Caorso e Roncaglia,12075,10,10273,1801,9294,2781,12075,0
2019/03,393,22/03/2019,5,SP 10R fra Caorso e Roncaglia,12300,10,10699,1600,9246,3054,12300,0
2019/03,393,23/03/2019,6,SP 10R fra Caorso e Roncaglia,9318,10,8977,340,6558,2760,0,9318
2019/03,393,24/03/2019,7,SP 10R fra Caorso e Roncaglia,8847,30,8773,71,6683,2164,0,8847
2019/03,393,25/03/2019,1,SP 10R fra Caorso e Roncaglia,11354,20,9846,1506,8940,2414,11354,0
2019/03,393,26/03/2019,2,SP 10R fra Caorso e Roncaglia,12243,10,10378,1864,9652,2591,12243,0
2019/03,393,27/03/2019,3,SP 10R fra Caorso e Roncaglia,12214,10,10466,1747,9485,2729,12214,0
2019/03,393,28/03/2019,4,SP 10R fra Caorso e Roncaglia,12315,10,10781,1533,9518,2797,12315,0
2019/03,394,15/03/2019,5,SP 523R da Roccamurata (bivio SP 308R) a Borgo Val di Taro,5080,00,4633,447,3932,1148,5080,0
2019/03,394,16/03/2019,6,SP 523R da Roccamurata (bivio SP 308R) a Borgo Val di Taro,4417,00,4297,120,3393,1024,0,4417
2019/03,394,17/03/2019,7,SP 523R da Roccamurata (bivio SP 308R) a Borgo Val di Taro,3932,00,3913,19,3041,891,0,3932
2019/03,394,18/03/2019,1,SP 523R da Roccamurata (bivio SP 308R) a Borgo Val di Taro,4936,00,4495,441,3924,1012,4936,0
2019/03,394,19/03/2019,2,SP 523R da Roccamurata (bivio SP 308R) a Borgo Val di Taro,4753,00,4328,425,3779,974,4753,0
2019/03,394,20/03/2019,3,SP 523R da Roccamurata (bivio SP 308R) a Borgo Val di Taro,4811,00,4358,453,3820,991,4811,0
2019/03,394,21/03/2019,4,SP 523R da Roccamurata (bivio SP 308R) a Borgo Val di Taro,4748,00,4304,444,3765,983,4748,0
2019/03,394,22/03/2019,5,SP 523R da Roccamurata (bivio SP 308R) a Borgo Val di Taro,5048,00,4617,431,3895,1153,5048,0
2019/03,394,23/03/2019,6,SP 523R da Roccamurata (bivio SP 308R) a Borgo Val di Taro,4212,00,4102,110,3209,1003,0,4212
2019/03,394,24/03/2019,7,SP 523R da Roccamurata (bivio SP 308R) a Borgo Val di Taro,4142,00,4113,29,3108,1034,0,4142
2019/03,394,25/03/2019,1,SP 523R da Roccamurata (bivio SP 308R) a Borgo Val di Taro,5312,00,4896,416,4234,1078,5312,0
2019/03,394,26/03/2019,2,SP 523R da Roccamurata (bivio SP 308R) a Borgo Val di Taro,4676,00,4242,434,3714,962,4676,0
2019/03,394,27/03/2019,3,SP 523R da Roccamurata (bivio SP 308R) a Borgo Val di Taro,4829,00,4381,448,3822,1007,4829,0
2019/03,394,28/03/2019,4,SP 523R da Roccamurata (bivio SP 308R) a Borgo Val di Taro,4963,00,4541,422,3859,1104,4963,0
2019/03,395,15/03/2019,5,SP 308R da Fornovo di Taro (bivio SS 62) a Solignano,4690,00,4457,233,3636,1054,4690,0
2019/03,395,16/03/2019,6,SP 308R da Fornovo di Taro (bivio SS 62) a Solignano,4027,00,3961,66,3082,945,0,4027
2019/03,395,17/03/2019,7,SP 308R da Fornovo di Taro (bivio SS 62) a Solignano,3773,00,3757,16,2887,886,0,3773
2019/03,395,18/03/2019,1,SP 308R da Fornovo di Taro (bivio SS 62) a Solignano,4318,00,4103,215,3385,933,4318,0
2019/03,395,19/03/2019,2,SP 308R da Fornovo di Taro (bivio SS 62) a Solignano,4463,00,4244,219,3501,962,4463,0
2019/03,395,20/03/2019,3,SP 308R da Fornovo di Taro (bivio SS 62) a Solignano,4428,00,4208,220,3456,972,4428,0
2019/03,395,21/03/2019,4,SP 308R da Fornovo di Taro (bivio SS 62) a Solignano,4443,10,4206,236,3457,986,4443,0
2019/03,395,22/03/2019,5,SP 308R da Fornovo di Taro (bivio SS 62) a Solignano,4653,00,4408,245,3610,1043,4653,0
2019/03,395,23/03/2019,6,SP 308R da Fornovo di Taro (bivio SS 62) a Solignano,3921,00,3854,67,2964,957,0,3921
2019/03,395,24/03/2019,7,SP 308R da Fornovo di Taro (bivio SS 62) a Solignano,4139,00,4127,12,3042,1097,0,4139
2019/03,395,25/03/2019,1,SP 308R da Fornovo di Taro (bivio SS 62) a Solignano,4605,00,4390,215,3630,975,4605,0
2019/03,395,26/03/2019,2,SP 308R da Fornovo di Taro (bivio SS 62) a Solignano,4524,10,4279,244,3565,959,4524,0
2019/03,395,27/03/2019,3,SP 308R da Fornovo di Taro (bivio SS 62) a Solignano,4372,00,4122,250,3407,965,4372,0
2019/03,395,28/03/2019,4,SP 308R da Fornovo di Taro (bivio SS 62) a Solignano,4555,00,4295,260,3542,1013,4555,0
2019/03,396,15/03/2019,5,SP 28 fra Fornovo di Taro e Varano de Melegari centro abitato Viazzano,8262,00,7860,402,6554,1708,8262,0
2019/03,396,16/03/2019,6,SP 28 fra Fornovo di Taro e Varano de Melegari centro abitato Viazzano,7135,10,7006,128,5552,1583,0,7135
2019/03,396,17/03/2019,7,SP 28 fra Fornovo di Taro e Varano de Melegari centro abitato Viazzano,6340,00,6297,43,5082,1258,0,6340
2019/03,396,18/03/2019,1,SP 28 fra Fornovo di Taro e Varano de Melegari centro abitato Viazzano,7582,00,7271,311,6140,1442,7582,0
2019/03,396,19/03/2019,2,SP 28 fra Fornovo di Taro e Varano de Melegari centro abitato Viazzano,8093,00,7726,367,6520,1573,8093,0
2019/03,396,20/03/2019,3,SP 28 fra Fornovo di Taro e Varano de Melegari centro abitato Viazzano,7954,00,7591,363,6365,1589,7954,0
2019/03,396,21/03/2019,4,SP 28 fra Fornovo di Taro e Varano de Melegari centro abitato Viazzano,8258,00,7932,326,6527,1731,8258,0
2019/03,396,22/03/2019,5,SP 28 fra Fornovo di Taro e Varano de Melegari centro abitato Viazzano,8205,00,7852,353,6429,1776,8205,0
2019/03,396,23/03/2019,6,SP 28 fra Fornovo di Taro e Varano de Melegari centro abitato Viazzano,7225,00,7105,120,5615,1610,0,7225
2019/03,396,24/03/2019,7,SP 28 fra Fornovo di Taro e Varano de Melegari centro abitato Viazzano,6361,00,6316,45,4946,1415,0,6361
2019/03,396,25/03/2019,1,SP 28 fra Fornovo di Taro e Varano de Melegari centro abitato Viazzano,7603,10,7270,332,6126,1477,7603,0
2019/03,396,26/03/2019,2,SP 28 fra Fornovo di Taro e Varano de Melegari centro abitato Viazzano,8035,00,7713,322,6540,1495,8035,0
2019/03,396,27/03/2019,3,SP 28 fra Fornovo di Taro e Varano de Melegari centro abitato Viazzano,7978,00,7601,377,6335,1643,7978,0
2019/03,396,28/03/2019,4,SP 28 fra Fornovo di Taro e Varano de Melegari centro abitato Viazzano,8218,10,7831,386,6545,1673,8218,0
2019/03,397,15/03/2019,5,SP 12 fra casello A 1 e Fidenza,,,,,,,,
2019/03,397,16/03/2019,6,SP 12 fra casello A 1 e Fidenza,,,,,,,,
2019/03,397,17/03/2019,7,SP 12 fra casello A 1 e Fidenza,,,,,,,,
2019/03,397,18/03/2019,1,SP 12 fra casello A 1 e Fidenza,,,,,,,,
2019/03,397,19/03/2019,2,SP 12 fra casello A 1 e Fidenza,,,,,,,,
2019/03,397,20/03/2019,3,SP 12 fra casello A 1 e Fidenza,,,,,,,,
2019/03,397,21/03/2019,4,SP 12 fra casello A 1 e Fidenza,,,,,,,,
2019/03,397,22/03/2019,5,SP 12 fra casello A 1 e Fidenza,,,,,,,,
2019/03,397,23/03/2019,6,SP 12 fra casello A 1 e Fidenza,,,,,,,,
2019/03,397,24/03/2019,7,SP 12 fra casello A 1 e Fidenza,,,,,,,,
2019/03,397,25/03/2019,1,SP 12 fra casello A 1 e Fidenza,,,,,,,,
2019/03,397,26/03/2019,2,SP 12 fra casello A 1 e Fidenza,,,,,,,,
2019/03,397,27/03/2019,3,SP 12 fra casello A 1 e Fidenza,,,,,,,,
2019/03,397,28/03/2019,4,SP 12 fra casello A 1 e Fidenza,,,,,,,,
2019/03,398,15/03/2019,5,SP 11 tra Fontevivo e Cispadana (tangenziale),,,,,,,,
2019/03,398,16/03/2019,6,SP 11 tra Fontevivo e Cispadana (tangenziale),,,,,,,,
2019/03,398,17/03/2019,7,SP 11 tra Fontevivo e Cispadana (tangenziale),,,,,,,,
2019/03,398,18/03/2019,1,SP 11 tra Fontevivo e Cispadana (tangenziale),,,,,,,,
2019/03,398,19/03/2019,2,SP 11 tra Fontevivo e Cispadana (tangenziale),,,,,,,,
2019/03,398,20/03/2019,3,SP 11 tra Fontevivo e Cispadana (tangenziale),,,,,,,,
2019/03,398,21/03/2019,4,SP 11 tra Fontevivo e Cispadana (tangenziale),,,,,,,,
2019/03,398,22/03/2019,5,SP 11 tra Fontevivo e Cispadana (tangenziale),,,,,,,,
2019/03,398,23/03/2019,6,SP 11 tra Fontevivo e Cispadana (tangenziale),,,,,,,,
2019/03,398,24/03/2019,7,SP 11 tra Fontevivo e Cispadana (tangenziale),,,,,,,,
2019/03,398,25/03/2019,1,SP 11 tra Fontevivo e Cispadana (tangenziale),,,,,,,,
2019/03,398,26/03/2019,2,SP 11 tra Fontevivo e Cispadana (tangenziale),,,,,,,,
2019/03,398,27/03/2019,3,SP 11 tra Fontevivo e Cispadana (tangenziale),,,,,,,,
2019/03,398,28/03/2019,4,SP 11 tra Fontevivo e Cispadana (tangenziale),,,,,,,,
2019/03,399,15/03/2019,5,SP 43 tra Trecasali (bivio SP 8) e Torrile,3947,00,3540,407,3083,864,3947,0
2019/03,399,16/03/2019,6,SP 43 tra Trecasali (bivio SP 8) e Torrile,2755,00,2647,108,2030,725,0,2755
2019/03,399,17/03/2019,7,SP 43 tra Trecasali (bivio SP 8) e Torrile,2120,00,2067,53,1521,599,0,2120
2019/03,399,18/03/2019,1,SP 43 tra Trecasali (bivio SP 8) e Torrile,3785,00,3382,403,3004,781,3785,0
2019/03,399,19/03/2019,2,SP 43 tra Trecasali (bivio SP 8) e Torrile,3930,20,3535,393,3088,842,3930,0
2019/03,399,20/03/2019,3,SP 43 tra Trecasali (bivio SP 8) e Torrile,3814,00,3447,367,3006,808,3814,0
2019/03,399,21/03/2019,4,SP 43 tra Trecasali (bivio SP 8) e Torrile,3896,00,3470,426,3028,868,3896,0
2019/03,399,22/03/2019,5,SP 43 tra Trecasali (bivio SP 8) e Torrile,3976,00,3582,394,3106,870,3976,0
2019/03,399,23/03/2019,6,SP 43 tra Trecasali (bivio SP 8) e Torrile,2786,00,2655,131,2050,736,0,2786
2019/03,399,24/03/2019,7,SP 43 tra Trecasali (bivio SP 8) e Torrile,2503,00,2448,55,1874,629,0,2503
2019/03,399,25/03/2019,1,SP 43 tra Trecasali (bivio SP 8) e Torrile,3740,10,3274,465,2921,819,3740,0
2019/03,399,26/03/2019,2,SP 43 tra Trecasali (bivio SP 8) e Torrile,4006,10,3515,490,3151,855,4006,0
2019/03,399,27/03/2019,3,SP 43 tra Trecasali (bivio SP 8) e Torrile,3959,00,3511,448,3066,893,3959,0
2019/03,399,28/03/2019,4,SP 43 tra Trecasali (bivio SP 8) e Torrile,4173,00,3748,425,3262,911,4173,0
2019/03,400,15/03/2019,5,SP 10 da San Secondo Parmense al bivio per Roccabianca centro abitato Pizzo,7686,00,6572,1114,6025,1661,7686,0
2019/03,400,16/03/2019,6,SP 10 da San Secondo Parmense al bivio per Roccabianca centro abitato Pizzo,6210,00,5901,309,4700,1510,0,6210
2019/03,400,17/03/2019,7,SP 10 da San Secondo Parmense al bivio per Roccabianca centro abitato Pizzo,5082,10,4980,101,3711,1371,0,5082
2019/03,400,18/03/2019,1,SP 10 da San Secondo Parmense al bivio per Roccabianca centro abitato Pizzo,7381,10,6292,1088,5936,1445,7381,0
2019/03,400,19/03/2019,2,SP 10 da San Secondo Parmense al bivio per Roccabianca centro abitato Pizzo,7542,00,6386,1156,6083,1459,7542,0
2019/03,400,20/03/2019,3,SP 10 da San Secondo Parmense al bivio per Roccabianca centro abitato Pizzo,7880,00,6739,1141,6339,1541,7880,0
2019/03,400,21/03/2019,4,SP 10 da San Secondo Parmense al bivio per Roccabianca centro abitato Pizzo,7608,00,6454,1154,5996,1612,7608,0
2019/03,400,22/03/2019,5,SP 10 da San Secondo Parmense al bivio per Roccabianca centro abitato Pizzo,7900,10,6815,1084,6170,1730,7900,0
2019/03,400,23/03/2019,6,SP 10 da San Secondo Parmense al bivio per Roccabianca centro abitato Pizzo,6182,10,5899,282,4586,1596,0,6182
2019/03,400,24/03/2019,7,SP 10 da San Secondo Parmense al bivio per Roccabianca centro abitato Pizzo,5215,00,5108,107,3720,1495,0,5215
2019/03,400,25/03/2019,1,SP 10 da San Secondo Parmense al bivio per Roccabianca centro abitato Pizzo,6932,00,5772,1160,5550,1382,6932,0
2019/03,400,26/03/2019,2,SP 10 da San Secondo Parmense al bivio per Roccabianca centro abitato Pizzo,7999,00,6723,1276,6457,1542,7999,0
2019/03,400,27/03/2019,3,SP 10 da San Secondo Parmense al bivio per Roccabianca centro abitato Pizzo,7854,00,6691,1163,6331,1523,7854,0
2019/03,400,28/03/2019,4,SP 10 da San Secondo Parmense al bivio per Roccabianca centro abitato Pizzo,8601,00,7459,1142,6920,1681,8601,0
2019/03,401,15/03/2019,5,SP 513R fra Traversetolo e confine provinciale,7857,20,7212,643,6248,1609,7857,0
2019/03,401,16/03/2019,6,SP 513R fra Traversetolo e confine provinciale,6881,10,6686,194,5202,1679,0,6881
2019/03,401,17/03/2019,7,SP 513R fra Traversetolo e confine provinciale,7452,20,7397,53,6124,1328,0,7452
2019/03,401,18/03/2019,1,SP 513R fra Traversetolo e confine provinciale,7132,10,6416,715,5851,1281,7132,0
2019/03,401,19/03/2019,2,SP 513R fra Traversetolo e confine provinciale,7372,00,6724,648,5936,1436,7372,0
2019/03,401,20/03/2019,3,SP 513R fra Traversetolo e confine provinciale,7575,30,6946,626,6131,1444,7575,0
2019/03,401,21/03/2019,4,SP 513R fra Traversetolo e confine provinciale,7598,30,6975,620,6160,1438,7598,0
2019/03,401,22/03/2019,5,SP 513R fra Traversetolo e confine provinciale,7762,10,7117,644,6148,1614,7762,0
2019/03,401,23/03/2019,6,SP 513R fra Traversetolo e confine provinciale,6553,40,6400,149,4985,1568,0,6553
2019/03,401,24/03/2019,7,SP 513R fra Traversetolo e confine provinciale,8086,20,8031,53,6615,1471,0,8086
2019/03,401,25/03/2019,1,SP 513R fra Traversetolo e confine provinciale,7262,10,6583,678,5916,1346,7262,0
2019/03,401,26/03/2019,2,SP 513R fra Traversetolo e confine provinciale,7342,10,6706,635,5987,1355,7342,0
2019/03,401,27/03/2019,3,SP 513R fra Traversetolo e confine provinciale,7625,30,6975,647,6100,1525,7625,0
2019/03,401,28/03/2019,4,SP 513R fra Traversetolo e confine provinciale,7690,10,7017,672,6167,1523,7690,0
2019/03,402,15/03/2019,5,SP 18 da Pilastrello (bivio SP 513R) al bivio per la Pedemontana,15283,00,14925,358,11914,3369,15283,0
2019/03,402,16/03/2019,6,SP 18 da Pilastrello (bivio SP 513R) al bivio per la Pedemontana,12975,10,12846,128,9630,3345,0,12975
2019/03,402,17/03/2019,7,SP 18 da Pilastrello (bivio SP 513R) al bivio per la Pedemontana,9846,20,9815,29,7222,2624,0,9846
2019/03,402,18/03/2019,1,SP 18 da Pilastrello (bivio SP 513R) al bivio per la Pedemontana,14721,00,14352,369,12052,2669,14721,0
2019/03,402,19/03/2019,2,SP 18 da Pilastrello (bivio SP 513R) al bivio per la Pedemontana,15286,00,14923,363,12267,3019,15286,0
2019/03,402,20/03/2019,3,SP 18 da Pilastrello (bivio SP 513R) al bivio per la Pedemontana,16000,00,15560,440,12866,3134,16000,0
2019/03,402,21/03/2019,4,SP 18 da Pilastrello (bivio SP 513R) al bivio per la Pedemontana,15259,10,14890,368,12305,2954,15259,0
2019/03,402,22/03/2019,5,SP 18 da Pilastrello (bivio SP 513R) al bivio per la Pedemontana,15353,10,14989,363,11997,3356,15353,0
2019/03,402,23/03/2019,6,SP 18 da Pilastrello (bivio SP 513R) al bivio per la Pedemontana,12810,10,12709,100,9698,3112,0,12810
2019/03,402,24/03/2019,7,SP 18 da Pilastrello (bivio SP 513R) al bivio per la Pedemontana,9524,00,9483,41,6969,2555,0,9524
2019/03,402,25/03/2019,1,SP 18 da Pilastrello (bivio SP 513R) al bivio per la Pedemontana,14375,00,14041,334,11568,2807,14375,0
2019/03,402,26/03/2019,2,SP 18 da Pilastrello (bivio SP 513R) al bivio per la Pedemontana,14857,00,14502,355,11845,3012,14857,0
2019/03,402,27/03/2019,3,SP 18 da Pilastrello (bivio SP 513R) al bivio per la Pedemontana,14897,00,14508,389,12037,2860,14897,0
2019/03,402,28/03/2019,4,SP 18 da Pilastrello (bivio SP 513R) al bivio per la Pedemontana,15646,00,15185,461,12584,3062,15646,0
2019/03,403,15/03/2019,5,SP 72 tra Parma e Mezzani,8716,00,8012,704,7059,1657,8716,0
2019/03,403,16/03/2019,6,SP 72 tra Parma e Mezzani,5876,00,5798,78,4291,1585,0,5876
2019/03,403,17/03/2019,7,SP 72 tra Parma e Mezzani,4580,00,4555,25,3444,1136,0,4580
2019/03,403,18/03/2019,1,SP 72 tra Parma e Mezzani,8386,00,7779,607,6961,1425,8386,0
2019/03,403,19/03/2019,2,SP 72 tra Parma e Mezzani,8854,00,8202,652,7303,1551,8854,0
2019/03,403,20/03/2019,3,SP 72 tra Parma e Mezzani,8831,00,8212,619,7258,1573,8831,0
2019/03,403,21/03/2019,4,SP 72 tra Parma e Mezzani,8742,00,8075,667,7155,1587,8742,0
2019/03,403,22/03/2019,5,SP 72 tra Parma e Mezzani,8598,00,7946,652,6904,1694,8598,0
2019/03,403,23/03/2019,6,SP 72 tra Parma e Mezzani,5931,00,5844,87,4306,1625,0,5931
2019/03,403,24/03/2019,7,SP 72 tra Parma e Mezzani,4767,00,4738,29,3421,1346,0,4767
2019/03,403,25/03/2019,1,SP 72 tra Parma e Mezzani,8596,00,7938,658,7128,1468,8596,0
2019/03,403,26/03/2019,2,SP 72 tra Parma e Mezzani,8531,20,7817,712,6945,1586,8531,0
2019/03,403,27/03/2019,3,SP 72 tra Parma e Mezzani,9009,10,8325,683,7366,1643,9009,0
2019/03,403,28/03/2019,4,SP 72 tra Parma e Mezzani,9515,20,8835,678,7831,1684,9515,0
2019/03,404,15/03/2019,5,exSP 32 (via Dante Alighieri) da Felino a Pilastro,7711,20,7474,235,5986,1725,7711,0
2019/03,404,16/03/2019,6,exSP 32 (via Dante Alighieri) da Felino a Pilastro,6715,30,6633,79,4953,1762,0,6715
2019/03,404,17/03/2019,7,exSP 32 (via Dante Alighieri) da Felino a Pilastro,5270,10,5244,25,3974,1296,0,5270
2019/03,404,18/03/2019,1,exSP 32 (via Dante Alighieri) da Felino a Pilastro,7136,20,6962,172,5797,1339,7136,0
2019/03,404,19/03/2019,2,exSP 32 (via Dante Alighieri) da Felino a Pilastro,7546,20,7333,211,6008,1538,7546,0
2019/03,404,20/03/2019,3,exSP 32 (via Dante Alighieri) da Felino a Pilastro,7363,20,7145,216,5846,1517,7363,0
2019/03,404,21/03/2019,4,exSP 32 (via Dante Alighieri) da Felino a Pilastro,7630,10,7428,201,5960,1670,7630,0
2019/03,404,22/03/2019,5,exSP 32 (via Dante Alighieri) da Felino a Pilastro,7597,10,7387,209,5939,1658,7597,0
2019/03,404,23/03/2019,6,exSP 32 (via Dante Alighieri) da Felino a Pilastro,6789,20,6706,81,5066,1723,0,6789
2019/03,404,24/03/2019,7,exSP 32 (via Dante Alighieri) da Felino a Pilastro,5426,50,5390,31,4000,1426,0,5426
2019/03,404,25/03/2019,1,exSP 32 (via Dante Alighieri) da Felino a Pilastro,7245,10,7062,182,5755,1490,7245,0
2019/03,404,26/03/2019,2,exSP 32 (via Dante Alighieri) da Felino a Pilastro,7468,20,7246,220,5969,1499,7468,0
2019/03,404,27/03/2019,3,exSP 32 (via Dante Alighieri) da Felino a Pilastro,7348,20,7155,191,5807,1541,7348,0
2019/03,404,28/03/2019,4,exSP 32 (via Dante Alighieri) da Felino a Pilastro,7516,60,7302,208,5925,1591,7516,0
2019/03,405,15/03/2019,5,SP 15 fra SS62 e Sala Baganza,11375,00,10567,808,9059,2316,11375,0
2019/03,405,16/03/2019,6,SP 15 fra SS62 e Sala Baganza,9081,00,8903,178,6597,2484,0,9081
2019/03,405,17/03/2019,7,SP 15 fra SS62 e Sala Baganza,6531,00,6504,27,4782,1749,0,6531
2019/03,405,18/03/2019,1,SP 15 fra SS62 e Sala Baganza,10861,00,10095,766,8850,2011,10861,0
2019/03,405,19/03/2019,2,SP 15 fra SS62 e Sala Baganza,10970,00,10178,792,8790,2180,10970,0
2019/03,405,20/03/2019,3,SP 15 fra SS62 e Sala Baganza,11155,00,10279,876,8956,2199,11155,0
2019/03,405,21/03/2019,4,SP 15 fra SS62 e Sala Baganza,11210,00,10289,921,8967,2243,11210,0
2019/03,405,22/03/2019,5,SP 15 fra SS62 e Sala Baganza,11158,00,10352,806,8657,2501,11158,0
2019/03,405,23/03/2019,6,SP 15 fra SS62 e Sala Baganza,9463,00,9276,187,6906,2557,0,9463
2019/03,405,24/03/2019,7,SP 15 fra SS62 e Sala Baganza,7119,00,7087,32,5107,2012,0,7119
2019/03,405,25/03/2019,1,SP 15 fra SS62 e Sala Baganza,11052,00,10228,824,9033,2019,11052,0
2019/03,405,26/03/2019,2,SP 15 fra SS62 e Sala Baganza,11382,00,10540,842,9158,2224,11382,0
2019/03,405,27/03/2019,3,SP 15 fra SS62 e Sala Baganza,11480,00,10672,808,9116,2364,11480,0
2019/03,405,28/03/2019,4,SP 15 fra SS62 e Sala Baganza,11217,00,10337,880,8851,2366,11217,0
2019/03,410,15/03/2019,5,SP 54 fra Pomposa e Codigoro,4943,00,4631,312,3883,1060,4943,0
2019/03,410,16/03/2019,6,SP 54 fra Pomposa e Codigoro,4300,00,4206,94,3185,1115,0,4300
2019/03,410,17/03/2019,7,SP 54 fra Pomposa e Codigoro,3874,00,3852,22,2824,1050,0,3874
2019/03,410,18/03/2019,1,SP 54 fra Pomposa e Codigoro,4262,00,4004,258,3454,808,4262,0
2019/03,410,19/03/2019,2,SP 54 fra Pomposa e Codigoro,4318,00,4056,262,3474,844,4318,0
2019/03,410,20/03/2019,3,SP 54 fra Pomposa e Codigoro,4014,00,3728,286,3164,850,4014,0
2019/03,410,21/03/2019,4,SP 54 fra Pomposa e Codigoro,4717,00,4477,240,3788,929,4717,0
2019/03,410,22/03/2019,5,SP 54 fra Pomposa e Codigoro,5007,00,4702,305,3937,1070,5007,0
2019/03,410,23/03/2019,6,SP 54 fra Pomposa e Codigoro,4662,00,4552,110,3423,1239,0,4662
2019/03,410,24/03/2019,7,SP 54 fra Pomposa e Codigoro,4621,00,4606,15,3566,1055,0,4621
2019/03,410,25/03/2019,1,SP 54 fra Pomposa e Codigoro,4391,00,4133,258,3582,809,4391,0
2019/03,410,26/03/2019,2,SP 54 fra Pomposa e Codigoro,4659,10,4376,282,3838,821,4659,0
2019/03,410,27/03/2019,3,SP 54 fra Pomposa e Codigoro,4671,00,4372,299,3805,866,4671,0
2019/03,410,28/03/2019,4,SP 54 fra Pomposa e Codigoro,4916,00,4624,292,3950,966,4916,0
2019/03,411,15/03/2019,5,SP 53 fra Codigoro e Marozzo,5561,00,5453,108,4410,1151,5561,0
2019/03,411,16/03/2019,6,SP 53 fra Codigoro e Marozzo,4344,00,4309,35,3335,1009,0,4344
2019/03,411,17/03/2019,7,SP 53 fra Codigoro e Marozzo,3330,00,3321,9,2415,915,0,3330
2019/03,411,18/03/2019,1,SP 53 fra Codigoro e Marozzo,5357,00,5268,89,4428,929,5357,0
2019/03,411,19/03/2019,2,SP 53 fra Codigoro e Marozzo,5542,00,5436,106,4560,982,5542,0
2019/03,411,20/03/2019,3,SP 53 fra Codigoro e Marozzo,5383,00,5271,112,4388,995,5383,0
2019/03,411,21/03/2019,4,SP 53 fra Codigoro e Marozzo,5384,00,5281,103,4355,1029,5384,0
2019/03,411,22/03/2019,5,SP 53 fra Codigoro e Marozzo,5470,00,5349,121,4353,1117,5470,0
2019/03,411,23/03/2019,6,SP 53 fra Codigoro e Marozzo,4395,00,4336,59,3330,1065,0,4395
2019/03,411,24/03/2019,7,SP 53 fra Codigoro e Marozzo,3353,10,3339,13,2449,904,0,3353
2019/03,411,25/03/2019,1,SP 53 fra Codigoro e Marozzo,5328,00,5222,106,4361,967,5328,0
2019/03,411,26/03/2019,2,SP 53 fra Codigoro e Marozzo,5482,00,5369,113,4448,1034,5482,0
2019/03,411,27/03/2019,3,SP 53 fra Codigoro e Marozzo,5437,00,5329,108,4446,991,5437,0
2019/03,411,28/03/2019,4,SP 53 fra Codigoro e Marozzo,5508,00,5402,106,4438,1070,5508,0
2019/03,425,15/03/2019,5,SS 67 tra Dovadola e Rocca San Casciano,3798,10,3556,241,3003,795,3798,0
2019/03,425,16/03/2019,6,SS 67 tra Dovadola e Rocca San Casciano,3626,00,3545,81,2815,811,0,3626
2019/03,425,17/03/2019,7,SS 67 tra Dovadola e Rocca San Casciano,3460,00,3447,13,2856,604,0,3460
2019/03,425,18/03/2019,1,SS 67 tra Dovadola e Rocca San Casciano,3423,00,3225,198,2752,671,3423,0
2019/03,425,19/03/2019,2,SS 67 tra Dovadola e Rocca San Casciano,3304,00,3113,191,2660,644,3304,0
2019/03,425,20/03/2019,3,SS 67 tra Dovadola e Rocca San Casciano,3425,00,3243,182,2718,707,3425,0
2019/03,425,21/03/2019,4,SS 67 tra Dovadola e Rocca San Casciano,3602,00,3385,217,2878,724,3602,0
2019/03,425,22/03/2019,5,SS 67 tra Dovadola e Rocca San Casciano,3777,00,3554,223,2917,860,3777,0
2019/03,425,23/03/2019,6,SS 67 tra Dovadola e Rocca San Casciano,3683,10,3595,87,2810,873,0,3683
2019/03,425,24/03/2019,7,SS 67 tra Dovadola e Rocca San Casciano,3543,00,3513,30,2848,695,0,3543
2019/03,425,25/03/2019,1,SS 67 tra Dovadola e Rocca San Casciano,3539,00,3337,202,2811,728,3539,0
2019/03,425,26/03/2019,2,SS 67 tra Dovadola e Rocca San Casciano,3485,00,3253,232,2831,654,3485,0
2019/03,425,27/03/2019,3,SS 67 tra Dovadola e Rocca San Casciano,3595,00,3412,183,2860,735,3595,0
2019/03,425,28/03/2019,4,SS 67 tra Dovadola e Rocca San Casciano,3622,00,3426,196,2874,748,3622,0
2019/03,426,15/03/2019,5,SS 63 tra Casina e Vezzano sul Crostolo,15773,20,15225,546,11875,3898,15773,0
2019/03,426,16/03/2019,6,SS 63 tra Casina e Vezzano sul Crostolo,15674,00,15434,240,11503,4171,0,15674
2019/03,426,17/03/2019,7,SS 63 tra Casina e Vezzano sul Crostolo,14055,10,13979,75,10632,3423,0,14055
2019/03,426,18/03/2019,1,SS 63 tra Casina e Vezzano sul Crostolo,14313,00,13829,484,11190,3123,14313,0
2019/03,426,19/03/2019,2,SS 63 tra Casina e Vezzano sul Crostolo,14522,10,14008,513,11202,3320,14522,0
2019/03,426,20/03/2019,3,SS 63 tra Casina e Vezzano sul Crostolo,14935,00,14419,516,11508,3427,14935,0
2019/03,426,21/03/2019,4,SS 63 tra Casina e Vezzano sul Crostolo,14961,00,14474,487,11300,3661,14961,0
2019/03,426,22/03/2019,5,SS 63 tra Casina e Vezzano sul Crostolo,15605,10,15075,529,11687,3918,15605,0
2019/03,426,23/03/2019,6,SS 63 tra Casina e Vezzano sul Crostolo,15186,00,14992,194,11150,4036,0,15186
2019/03,426,24/03/2019,7,SS 63 tra Casina e Vezzano sul Crostolo,14815,00,14741,74,11067,3748,0,14815
2019/03,426,25/03/2019,1,SS 63 tra Casina e Vezzano sul Crostolo,14421,00,13923,498,11143,3278,14421,0
2019/03,426,26/03/2019,2,SS 63 tra Casina e Vezzano sul Crostolo,14741,00,14236,505,11419,3322,14741,0
2019/03,426,27/03/2019,3,SS 63 tra Casina e Vezzano sul Crostolo,15022,10,14487,534,11834,3188,15022,0
2019/03,426,28/03/2019,4,SS 63 tra Casina e Vezzano sul Crostolo,14956,00,14416,540,11290,3666,14956,0
2019/03,428,15/03/2019,5,SP 19 fra Colombaia (bivio SP 76) e il Bivio SP 486R al confine provinciale,4080,00,3616,464,3090,990,4080,0
2019/03,428,16/03/2019,6,SP 19 fra Colombaia (bivio SP 76) e il Bivio SP 486R al confine provinciale,3666,00,3606,60,2828,838,0,3666
2019/03,428,17/03/2019,7,SP 19 fra Colombaia (bivio SP 76) e il Bivio SP 486R al confine provinciale,3600,00,3577,23,2796,804,0,3600
2019/03,428,18/03/2019,1,SP 19 fra Colombaia (bivio SP 76) e il Bivio SP 486R al confine provinciale,3707,00,3282,425,2897,810,3707,0
2019/03,428,19/03/2019,2,SP 19 fra Colombaia (bivio SP 76) e il Bivio SP 486R al confine provinciale,3658,00,3244,414,2812,846,3658,0
2019/03,428,20/03/2019,3,SP 19 fra Colombaia (bivio SP 76) e il Bivio SP 486R al confine provinciale,3638,00,3266,372,2770,868,3638,0
2019/03,428,21/03/2019,4,SP 19 fra Colombaia (bivio SP 76) e il Bivio SP 486R al confine provinciale,3845,00,3383,462,3010,835,3845,0
2019/03,428,22/03/2019,5,SP 19 fra Colombaia (bivio SP 76) e il Bivio SP 486R al confine provinciale,4128,00,3638,490,3154,974,4128,0
2019/03,428,23/03/2019,6,SP 19 fra Colombaia (bivio SP 76) e il Bivio SP 486R al confine provinciale,3538,00,3492,46,2632,906,0,3538
2019/03,428,25/03/2019,1,SP 19 fra Colombaia (bivio SP 76) e il Bivio SP 486R al confine provinciale,3687,00,3273,414,2839,848,3687,0
2019/03,428,26/03/2019,2,SP 19 fra Colombaia (bivio SP 76) e il Bivio SP 486R al confine provinciale,3747,00,3321,426,2916,831,3747,0
2019/03,428,27/03/2019,3,SP 19 fra Colombaia (bivio SP 76) e il Bivio SP 486R al confine provinciale,3730,00,3335,395,2857,873,3730,0
2019/03,428,28/03/2019,4,SP 19 fra Colombaia (bivio SP 76) e il Bivio SP 486R al confine provinciale,4136,00,3643,493,3134,1002,4136,0
2019/03,429,15/03/2019,5,SP 12 fra San Polo d'Enza e Montecchio Emilia (variante a sud abitato),8596,10,7637,958,6788,1808,8596,0
2019/03,429,16/03/2019,6,SP 12 fra San Polo d'Enza e Montecchio Emilia (variante a sud abitato),7162,00,6922,240,5451,1711,0,7162
2019/03,429,17/03/2019,7,SP 12 fra San Polo d'Enza e Montecchio Emilia (variante a sud abitato),6019,00,5936,83,4565,1454,0,6019
2019/03,429,18/03/2019,1,SP 12 fra San Polo d'Enza e Montecchio Emilia (variante a sud abitato),8147,00,7210,937,6639,1508,8147,0
2019/03,429,19/03/2019,2,SP 12 fra San Polo d'Enza e Montecchio Emilia (variante a sud abitato),8395,10,7459,935,6822,1573,8395,0
2019/03,429,20/03/2019,3,SP 12 fra San Polo d'Enza e Montecchio Emilia (variante a sud abitato),8271,10,7319,951,6617,1654,8271,0
2019/03,429,21/03/2019,4,SP 12 fra San Polo d'Enza e Montecchio Emilia (variante a sud abitato),8317,00,7449,868,6680,1637,8317,0
2019/03,429,22/03/2019,5,SP 12 fra San Polo d'Enza e Montecchio Emilia (variante a sud abitato),8449,00,7595,854,6623,1826,8449,0
2019/03,429,23/03/2019,6,SP 12 fra San Polo d'Enza e Montecchio Emilia (variante a sud abitato),7366,10,7132,233,5469,1897,0,7366
2019/03,429,24/03/2019,7,SP 12 fra San Polo d'Enza e Montecchio Emilia (variante a sud abitato),6327,00,6209,118,4782,1545,0,6327
2019/03,429,25/03/2019,1,SP 12 fra San Polo d'Enza e Montecchio Emilia (variante a sud abitato),8269,00,7365,904,6708,1561,8269,0
2019/03,429,26/03/2019,2,SP 12 fra San Polo d'Enza e Montecchio Emilia (variante a sud abitato),8086,00,7299,787,6500,1586,8086,0
2019/03,429,27/03/2019,3,SP 12 fra San Polo d'Enza e Montecchio Emilia (variante a sud abitato),8397,00,7422,975,6688,1709,8397,0
2019/03,429,28/03/2019,4,SP 12 fra San Polo d'Enza e Montecchio Emilia (variante a sud abitato),8414,10,7463,950,6700,1714,8414,0
2019/03,430,19/03/2019,2,SP 28 tra Montecchio Emilia e bivio circonvallazione,11424,00,10749,675,9311,2113,11424,0
2019/03,430,20/03/2019,3,SP 28 tra Montecchio Emilia e bivio circonvallazione,11678,00,10943,735,9531,2147,11678,0
2019/03,430,21/03/2019,4,SP 28 tra Montecchio Emilia e bivio circonvallazione,11492,00,10853,639,9267,2225,11492,0
2019/03,430,22/03/2019,5,SP 28 tra Montecchio Emilia e bivio circonvallazione,11690,00,11046,644,9246,2444,11690,0
2019/03,430,23/03/2019,6,SP 28 tra Montecchio Emilia e bivio circonvallazione,8695,00,8527,168,6296,2399,0,8695
2019/03,430,24/03/2019,7,SP 28 tra Montecchio Emilia e bivio circonvallazione,7021,00,6963,58,5152,1869,0,7021
2019/03,430,25/03/2019,1,SP 28 tra Montecchio Emilia e bivio circonvallazione,11062,00,10432,630,9213,1849,11062,0
2019/03,430,26/03/2019,2,SP 28 tra Montecchio Emilia e bivio circonvallazione,11497,10,10724,772,9529,1968,11497,0
2019/03,430,27/03/2019,3,SP 28 tra Montecchio Emilia e bivio circonvallazione,11273,00,10573,700,9170,2103,11273,0
2019/03,430,28/03/2019,4,SP 28 tra Montecchio Emilia e bivio circonvallazione,11428,00,10760,668,9230,2198,11428,0
2019/03,431,15/03/2019,5,SP 12 fra Sant'Ilario d'Enza (variante a sud) e Montecchio Emilia,7106,00,6787,319,5588,1518,7106,0
2019/03,431,16/03/2019,6,SP 12 fra Sant'Ilario d'Enza (variante a sud) e Montecchio Emilia,6129,00,6044,85,4606,1523,0,6129
2019/03,431,17/03/2019,7,SP 12 fra Sant'Ilario d'Enza (variante a sud) e Montecchio Emilia,4274,00,4262,12,3121,1153,0,4274
2019/03,431,18/03/2019,1,SP 12 fra Sant'Ilario d'Enza (variante a sud) e Montecchio Emilia,6798,00,6573,225,5571,1227,6798,0
2019/03,431,19/03/2019,2,SP 12 fra Sant'Ilario d'Enza (variante a sud) e Montecchio Emilia,7059,00,6740,319,5638,1421,7059,0
2019/03,431,20/03/2019,3,SP 12 fra Sant'Ilario d'Enza (variante a sud) e Montecchio Emilia,7327,00,6987,340,5862,1465,7327,0
2019/03,431,21/03/2019,4,SP 12 fra Sant'Ilario d'Enza (variante a sud) e Montecchio Emilia,6959,00,6621,338,5575,1384,6959,0
2019/03,431,22/03/2019,5,SP 12 fra Sant'Ilario d'Enza (variante a sud) e Montecchio Emilia,7092,00,6776,316,5578,1514,7092,0
2019/03,431,23/03/2019,6,SP 12 fra Sant'Ilario d'Enza (variante a sud) e Montecchio Emilia,6200,00,6121,79,4705,1495,0,6200
2019/03,431,24/03/2019,7,SP 12 fra Sant'Ilario d'Enza (variante a sud) e Montecchio Emilia,4636,00,4620,16,3423,1213,0,4636
2019/03,431,25/03/2019,1,SP 12 fra Sant'Ilario d'Enza (variante a sud) e Montecchio Emilia,6772,00,6456,316,5486,1286,6772,0
2019/03,431,26/03/2019,2,SP 12 fra Sant'Ilario d'Enza (variante a sud) e Montecchio Emilia,6819,00,6500,319,5507,1312,6819,0
2019/03,431,27/03/2019,3,SP 12 fra Sant'Ilario d'Enza (variante a sud) e Montecchio Emilia,7031,00,6716,315,5662,1369,7031,0
2019/03,431,28/03/2019,4,SP 12 fra Sant'Ilario d'Enza (variante a sud) e Montecchio Emilia,7139,00,6819,320,5737,1402,7139,0
2019/03,432,15/03/2019,5,SP 67 fra Calerno e Montecchio Emilia,11506,00,10025,1481,9062,2444,11506,0
2019/03,432,16/03/2019,6,SP 67 fra Calerno e Montecchio Emilia,8123,00,7896,227,5958,2165,0,8123
2019/03,432,17/03/2019,7,SP 67 fra Calerno e Montecchio Emilia,6960,00,6846,114,5042,1918,0,6960
2019/03,432,18/03/2019,1,SP 67 fra Calerno e Montecchio Emilia,10567,00,9256,1311,8553,2014,10567,0
2019/03,432,19/03/2019,2,SP 67 fra Calerno e Montecchio Emilia,10802,10,9410,1391,8717,2085,10802,0
2019/03,432,20/03/2019,3,SP 67 fra Calerno e Montecchio Emilia,10994,10,9578,1415,8842,2152,10994,0
2019/03,432,21/03/2019,4,SP 67 fra Calerno e Montecchio Emilia,10997,00,9647,1350,8829,2168,10997,0
2019/03,432,22/03/2019,5,SP 67 fra Calerno e Montecchio Emilia,11513,00,10144,1369,9110,2403,11513,0
2019/03,432,23/03/2019,6,SP 67 fra Calerno e Montecchio Emilia,8120,00,7843,277,5932,2188,0,8120
2019/03,432,24/03/2019,7,SP 67 fra Calerno e Montecchio Emilia,7447,00,7329,118,5421,2026,0,7447
2019/03,432,25/03/2019,1,SP 67 fra Calerno e Montecchio Emilia,10589,10,9262,1326,8578,2011,10589,0
2019/03,432,26/03/2019,2,SP 67 fra Calerno e Montecchio Emilia,10838,00,9528,1310,8766,2072,10838,0
2019/03,432,27/03/2019,3,SP 67 fra Calerno e Montecchio Emilia,11077,20,9702,1373,8875,2202,11077,0
2019/03,432,28/03/2019,4,SP 67 fra Calerno e Montecchio Emilia,11230,10,9909,1320,8966,2264,11230,0
2019/03,434,15/03/2019,5,Via San Nicola (ex SP 39) tra bivio per Taneto a Caprara,3643,00,3564,79,2839,804,3643,0
2019/03,434,16/03/2019,6,Via San Nicola (ex SP 39) tra bivio per Taneto a Caprara,3140,00,3102,38,2321,819,0,3140
2019/03,434,17/03/2019,7,Via San Nicola (ex SP 39) tra bivio per Taneto a Caprara,2569,00,2558,11,1852,717,0,2569
2019/03,434,18/03/2019,1,Via San Nicola (ex SP 39) tra bivio per Taneto a Caprara,3333,10,3254,78,2674,659,3333,0
2019/03,434,19/03/2019,2,Via San Nicola (ex SP 39) tra bivio per Taneto a Caprara,3460,00,3369,91,2737,723,3460,0
2019/03,434,20/03/2019,3,Via San Nicola (ex SP 39) tra bivio per Taneto a Caprara,3260,10,3170,89,2546,714,3260,0
2019/03,434,21/03/2019,4,Via San Nicola (ex SP 39) tra bivio per Taneto a Caprara,3450,00,3355,95,2724,726,3450,0
2019/03,434,22/03/2019,5,Via San Nicola (ex SP 39) tra bivio per Taneto a Caprara,3571,20,3478,91,2741,830,3571,0
2019/03,434,23/03/2019,6,Via San Nicola (ex SP 39) tra bivio per Taneto a Caprara,3124,00,3089,35,2294,830,0,3124
2019/03,434,24/03/2019,7,Via San Nicola (ex SP 39) tra bivio per Taneto a Caprara,2210,00,2196,14,1519,691,0,2210
2019/03,434,25/03/2019,1,Via San Nicola (ex SP 39) tra bivio per Taneto a Caprara,3395,00,3318,77,2719,676,3395,0
2019/03,434,26/03/2019,2,Via San Nicola (ex SP 39) tra bivio per Taneto a Caprara,3444,00,3369,75,2736,708,3444,0
2019/03,434,27/03/2019,3,Via San Nicola (ex SP 39) tra bivio per Taneto a Caprara,3572,00,3499,73,2816,756,3572,0
2019/03,434,28/03/2019,4,Via San Nicola (ex SP 39) tra bivio per Taneto a Caprara,3621,00,3543,78,2843,778,3621,0
2019/03,435,15/03/2019,5,SP 37Bis dalla località Selbagnone al bivio SP 72 (Meldola),7982,20,7522,458,6132,1850,7982,0
2019/03,435,16/03/2019,6,SP 37Bis dalla località Selbagnone al bivio SP 72 (Meldola),6989,40,6819,166,5119,1870,0,6989
2019/03,435,17/03/2019,7,SP 37Bis dalla località Selbagnone al bivio SP 72 (Meldola),6233,00,6216,17,4808,1425,0,6233
2019/03,435,18/03/2019,1,SP 37Bis dalla località Selbagnone al bivio SP 72 (Meldola),7228,60,6802,420,5802,1426,7228,0
2019/03,435,19/03/2019,2,SP 37Bis dalla località Selbagnone al bivio SP 72 (Meldola),7520,40,7128,388,5872,1648,7520,0
2019/03,435,20/03/2019,3,SP 37Bis dalla località Selbagnone al bivio SP 72 (Meldola),7689,40,7224,461,6010,1679,7689,0
2019/03,435,21/03/2019,4,SP 37Bis dalla località Selbagnone al bivio SP 72 (Meldola),7847,90,7392,446,6130,1717,7847,0
2019/03,435,22/03/2019,5,SP 37Bis dalla località Selbagnone al bivio SP 72 (Meldola),8127,80,7614,505,6220,1907,8127,0
2019/03,435,23/03/2019,6,SP 37Bis dalla località Selbagnone al bivio SP 72 (Meldola),7432,40,7265,163,5247,2185,0,7432
2019/03,435,24/03/2019,7,SP 37Bis dalla località Selbagnone al bivio SP 72 (Meldola),7155,20,7114,39,5300,1855,0,7155
2019/03,435,25/03/2019,1,SP 37Bis dalla località Selbagnone al bivio SP 72 (Meldola),7506,70,7037,462,5930,1576,7506,0
2019/03,435,26/03/2019,2,SP 37Bis dalla località Selbagnone al bivio SP 72 (Meldola),7688,40,7156,528,6017,1671,7688,0
2019/03,435,27/03/2019,3,SP 37Bis dalla località Selbagnone al bivio SP 72 (Meldola),7739,70,7297,435,5990,1749,7739,0
2019/03,435,28/03/2019,4,SP 37Bis dalla località Selbagnone al bivio SP 72 (Meldola),7942,40,7458,480,6260,1682,7942,0
2019/03,436,15/03/2019,5,SP 26 da Santa Sofia a San Piero in Bagno,931,00,887,44,711,220,931,0
2019/03,436,16/03/2019,6,SP 26 da Santa Sofia a San Piero in Bagno,883,00,862,21,654,229,0,883
2019/03,436,17/03/2019,7,SP 26 da Santa Sofia a San Piero in Bagno,1007,00,1003,4,776,231,0,1007
2019/03,436,18/03/2019,1,SP 26 da Santa Sofia a San Piero in Bagno,780,00,749,31,628,152,780,0
2019/03,436,19/03/2019,2,SP 26 da Santa Sofia a San Piero in Bagno,821,00,784,37,658,163,821,0
2019/03,436,20/03/2019,3,SP 26 da Santa Sofia a San Piero in Bagno,929,10,883,45,767,162,929,0
2019/03,436,21/03/2019,4,SP 26 da Santa Sofia a San Piero in Bagno,910,10,879,30,719,191,910,0
2019/03,436,22/03/2019,5,SP 26 da Santa Sofia a San Piero in Bagno,924,00,883,41,707,217,924,0
2019/03,436,23/03/2019,6,SP 26 da Santa Sofia a San Piero in Bagno,1005,00,984,21,721,284,0,1005
2019/03,436,24/03/2019,7,SP 26 da Santa Sofia a San Piero in Bagno,1083,00,1080,3,818,265,0,1083
2019/03,436,25/03/2019,1,SP 26 da Santa Sofia a San Piero in Bagno,909,00,856,53,732,177,909,0
2019/03,436,26/03/2019,2,SP 26 da Santa Sofia a San Piero in Bagno,777,00,738,39,609,168,777,0
2019/03,436,27/03/2019,3,SP 26 da Santa Sofia a San Piero in Bagno,957,00,912,45,765,192,957,0
2019/03,436,28/03/2019,4,SP 26 da Santa Sofia a San Piero in Bagno,875,10,818,56,696,179,875,0
2019/03,437,15/03/2019,5,SP 13 tra SS 9 (Santarcangelo di Romagna) e SP 92 (località Camerano),7433,00,6329,1104,5919,1514,7433,0
2019/03,437,16/03/2019,6,SP 13 tra SS 9 (Santarcangelo di Romagna) e SP 92 (località Camerano),6011,00,5713,298,4462,1549,0,6011
2019/03,437,17/03/2019,7,SP 13 tra SS 9 (Santarcangelo di Romagna) e SP 92 (località Camerano),5124,00,5078,46,3834,1290,0,5124
2019/03,437,18/03/2019,1,SP 13 tra SS 9 (Santarcangelo di Romagna) e SP 92 (località Camerano),7146,00,6026,1120,5830,1316,7146,0
2019/03,437,19/03/2019,2,SP 13 tra SS 9 (Santarcangelo di Romagna) e SP 92 (località Camerano),7176,00,6087,1089,5808,1368,7176,0
2019/03,437,20/03/2019,3,SP 13 tra SS 9 (Santarcangelo di Romagna) e SP 92 (località Camerano),7301,20,6192,1107,5871,1430,7301,0
2019/03,437,21/03/2019,4,SP 13 tra SS 9 (Santarcangelo di Romagna) e SP 92 (località Camerano),7446,10,6243,1202,5961,1485,7446,0
2019/03,437,22/03/2019,5,SP 13 tra SS 9 (Santarcangelo di Romagna) e SP 92 (località Camerano),8039,20,6880,1157,6398,1641,8039,0
2019/03,437,23/03/2019,6,SP 13 tra SS 9 (Santarcangelo di Romagna) e SP 92 (località Camerano),5966,00,5745,221,4473,1493,0,5966
2019/03,437,24/03/2019,7,SP 13 tra SS 9 (Santarcangelo di Romagna) e SP 92 (località Camerano),4940,00,4905,35,3627,1313,0,4940
2019/03,437,25/03/2019,1,SP 13 tra SS 9 (Santarcangelo di Romagna) e SP 92 (località Camerano),7161,00,6146,1015,5821,1340,7161,0
2019/03,437,26/03/2019,2,SP 13 tra SS 9 (Santarcangelo di Romagna) e SP 92 (località Camerano),7089,00,6037,1052,5757,1332,7089,0
2019/03,437,27/03/2019,3,SP 13 tra SS 9 (Santarcangelo di Romagna) e SP 92 (località Camerano),7010,00,6003,1007,5658,1352,7010,0
2019/03,437,28/03/2019,4,SP 13 tra SS 9 (Santarcangelo di Romagna) e SP 92 (località Camerano),7101,10,6029,1071,5590,1511,7101,0
2019/03,438,15/03/2019,5,SP 14 tra Colombare (bivio SP 14Ter) e bivio SP 258R,8971,20,8227,742,7055,1916,8971,0
2019/03,438,16/03/2019,6,SP 14 tra Colombare (bivio SP 14Ter) e bivio SP 258R,7244,20,7076,166,5378,1866,0,7244
2019/03,438,17/03/2019,7,SP 14 tra Colombare (bivio SP 14Ter) e bivio SP 258R,6851,00,6823,28,5243,1608,0,6851
2019/03,438,18/03/2019,1,SP 14 tra Colombare (bivio SP 14Ter) e bivio SP 258R,8183,00,7398,785,6733,1450,8183,0
2019/03,438,19/03/2019,2,SP 14 tra Colombare (bivio SP 14Ter) e bivio SP 258R,8288,10,7545,742,6722,1566,8288,0
2019/03,438,20/03/2019,3,SP 14 tra Colombare (bivio SP 14Ter) e bivio SP 258R,7276,10,6558,717,5653,1623,7276,0
2019/03,438,21/03/2019,4,SP 14 tra Colombare (bivio SP 14Ter) e bivio SP 258R,8427,00,7644,783,6797,1630,8427,0
2019/03,438,22/03/2019,5,SP 14 tra Colombare (bivio SP 14Ter) e bivio SP 258R,8722,30,7950,769,6856,1866,8722,0
2019/03,438,23/03/2019,6,SP 14 tra Colombare (bivio SP 14Ter) e bivio SP 258R,7048,00,6896,152,5265,1783,0,7048
2019/03,438,24/03/2019,7,SP 14 tra Colombare (bivio SP 14Ter) e bivio SP 258R,6639,10,6606,32,5105,1534,0,6639
2019/03,438,25/03/2019,1,SP 14 tra Colombare (bivio SP 14Ter) e bivio SP 258R,7863,10,7327,535,6372,1491,7863,0
2019/03,438,26/03/2019,2,SP 14 tra Colombare (bivio SP 14Ter) e bivio SP 258R,7910,00,7178,732,6461,1449,7910,0
2019/03,438,27/03/2019,3,SP 14 tra Colombare (bivio SP 14Ter) e bivio SP 258R,8204,00,7502,702,6600,1604,8204,0
2019/03,438,28/03/2019,4,SP 14 tra Colombare (bivio SP 14Ter) e bivio SP 258R,8548,20,7768,778,6792,1756,8548,0
2019/03,439,15/03/2019,5,SP 49 da Santarcangelo di Romagna alla località Posta (bivio SP 258R),13440,20,12504,934,10455,2985,13440,0
2019/03,439,16/03/2019,6,SP 49 da Santarcangelo di Romagna alla località Posta (bivio SP 258R),11387,00,11149,238,8312,3075,0,11387
2019/03,439,17/03/2019,7,SP 49 da Santarcangelo di Romagna alla località Posta (bivio SP 258R),9840,00,9805,35,7148,2692,0,9840
2019/03,439,18/03/2019,1,SP 49 da Santarcangelo di Romagna alla località Posta (bivio SP 258R),12036,00,11148,888,9709,2327,12036,0
2019/03,439,19/03/2019,2,SP 49 da Santarcangelo di Romagna alla località Posta (bivio SP 258R),12662,00,11793,869,10102,2560,12662,0
2019/03,439,20/03/2019,3,SP 49 da Santarcangelo di Romagna alla località Posta (bivio SP 258R),12950,10,11929,1020,10373,2577,12950,0
2019/03,439,21/03/2019,4,SP 49 da Santarcangelo di Romagna alla località Posta (bivio SP 258R),12590,20,11664,924,9972,2618,12590,0
2019/03,439,22/03/2019,5,SP 49 da Santarcangelo di Romagna alla località Posta (bivio SP 258R),13083,10,12143,939,10057,3026,13083,0
2019/03,439,23/03/2019,6,SP 49 da Santarcangelo di Romagna alla località Posta (bivio SP 258R),11464,30,11251,210,8184,3280,0,11464
2019/03,439,24/03/2019,7,SP 49 da Santarcangelo di Romagna alla località Posta (bivio SP 258R),9427,00,9394,33,6742,2685,0,9427
2019/03,439,25/03/2019,1,SP 49 da Santarcangelo di Romagna alla località Posta (bivio SP 258R),12100,00,11283,817,9733,2367,12100,0
2019/03,439,26/03/2019,2,SP 49 da Santarcangelo di Romagna alla località Posta (bivio SP 258R),12456,00,11585,871,9857,2599,12456,0
2019/03,439,27/03/2019,3,SP 49 da Santarcangelo di Romagna alla località Posta (bivio SP 258R),12780,20,11900,878,10090,2690,12780,0
2019/03,439,28/03/2019,4,SP 49 da Santarcangelo di Romagna alla località Posta (bivio SP 258R),12841,30,11892,946,10042,2799,12841,0
2019/03,440,15/03/2019,5,SP 35 tra bivio SP 50 (località Cella) e Sant'Andrea in Casale,14423,00,14033,390,10882,3541,14423,0
2019/03,440,16/03/2019,6,SP 35 tra bivio SP 50 (località Cella) e Sant'Andrea in Casale,13642,00,13497,145,9696,3946,0,13642
2019/03,440,17/03/2019,7,SP 35 tra bivio SP 50 (località Cella) e Sant'Andrea in Casale,11509,10,11488,20,8220,3289,0,11509
2019/03,440,18/03/2019,1,SP 35 tra bivio SP 50 (località Cella) e Sant'Andrea in Casale,12231,00,11922,309,9886,2345,12231,0
2019/03,440,19/03/2019,2,SP 35 tra bivio SP 50 (località Cella) e Sant'Andrea in Casale,12533,00,12244,289,9825,2708,12533,0
2019/03,440,20/03/2019,3,SP 35 tra bivio SP 50 (località Cella) e Sant'Andrea in Casale,12432,30,12103,326,9823,2609,12432,0
2019/03,440,21/03/2019,4,SP 35 tra bivio SP 50 (località Cella) e Sant'Andrea in Casale,12745,10,12388,356,9909,2836,12745,0
2019/03,440,22/03/2019,5,SP 35 tra bivio SP 50 (località Cella) e Sant'Andrea in Casale,13303,10,12985,317,10160,3143,13303,0
2019/03,440,23/03/2019,6,SP 35 tra bivio SP 50 (località Cella) e Sant'Andrea in Casale,12321,30,12172,146,8868,3453,0,12321
2019/03,440,24/03/2019,7,SP 35 tra bivio SP 50 (località Cella) e Sant'Andrea in Casale,10412,10,10386,25,7351,3061,0,10412
2019/03,440,25/03/2019,1,SP 35 tra bivio SP 50 (località Cella) e Sant'Andrea in Casale,12290,00,12000,290,9835,2455,12290,0
2019/03,440,26/03/2019,2,SP 35 tra bivio SP 50 (località Cella) e Sant'Andrea in Casale,12346,00,11991,355,9749,2597,12346,0
2019/03,440,27/03/2019,3,SP 35 tra bivio SP 50 (località Cella) e Sant'Andrea in Casale,12470,10,12151,318,9772,2698,12470,0
2019/03,440,28/03/2019,4,SP 35 tra bivio SP 50 (località Cella) e Sant'Andrea in Casale,12851,00,12489,362,9997,2854,12851,0
2019/03,441,15/03/2019,5,SP 58 tra San Giovanni in Marignano e il confine regionale (Marche),9723,00,9273,450,7540,2183,9723,0
2019/03,441,16/03/2019,6,SP 58 tra San Giovanni in Marignano e il confine regionale (Marche),8666,00,8546,120,6175,2491,0,8666
2019/03,441,17/03/2019,7,SP 58 tra San Giovanni in Marignano e il confine regionale (Marche),8047,00,8026,21,5778,2269,0,8047
2019/03,441,18/03/2019,1,SP 58 tra San Giovanni in Marignano e il confine regionale (Marche),8893,00,8462,431,7188,1705,8893,0
2019/03,441,19/03/2019,2,SP 58 tra San Giovanni in Marignano e il confine regionale (Marche),9011,10,8563,447,7186,1825,9011,0
2019/03,441,20/03/2019,3,SP 58 tra San Giovanni in Marignano e il confine regionale (Marche),9121,00,8610,511,7185,1936,9121,0
2019/03,441,21/03/2019,4,SP 58 tra San Giovanni in Marignano e il confine regionale (Marche),9361,00,8908,453,7355,2006,9361,0
2019/03,441,22/03/2019,5,SP 58 tra San Giovanni in Marignano e il confine regionale (Marche),9624,00,9156,468,7552,2072,9624,0
2019/03,441,23/03/2019,6,SP 58 tra San Giovanni in Marignano e il confine regionale (Marche),8318,10,8193,124,5948,2370,0,8318
2019/03,441,24/03/2019,7,SP 58 tra San Giovanni in Marignano e il confine regionale (Marche),7636,10,7604,31,5280,2356,0,7636
2019/03,441,25/03/2019,1,SP 58 tra San Giovanni in Marignano e il confine regionale (Marche),8948,00,8523,425,7062,1886,8948,0
2019/03,441,26/03/2019,2,SP 58 tra San Giovanni in Marignano e il confine regionale (Marche),8908,10,8463,444,7139,1769,8908,0
2019/03,441,27/03/2019,3,SP 58 tra San Giovanni in Marignano e il confine regionale (Marche),9272,00,8750,522,7396,1876,9272,0
2019/03,441,28/03/2019,4,SP 58 tra San Giovanni in Marignano e il confine regionale (Marche),9228,10,8813,414,7238,1990,9228,0
2019/03,442,15/03/2019,5,SP 118 tra Casemurate (bivio SP 254R) e il confine provinciale,3922,00,3554,368,2939,983,3922,0
2019/03,442,16/03/2019,6,SP 118 tra Casemurate (bivio SP 254R) e il confine provinciale,3913,10,3803,109,3011,902,0,3913
2019/03,442,17/03/2019,7,SP 118 tra Casemurate (bivio SP 254R) e il confine provinciale,3214,00,3182,32,2354,860,0,3214
2019/03,442,18/03/2019,1,SP 118 tra Casemurate (bivio SP 254R) e il confine provinciale,3597,10,3255,341,2869,728,3597,0
2019/03,442,19/03/2019,2,SP 118 tra Casemurate (bivio SP 254R) e il confine provinciale,3528,10,3219,308,2820,708,3528,0
2019/03,442,20/03/2019,3,SP 118 tra Casemurate (bivio SP 254R) e il confine provinciale,3774,00,3449,325,2983,791,3774,0
2019/03,442,21/03/2019,4,SP 118 tra Casemurate (bivio SP 254R) e il confine provinciale,3673,20,3319,352,2843,830,3673,0
2019/03,442,22/03/2019,5,SP 118 tra Casemurate (bivio SP 254R) e il confine provinciale,3745,00,3448,297,2869,876,3745,0
2019/03,442,23/03/2019,6,SP 118 tra Casemurate (bivio SP 254R) e il confine provinciale,3270,10,3164,105,2353,917,0,3270
2019/03,442,24/03/2019,7,SP 118 tra Casemurate (bivio SP 254R) e il confine provinciale,3242,00,3207,35,2399,843,0,3242
2019/03,442,25/03/2019,1,SP 118 tra Casemurate (bivio SP 254R) e il confine provinciale,3619,00,3310,309,2833,786,3619,0
2019/03,442,26/03/2019,2,SP 118 tra Casemurate (bivio SP 254R) e il confine provinciale,3597,10,3295,301,2867,730,3597,0
2019/03,442,27/03/2019,3,SP 118 tra Casemurate (bivio SP 254R) e il confine provinciale,3666,00,3393,273,2864,802,3666,0
2019/03,442,28/03/2019,4,SP 118 tra Casemurate (bivio SP 254R) e il confine provinciale,3660,00,3362,298,2825,835,3660,0
2019/03,443,15/03/2019,5,SP 16 tra Faenza e il confine provinciale,5958,00,5656,302,4650,1308,5958,0
2019/03,443,16/03/2019,6,SP 16 tra Faenza e il confine provinciale,5579,00,5500,79,4249,1330,0,5579
2019/03,443,17/03/2019,7,SP 16 tra Faenza e il confine provinciale,5146,00,5119,27,3972,1174,0,5146
2019/03,443,18/03/2019,1,SP 16 tra Faenza e il confine provinciale,5582,10,5328,253,4405,1177,5582,0
2019/03,443,19/03/2019,2,SP 16 tra Faenza e il confine provinciale,5741,00,5473,268,4513,1228,5741,0
2019/03,443,20/03/2019,3,SP 16 tra Faenza e il confine provinciale,5715,00,5453,262,4471,1244,5715,0
2019/03,443,21/03/2019,4,SP 16 tra Faenza e il confine provinciale,5776,00,5507,269,4560,1216,5776,0
2019/03,443,22/03/2019,5,SP 16 tra Faenza e il confine provinciale,6034,00,5742,292,4645,1389,6034,0
2019/03,443,23/03/2019,6,SP 16 tra Faenza e il confine provinciale,5832,20,5753,77,4296,1536,0,5832
2019/03,443,24/03/2019,7,SP 16 tra Faenza e il confine provinciale,4964,00,4930,34,3849,1115,0,4964
2019/03,443,25/03/2019,1,SP 16 tra Faenza e il confine provinciale,5596,10,5300,295,4416,1180,5596,0
2019/03,443,26/03/2019,2,SP 16 tra Faenza e il confine provinciale,5796,00,5521,275,4665,1131,5796,0
2019/03,443,27/03/2019,3,SP 16 tra Faenza e il confine provinciale,5765,00,5510,255,4549,1216,5765,0
2019/03,443,28/03/2019,4,SP 16 tra Faenza e il confine provinciale,5865,10,5612,252,4611,1254,5865,0
2019/03,444,15/03/2019,5,SP 5 fra Russi e San Pancrazio,,,,,,,,
2019/03,444,16/03/2019,6,SP 5 fra Russi e San Pancrazio,,,,,,,,
2019/03,444,17/03/2019,7,SP 5 fra Russi e San Pancrazio,,,,,,,,
2019/03,444,18/03/2019,1,SP 5 fra Russi e San Pancrazio,,,,,,,,
2019/03,444,19/03/2019,2,SP 5 fra Russi e San Pancrazio,,,,,,,,
2019/03,444,20/03/2019,3,SP 5 fra Russi e San Pancrazio,,,,,,,,
2019/03,444,21/03/2019,4,SP 5 fra Russi e San Pancrazio,,,,,,,,
2019/03,444,22/03/2019,5,SP 5 fra Russi e San Pancrazio,,,,,,,,
2019/03,444,23/03/2019,6,SP 5 fra Russi e San Pancrazio,,,,,,,,
2019/03,444,24/03/2019,7,SP 5 fra Russi e San Pancrazio,,,,,,,,
2019/03,444,25/03/2019,1,SP 5 fra Russi e San Pancrazio,,,,,,,,
2019/03,444,26/03/2019,2,SP 5 fra Russi e San Pancrazio,,,,,,,,
2019/03,444,27/03/2019,3,SP 5 fra Russi e San Pancrazio,,,,,,,,
2019/03,444,28/03/2019,4,SP 5 fra Russi e San Pancrazio,,,,,,,,
2019/03,445,15/03/2019,5,SP 610R fra SP 253R e Conselice,6593,00,5715,878,4907,1686,6593,0
2019/03,445,16/03/2019,6,SP 610R fra SP 253R e Conselice,5001,00,4813,188,3578,1423,0,5001
2019/03,445,17/03/2019,7,SP 610R fra SP 253R e Conselice,4665,00,4602,63,3544,1121,0,4665
2019/03,445,18/03/2019,1,SP 610R fra SP 253R e Conselice,5608,10,4827,780,4488,1120,5608,0
2019/03,445,19/03/2019,2,SP 610R fra SP 253R e Conselice,5830,10,5007,822,4543,1287,5830,0
2019/03,445,20/03/2019,3,SP 610R fra SP 253R e Conselice,5640,00,4824,816,4392,1248,5640,0
2019/03,445,21/03/2019,4,SP 610R fra SP 253R e Conselice,5858,00,5005,853,4567,1291,5858,0
2019/03,445,22/03/2019,5,SP 610R fra SP 253R e Conselice,6174,20,5344,828,4755,1419,6174,0
2019/03,445,23/03/2019,6,SP 610R fra SP 253R e Conselice,4820,00,4633,187,3475,1345,0,4820
2019/03,445,24/03/2019,7,SP 610R fra SP 253R e Conselice,4495,00,4446,49,3388,1107,0,4495
2019/03,445,25/03/2019,1,SP 610R fra SP 253R e Conselice,5779,00,4928,851,4556,1223,5779,0
2019/03,445,26/03/2019,2,SP 610R fra SP 253R e Conselice,5775,00,4944,831,4613,1162,5775,0
2019/03,445,27/03/2019,3,SP 610R fra SP 253R e Conselice,5759,10,4943,815,4438,1321,5759,0
2019/03,445,28/03/2019,4,SP 610R fra SP 253R e Conselice,5989,10,5072,916,4685,1304,5989,0
2019/03,446,15/03/2019,5,SP 13 in località Santa Maria di Fabriago,9304,00,8542,762,7171,2133,9304,0
2019/03,446,16/03/2019,6,SP 13 in località Santa Maria di Fabriago,7729,10,7487,241,5664,2065,0,7729
2019/03,446,17/03/2019,7,SP 13 in località Santa Maria di Fabriago,6190,00,6157,33,4493,1697,0,6190
2019/03,446,18/03/2019,1,SP 13 in località Santa Maria di Fabriago,8501,00,7876,625,6796,1705,8501,0
2019/03,446,19/03/2019,2,SP 13 in località Santa Maria di Fabriago,9156,00,8566,590,7257,1899,9156,0
2019/03,446,20/03/2019,3,SP 13 in località Santa Maria di Fabriago,9671,00,9070,601,7762,1909,9671,0
2019/03,446,21/03/2019,4,SP 13 in località Santa Maria di Fabriago,9163,00,8542,621,7280,1883,9163,0
2019/03,446,22/03/2019,5,SP 13 in località Santa Maria di Fabriago,9042,00,8312,730,7002,2040,9042,0
2019/03,446,23/03/2019,6,SP 13 in località Santa Maria di Fabriago,7712,00,7483,229,5649,2063,0,7712
2019/03,446,24/03/2019,7,SP 13 in località Santa Maria di Fabriago,5636,00,5614,22,3965,1671,0,5636
2019/03,446,27/03/2019,3,SP 13 in località Santa Maria di Fabriago,9575,00,8944,631,7561,2014,9575,0
2019/03,446,28/03/2019,4,SP 13 in località Santa Maria di Fabriago,9389,00,8762,627,7387,2002,9389,0
2019/03,447,15/03/2019,5,SP 28 in località Molinazzo (Comune di Gossolengo),5888,00,5636,252,4645,1243,5888,0
2019/03,447,16/03/2019,6,SP 28 in località Molinazzo (Comune di Gossolengo),5938,00,5848,90,4466,1472,0,5938
2019/03,447,17/03/2019,7,SP 28 in località Molinazzo (Comune di Gossolengo),4774,00,4751,23,3721,1053,0,4774
2019/03,447,18/03/2019,1,SP 28 in località Molinazzo (Comune di Gossolengo),5264,00,5078,186,4228,1036,5264,0
2019/03,447,19/03/2019,2,SP 28 in località Molinazzo (Comune di Gossolengo),5265,00,5066,199,4240,1025,5265,0
2019/03,447,20/03/2019,3,SP 28 in località Molinazzo (Comune di Gossolengo),5562,00,5371,191,4344,1218,5562,0
2019/03,447,21/03/2019,4,SP 28 in località Molinazzo (Comune di Gossolengo),5646,00,5422,224,4494,1152,5646,0
2019/03,447,22/03/2019,5,SP 28 in località Molinazzo (Comune di Gossolengo),5952,00,5754,198,4623,1329,5952,0
2019/03,447,23/03/2019,6,SP 28 in località Molinazzo (Comune di Gossolengo),5829,10,5751,77,4404,1425,0,5829
2019/03,447,24/03/2019,7,SP 28 in località Molinazzo (Comune di Gossolengo),6658,00,6632,26,5395,1263,0,6658
2019/03,447,25/03/2019,1,SP 28 in località Molinazzo (Comune di Gossolengo),5396,00,5197,199,4374,1022,5396,0
2019/03,447,26/03/2019,2,SP 28 in località Molinazzo (Comune di Gossolengo),5438,00,5245,193,4394,1044,5438,0
2019/03,447,27/03/2019,3,SP 28 in località Molinazzo (Comune di Gossolengo),5580,00,5371,209,4524,1056,5580,0
2019/03,447,28/03/2019,4,SP 28 in località Molinazzo (Comune di Gossolengo),5480,00,5246,234,4422,1058,5480,0
2019/03,448,15/03/2019,5,SP 5 fra Reggiolo e intersezione SP 45 per Fabbrico,8274,00,7546,728,6219,2055,8274,0
2019/03,448,16/03/2019,6,SP 5 fra Reggiolo e intersezione SP 45 per Fabbrico,7077,00,6901,176,5059,2018,0,7077
2019/03,448,17/03/2019,7,SP 5 fra Reggiolo e intersezione SP 45 per Fabbrico,6232,00,6191,41,4419,1813,0,6232
2019/03,448,18/03/2019,1,SP 5 fra Reggiolo e intersezione SP 45 per Fabbrico,7426,30,6685,738,5919,1507,7426,0
2019/03,448,19/03/2019,2,SP 5 fra Reggiolo e intersezione SP 45 per Fabbrico,7532,10,6784,747,5939,1593,7532,0
2019/03,448,20/03/2019,3,SP 5 fra Reggiolo e intersezione SP 45 per Fabbrico,7712,10,6933,778,6032,1680,7712,0
2019/03,448,21/03/2019,4,SP 5 fra Reggiolo e intersezione SP 45 per Fabbrico,7975,00,7148,827,6206,1769,7975,0
2019/03,448,22/03/2019,5,SP 5 fra Reggiolo e intersezione SP 45 per Fabbrico,8117,00,7309,808,6207,1910,8117,0
2019/03,448,23/03/2019,6,SP 5 fra Reggiolo e intersezione SP 45 per Fabbrico,6538,00,6367,171,4498,2040,0,6538
2019/03,448,24/03/2019,7,SP 5 fra Reggiolo e intersezione SP 45 per Fabbrico,6427,00,6386,41,4616,1811,0,6427
2019/03,448,25/03/2019,1,SP 5 fra Reggiolo e intersezione SP 45 per Fabbrico,7273,00,6491,782,5770,1503,7273,0
2019/03,448,26/03/2019,2,SP 5 fra Reggiolo e intersezione SP 45 per Fabbrico,7477,20,6691,784,5943,1534,7477,0
2019/03,448,27/03/2019,3,SP 5 fra Reggiolo e intersezione SP 45 per Fabbrico,7850,00,7040,810,6138,1712,7850,0
2019/03,448,28/03/2019,4,SP 5 fra Reggiolo e intersezione SP 45 per Fabbrico,7828,00,7023,805,6116,1712,7828,0
2019/03,449,15/03/2019,5,SP 111 fra via Emilia e la variante Asse Val d'Enza,13237,00,10952,2285,10371,2866,13237,0
2019/03,449,16/03/2019,6,SP 111 fra via Emilia e la variante Asse Val d'Enza,8787,00,8410,377,6310,2477,0,8787
2019/03,449,17/03/2019,7,SP 111 fra via Emilia e la variante Asse Val d'Enza,8264,00,8129,135,6002,2262,0,8264
2019/03,449,18/03/2019,1,SP 111 fra via Emilia e la variante Asse Val d'Enza,12210,00,10135,2075,9702,2508,12210,0
2019/03,449,19/03/2019,2,SP 111 fra via Emilia e la variante Asse Val d'Enza,12367,10,10202,2164,9962,2405,12367,0
2019/03,449,20/03/2019,3,SP 111 fra via Emilia e la variante Asse Val d'Enza,12680,20,10382,2296,10216,2464,12680,0
2019/03,449,21/03/2019,4,SP 111 fra via Emilia e la variante Asse Val d'Enza,12301,10,10073,2227,9845,2456,12301,0
2019/03,449,22/03/2019,5,SP 111 fra via Emilia e la variante Asse Val d'Enza,13129,20,11064,2063,10241,2888,13129,0
2019/03,449,23/03/2019,6,SP 111 fra via Emilia e la variante Asse Val d'Enza,8567,00,8131,436,6108,2459,0,8567
2019/03,449,24/03/2019,7,SP 111 fra via Emilia e la variante Asse Val d'Enza,8544,00,8387,157,6182,2362,0,8544
2019/03,449,25/03/2019,1,SP 111 fra via Emilia e la variante Asse Val d'Enza,12044,00,9808,2236,9668,2376,12044,0
2019/03,449,26/03/2019,2,SP 111 fra via Emilia e la variante Asse Val d'Enza,12414,00,10284,2130,10016,2398,12414,0
2019/03,449,27/03/2019,3,SP 111 fra via Emilia e la variante Asse Val d'Enza,12737,00,10502,2235,10195,2542,12737,0
2019/03,449,28/03/2019,4,SP 111 fra via Emilia e la variante Asse Val d'Enza,12974,30,10769,2202,10367,2607,12974,0
2019/03,450,15/03/2019,5,SP 35 sul Ponte Po,9443,20,8443,998,7204,2239,9443,0
2019/03,450,16/03/2019,6,SP 35 sul Ponte Po,7857,00,7712,145,5622,2235,0,7857
2019/03,450,17/03/2019,7,SP 35 sul Ponte Po,6309,00,6275,34,4312,1997,0,6309
2019/03,450,18/03/2019,1,SP 35 sul Ponte Po,8475,00,7502,973,6750,1725,8475,0
2019/03,450,19/03/2019,2,SP 35 sul Ponte Po,8708,20,7701,1005,6937,1771,8708,0
2019/03,450,20/03/2019,3,SP 35 sul Ponte Po,8659,10,7685,973,6823,1836,8659,0
2019/03,450,21/03/2019,4,SP 35 sul Ponte Po,8610,30,7616,991,6826,1784,8610,0
2019/03,450,22/03/2019,5,SP 35 sul Ponte Po,9200,00,8274,926,6967,2233,9200,0
2019/03,450,23/03/2019,6,SP 35 sul Ponte Po,7869,00,7722,147,5605,2264,0,7869
2019/03,450,24/03/2019,7,SP 35 sul Ponte Po,6490,00,6453,37,4242,2248,0,6490
2019/03,450,25/03/2019,1,SP 35 sul Ponte Po,8313,20,7341,970,6648,1665,8313,0
2019/03,450,26/03/2019,2,SP 35 sul Ponte Po,8711,80,7605,1098,6955,1756,8711,0
2019/03,450,27/03/2019,3,SP 35 sul Ponte Po,8855,10,7822,1032,7020,1835,8855,0
2019/03,450,28/03/2019,4,SP 35 sul Ponte Po,8761,10,7636,1124,6953,1808,8761,0
2019/03,451,15/03/2019,5,SP 62RVar sulla variante di Luzzara (c/o Codisotto),13318,00,10251,3067,10234,3084,13318,0
2019/03,451,16/03/2019,6,SP 62RVar sulla variante di Luzzara (c/o Codisotto),9896,00,9484,412,7039,2857,0,9896
2019/03,451,17/03/2019,7,SP 62RVar sulla variante di Luzzara (c/o Codisotto),9407,10,9283,123,6488,2919,0,9407
2019/03,451,18/03/2019,1,SP 62RVar sulla variante di Luzzara (c/o Codisotto),12454,00,9332,3122,9865,2589,12454,0
2019/03,451,19/03/2019,2,SP 62RVar sulla variante di Luzzara (c/o Codisotto),12630,00,9473,3157,10010,2620,12630,0
2019/03,451,20/03/2019,3,SP 62RVar sulla variante di Luzzara (c/o Codisotto),12791,00,9542,3249,10031,2760,12791,0
2019/03,451,21/03/2019,4,SP 62RVar sulla variante di Luzzara (c/o Codisotto),12903,10,9673,3229,10092,2811,12903,0
2019/03,451,22/03/2019,5,SP 62RVar sulla variante di Luzzara (c/o Codisotto),13349,10,10301,3047,10226,3123,13349,0
2019/03,451,23/03/2019,6,SP 62RVar sulla variante di Luzzara (c/o Codisotto),9781,00,9289,492,6938,2843,0,9781
2019/03,451,24/03/2019,7,SP 62RVar sulla variante di Luzzara (c/o Codisotto),9900,00,9761,139,6768,3132,0,9900
2019/03,451,25/03/2019,1,SP 62RVar sulla variante di Luzzara (c/o Codisotto),12341,00,9187,3154,9737,2604,12341,0
2019/03,451,26/03/2019,2,SP 62RVar sulla variante di Luzzara (c/o Codisotto),12526,20,9203,3321,9970,2556,12526,0
2019/03,451,27/03/2019,3,SP 62RVar sulla variante di Luzzara (c/o Codisotto),13064,00,9744,3320,10271,2793,13064,0
2019/03,451,28/03/2019,4,SP 62RVar sulla variante di Luzzara (c/o Codisotto),13508,00,10058,3450,10588,2920,13508,0
2019/03,452,15/03/2019,5,SP 3 sulla variante tra Bagnolo in Piano e il casello A 1 di Reggio Emilia,13469,00,12129,1340,10330,3139,13469,0
2019/03,452,16/03/2019,6,SP 3 sulla variante tra Bagnolo in Piano e il casello A 1 di Reggio Emilia,10363,00,10111,252,7358,3005,0,10363
2019/03,452,17/03/2019,7,SP 3 sulla variante tra Bagnolo in Piano e il casello A 1 di Reggio Emilia,8493,00,8426,67,5847,2646,0,8493
2019/03,452,18/03/2019,1,SP 3 sulla variante tra Bagnolo in Piano e il casello A 1 di Reggio Emilia,12613,00,11313,1300,10005,2608,12613,0
2019/03,452,19/03/2019,2,SP 3 sulla variante tra Bagnolo in Piano e il casello A 1 di Reggio Emilia,12777,10,11376,1400,10204,2573,12777,0
2019/03,452,20/03/2019,3,SP 3 sulla variante tra Bagnolo in Piano e il casello A 1 di Reggio Emilia,12977,00,11599,1378,10213,2764,12977,0
2019/03,452,21/03/2019,4,SP 3 sulla variante tra Bagnolo in Piano e il casello A 1 di Reggio Emilia,12815,10,11419,1395,9953,2862,12815,0
2019/03,452,22/03/2019,5,SP 3 sulla variante tra Bagnolo in Piano e il casello A 1 di Reggio Emilia,13713,00,12351,1362,10463,3250,13713,0
2019/03,452,23/03/2019,6,SP 3 sulla variante tra Bagnolo in Piano e il casello A 1 di Reggio Emilia,10147,00,9872,275,7049,3098,0,10147
2019/03,452,24/03/2019,7,SP 3 sulla variante tra Bagnolo in Piano e il casello A 1 di Reggio Emilia,9782,00,9713,69,6819,2963,0,9782
2019/03,452,25/03/2019,1,SP 3 sulla variante tra Bagnolo in Piano e il casello A 1 di Reggio Emilia,12552,00,11170,1382,10011,2541,12552,0
2019/03,452,26/03/2019,2,SP 3 sulla variante tra Bagnolo in Piano e il casello A 1 di Reggio Emilia,12640,10,11257,1382,10082,2558,12640,0
2019/03,452,27/03/2019,3,SP 3 sulla variante tra Bagnolo in Piano e il casello A 1 di Reggio Emilia,13052,00,11616,1436,10263,2789,13052,0
2019/03,452,28/03/2019,4,SP 3 sulla variante tra Bagnolo in Piano e il casello A 1 di Reggio Emilia,13103,00,11738,1365,10258,2845,13103,0
2019/03,453,15/03/2019,5,Asse viario Modena-Sassuolo tra Modena e Baggiovara,58825,50,52572,6248,45274,13551,58825,0
2019/03,453,16/03/2019,6,Asse viario Modena-Sassuolo tra Modena e Baggiovara,43988,00,42992,996,30272,13716,0,43988
2019/03,453,17/03/2019,7,Asse viario Modena-Sassuolo tra Modena e Baggiovara,35865,00,35641,224,24648,11217,0,35865
2019/03,453,18/03/2019,1,Asse viario Modena-Sassuolo tra Modena e Baggiovara,54335,40,48820,5511,43294,11041,54335,0
2019/03,453,19/03/2019,2,Asse viario Modena-Sassuolo tra Modena e Baggiovara,55759,30,49582,6174,44125,11634,55759,0
2019/03,453,20/03/2019,3,Asse viario Modena-Sassuolo tra Modena e Baggiovara,52146,70,46379,5760,40122,12024,52146,0
2019/03,453,21/03/2019,4,Asse viario Modena-Sassuolo tra Modena e Baggiovara,57231,30,50597,6631,44819,12412,57231,0
2019/03,453,22/03/2019,5,Asse viario Modena-Sassuolo tra Modena e Baggiovara,58154,40,51890,6260,44874,13280,58154,0
2019/03,453,23/03/2019,6,Asse viario Modena-Sassuolo tra Modena e Baggiovara,43573,00,42586,987,30259,13314,0,43573
2019/03,453,24/03/2019,7,Asse viario Modena-Sassuolo tra Modena e Baggiovara,35860,00,35625,235,24027,11833,0,35860
2019/03,453,25/03/2019,1,Asse viario Modena-Sassuolo tra Modena e Baggiovara,54839,20,49005,5832,43682,11157,54839,0
2019/03,453,26/03/2019,2,Asse viario Modena-Sassuolo tra Modena e Baggiovara,55804,50,49670,6129,44203,11601,55804,0
2019/03,453,27/03/2019,3,Asse viario Modena-Sassuolo tra Modena e Baggiovara,55819,40,49369,6446,43916,11903,55819,0
2019/03,453,28/03/2019,4,Asse viario Modena-Sassuolo tra Modena e Baggiovara,57196,30,50576,6617,44538,12658,57196,0
2019/03,502,15/03/2019,5,SP 26 tra località Pioppa e viadotto A 1 (c/o Zola Predosa),15063,00,14091,972,11930,3133,15063,0
2019/03,502,16/03/2019,6,SP 26 tra località Pioppa e viadotto A 1 (c/o Zola Predosa),10723,20,10580,141,7647,3076,0,10723
2019/03,502,17/03/2019,7,SP 26 tra località Pioppa e viadotto A 1 (c/o Zola Predosa),9010,00,8949,61,5985,3025,0,9010
2019/03,502,18/03/2019,1,SP 26 tra località Pioppa e viadotto A 1 (c/o Zola Predosa),13820,10,12848,971,11468,2352,13820,0
2019/03,502,19/03/2019,2,SP 26 tra località Pioppa e viadotto A 1 (c/o Zola Predosa),14074,00,13059,1015,11636,2438,14074,0
2019/03,502,20/03/2019,3,SP 26 tra località Pioppa e viadotto A 1 (c/o Zola Predosa),14337,00,13342,995,11835,2502,14337,0
2019/03,502,21/03/2019,4,SP 26 tra località Pioppa e viadotto A 1 (c/o Zola Predosa),14434,00,13387,1047,11797,2637,14434,0
2019/03,502,22/03/2019,5,SP 26 tra località Pioppa e viadotto A 1 (c/o Zola Predosa),14511,00,13553,958,11822,2689,14511,0
2019/03,502,23/03/2019,6,SP 26 tra località Pioppa e viadotto A 1 (c/o Zola Predosa),10391,00,10247,144,7633,2758,0,10391
2019/03,502,24/03/2019,7,SP 26 tra località Pioppa e viadotto A 1 (c/o Zola Predosa),7688,00,7637,51,5767,1921,0,7688
2019/03,502,25/03/2019,1,SP 26 tra località Pioppa e viadotto A 1 (c/o Zola Predosa),14403,00,13428,975,12078,2325,14403,0
2019/03,504,15/03/2019,5,SP 7 dalla località Ca de' Mandorli al bivio per Castel de Britti,11952,00,11623,329,9120,2832,11952,0
2019/03,504,16/03/2019,6,SP 7 dalla località Ca de' Mandorli al bivio per Castel de Britti,11000,00,10847,153,8132,2868,0,11000
2019/03,504,17/03/2019,7,SP 7 dalla località Ca de' Mandorli al bivio per Castel de Britti,9207,00,9172,35,6970,2237,0,9207
2019/03,504,18/03/2019,1,SP 7 dalla località Ca de' Mandorli al bivio per Castel de Britti,11127,00,10794,333,8762,2365,11127,0
2019/03,504,19/03/2019,2,SP 7 dalla località Ca de' Mandorli al bivio per Castel de Britti,11296,00,10972,324,8677,2619,11296,0
2019/03,504,20/03/2019,3,SP 7 dalla località Ca de' Mandorli al bivio per Castel de Britti,11527,00,11156,371,8899,2628,11527,0
2019/03,504,21/03/2019,4,SP 7 dalla località Ca de' Mandorli al bivio per Castel de Britti,11698,00,11414,284,8905,2793,11698,0
2019/03,504,22/03/2019,5,SP 7 dalla località Ca de' Mandorli al bivio per Castel de Britti,12109,00,11756,353,9145,2964,12109,0
2019/03,504,23/03/2019,6,SP 7 dalla località Ca de' Mandorli al bivio per Castel de Britti,10841,10,10706,134,7990,2851,0,10841
2019/03,504,24/03/2019,7,SP 7 dalla località Ca de' Mandorli al bivio per Castel de Britti,9436,00,9406,30,7141,2295,0,9436
2019/03,504,25/03/2019,1,SP 7 dalla località Ca de' Mandorli al bivio per Castel de Britti,11296,00,10990,306,8659,2637,11296,0
2019/03,504,26/03/2019,2,SP 7 dalla località Ca de' Mandorli al bivio per Castel de Britti,11436,00,11138,298,8846,2590,11436,0
2019/03,504,27/03/2019,3,SP 7 dalla località Ca de' Mandorli al bivio per Castel de Britti,11624,00,11277,347,8819,2805,11624,0
2019/03,504,28/03/2019,4,SP 7 dalla località Ca de' Mandorli al bivio per Castel de Britti,11392,00,11098,294,8713,2679,11392,0
2019/03,505,15/03/2019,5,SP 610 tra casello A 1 (Imola) e bivio SP 51 per Castel Guelfo di Bologna,14678,10,12276,2401,10984,3694,14678,0
2019/03,505,16/03/2019,6,SP 610 tra casello A 1 (Imola) e bivio SP 51 per Castel Guelfo di Bologna,10528,10,10079,448,7296,3232,0,10528
2019/03,505,17/03/2019,7,SP 610 tra casello A 1 (Imola) e bivio SP 51 per Castel Guelfo di Bologna,9235,00,9076,159,6532,2703,0,9235
2019/03,505,18/03/2019,1,SP 610 tra casello A 1 (Imola) e bivio SP 51 per Castel Guelfo di Bologna,13537,00,11194,2343,10597,2940,13537,0
2019/03,505,19/03/2019,2,SP 610 tra casello A 1 (Imola) e bivio SP 51 per Castel Guelfo di Bologna,13592,00,11344,2248,10413,3179,13592,0
2019/03,505,20/03/2019,3,SP 610 tra casello A 1 (Imola) e bivio SP 51 per Castel Guelfo di Bologna,13450,30,11124,2323,10373,3077,13450,0
2019/03,505,21/03/2019,4,SP 610 tra casello A 1 (Imola) e bivio SP 51 per Castel Guelfo di Bologna,13724,00,11364,2360,10554,3170,13724,0
2019/03,505,22/03/2019,5,SP 610 tra casello A 1 (Imola) e bivio SP 51 per Castel Guelfo di Bologna,14191,20,11773,2416,10855,3336,14191,0
2019/03,505,23/03/2019,6,SP 610 tra casello A 1 (Imola) e bivio SP 51 per Castel Guelfo di Bologna,10725,00,10320,405,7546,3179,0,10725
2019/03,505,24/03/2019,7,SP 610 tra casello A 1 (Imola) e bivio SP 51 per Castel Guelfo di Bologna,9071,00,8926,145,6492,2579,0,9071
2019/03,505,25/03/2019,1,SP 610 tra casello A 1 (Imola) e bivio SP 51 per Castel Guelfo di Bologna,13431,20,11160,2269,10486,2945,13431,0
2019/03,505,26/03/2019,2,SP 610 tra casello A 1 (Imola) e bivio SP 51 per Castel Guelfo di Bologna,13580,00,11340,2240,10529,3051,13580,0
2019/03,505,27/03/2019,3,SP 610 tra casello A 1 (Imola) e bivio SP 51 per Castel Guelfo di Bologna,13781,10,11361,2419,10597,3184,13781,0
2019/03,505,28/03/2019,4,SP 610 tra casello A 1 (Imola) e bivio SP 51 per Castel Guelfo di Bologna,13916,00,11500,2416,10660,3256,13916,0
2019/03,600,15/03/2019,5,SP 19 tra SP31 e Medicina,8971,00,7963,1008,7207,1764,8971,0
2019/03,600,16/03/2019,6,SP 19 tra SP31 e Medicina,6675,10,6505,169,5055,1620,0,6675
2019/03,600,17/03/2019,7,SP 19 tra SP31 e Medicina,6336,00,6306,30,4912,1424,0,6336
2019/03,600,18/03/2019,1,SP 19 tra SP31 e Medicina,7710,10,6870,839,6383,1327,7710,0
2019/03,600,19/03/2019,2,SP 19 tra SP31 e Medicina,8098,10,7143,954,6435,1663,8098,0
2019/03,600,20/03/2019,3,SP 19 tra SP31 e Medicina,7948,00,7052,896,6467,1481,7948,0
2019/03,600,21/03/2019,4,SP 19 tra SP31 e Medicina,7906,10,6953,952,6348,1558,7906,0
2019/03,600,22/03/2019,5,SP 19 tra SP31 e Medicina,8316,00,7367,949,6664,1652,8316,0
2019/03,600,23/03/2019,6,SP 19 tra SP31 e Medicina,6586,00,6429,157,4971,1615,0,6586
2019/03,600,24/03/2019,7,SP 19 tra SP31 e Medicina,6500,00,6464,36,4971,1529,0,6500
2019/03,600,25/03/2019,1,SP 19 tra SP31 e Medicina,7863,20,7027,834,6411,1452,7863,0
2019/03,600,26/03/2019,2,SP 19 tra SP31 e Medicina,7664,00,6854,810,6289,1375,7664,0
2019/03,600,27/03/2019,3,SP 19 tra SP31 e Medicina,7689,10,6861,827,6225,1464,7689,0
2019/03,600,28/03/2019,4,SP 19 tra SP31 e Medicina,8043,10,7067,975,6434,1609,8043,0
2019/03,601,15/03/2019,5,SP 21 da Castel San Pietro al bivio SP 35 (c/o Sassoleone),3450,00,3363,87,2559,891,3450,0
2019/03,601,16/03/2019,6,SP 21 da Castel San Pietro al bivio SP 35 (c/o Sassoleone),3775,00,3727,48,2868,907,0,3775
2019/03,601,17/03/2019,7,SP 21 da Castel San Pietro al bivio SP 35 (c/o Sassoleone),3510,10,3487,22,2706,804,0,3510
2019/03,601,18/03/2019,1,SP 21 da Castel San Pietro al bivio SP 35 (c/o Sassoleone),3230,00,3153,77,2533,697,3230,0
2019/03,601,19/03/2019,2,SP 21 da Castel San Pietro al bivio SP 35 (c/o Sassoleone),3106,00,3042,64,2391,715,3106,0
2019/03,601,20/03/2019,3,SP 21 da Castel San Pietro al bivio SP 35 (c/o Sassoleone),3284,00,3192,92,2580,704,3284,0
2019/03,601,21/03/2019,4,SP 21 da Castel San Pietro al bivio SP 35 (c/o Sassoleone),3228,00,3140,88,2456,772,3228,0
2019/03,601,22/03/2019,5,SP 21 da Castel San Pietro al bivio SP 35 (c/o Sassoleone),3398,00,3311,87,2581,817,3398,0
2019/03,601,23/03/2019,6,SP 21 da Castel San Pietro al bivio SP 35 (c/o Sassoleone),3835,10,3795,39,2861,974,0,3835
2019/03,601,24/03/2019,7,SP 21 da Castel San Pietro al bivio SP 35 (c/o Sassoleone),3312,00,3291,21,2546,766,0,3312
2019/03,601,25/03/2019,1,SP 21 da Castel San Pietro al bivio SP 35 (c/o Sassoleone),3225,10,3129,95,2557,668,3225,0
2019/03,601,26/03/2019,2,SP 21 da Castel San Pietro al bivio SP 35 (c/o Sassoleone),3121,00,3038,83,2446,675,3121,0
2019/03,601,27/03/2019,3,SP 21 da Castel San Pietro al bivio SP 35 (c/o Sassoleone),3409,00,3261,148,2647,762,3409,0
2019/03,601,28/03/2019,4,SP 21 da Castel San Pietro al bivio SP 35 (c/o Sassoleone),3295,00,3192,103,2571,724,3295,0
2019/03,602,15/03/2019,5,SP 9_1 da Crevalcore alla località Caselle,1785,00,1717,68,1398,387,1785,0
2019/03,602,16/03/2019,6,SP 9_1 da Crevalcore alla località Caselle,1542,00,1500,42,1139,403,0,1542
2019/03,602,17/03/2019,7,SP 9_1 da Crevalcore alla località Caselle,1216,00,1214,2,935,281,0,1216
2019/03,602,18/03/2019,1,SP 9_1 da Crevalcore alla località Caselle,1678,00,1610,68,1315,363,1678,0
2019/03,602,19/03/2019,2,SP 9_1 da Crevalcore alla località Caselle,1731,00,1648,83,1302,429,1731,0
2019/03,602,20/03/2019,3,SP 9_1 da Crevalcore alla località Caselle,1566,00,1491,75,1248,318,1566,0
2019/03,602,21/03/2019,4,SP 9_1 da Crevalcore alla località Caselle,1644,00,1577,67,1295,349,1644,0
2019/03,602,22/03/2019,5,SP 9_1 da Crevalcore alla località Caselle,1771,00,1697,74,1338,433,1771,0
2019/03,602,23/03/2019,6,SP 9_1 da Crevalcore alla località Caselle,1615,00,1583,32,1199,416,0,1615
2019/03,602,24/03/2019,7,SP 9_1 da Crevalcore alla località Caselle,1169,00,1165,4,855,314,0,1169
2019/03,602,25/03/2019,1,SP 9_1 da Crevalcore alla località Caselle,1729,00,1656,73,1380,349,1729,0
2019/03,602,26/03/2019,2,SP 9_1 da Crevalcore alla località Caselle,1631,00,1552,79,1290,341,1631,0
2019/03,602,27/03/2019,3,SP 9_1 da Crevalcore alla località Caselle,1633,00,1567,66,1281,352,1633,0
2019/03,602,28/03/2019,4,SP 9_1 da Crevalcore alla località Caselle,1643,00,1566,77,1294,349,1643,0
2019/03,603,15/03/2019,5,SP 10 dalla località Decima ai confini provinciali di Bologna e Ferrara,4305,00,4145,160,3135,1170,4305,0
2019/03,603,16/03/2019,6,SP 10 dalla località Decima ai confini provinciali di Bologna e Ferrara,3460,00,3391,69,2339,1121,0,3460
2019/03,603,17/03/2019,7,SP 10 dalla località Decima ai confini provinciali di Bologna e Ferrara,2765,00,2758,7,1860,905,0,2765
2019/03,603,18/03/2019,1,SP 10 dalla località Decima ai confini provinciali di Bologna e Ferrara,3985,10,3841,143,3070,915,3985,0
2019/03,603,19/03/2019,2,SP 10 dalla località Decima ai confini provinciali di Bologna e Ferrara,4063,00,3877,186,3062,1001,4063,0
2019/03,603,20/03/2019,3,SP 10 dalla località Decima ai confini provinciali di Bologna e Ferrara,4159,10,3964,194,3099,1060,4159,0
2019/03,603,21/03/2019,4,SP 10 dalla località Decima ai confini provinciali di Bologna e Ferrara,4142,10,3972,169,3052,1090,4142,0
2019/03,603,22/03/2019,5,SP 10 dalla località Decima ai confini provinciali di Bologna e Ferrara,4336,00,4155,181,3128,1208,4336,0
2019/03,603,23/03/2019,6,SP 10 dalla località Decima ai confini provinciali di Bologna e Ferrara,3460,00,3401,59,2418,1042,0,3460
2019/03,603,24/03/2019,7,SP 10 dalla località Decima ai confini provinciali di Bologna e Ferrara,2960,00,2942,18,2075,885,0,2960
2019/03,603,25/03/2019,1,SP 10 dalla località Decima ai confini provinciali di Bologna e Ferrara,3936,00,3771,165,3019,917,3936,0
2019/03,603,26/03/2019,2,SP 10 dalla località Decima ai confini provinciali di Bologna e Ferrara,4069,00,3897,172,3112,957,4069,0
2019/03,603,27/03/2019,3,SP 10 dalla località Decima ai confini provinciali di Bologna e Ferrara,4162,00,3978,184,3178,984,4162,0
2019/03,603,28/03/2019,4,SP 10 dalla località Decima ai confini provinciali di Bologna e Ferrara,4188,10,4025,162,3076,1112,4188,0
2019/03,604,15/03/2019,5,SP 37 da Sasso Marconi alla intersezione SP 58,5918,30,5680,235,4782,1136,5918,0
2019/03,604,16/03/2019,6,SP 37 da Sasso Marconi alla intersezione SP 58,4540,00,4508,32,3579,961,0,4540
2019/03,604,17/03/2019,7,SP 37 da Sasso Marconi alla intersezione SP 58,4485,00,4469,16,3594,891,0,4485
2019/03,604,18/03/2019,1,SP 37 da Sasso Marconi alla intersezione SP 58,5152,00,4951,201,4318,834,5152,0
2019/03,604,19/03/2019,2,SP 37 da Sasso Marconi alla intersezione SP 58,5591,00,5375,216,4482,1109,5591,0
2019/03,604,20/03/2019,3,SP 37 da Sasso Marconi alla intersezione SP 58,5370,10,5117,252,4448,922,5370,0
2019/03,604,21/03/2019,4,SP 37 da Sasso Marconi alla intersezione SP 58,5451,20,5229,220,4505,946,5451,0
2019/03,604,22/03/2019,5,SP 37 da Sasso Marconi alla intersezione SP 58,5676,00,5419,257,4699,977,5676,0
2019/03,604,23/03/2019,6,SP 37 da Sasso Marconi alla intersezione SP 58,4339,00,4297,42,3412,927,0,4339
2019/03,604,24/03/2019,7,SP 37 da Sasso Marconi alla intersezione SP 58,4220,00,4211,9,3373,847,0,4220
2019/03,604,25/03/2019,1,SP 37 da Sasso Marconi alla intersezione SP 58,5103,00,4897,206,4270,833,5103,0
2019/03,604,26/03/2019,2,SP 37 da Sasso Marconi alla intersezione SP 58,5324,10,5097,226,4450,874,5324,0
2019/03,604,27/03/2019,3,SP 37 da Sasso Marconi alla intersezione SP 58,5476,00,5215,261,4565,911,5476,0
2019/03,604,28/03/2019,4,SP 37 da Sasso Marconi alla intersezione SP 58,5486,00,5248,238,4501,985,5486,0
2019/03,605,15/03/2019,5,SP 324 da Silla alla intersezione SP 623,8001,00,7668,333,6345,1656,8001,0
2019/03,605,16/03/2019,6,SP 324 da Silla alla intersezione SP 623,7004,00,6916,88,5355,1649,0,7004
2019/03,605,17/03/2019,7,SP 324 da Silla alla intersezione SP 623,5565,00,5533,32,4327,1238,0,5565
2019/03,605,18/03/2019,1,SP 324 da Silla alla intersezione SP 623,7209,00,6917,292,5982,1227,7209,0
2019/03,605,19/03/2019,2,SP 324 da Silla alla intersezione SP 623,7229,00,6922,307,5873,1356,7229,0
2019/03,605,20/03/2019,3,SP 324 da Silla alla intersezione SP 623,7307,00,7004,303,5909,1398,7307,0
2019/03,605,21/03/2019,4,SP 324 da Silla alla intersezione SP 623,7486,00,7193,293,6042,1444,7486,0
2019/03,605,22/03/2019,5,SP 324 da Silla alla intersezione SP 623,8375,00,8069,306,6447,1928,8375,0
2019/03,605,23/03/2019,6,SP 324 da Silla alla intersezione SP 623,6942,20,6840,100,5188,1754,0,6942
2019/03,605,24/03/2019,7,SP 324 da Silla alla intersezione SP 623,5787,00,5741,46,4450,1337,0,5787
2019/03,605,25/03/2019,1,SP 324 da Silla alla intersezione SP 623,7379,10,7057,321,6099,1280,7379,0
2019/03,605,26/03/2019,2,SP 324 da Silla alla intersezione SP 623,7223,00,6896,327,5911,1312,7223,0
2019/03,605,27/03/2019,3,SP 324 da Silla alla intersezione SP 623,7427,00,7106,321,6007,1420,7427,0
2019/03,605,28/03/2019,4,SP 324 da Silla alla intersezione SP 623,7357,00,7039,318,5976,1381,7357,0
2019/03,606,15/03/2019,5,SP 70 Cispadana in località Sant'Agostino/San Carlo,5914,20,5489,423,4559,1355,5914,0
2019/03,606,17/03/2019,7,SP 70 Cispadana in località Sant'Agostino/San Carlo,4964,40,4942,18,3737,1227,0,4964
2019/03,606,18/03/2019,1,SP 70 Cispadana in località Sant'Agostino/San Carlo,6234,00,5782,452,5204,1030,6234,0
2019/03,606,19/03/2019,2,SP 70 Cispadana in località Sant'Agostino/San Carlo,6413,10,5909,503,5201,1212,6413,0
2019/03,606,20/03/2019,3,SP 70 Cispadana in località Sant'Agostino/San Carlo,5985,70,5504,474,4780,1205,5985,0
2019/03,606,21/03/2019,4,SP 70 Cispadana in località Sant'Agostino/San Carlo,6163,50,5692,466,4962,1201,6163,0
2019/03,606,23/03/2019,6,SP 70 Cispadana in località Sant'Agostino/San Carlo,4595,00,4534,61,3280,1315,0,4595
2019/03,606,24/03/2019,7,SP 70 Cispadana in località Sant'Agostino/San Carlo,5604,20,5580,22,3852,1752,0,5604
2019/03,606,25/03/2019,1,SP 70 Cispadana in località Sant'Agostino/San Carlo,6046,20,5605,439,4873,1173,6046,0
2019/03,606,26/03/2019,2,SP 70 Cispadana in località Sant'Agostino/San Carlo,5851,20,5443,406,4872,979,5851,0
2019/03,606,27/03/2019,3,SP 70 Cispadana in località Sant'Agostino/San Carlo,6418,30,5961,454,5142,1276,6418,0
2019/03,606,28/03/2019,4,SP 70 Cispadana in località Sant'Agostino/San Carlo,5310,20,4918,390,4107,1203,5310,0
2019/03,607,15/03/2019,5,SP 1 da Villafranca di Forlì al confine provinciale,4494,10,4208,285,3502,992,4494,0
2019/03,607,16/03/2019,6,SP 1 da Villafranca di Forlì al confine provinciale,3390,00,3331,59,2417,973,0,3390
2019/03,607,17/03/2019,7,SP 1 da Villafranca di Forlì al confine provinciale,3312,00,3302,10,2391,921,0,3312
2019/03,607,18/03/2019,1,SP 1 da Villafranca di Forlì al confine provinciale,4230,10,3949,280,3398,832,4230,0
2019/03,607,19/03/2019,2,SP 1 da Villafranca di Forlì al confine provinciale,4401,10,4096,304,3538,863,4401,0
2019/03,607,20/03/2019,3,SP 1 da Villafranca di Forlì al confine provinciale,4519,00,4255,264,3579,940,4519,0
2019/03,607,21/03/2019,4,SP 1 da Villafranca di Forlì al confine provinciale,4456,00,4186,270,3515,941,4456,0
2019/03,607,22/03/2019,5,SP 1 da Villafranca di Forlì al confine provinciale,4448,00,4198,250,3460,988,4448,0
2019/03,607,23/03/2019,6,SP 1 da Villafranca di Forlì al confine provinciale,3378,00,3314,64,2390,988,0,3378
2019/03,607,24/03/2019,7,SP 1 da Villafranca di Forlì al confine provinciale,3642,00,3626,16,2671,971,0,3642
2019/03,607,25/03/2019,1,SP 1 da Villafranca di Forlì al confine provinciale,4218,00,3932,286,3357,861,4218,0
2019/03,607,26/03/2019,2,SP 1 da Villafranca di Forlì al confine provinciale,4267,00,3990,277,3396,871,4267,0
2019/03,607,27/03/2019,3,SP 1 da Villafranca di Forlì al confine provinciale,4521,00,4294,227,3564,957,4521,0
2019/03,607,28/03/2019,4,SP 1 da Villafranca di Forlì al confine provinciale,4561,10,4272,288,3568,993,4561,0
2019/03,608,15/03/2019,5,SP 140 da Diegaro (SS 9) a Pievesestina (E 45),14704,20,13177,1525,11365,3339,14704,0
2019/03,608,16/03/2019,6,SP 140 da Diegaro (SS 9) a Pievesestina (E 45),11538,00,11005,533,8384,3154,0,11538
2019/03,608,17/03/2019,7,SP 140 da Diegaro (SS 9) a Pievesestina (E 45),8785,00,8644,141,6282,2503,0,8785
2019/03,608,18/03/2019,1,SP 140 da Diegaro (SS 9) a Pievesestina (E 45),14138,00,12790,1348,11078,3060,14138,0
2019/03,608,19/03/2019,2,SP 140 da Diegaro (SS 9) a Pievesestina (E 45),14178,10,12773,1404,11173,3005,14178,0
2019/03,608,20/03/2019,3,SP 140 da Diegaro (SS 9) a Pievesestina (E 45),14200,30,12758,1439,11104,3096,14200,0
2019/03,608,21/03/2019,4,SP 140 da Diegaro (SS 9) a Pievesestina (E 45),14480,00,13102,1378,11229,3251,14480,0
2019/03,608,22/03/2019,5,SP 140 da Diegaro (SS 9) a Pievesestina (E 45),14529,10,13043,1485,11146,3383,14529,0
2019/03,608,23/03/2019,6,SP 140 da Diegaro (SS 9) a Pievesestina (E 45),11063,00,10498,565,7874,3189,0,11063
2019/03,608,24/03/2019,7,SP 140 da Diegaro (SS 9) a Pievesestina (E 45),8923,00,8781,142,6365,2558,0,8923
2019/03,608,25/03/2019,1,SP 140 da Diegaro (SS 9) a Pievesestina (E 45),13839,30,12400,1436,10951,2888,13839,0
2019/03,608,26/03/2019,2,SP 140 da Diegaro (SS 9) a Pievesestina (E 45),14298,20,12782,1514,11291,3007,14298,0
2019/03,608,27/03/2019,3,SP 140 da Diegaro (SS 9) a Pievesestina (E 45),14493,40,13021,1468,11369,3124,14493,0
2019/03,608,28/03/2019,4,SP 140 da Diegaro (SS 9) a Pievesestina (E 45),14398,00,12952,1446,11142,3256,14398,0
2019/03,609,15/03/2019,5,SP 4 dal bivio SP22 (per SS 12) al bivio SP 26 (per Pavullo nel Frignano),4255,00,3912,343,3169,1086,4255,0
2019/03,609,16/03/2019,6,SP 4 dal bivio SP22 (per SS 12) al bivio SP 26 (per Pavullo nel Frignano),4821,00,4718,103,3771,1050,0,4821
2019/03,609,17/03/2019,7,SP 4 dal bivio SP22 (per SS 12) al bivio SP 26 (per Pavullo nel Frignano),5561,00,5520,41,4629,932,0,5561
2019/03,609,18/03/2019,1,SP 4 dal bivio SP22 (per SS 12) al bivio SP 26 (per Pavullo nel Frignano),3674,00,3250,424,2906,768,3674,0
2019/03,609,19/03/2019,2,SP 4 dal bivio SP22 (per SS 12) al bivio SP 26 (per Pavullo nel Frignano),3561,00,3133,428,2804,757,3561,0
2019/03,609,20/03/2019,3,SP 4 dal bivio SP22 (per SS 12) al bivio SP 26 (per Pavullo nel Frignano),3758,00,3351,407,2962,796,3758,0
2019/03,609,21/03/2019,4,SP 4 dal bivio SP22 (per SS 12) al bivio SP 26 (per Pavullo nel Frignano),4126,00,3711,415,3245,881,4126,0
2019/03,609,22/03/2019,5,SP 4 dal bivio SP22 (per SS 12) al bivio SP 26 (per Pavullo nel Frignano),4665,00,4224,441,3585,1080,4665,0
2019/03,609,23/03/2019,6,SP 4 dal bivio SP22 (per SS 12) al bivio SP 26 (per Pavullo nel Frignano),5048,00,4953,95,3925,1123,0,5048
2019/03,609,24/03/2019,7,SP 4 dal bivio SP22 (per SS 12) al bivio SP 26 (per Pavullo nel Frignano),6293,10,6249,43,5203,1090,0,6293
2019/03,609,26/03/2019,2,SP 4 dal bivio SP22 (per SS 12) al bivio SP 26 (per Pavullo nel Frignano),3378,00,2980,398,2666,712,3378,0
2019/03,609,27/03/2019,3,SP 4 dal bivio SP22 (per SS 12) al bivio SP 26 (per Pavullo nel Frignano),3570,00,3200,370,2767,803,3570,0
2019/03,609,28/03/2019,4,SP 4 dal bivio SP22 (per SS 12) al bivio SP 26 (per Pavullo nel Frignano),3968,00,3534,434,3138,830,3968,0
2019/03,610,15/03/2019,5,SP 11 da Soragna a Roncole Verdi,4052,00,3747,305,3064,988,4052,0
2019/03,610,16/03/2019,6,SP 11 da Soragna a Roncole Verdi,3422,00,3304,118,2562,860,0,3422
2019/03,610,17/03/2019,7,SP 11 da Soragna a Roncole Verdi,2949,00,2917,32,2328,621,0,2949
2019/03,610,18/03/2019,1,SP 11 da Soragna a Roncole Verdi,3653,00,3318,335,2927,726,3653,0
2019/03,610,19/03/2019,2,SP 11 da Soragna a Roncole Verdi,3941,00,3575,366,3196,745,3941,0
2019/03,610,20/03/2019,3,SP 11 da Soragna a Roncole Verdi,3858,00,3528,330,3064,794,3858,0
2019/03,610,21/03/2019,4,SP 11 da Soragna a Roncole Verdi,3965,00,3605,360,3150,815,3965,0
2019/03,610,22/03/2019,5,SP 11 da Soragna a Roncole Verdi,3993,00,3677,316,3081,912,3993,0
2019/03,610,23/03/2019,6,SP 11 da Soragna a Roncole Verdi,3062,00,2956,106,2179,883,0,3062
2019/03,610,24/03/2019,7,SP 11 da Soragna a Roncole Verdi,3339,00,3306,33,2592,747,0,3339
2019/03,610,25/03/2019,1,SP 11 da Soragna a Roncole Verdi,3666,00,3390,276,2938,728,3666,0
2019/03,610,26/03/2019,2,SP 11 da Soragna a Roncole Verdi,4517,00,4103,414,3760,757,4517,0
2019/03,610,27/03/2019,3,SP 11 da Soragna a Roncole Verdi,3712,00,3396,316,2931,781,3712,0
2019/03,610,28/03/2019,4,SP 11 da Soragna a Roncole Verdi,4209,00,3835,374,3421,788,4209,0
2019/03,611,15/03/2019,5,SP 357R da Fornovo di Taro al bivio SP 93 per Fidenza,,,,,,,,
2019/03,611,16/03/2019,6,SP 357R da Fornovo di Taro al bivio SP 93 per Fidenza,,,,,,,,
2019/03,611,17/03/2019,7,SP 357R da Fornovo di Taro al bivio SP 93 per Fidenza,,,,,,,,
2019/03,611,18/03/2019,1,SP 357R da Fornovo di Taro al bivio SP 93 per Fidenza,,,,,,,,
2019/03,611,19/03/2019,2,SP 357R da Fornovo di Taro al bivio SP 93 per Fidenza,,,,,,,,
2019/03,611,20/03/2019,3,SP 357R da Fornovo di Taro al bivio SP 93 per Fidenza,,,,,,,,
2019/03,611,21/03/2019,4,SP 357R da Fornovo di Taro al bivio SP 93 per Fidenza,,,,,,,,
2019/03,611,22/03/2019,5,SP 357R da Fornovo di Taro al bivio SP 93 per Fidenza,,,,,,,,
2019/03,611,23/03/2019,6,SP 357R da Fornovo di Taro al bivio SP 93 per Fidenza,,,,,,,,
2019/03,611,24/03/2019,7,SP 357R da Fornovo di Taro al bivio SP 93 per Fidenza,,,,,,,,
2019/03,611,25/03/2019,1,SP 357R da Fornovo di Taro al bivio SP 93 per Fidenza,,,,,,,,
2019/03,611,26/03/2019,2,SP 357R da Fornovo di Taro al bivio SP 93 per Fidenza,,,,,,,,
2019/03,611,27/03/2019,3,SP 357R da Fornovo di Taro al bivio SP 93 per Fidenza,,,,,,,,
2019/03,611,28/03/2019,4,SP 357R da Fornovo di Taro al bivio SP 93 per Fidenza,,,,,,,,
2019/03,612,15/03/2019,5,SP 665R dalla località Pilastro a Langhirano,19126,10,17894,1231,15088,4038,19126,0
2019/03,612,16/03/2019,6,SP 665R dalla località Pilastro a Langhirano,15791,00,15562,229,11794,3997,0,15791
2019/03,612,17/03/2019,7,SP 665R dalla località Pilastro a Langhirano,12984,00,12906,78,9855,3129,0,12984
2019/03,612,18/03/2019,1,SP 665R dalla località Pilastro a Langhirano,17546,10,16542,1003,14385,3161,17546,0
2019/03,612,19/03/2019,2,SP 665R dalla località Pilastro a Langhirano,18071,00,16949,1122,14652,3419,18071,0
2019/03,612,20/03/2019,3,SP 665R dalla località Pilastro a Langhirano,17736,10,16632,1103,14266,3470,17736,0
2019/03,612,21/03/2019,4,SP 665R dalla località Pilastro a Langhirano,18257,00,17111,1146,14618,3639,18257,0
2019/03,612,22/03/2019,5,SP 665R dalla località Pilastro a Langhirano,18353,00,17189,1164,14461,3892,18353,0
2019/03,612,23/03/2019,6,SP 665R dalla località Pilastro a Langhirano,15390,10,15091,298,11523,3867,0,15390
2019/03,612,24/03/2019,7,SP 665R dalla località Pilastro a Langhirano,14286,00,14212,74,10968,3318,0,14286
2019/03,612,25/03/2019,1,SP 665R dalla località Pilastro a Langhirano,16893,20,15808,1083,13705,3188,16893,0
2019/03,612,26/03/2019,2,SP 665R dalla località Pilastro a Langhirano,18005,10,16854,1150,14588,3417,18005,0
2019/03,612,27/03/2019,3,SP 665R dalla località Pilastro a Langhirano,17840,10,16694,1145,14334,3506,17840,0
2019/03,612,28/03/2019,4,SP 665R dalla località Pilastro a Langhirano,18400,00,17312,1088,14661,3739,18400,0
2019/03,613,15/03/2019,5,SP 16 dalla località Basilicanova al bivio SP 32 centro abitato Mamiano,7292,10,7006,285,5464,1828,7292,0
2019/03,613,16/03/2019,6,SP 16 dalla località Basilicanova al bivio SP 32 centro abitato Mamiano,6110,00,5980,130,4452,1658,0,6110
2019/03,613,17/03/2019,7,SP 16 dalla località Basilicanova al bivio SP 32 centro abitato Mamiano,4729,10,4686,42,3462,1267,0,4729
2019/03,613,18/03/2019,1,SP 16 dalla località Basilicanova al bivio SP 32 centro abitato Mamiano,6754,00,6466,288,5367,1387,6754,0
2019/03,613,19/03/2019,2,SP 16 dalla località Basilicanova al bivio SP 32 centro abitato Mamiano,7005,00,6683,322,5515,1490,7005,0
2019/03,613,20/03/2019,3,SP 16 dalla località Basilicanova al bivio SP 32 centro abitato Mamiano,7146,00,6842,304,5649,1497,7146,0
2019/03,613,21/03/2019,4,SP 16 dalla località Basilicanova al bivio SP 32 centro abitato Mamiano,7090,10,6755,334,5548,1542,7090,0
2019/03,613,22/03/2019,5,SP 16 dalla località Basilicanova al bivio SP 32 centro abitato Mamiano,7195,00,6865,330,5473,1722,7195,0
2019/03,613,23/03/2019,6,SP 16 dalla località Basilicanova al bivio SP 32 centro abitato Mamiano,5995,10,5845,149,4360,1635,0,5995
2019/03,613,24/03/2019,7,SP 16 dalla località Basilicanova al bivio SP 32 centro abitato Mamiano,4792,00,4746,46,3500,1292,0,4792
2019/03,613,25/03/2019,1,SP 16 dalla località Basilicanova al bivio SP 32 centro abitato Mamiano,6560,00,6253,307,5211,1349,6560,0
2019/03,613,26/03/2019,2,SP 16 dalla località Basilicanova al bivio SP 32 centro abitato Mamiano,6923,00,6619,304,5419,1504,6923,0
2019/03,613,27/03/2019,3,SP 16 dalla località Basilicanova al bivio SP 32 centro abitato Mamiano,6903,00,6579,324,5387,1516,6903,0
2019/03,613,28/03/2019,4,SP 16 dalla località Basilicanova al bivio SP 32 centro abitato Mamiano,7023,00,6703,320,5464,1559,7023,0
2019/03,614,15/03/2019,5,SP 587R dal bivio SP 10R alla A 21Dir,7594,20,6911,681,5831,1763,7594,0
2019/03,614,16/03/2019,6,SP 587R dal bivio SP 10R alla A 21Dir,6710,00,6485,225,4859,1851,0,6710
2019/03,614,17/03/2019,7,SP 587R dal bivio SP 10R alla A 21Dir,8956,00,8902,54,7386,1570,0,8956
2019/03,614,18/03/2019,1,SP 587R dal bivio SP 10R alla A 21Dir,7120,00,6533,587,5763,1357,7120,0
2019/03,614,19/03/2019,2,SP 587R dal bivio SP 10R alla A 21Dir,7225,00,6607,618,5792,1433,7225,0
2019/03,614,20/03/2019,3,SP 587R dal bivio SP 10R alla A 21Dir,7246,10,6659,586,5789,1457,7246,0
2019/03,614,21/03/2019,4,SP 587R dal bivio SP 10R alla A 21Dir,7213,00,6652,561,5641,1572,7213,0
2019/03,614,22/03/2019,5,SP 587R dal bivio SP 10R alla A 21Dir,7544,00,6882,662,5860,1684,7544,0
2019/03,614,23/03/2019,6,SP 587R dal bivio SP 10R alla A 21Dir,5843,00,5607,236,4347,1496,0,5843
2019/03,614,24/03/2019,7,SP 587R dal bivio SP 10R alla A 21Dir,5217,00,5165,52,3888,1329,0,5217
2019/03,614,25/03/2019,1,SP 587R dal bivio SP 10R alla A 21Dir,7183,10,6608,574,5832,1351,7183,0
2019/03,614,26/03/2019,2,SP 587R dal bivio SP 10R alla A 21Dir,8095,00,7402,693,6652,1443,8095,0
2019/03,614,27/03/2019,3,SP 587R dal bivio SP 10R alla A 21Dir,7493,10,6883,609,5999,1494,7493,0
2019/03,614,28/03/2019,4,SP 587R dal bivio SP 10R alla A 21Dir,8276,00,7589,687,6682,1594,8276,0
2019/03,615,15/03/2019,5,Piazzale Milano (ex SS 9) c/o ponte fiume Po,28726,160,28036,674,20908,7818,28726,0
2019/03,615,16/03/2019,6,Piazzale Milano (ex SS 9) c/o ponte fiume Po,28858,110,28482,365,20681,8177,0,28858
2019/03,615,17/03/2019,7,Piazzale Milano (ex SS 9) c/o ponte fiume Po,23800,40,23685,111,17226,6574,0,23800
2019/03,615,18/03/2019,1,Piazzale Milano (ex SS 9) c/o ponte fiume Po,26614,170,25978,619,20298,6316,26614,0
2019/03,615,19/03/2019,2,Piazzale Milano (ex SS 9) c/o ponte fiume Po,26385,190,25811,555,20176,6209,26385,0
2019/03,615,20/03/2019,3,Piazzale Milano (ex SS 9) c/o ponte fiume Po,26602,170,25977,608,20070,6532,26602,0
2019/03,615,21/03/2019,4,Piazzale Milano (ex SS 9) c/o ponte fiume Po,26982,210,26325,636,20239,6743,26982,0
2019/03,615,22/03/2019,5,Piazzale Milano (ex SS 9) c/o ponte fiume Po,28449,170,27813,619,20772,7677,28449,0
2019/03,615,23/03/2019,6,Piazzale Milano (ex SS 9) c/o ponte fiume Po,28221,40,27854,363,20131,8090,0,28221
2019/03,615,24/03/2019,7,Piazzale Milano (ex SS 9) c/o ponte fiume Po,24252,20,24114,136,17383,6869,0,24252
2019/03,615,25/03/2019,1,Piazzale Milano (ex SS 9) c/o ponte fiume Po,25943,160,25386,541,19485,6458,25943,0
2019/03,615,26/03/2019,2,Piazzale Milano (ex SS 9) c/o ponte fiume Po,28237,400,27375,822,21988,6249,28237,0
2019/03,615,27/03/2019,3,Piazzale Milano (ex SS 9) c/o ponte fiume Po,26830,120,26215,603,20226,6604,26830,0
2019/03,615,28/03/2019,4,Piazzale Milano (ex SS 9) c/o ponte fiume Po,27181,140,26560,607,20381,6800,27181,0
2019/03,616,15/03/2019,5,SP 588R dal casello A 21 di Castelvetro Piacentino a Villanova d'Arda,4309,00,4030,279,3366,943,4309,0
2019/03,616,16/03/2019,6,SP 588R dal casello A 21 di Castelvetro Piacentino a Villanova d'Arda,4042,00,3981,61,2978,1064,0,4042
2019/03,616,17/03/2019,7,SP 588R dal casello A 21 di Castelvetro Piacentino a Villanova d'Arda,3650,00,3625,25,2807,843,0,3650
2019/03,616,18/03/2019,1,SP 588R dal casello A 21 di Castelvetro Piacentino a Villanova d'Arda,3959,00,3648,311,3219,740,3959,0
2019/03,616,19/03/2019,2,SP 588R dal casello A 21 di Castelvetro Piacentino a Villanova d'Arda,4042,00,3714,328,3277,765,4042,0
2019/03,616,20/03/2019,3,SP 588R dal casello A 21 di Castelvetro Piacentino a Villanova d'Arda,4089,00,3776,313,3220,869,4089,0
2019/03,616,21/03/2019,4,SP 588R dal casello A 21 di Castelvetro Piacentino a Villanova d'Arda,4134,00,3794,340,3288,846,4134,0
2019/03,616,22/03/2019,5,SP 588R dal casello A 21 di Castelvetro Piacentino a Villanova d'Arda,4243,00,3906,337,3288,955,4243,0
2019/03,616,23/03/2019,6,SP 588R dal casello A 21 di Castelvetro Piacentino a Villanova d'Arda,4291,00,4205,86,3134,1157,0,4291
2019/03,616,24/03/2019,7,SP 588R dal casello A 21 di Castelvetro Piacentino a Villanova d'Arda,3776,00,3733,43,2877,899,0,3776
2019/03,616,25/03/2019,1,SP 588R dal casello A 21 di Castelvetro Piacentino a Villanova d'Arda,3827,10,3532,294,3118,709,3827,0
2019/03,616,26/03/2019,2,SP 588R dal casello A 21 di Castelvetro Piacentino a Villanova d'Arda,4363,00,3932,431,3566,797,4363,0
2019/03,616,27/03/2019,3,SP 588R dal casello A 21 di Castelvetro Piacentino a Villanova d'Arda,4058,10,3725,332,3254,804,4058,0
2019/03,616,28/03/2019,4,SP 588R dal casello A 21 di Castelvetro Piacentino a Villanova d'Arda,4443,00,4092,351,3615,828,4443,0
2019/03,617,15/03/2019,5,SP 7 dalla intersezione tangenziale sud/ovest di Piacenza a San Nicolò,8316,00,7851,465,6538,1778,8316,0
2019/03,617,16/03/2019,6,SP 7 dalla intersezione tangenziale sud/ovest di Piacenza a San Nicolò,7528,00,7409,119,5612,1916,0,7528
2019/03,617,17/03/2019,7,SP 7 dalla intersezione tangenziale sud/ovest di Piacenza a San Nicolò,5360,00,5344,16,4042,1318,0,5360
2019/03,617,18/03/2019,1,SP 7 dalla intersezione tangenziale sud/ovest di Piacenza a San Nicolò,7829,00,7492,337,6436,1393,7829,0
2019/03,617,19/03/2019,2,SP 7 dalla intersezione tangenziale sud/ovest di Piacenza a San Nicolò,8311,00,7898,413,6721,1590,8311,0
2019/03,617,20/03/2019,3,SP 7 dalla intersezione tangenziale sud/ovest di Piacenza a San Nicolò,8221,10,7712,508,6680,1541,8221,0
2019/03,617,21/03/2019,4,SP 7 dalla intersezione tangenziale sud/ovest di Piacenza a San Nicolò,7853,00,7459,394,6291,1562,7853,0
2019/03,617,22/03/2019,5,SP 7 dalla intersezione tangenziale sud/ovest di Piacenza a San Nicolò,8297,20,7886,409,6499,1798,8297,0
2019/03,617,23/03/2019,6,SP 7 dalla intersezione tangenziale sud/ovest di Piacenza a San Nicolò,7407,00,7303,104,5554,1853,0,7407
2019/03,617,24/03/2019,7,SP 7 dalla intersezione tangenziale sud/ovest di Piacenza a San Nicolò,5727,00,5711,16,4385,1342,0,5727
2019/03,617,25/03/2019,1,SP 7 dalla intersezione tangenziale sud/ovest di Piacenza a San Nicolò,7616,10,7210,405,6283,1333,7616,0
2019/03,617,26/03/2019,2,SP 7 dalla intersezione tangenziale sud/ovest di Piacenza a San Nicolò,7785,10,7367,417,6383,1402,7785,0
2019/03,617,27/03/2019,3,SP 7 dalla intersezione tangenziale sud/ovest di Piacenza a San Nicolò,7835,10,7466,368,6334,1501,7835,0
2019/03,617,28/03/2019,4,SP 7 dalla intersezione tangenziale sud/ovest di Piacenza a San Nicolò,7994,00,7508,486,6482,1512,7994,0
2019/03,618,15/03/2019,5,SP 253R fra Bagnacavallo (A14 Dir) e Godo (bivio SP 302R),7964,00,7418,546,6209,1755,7964,0
2019/03,618,16/03/2019,6,SP 253R fra Bagnacavallo (A14 Dir) e Godo (bivio SP 302R),6909,00,6788,121,5187,1722,0,6909
2019/03,618,17/03/2019,7,SP 253R fra Bagnacavallo (A14 Dir) e Godo (bivio SP 302R),5066,00,5033,33,3805,1261,0,5066
2019/03,618,18/03/2019,1,SP 253R fra Bagnacavallo (A14 Dir) e Godo (bivio SP 302R),7373,00,6858,515,5997,1376,7373,0
2019/03,618,19/03/2019,2,SP 253R fra Bagnacavallo (A14 Dir) e Godo (bivio SP 302R),7810,00,7209,601,6307,1503,7810,0
2019/03,618,20/03/2019,3,SP 253R fra Bagnacavallo (A14 Dir) e Godo (bivio SP 302R),7734,00,7196,538,6115,1619,7734,0
2019/03,618,21/03/2019,4,SP 253R fra Bagnacavallo (A14 Dir) e Godo (bivio SP 302R),7841,00,7318,523,6236,1605,7841,0
2019/03,618,22/03/2019,5,SP 253R fra Bagnacavallo (A14 Dir) e Godo (bivio SP 302R),8171,00,7661,510,6387,1784,8171,0
2019/03,618,23/03/2019,6,SP 253R fra Bagnacavallo (A14 Dir) e Godo (bivio SP 302R),6583,10,6461,121,4852,1731,0,6583
2019/03,618,24/03/2019,7,SP 253R fra Bagnacavallo (A14 Dir) e Godo (bivio SP 302R),5453,00,5420,33,4061,1392,0,5453
2019/03,618,25/03/2019,1,SP 253R fra Bagnacavallo (A14 Dir) e Godo (bivio SP 302R),7658,00,7054,604,6232,1426,7658,0
2019/03,618,26/03/2019,2,SP 253R fra Bagnacavallo (A14 Dir) e Godo (bivio SP 302R),7809,00,7177,632,6317,1492,7809,0
2019/03,618,27/03/2019,3,SP 253R fra Bagnacavallo (A14 Dir) e Godo (bivio SP 302R),8050,10,7480,569,6380,1670,8050,0
2019/03,618,28/03/2019,4,SP 253R fra Bagnacavallo (A14 Dir) e Godo (bivio SP 302R),8022,00,7476,546,6370,1652,8022,0
2019/03,619,15/03/2019,5,SP 8 da Bagnacavallo al bivio SS 16,3357,00,3173,184,2525,832,3357,0
2019/03,619,16/03/2019,6,SP 8 da Bagnacavallo al bivio SS 16,2949,20,2901,46,2170,779,0,2949
2019/03,619,17/03/2019,7,SP 8 da Bagnacavallo al bivio SS 16,2452,00,2433,19,1822,630,0,2452
2019/03,619,18/03/2019,1,SP 8 da Bagnacavallo al bivio SS 16,3288,20,3080,206,2613,675,3288,0
2019/03,619,19/03/2019,2,SP 8 da Bagnacavallo al bivio SS 16,3249,10,3043,205,2554,695,3249,0
2019/03,619,20/03/2019,3,SP 8 da Bagnacavallo al bivio SS 16,3273,00,3062,211,2567,706,3273,0
2019/03,619,21/03/2019,4,SP 8 da Bagnacavallo al bivio SS 16,3353,00,3122,231,2627,726,3353,0
2019/03,619,22/03/2019,5,SP 8 da Bagnacavallo al bivio SS 16,,,,,,,,
2019/03,619,23/03/2019,6,SP 8 da Bagnacavallo al bivio SS 16,,,,,,,,
2019/03,619,24/03/2019,7,SP 8 da Bagnacavallo al bivio SS 16,,,,,,,,
2019/03,619,25/03/2019,1,SP 8 da Bagnacavallo al bivio SS 16,,,,,,,,
2019/03,619,26/03/2019,2,SP 8 da Bagnacavallo al bivio SS 16,,,,,,,,
2019/03,619,27/03/2019,3,SP 8 da Bagnacavallo al bivio SS 16,,,,,,,,
2019/03,619,28/03/2019,4,SP 8 da Bagnacavallo al bivio SS 16,,,,,,,,
2019/03,620,15/03/2019,5,SP 113 sulla variante di San Martino in Rio/Correggio c/o le località Prato/Gazzata,8829,00,7663,1166,6846,1983,8829,0
2019/03,620,16/03/2019,6,SP 113 sulla variante di San Martino in Rio/Correggio c/o le località Prato/Gazzata,6421,10,6199,221,4616,1805,0,6421
2019/03,620,17/03/2019,7,SP 113 sulla variante di San Martino in Rio/Correggio c/o le località Prato/Gazzata,5411,00,5351,60,3879,1532,0,5411
2019/03,620,18/03/2019,1,SP 113 sulla variante di San Martino in Rio/Correggio c/o le località Prato/Gazzata,8397,00,7270,1127,6819,1578,8397,0
2019/03,620,19/03/2019,2,SP 113 sulla variante di San Martino in Rio/Correggio c/o le località Prato/Gazzata,8294,00,7219,1075,6638,1656,8294,0
2019/03,620,20/03/2019,3,SP 113 sulla variante di San Martino in Rio/Correggio c/o le località Prato/Gazzata,8538,00,7426,1112,6779,1759,8538,0
2019/03,620,21/03/2019,4,SP 113 sulla variante di San Martino in Rio/Correggio c/o le località Prato/Gazzata,8797,00,7691,1106,6947,1850,8797,0
2019/03,620,22/03/2019,5,SP 113 sulla variante di San Martino in Rio/Correggio c/o le località Prato/Gazzata,9078,00,7998,1080,7050,2028,9078,0
2019/03,620,23/03/2019,6,SP 113 sulla variante di San Martino in Rio/Correggio c/o le località Prato/Gazzata,6032,10,5830,201,4174,1858,0,6032
2019/03,620,24/03/2019,7,SP 113 sulla variante di San Martino in Rio/Correggio c/o le località Prato/Gazzata,5186,00,5120,66,3591,1595,0,5186
2019/03,620,25/03/2019,1,SP 113 sulla variante di San Martino in Rio/Correggio c/o le località Prato/Gazzata,8426,00,7381,1045,6750,1676,8426,0
2019/03,620,26/03/2019,2,SP 113 sulla variante di San Martino in Rio/Correggio c/o le località Prato/Gazzata,8553,00,7450,1103,6836,1717,8553,0
2019/03,620,27/03/2019,3,SP 113 sulla variante di San Martino in Rio/Correggio c/o le località Prato/Gazzata,9433,00,8241,1192,7564,1869,9433,0
2019/03,620,28/03/2019,4,SP 113 sulla variante di San Martino in Rio/Correggio c/o le località Prato/Gazzata,9751,00,8518,1233,7929,1822,9751,0
2019/03,621,15/03/2019,5,SP 513R a nord di Vetto,2270,00,2151,119,1749,521,2270,0
2019/03,621,16/03/2019,6,SP 513R a nord di Vetto,2275,00,2220,55,1836,439,0,2275
2019/03,621,17/03/2019,7,SP 513R a nord di Vetto,2499,00,2480,19,2067,432,0,2499
2019/03,621,18/03/2019,1,SP 513R a nord di Vetto,2000,00,1858,142,1564,436,2000,0
2019/03,621,19/03/2019,2,SP 513R a nord di Vetto,2104,00,1990,114,1633,471,2104,0
2019/03,621,20/03/2019,3,SP 513R a nord di Vetto,1978,00,1868,110,1537,441,1978,0
2019/03,621,21/03/2019,4,SP 513R a nord di Vetto,2149,00,2014,135,1659,490,2149,0
2019/03,621,22/03/2019,5,SP 513R a nord di Vetto,2347,10,2229,117,1784,563,2347,0
2019/03,621,23/03/2019,6,SP 513R a nord di Vetto,2302,00,2251,51,1815,487,0,2302
2019/03,621,24/03/2019,7,SP 513R a nord di Vetto,2682,00,2670,12,2214,468,0,2682
2019/03,621,25/03/2019,1,SP 513R a nord di Vetto,2135,00,1977,158,1643,492,2135,0
2019/03,621,26/03/2019,2,SP 513R a nord di Vetto,1951,00,1828,123,1549,402,1951,0
2019/03,621,27/03/2019,3,SP 513R a nord di Vetto,2087,00,1967,120,1589,498,2087,0
2019/03,621,28/03/2019,4,SP 513R a nord di Vetto,2077,00,1965,112,1597,480,2077,0
2019/03,622,15/03/2019,5,SP 468R tra Correggio e il confine provinciale,,,,,,,,
2019/03,622,16/03/2019,6,SP 468R tra Correggio e il confine provinciale,,,,,,,,
2019/03,622,17/03/2019,7,SP 468R tra Correggio e il confine provinciale,,,,,,,,
2019/03,622,18/03/2019,1,SP 468R tra Correggio e il confine provinciale,,,,,,,,
2019/03,622,19/03/2019,2,SP 468R tra Correggio e il confine provinciale,,,,,,,,
2019/03,622,20/03/2019,3,SP 468R tra Correggio e il confine provinciale,,,,,,,,
2019/03,622,21/03/2019,4,SP 468R tra Correggio e il confine provinciale,,,,,,,,
2019/03,622,22/03/2019,5,SP 468R tra Correggio e il confine provinciale,,,,,,,,
2019/03,622,23/03/2019,6,SP 468R tra Correggio e il confine provinciale,,,,,,,,
2019/03,622,24/03/2019,7,SP 468R tra Correggio e il confine provinciale,,,,,,,,
2019/03,622,25/03/2019,1,SP 468R tra Correggio e il confine provinciale,,,,,,,,
2019/03,622,26/03/2019,2,SP 468R tra Correggio e il confine provinciale,,,,,,,,
2019/03,622,27/03/2019,3,SP 468R tra Correggio e il confine provinciale,,,,,,,,
2019/03,622,28/03/2019,4,SP 468R tra Correggio e il confine provinciale,,,,,,,,
2019/03,623,15/03/2019,5,SP 30 tra Campagnola Emilia e il confine provinciale,16354,10,15086,1267,12561,3793,16354,0
2019/03,623,16/03/2019,6,SP 30 tra Campagnola Emilia e il confine provinciale,13975,10,13689,285,9907,4068,0,13975
2019/03,623,17/03/2019,7,SP 30 tra Campagnola Emilia e il confine provinciale,11125,00,11051,74,7890,3235,0,11125
2019/03,623,18/03/2019,1,SP 30 tra Campagnola Emilia e il confine provinciale,15377,00,14139,1238,12255,3122,15377,0
2019/03,623,19/03/2019,2,SP 30 tra Campagnola Emilia e il confine provinciale,15743,10,14419,1323,12519,3224,15743,0
2019/03,623,20/03/2019,3,SP 30 tra Campagnola Emilia e il confine provinciale,16136,00,14879,1257,12671,3465,16136,0
2019/03,623,21/03/2019,4,SP 30 tra Campagnola Emilia e il confine provinciale,16054,00,14809,1245,12699,3355,16054,0
2019/03,623,22/03/2019,5,SP 30 tra Campagnola Emilia e il confine provinciale,16525,20,15344,1179,12673,3852,16525,0
2019/03,623,23/03/2019,6,SP 30 tra Campagnola Emilia e il confine provinciale,13293,00,13035,258,9246,4047,0,13293
2019/03,623,24/03/2019,7,SP 30 tra Campagnola Emilia e il confine provinciale,11257,00,11178,79,7806,3451,0,11257
2019/03,623,25/03/2019,1,SP 30 tra Campagnola Emilia e il confine provinciale,14912,10,13698,1213,11861,3051,14912,0
2019/03,623,26/03/2019,2,SP 30 tra Campagnola Emilia e il confine provinciale,15592,00,14437,1155,12428,3164,15592,0
2019/03,623,27/03/2019,3,SP 30 tra Campagnola Emilia e il confine provinciale,15798,00,14585,1213,12445,3353,15798,0
2019/03,623,28/03/2019,4,SP 30 tra Campagnola Emilia e il confine provinciale,16155,20,14949,1204,12707,3448,16155,0
2019/03,624,15/03/2019,5,SP 23 tra Rivalta e la variante di Montecavolo,11982,00,11628,354,9050,2932,11982,0
2019/03,624,16/03/2019,6,SP 23 tra Rivalta e la variante di Montecavolo,11658,00,11560,98,8364,3294,0,11658
2019/03,624,17/03/2019,7,SP 23 tra Rivalta e la variante di Montecavolo,9031,00,9004,27,6606,2425,0,9031
2019/03,624,18/03/2019,1,SP 23 tra Rivalta e la variante di Montecavolo,11313,00,10949,364,8915,2398,11313,0
2019/03,624,19/03/2019,2,SP 23 tra Rivalta e la variante di Montecavolo,11466,00,11118,348,8896,2570,11466,0
2019/03,624,20/03/2019,3,SP 23 tra Rivalta e la variante di Montecavolo,11877,10,11490,386,9167,2710,11877,0
2019/03,624,21/03/2019,4,SP 23 tra Rivalta e la variante di Montecavolo,11381,00,11023,358,8705,2676,11381,0
2019/03,624,22/03/2019,5,SP 23 tra Rivalta e la variante di Montecavolo,11941,00,11610,331,8981,2960,11941,0
2019/03,624,23/03/2019,6,SP 23 tra Rivalta e la variante di Montecavolo,11374,00,11254,120,8175,3199,0,11374
2019/03,624,24/03/2019,7,SP 23 tra Rivalta e la variante di Montecavolo,9408,00,9377,31,6898,2510,0,9408
2019/03,624,25/03/2019,1,SP 23 tra Rivalta e la variante di Montecavolo,10970,10,10615,354,8608,2362,10970,0
2019/03,624,26/03/2019,2,SP 23 tra Rivalta e la variante di Montecavolo,11412,00,11024,388,8920,2492,11412,0
2019/03,624,27/03/2019,3,SP 23 tra Rivalta e la variante di Montecavolo,11911,00,11507,404,9186,2725,11911,0
2019/03,624,28/03/2019,4,SP 23 tra Rivalta e la variante di Montecavolo,11629,00,11257,372,8954,2675,11629,0
2019/03,625,15/03/2019,5,SP 14 da Poggio Berni (bivio SP 73) a Sant'Arcangelo di Romagna,,,,,,,,
2019/03,625,16/03/2019,6,SP 14 da Poggio Berni (bivio SP 73) a Sant'Arcangelo di Romagna,,,,,,,,
2019/03,625,17/03/2019,7,SP 14 da Poggio Berni (bivio SP 73) a Sant'Arcangelo di Romagna,,,,,,,,
2019/03,625,18/03/2019,1,SP 14 da Poggio Berni (bivio SP 73) a Sant'Arcangelo di Romagna,,,,,,,,
2019/03,625,19/03/2019,2,SP 14 da Poggio Berni (bivio SP 73) a Sant'Arcangelo di Romagna,,,,,,,,
2019/03,625,20/03/2019,3,SP 14 da Poggio Berni (bivio SP 73) a Sant'Arcangelo di Romagna,,,,,,,,
2019/03,625,21/03/2019,4,SP 14 da Poggio Berni (bivio SP 73) a Sant'Arcangelo di Romagna,,,,,,,,
2019/03,625,22/03/2019,5,SP 14 da Poggio Berni (bivio SP 73) a Sant'Arcangelo di Romagna,,,,,,,,
2019/03,625,23/03/2019,6,SP 14 da Poggio Berni (bivio SP 73) a Sant'Arcangelo di Romagna,,,,,,,,
2019/03,625,24/03/2019,7,SP 14 da Poggio Berni (bivio SP 73) a Sant'Arcangelo di Romagna,,,,,,,,
2019/03,625,25/03/2019,1,SP 14 da Poggio Berni (bivio SP 73) a Sant'Arcangelo di Romagna,,,,,,,,
2019/03,625,26/03/2019,2,SP 14 da Poggio Berni (bivio SP 73) a Sant'Arcangelo di Romagna,,,,,,,,
2019/03,625,27/03/2019,3,SP 14 da Poggio Berni (bivio SP 73) a Sant'Arcangelo di Romagna,,,,,,,,
2019/03,625,28/03/2019,4,SP 14 da Poggio Berni (bivio SP 73) a Sant'Arcangelo di Romagna,,,,,,,,
2019/03,626,15/03/2019,5,SP 18 da San Clemente al bivio SP 132 (località Osteria Nuova),8486,10,8057,428,6435,2051,8486,0
2019/03,626,16/03/2019,6,SP 18 da San Clemente al bivio SP 132 (località Osteria Nuova),8200,10,8040,159,5945,2255,0,8200
2019/03,626,17/03/2019,7,SP 18 da San Clemente al bivio SP 132 (località Osteria Nuova),7705,10,7687,17,5926,1779,0,7705
2019/03,626,18/03/2019,1,SP 18 da San Clemente al bivio SP 132 (località Osteria Nuova),7469,10,7054,414,6107,1362,7469,0
2019/03,626,19/03/2019,2,SP 18 da San Clemente al bivio SP 132 (località Osteria Nuova),7815,00,7430,385,6294,1521,7815,0
2019/03,626,20/03/2019,3,SP 18 da San Clemente al bivio SP 132 (località Osteria Nuova),8059,00,7644,415,6457,1602,8059,0
2019/03,626,21/03/2019,4,SP 18 da San Clemente al bivio SP 132 (località Osteria Nuova),8301,00,7835,466,6637,1664,8301,0
2019/03,626,22/03/2019,5,SP 18 da San Clemente al bivio SP 132 (località Osteria Nuova),8265,00,7839,426,6501,1764,8265,0
2019/03,626,23/03/2019,6,SP 18 da San Clemente al bivio SP 132 (località Osteria Nuova),7856,00,7657,199,5875,1981,0,7856
2019/03,626,24/03/2019,7,SP 18 da San Clemente al bivio SP 132 (località Osteria Nuova),6795,00,6773,22,5105,1690,0,6795
2019/03,626,25/03/2019,1,SP 18 da San Clemente al bivio SP 132 (località Osteria Nuova),7976,00,7569,407,6448,1528,7976,0
2019/03,626,26/03/2019,2,SP 18 da San Clemente al bivio SP 132 (località Osteria Nuova),7816,00,7387,429,6315,1501,7816,0
2019/03,626,27/03/2019,3,SP 18 da San Clemente al bivio SP 132 (località Osteria Nuova),7919,20,7465,452,6308,1611,7919,0
2019/03,626,28/03/2019,4,SP 18 da San Clemente al bivio SP 132 (località Osteria Nuova),8256,00,7859,397,6546,1710,8256,0
2019/03,627,15/03/2019,5,SS 64 variante di Riola di Vergato,8690,30,8193,494,6736,1954,8690,0
2019/03,627,16/03/2019,6,SS 64 variante di Riola di Vergato,8278,00,8124,154,6444,1834,0,8278
2019/03,627,17/03/2019,7,SS 64 variante di Riola di Vergato,7427,00,7384,43,5710,1717,0,7427
2019/03,627,18/03/2019,1,SS 64 variante di Riola di Vergato,8166,00,7660,506,6619,1547,8166,0
2019/03,627,19/03/2019,2,SS 64 variante di Riola di Vergato,7872,00,7394,478,6361,1511,7872,0
2019/03,627,20/03/2019,3,SS 64 variante di Riola di Vergato,7994,10,7531,462,6360,1634,7994,0
2019/03,627,21/03/2019,4,SS 64 variante di Riola di Vergato,8417,10,7912,504,6667,1750,8417,0
2019/03,627,22/03/2019,5,SS 64 variante di Riola di Vergato,8849,00,8391,458,6862,1987,8849,0
2019/03,627,23/03/2019,6,SS 64 variante di Riola di Vergato,8522,00,8332,190,6561,1961,0,8522
2019/03,627,24/03/2019,7,SS 64 variante di Riola di Vergato,7828,00,7794,34,6102,1726,0,7828
2019/03,627,25/03/2019,1,SS 64 variante di Riola di Vergato,8500,10,8004,495,6844,1656,8500,0
2019/03,627,26/03/2019,2,SS 64 variante di Riola di Vergato,8184,00,7690,494,6578,1606,8184,0
2019/03,627,27/03/2019,3,SS 64 variante di Riola di Vergato,8253,40,7763,486,6579,1674,8253,0
2019/03,627,28/03/2019,4,SS 64 variante di Riola di Vergato,8384,10,7865,518,6713,1671,8384,0
2019/03,629,15/03/2019,5,SS 727 (tg Forli') tra intersezione SS 9 e l'intersezione SS 67,17786,00,16469,1317,13741,4045,17786,0
2019/03,629,16/03/2019,6,SS 727 (tg Forli') tra intersezione SS 9 e l'intersezione SS 67,12869,00,12561,308,9343,3526,0,12869
2019/03,629,17/03/2019,7,SS 727 (tg Forli') tra intersezione SS 9 e l'intersezione SS 67,11479,00,11426,53,8402,3077,0,11479
2019/03,629,18/03/2019,1,SS 727 (tg Forli') tra intersezione SS 9 e l'intersezione SS 67,16677,10,15587,1089,13470,3207,16677,0
2019/03,629,19/03/2019,2,SS 727 (tg Forli') tra intersezione SS 9 e l'intersezione SS 67,17163,00,16025,1138,13645,3518,17163,0
2019/03,629,20/03/2019,3,SS 727 (tg Forli') tra intersezione SS 9 e l'intersezione SS 67,17363,00,16190,1173,13688,3675,17363,0
2019/03,629,21/03/2019,4,SS 727 (tg Forli') tra intersezione SS 9 e l'intersezione SS 67,17044,00,15919,1125,13345,3699,17044,0
2019/03,629,22/03/2019,5,SS 727 (tg Forli') tra intersezione SS 9 e l'intersezione SS 67,18282,00,17014,1268,14099,4183,18282,0
2019/03,629,23/03/2019,6,SS 727 (tg Forli') tra intersezione SS 9 e l'intersezione SS 67,13071,00,12769,302,9226,3845,0,13071
2019/03,629,24/03/2019,7,SS 727 (tg Forli') tra intersezione SS 9 e l'intersezione SS 67,11879,00,11808,71,8512,3367,0,11879
2019/03,629,25/03/2019,1,SS 727 (tg Forli') tra intersezione SS 9 e l'intersezione SS 67,16983,00,15743,1240,13499,3484,16983,0
2019/03,629,26/03/2019,2,SS 727 (tg Forli') tra intersezione SS 9 e l'intersezione SS 67,17136,00,15969,1167,13623,3513,17136,0
2019/03,629,27/03/2019,3,SS 727 (tg Forli') tra intersezione SS 9 e l'intersezione SS 67,17415,10,16266,1148,13660,3755,17415,0
2019/03,629,28/03/2019,4,SS 727 (tg Forli') tra intersezione SS 9 e l'intersezione SS 67,17518,00,16391,1127,13700,3818,17518,0
2019/03,630,15/03/2019,5,SS 726 (tg Cesena) tra intersezione ex SS 71BIS e l'intersezione SP 304R,,,,,,,,
2019/03,630,16/03/2019,6,SS 726 (tg Cesena) tra intersezione ex SS 71BIS e l'intersezione SP 304R,,,,,,,,
2019/03,630,17/03/2019,7,SS 726 (tg Cesena) tra intersezione ex SS 71BIS e l'intersezione SP 304R,,,,,,,,
2019/03,630,18/03/2019,1,SS 726 (tg Cesena) tra intersezione ex SS 71BIS e l'intersezione SP 304R,,,,,,,,
2019/03,630,19/03/2019,2,SS 726 (tg Cesena) tra intersezione ex SS 71BIS e l'intersezione SP 304R,,,,,,,,
2019/03,630,20/03/2019,3,SS 726 (tg Cesena) tra intersezione ex SS 71BIS e l'intersezione SP 304R,,,,,,,,
2019/03,630,21/03/2019,4,SS 726 (tg Cesena) tra intersezione ex SS 71BIS e l'intersezione SP 304R,,,,,,,,
2019/03,630,22/03/2019,5,SS 726 (tg Cesena) tra intersezione ex SS 71BIS e l'intersezione SP 304R,,,,,,,,
2019/03,630,23/03/2019,6,SS 726 (tg Cesena) tra intersezione ex SS 71BIS e l'intersezione SP 304R,,,,,,,,
2019/03,630,24/03/2019,7,SS 726 (tg Cesena) tra intersezione ex SS 71BIS e l'intersezione SP 304R,,,,,,,,
2019/03,630,25/03/2019,1,SS 726 (tg Cesena) tra intersezione ex SS 71BIS e l'intersezione SP 304R,,,,,,,,
2019/03,630,26/03/2019,2,SS 726 (tg Cesena) tra intersezione ex SS 71BIS e l'intersezione SP 304R,,,,,,,,
2019/03,630,27/03/2019,3,SS 726 (tg Cesena) tra intersezione ex SS 71BIS e l'intersezione SP 304R,,,,,,,,
2019/03,630,28/03/2019,4,SS 726 (tg Cesena) tra intersezione ex SS 71BIS e l'intersezione SP 304R,,,,,,,,
2019/03,631,15/03/2019,5,SS 3Bis/E 45 tra Sarsina e San Piero in Bagno,,,,,,,,
2019/03,631,16/03/2019,6,SS 3Bis/E 45 tra Sarsina e San Piero in Bagno,,,,,,,,
2019/03,631,17/03/2019,7,SS 3Bis/E 45 tra Sarsina e San Piero in Bagno,,,,,,,,
2019/03,631,18/03/2019,1,SS 3Bis/E 45 tra Sarsina e San Piero in Bagno,,,,,,,,
2019/03,631,19/03/2019,2,SS 3Bis/E 45 tra Sarsina e San Piero in Bagno,,,,,,,,
2019/03,631,20/03/2019,3,SS 3Bis/E 45 tra Sarsina e San Piero in Bagno,,,,,,,,
2019/03,631,21/03/2019,4,SS 3Bis/E 45 tra Sarsina e San Piero in Bagno,,,,,,,,
2019/03,631,22/03/2019,5,SS 3Bis/E 45 tra Sarsina e San Piero in Bagno,,,,,,,,
2019/03,631,23/03/2019,6,SS 3Bis/E 45 tra Sarsina e San Piero in Bagno,,,,,,,,
2019/03,631,24/03/2019,7,SS 3Bis/E 45 tra Sarsina e San Piero in Bagno,,,,,,,,
2019/03,631,25/03/2019,1,SS 3Bis/E 45 tra Sarsina e San Piero in Bagno,,,,,,,,
2019/03,631,26/03/2019,2,SS 3Bis/E 45 tra Sarsina e San Piero in Bagno,,,,,,,,
2019/03,631,27/03/2019,3,SS 3Bis/E 45 tra Sarsina e San Piero in Bagno,,,,,,,,
2019/03,631,28/03/2019,4,SS 3Bis/E 45 tra Sarsina e San Piero in Bagno,,,,,,,,
2019/03,632,22/03/2019,5,SS 724Dir/tangenziale complanare sud alla A 1 in direzione Reggio Emilia - tra intersezione Modena/Sassuolo e intersezione SS 12,8016,00,7650,366,6474,1542,8016,0
2019/03,632,23/03/2019,6,SS 724Dir/tangenziale complanare sud alla A 1 in direzione Reggio Emilia - tra intersezione Modena/Sassuolo e intersezione SS 12,6686,00,6587,99,4957,1729,0,6686
2019/03,632,24/03/2019,7,SS 724Dir/tangenziale complanare sud alla A 1 in direzione Reggio Emilia - tra intersezione Modena/Sassuolo e intersezione SS 12,5378,00,5344,34,3908,1470,0,5378
2019/03,632,25/03/2019,1,SS 724Dir/tangenziale complanare sud alla A 1 in direzione Reggio Emilia - tra intersezione Modena/Sassuolo e intersezione SS 12,7815,00,7450,365,6417,1398,7815,0
2019/03,632,27/03/2019,3,SS 724Dir/tangenziale complanare sud alla A 1 in direzione Reggio Emilia - tra intersezione Modena/Sassuolo e intersezione SS 12,8169,00,7750,419,6408,1761,8169,0
2019/03,632,28/03/2019,4,SS 724Dir/tangenziale complanare sud alla A 1 in direzione Reggio Emilia - tra intersezione Modena/Sassuolo e intersezione SS 12,8590,00,8155,435,6815,1775,8590,0
2019/03,633,15/03/2019,5,SS 724Dir/tangenziale complanare sud alla A 1 in direzione Bologna - tra intersezione Modena/Sassuolo e intersezione SS12,8252,00,7785,467,6148,2104,8252,0
2019/03,633,16/03/2019,6,SS 724Dir/tangenziale complanare sud alla A 1 in direzione Bologna - tra intersezione Modena/Sassuolo e intersezione SS12,6574,00,6456,118,4543,2031,0,6574
2019/03,633,17/03/2019,7,SS 724Dir/tangenziale complanare sud alla A 1 in direzione Bologna - tra intersezione Modena/Sassuolo e intersezione SS12,5330,00,5289,41,3669,1661,0,5330
2019/03,633,18/03/2019,1,SS 724Dir/tangenziale complanare sud alla A 1 in direzione Bologna - tra intersezione Modena/Sassuolo e intersezione SS12,8235,00,7774,461,6369,1866,8235,0
2019/03,633,19/03/2019,2,SS 724Dir/tangenziale complanare sud alla A 1 in direzione Bologna - tra intersezione Modena/Sassuolo e intersezione SS12,8506,10,7994,511,6489,2017,8506,0
2019/03,633,20/03/2019,3,SS 724Dir/tangenziale complanare sud alla A 1 in direzione Bologna - tra intersezione Modena/Sassuolo e intersezione SS12,8340,00,7797,543,6345,1995,8340,0
2019/03,633,21/03/2019,4,SS 724Dir/tangenziale complanare sud alla A 1 in direzione Bologna - tra intersezione Modena/Sassuolo e intersezione SS12,8382,00,7874,508,6375,2007,8382,0
2019/03,633,22/03/2019,5,SS 724Dir/tangenziale complanare sud alla A 1 in direzione Bologna - tra intersezione Modena/Sassuolo e intersezione SS12,8165,00,7675,490,6136,2029,8165,0
2019/03,633,23/03/2019,6,SS 724Dir/tangenziale complanare sud alla A 1 in direzione Bologna - tra intersezione Modena/Sassuolo e intersezione SS12,6496,00,6363,133,4530,1966,0,6496
2019/03,633,24/03/2019,7,SS 724Dir/tangenziale complanare sud alla A 1 in direzione Bologna - tra intersezione Modena/Sassuolo e intersezione SS12,5194,00,5161,33,3463,1731,0,5194
2019/03,633,25/03/2019,1,SS 724Dir/tangenziale complanare sud alla A 1 in direzione Bologna - tra intersezione Modena/Sassuolo e intersezione SS12,8032,00,7556,476,6194,1838,8032,0
2019/03,633,26/03/2019,2,SS 724Dir/tangenziale complanare sud alla A 1 in direzione Bologna - tra intersezione Modena/Sassuolo e intersezione SS12,8104,00,7594,510,6248,1856,8104,0
2019/03,633,27/03/2019,3,SS 724Dir/tangenziale complanare sud alla A 1 in direzione Bologna - tra intersezione Modena/Sassuolo e intersezione SS12,8198,10,7698,499,6224,1974,8198,0
2019/03,633,28/03/2019,4,SS 724Dir/tangenziale complanare sud alla A 1 in direzione Bologna - tra intersezione Modena/Sassuolo e intersezione SS12,8484,00,7955,529,6356,2128,8484,0
2019/03,634,15/03/2019,5,SS 12 tra Pavullo e intersezione SP 31,,,,,,,,
2019/03,634,16/03/2019,6,SS 12 tra Pavullo e intersezione SP 31,,,,,,,,
2019/03,634,17/03/2019,7,SS 12 tra Pavullo e intersezione SP 31,,,,,,,,
2019/03,634,18/03/2019,1,SS 12 tra Pavullo e intersezione SP 31,,,,,,,,
2019/03,634,19/03/2019,2,SS 12 tra Pavullo e intersezione SP 31,,,,,,,,
2019/03,634,20/03/2019,3,SS 12 tra Pavullo e intersezione SP 31,,,,,,,,
2019/03,634,21/03/2019,4,SS 12 tra Pavullo e intersezione SP 31,,,,,,,,
2019/03,634,22/03/2019,5,SS 12 tra Pavullo e intersezione SP 31,,,,,,,,
2019/03,634,23/03/2019,6,SS 12 tra Pavullo e intersezione SP 31,,,,,,,,
2019/03,634,24/03/2019,7,SS 12 tra Pavullo e intersezione SP 31,,,,,,,,
2019/03,634,25/03/2019,1,SS 12 tra Pavullo e intersezione SP 31,,,,,,,,
2019/03,634,26/03/2019,2,SS 12 tra Pavullo e intersezione SP 31,,,,,,,,
2019/03,634,27/03/2019,3,SS 12 tra Pavullo e intersezione SP 31,,,,,,,,
2019/03,634,28/03/2019,4,SS 12 tra Pavullo e intersezione SP 31,,,,,,,,
2019/03,635,15/03/2019,5,SS 725 (tg sud Piacenza) tra intersezione SS 45 e l'intersezione SP 6,48977,00,45606,3371,38590,10387,48977,0
2019/03,635,16/03/2019,6,SS 725 (tg sud Piacenza) tra intersezione SS 45 e l'intersezione SP 6,42337,00,41381,956,32379,9958,0,42337
2019/03,635,17/03/2019,7,SS 725 (tg sud Piacenza) tra intersezione SS 45 e l'intersezione SP 6,35242,10,34993,248,27196,8046,0,35242
2019/03,635,18/03/2019,1,SS 725 (tg sud Piacenza) tra intersezione SS 45 e l'intersezione SP 6,46847,20,42961,3884,37684,9163,46847,0
2019/03,635,19/03/2019,2,SS 725 (tg sud Piacenza) tra intersezione SS 45 e l'intersezione SP 6,47250,00,43574,3676,38085,9165,47250,0
2019/03,635,20/03/2019,3,SS 725 (tg sud Piacenza) tra intersezione SS 45 e l'intersezione SP 6,46593,10,43074,3518,37324,9269,46593,0
2019/03,635,21/03/2019,4,SS 725 (tg sud Piacenza) tra intersezione SS 45 e l'intersezione SP 6,47040,10,43554,3485,37661,9379,47040,0
2019/03,635,22/03/2019,5,SS 725 (tg sud Piacenza) tra intersezione SS 45 e l'intersezione SP 6,49024,40,45616,3404,38444,10580,49024,0
2019/03,635,23/03/2019,6,SS 725 (tg sud Piacenza) tra intersezione SS 45 e l'intersezione SP 6,41047,00,40142,905,30911,10136,0,41047
2019/03,635,24/03/2019,7,SS 725 (tg sud Piacenza) tra intersezione SS 45 e l'intersezione SP 6,34885,00,34656,229,26332,8553,0,34885
2019/03,635,25/03/2019,1,SS 725 (tg sud Piacenza) tra intersezione SS 45 e l'intersezione SP 6,46155,10,42633,3521,37257,8898,46155,0
2019/03,635,26/03/2019,2,SS 725 (tg sud Piacenza) tra intersezione SS 45 e l'intersezione SP 6,46758,00,42884,3874,37815,8943,46758,0
2019/03,635,27/03/2019,3,SS 725 (tg sud Piacenza) tra intersezione SS 45 e l'intersezione SP 6,47316,30,43916,3397,37978,9338,47316,0
2019/03,635,28/03/2019,4,SS 725 (tg sud Piacenza) tra intersezione SS 45 e l'intersezione SP 6,47608,10,44016,3591,37921,9687,47608,0
2019/03,636,15/03/2019,5,SS 9Var tra la tangenziale nord di Parma (intersezione SP 343R) e l'intersezione SP 62R,59391,50,55879,3507,45722,13669,59391,0
2019/03,636,16/03/2019,6,SS 9Var tra la tangenziale nord di Parma (intersezione SP 343R) e l'intersezione SP 62R,51034,60,49912,1116,37010,14024,0,51034
2019/03,636,17/03/2019,7,SS 9Var tra la tangenziale nord di Parma (intersezione SP 343R) e l'intersezione SP 62R,39290,00,38897,393,27707,11583,0,39290
2019/03,636,18/03/2019,1,SS 9Var tra la tangenziale nord di Parma (intersezione SP 343R) e l'intersezione SP 62R,57134,60,53265,3863,45477,11657,57134,0
2019/03,636,19/03/2019,2,SS 9Var tra la tangenziale nord di Parma (intersezione SP 343R) e l'intersezione SP 62R,57561,100,53640,3911,45544,12017,57561,0
2019/03,636,20/03/2019,3,SS 9Var tra la tangenziale nord di Parma (intersezione SP 343R) e l'intersezione SP 62R,53446,480,49035,4363,41361,12085,53446,0
2019/03,636,21/03/2019,4,SS 9Var tra la tangenziale nord di Parma (intersezione SP 343R) e l'intersezione SP 62R,57404,100,53537,3857,44753,12651,57404,0
2019/03,636,22/03/2019,5,SS 9Var tra la tangenziale nord di Parma (intersezione SP 343R) e l'intersezione SP 62R,59378,130,55401,3964,45864,13514,59378,0
2019/03,636,23/03/2019,6,SS 9Var tra la tangenziale nord di Parma (intersezione SP 343R) e l'intersezione SP 62R,50459,10,49337,1121,36375,14084,0,50459
2019/03,636,24/03/2019,7,SS 9Var tra la tangenziale nord di Parma (intersezione SP 343R) e l'intersezione SP 62R,39465,10,39102,362,27581,11884,0,39465
2019/03,636,25/03/2019,1,SS 9Var tra la tangenziale nord di Parma (intersezione SP 343R) e l'intersezione SP 62R,54795,50,51362,3428,43868,10927,54795,0
2019/03,636,26/03/2019,2,SS 9Var tra la tangenziale nord di Parma (intersezione SP 343R) e l'intersezione SP 62R,56918,260,53343,3549,44287,12631,56918,0
2019/03,636,27/03/2019,3,SS 9Var tra la tangenziale nord di Parma (intersezione SP 343R) e l'intersezione SP 62R,57468,40,53960,3504,45234,12234,57468,0
2019/03,636,28/03/2019,4,SS 9Var tra la tangenziale nord di Parma (intersezione SP 343R) e l'intersezione SP 62R,58756,100,54941,3805,46196,12560,58756,0
2019/03,637,15/03/2019,5,SS 62 tra Fornovo di Taro e Collecchio,15234,00,14362,872,11713,3521,15234,0
2019/03,637,16/03/2019,6,SS 62 tra Fornovo di Taro e Collecchio,13092,00,12830,262,9824,3268,0,13092
2019/03,637,17/03/2019,7,SS 62 tra Fornovo di Taro e Collecchio,11478,10,11406,71,8452,3026,0,11478
2019/03,637,18/03/2019,1,SS 62 tra Fornovo di Taro e Collecchio,13889,10,12998,890,11066,2823,13889,0
2019/03,637,19/03/2019,2,SS 62 tra Fornovo di Taro e Collecchio,14315,10,13393,921,11214,3101,14315,0
2019/03,637,20/03/2019,3,SS 62 tra Fornovo di Taro e Collecchio,14350,00,13406,944,11189,3161,14350,0
2019/03,637,21/03/2019,4,SS 62 tra Fornovo di Taro e Collecchio,14451,00,13553,898,11230,3221,14451,0
2019/03,637,22/03/2019,5,SS 62 tra Fornovo di Taro e Collecchio,15250,00,14359,891,11778,3472,15250,0
2019/03,637,23/03/2019,6,SS 62 tra Fornovo di Taro e Collecchio,13294,20,13028,264,9981,3313,0,13294
2019/03,637,24/03/2019,7,SS 62 tra Fornovo di Taro e Collecchio,12463,10,12387,75,8761,3702,0,12463
2019/03,637,25/03/2019,1,SS 62 tra Fornovo di Taro e Collecchio,14222,10,13271,950,11271,2951,14222,0
2019/03,637,26/03/2019,2,SS 62 tra Fornovo di Taro e Collecchio,14438,00,13466,972,11332,3106,14438,0
2019/03,637,27/03/2019,3,SS 62 tra Fornovo di Taro e Collecchio,14631,00,13713,918,11300,3331,14631,0
2019/03,637,28/03/2019,4,SS 62 tra Fornovo di Taro e Collecchio,14621,10,13680,940,11428,3193,14621,0
2019/03,638,15/03/2019,5,SS 9 tra la tangenziale nord di Reggio Emilia e Sant'Ilario d'Enza,21094,00,19347,1747,14762,6332,21094,0
2019/03,638,16/03/2019,6,SS 9 tra la tangenziale nord di Reggio Emilia e Sant'Ilario d'Enza,19769,00,19261,508,12907,6862,0,19769
2019/03,638,17/03/2019,7,SS 9 tra la tangenziale nord di Reggio Emilia e Sant'Ilario d'Enza,16917,00,16745,172,11360,5557,0,16917
2019/03,638,18/03/2019,1,SS 9 tra la tangenziale nord di Reggio Emilia e Sant'Ilario d'Enza,19249,20,17563,1684,14539,4710,19249,0
2019/03,638,19/03/2019,2,SS 9 tra la tangenziale nord di Reggio Emilia e Sant'Ilario d'Enza,19906,00,18177,1729,14867,5039,19906,0
2019/03,638,20/03/2019,3,SS 9 tra la tangenziale nord di Reggio Emilia e Sant'Ilario d'Enza,20242,00,18459,1783,14893,5349,20242,0
2019/03,638,21/03/2019,4,SS 9 tra la tangenziale nord di Reggio Emilia e Sant'Ilario d'Enza,20496,00,18736,1760,14858,5638,20496,0
2019/03,638,22/03/2019,5,SS 9 tra la tangenziale nord di Reggio Emilia e Sant'Ilario d'Enza,21235,10,19466,1768,14962,6273,21235,0
2019/03,638,23/03/2019,6,SS 9 tra la tangenziale nord di Reggio Emilia e Sant'Ilario d'Enza,19514,00,18989,525,12746,6768,0,19514
2019/03,638,24/03/2019,7,SS 9 tra la tangenziale nord di Reggio Emilia e Sant'Ilario d'Enza,16125,00,15949,176,10709,5416,0,16125
2019/03,638,25/03/2019,1,SS 9 tra la tangenziale nord di Reggio Emilia e Sant'Ilario d'Enza,18637,00,16915,1722,13914,4723,18637,0
2019/03,638,26/03/2019,2,SS 9 tra la tangenziale nord di Reggio Emilia e Sant'Ilario d'Enza,19899,00,18123,1776,14925,4974,19899,0
2019/03,638,27/03/2019,3,SS 9 tra la tangenziale nord di Reggio Emilia e Sant'Ilario d'Enza,19670,00,18067,1603,14525,5145,19670,0
2019/03,638,28/03/2019,4,SS 9 tra la tangenziale nord di Reggio Emilia e Sant'Ilario d'Enza,21116,30,19286,1827,15548,5568,21116,0
2019/03,639,15/03/2019,5,SS 63 località Casina (variante abitato),7415,10,7059,355,5546,1869,7415,0
2019/03,639,16/03/2019,6,SS 63 località Casina (variante abitato),7238,00,7063,175,5430,1808,0,7238
2019/03,639,17/03/2019,7,SS 63 località Casina (variante abitato),6807,00,6753,54,5133,1674,0,6807
2019/03,639,18/03/2019,1,SS 63 località Casina (variante abitato),6596,00,6319,277,5106,1490,6596,0
2019/03,639,19/03/2019,2,SS 63 località Casina (variante abitato),6581,00,6256,325,5045,1536,6581,0
2019/03,639,20/03/2019,3,SS 63 località Casina (variante abitato),6948,00,6615,333,5344,1604,6948,0
2019/03,639,21/03/2019,4,SS 63 località Casina (variante abitato),6872,00,6531,341,5236,1636,6872,0
2019/03,639,22/03/2019,5,SS 63 località Casina (variante abitato),7372,00,7021,351,5535,1837,7372,0
2019/03,639,23/03/2019,6,SS 63 località Casina (variante abitato),7038,00,6913,125,5228,1810,0,7038
2019/03,639,24/03/2019,7,SS 63 località Casina (variante abitato),7298,00,7247,51,5412,1886,0,7298
2019/03,639,25/03/2019,1,SS 63 località Casina (variante abitato),6628,00,6315,313,5116,1512,6628,0
2019/03,639,26/03/2019,2,SS 63 località Casina (variante abitato),6562,00,6227,335,5079,1483,6562,0
2019/03,639,27/03/2019,3,SS 63 località Casina (variante abitato),6862,00,6583,279,5179,1683,6862,0
2019/03,639,28/03/2019,4,SS 63 località Casina (variante abitato),6760,10,6434,325,5205,1555,6760,0
2019/03,651,15/03/2019,5,SS 9 da Imola a Castelbolognese (al confine provinciale),17558,00,16757,801,12609,4949,17558,0
2019/03,651,16/03/2019,6,SS 9 da Imola a Castelbolognese (al confine provinciale),16182,00,15964,218,10745,5437,0,16182
2019/03,651,17/03/2019,7,SS 9 da Imola a Castelbolognese (al confine provinciale),12093,00,12014,79,7614,4479,0,12093
2019/03,651,18/03/2019,1,SS 9 da Imola a Castelbolognese (al confine provinciale),16652,00,15912,740,12999,3653,16652,0
2019/03,651,19/03/2019,2,SS 9 da Imola a Castelbolognese (al confine provinciale),17214,00,16458,756,13085,4129,17214,0
2019/03,651,20/03/2019,3,SS 9 da Imola a Castelbolognese (al confine provinciale),17115,00,16339,776,12833,4282,17115,0
2019/03,651,21/03/2019,4,SS 9 da Imola a Castelbolognese (al confine provinciale),17052,00,16305,747,12767,4285,17052,0
2019/03,651,22/03/2019,5,SS 9 da Imola a Castelbolognese (al confine provinciale),18319,00,17501,818,13272,5047,18319,0
2019/03,651,23/03/2019,6,SS 9 da Imola a Castelbolognese (al confine provinciale),16950,00,16726,224,11349,5601,0,16950
2019/03,651,24/03/2019,7,SS 9 da Imola a Castelbolognese (al confine provinciale),16127,00,16030,97,11120,5007,0,16127
2019/03,651,25/03/2019,1,SS 9 da Imola a Castelbolognese (al confine provinciale),16406,00,15637,769,12532,3874,16406,0
2019/03,651,26/03/2019,2,SS 9 da Imola a Castelbolognese (al confine provinciale),17080,00,16273,807,13092,3988,17080,0
2019/03,651,27/03/2019,3,SS 9 da Imola a Castelbolognese (al confine provinciale),17400,00,16479,921,13002,4398,17400,0
2019/03,651,28/03/2019,4,SS 9 da Imola a Castelbolognese (al confine provinciale),16892,00,16068,824,12703,4189,16892,0
2019/03,652,15/03/2019,5,SS 16 dal bivio SP 610R ad Argenta,13853,00,12363,1490,10648,3205,13853,0
2019/03,652,16/03/2019,6,SS 16 dal bivio SP 610R ad Argenta,11036,00,10756,280,8164,2872,0,11036
2019/03,652,17/03/2019,7,SS 16 dal bivio SP 610R ad Argenta,10387,00,10310,77,7670,2717,0,10387
2019/03,652,18/03/2019,1,SS 16 dal bivio SP 610R ad Argenta,12005,00,10684,1321,9634,2371,12005,0
2019/03,652,19/03/2019,2,SS 16 dal bivio SP 610R ad Argenta,12221,00,10789,1432,9687,2534,12221,0
2019/03,652,20/03/2019,3,SS 16 dal bivio SP 610R ad Argenta,12407,00,10934,1473,9856,2551,12407,0
2019/03,652,21/03/2019,4,SS 16 dal bivio SP 610R ad Argenta,12984,00,11541,1443,10243,2741,12984,0
2019/03,652,22/03/2019,5,SS 16 dal bivio SP 610R ad Argenta,13724,00,12274,1450,10652,3072,13724,0
2019/03,652,23/03/2019,6,SS 16 dal bivio SP 610R ad Argenta,11363,00,11064,299,8587,2776,0,11363
2019/03,652,24/03/2019,7,SS 16 dal bivio SP 610R ad Argenta,11317,00,11220,97,8140,3177,0,11317
2019/03,652,25/03/2019,1,SS 16 dal bivio SP 610R ad Argenta,12412,00,10976,1436,9906,2506,12412,0
2019/03,652,26/03/2019,2,SS 16 dal bivio SP 610R ad Argenta,12466,00,11075,1391,9881,2585,12466,0
2019/03,652,27/03/2019,3,SS 16 dal bivio SP 610R ad Argenta,12206,00,10873,1333,9705,2501,12206,0
2019/03,652,28/03/2019,4,SS 16 dal bivio SP 610R ad Argenta,13150,00,11713,1437,10451,2699,13150,0
2019/03,653,15/03/2019,5,SP 254R dal ponte sul fiume Savio alla SS 16,9174,00,8968,206,7184,1990,9174,0
2019/03,653,16/03/2019,6,SP 254R dal ponte sul fiume Savio alla SS 16,10334,00,10264,70,7654,2680,0,10334
2019/03,653,17/03/2019,7,SP 254R dal ponte sul fiume Savio alla SS 16,12091,00,12064,27,9884,2207,0,12091
2019/03,653,18/03/2019,1,SP 254R dal ponte sul fiume Savio alla SS 16,7458,00,7247,211,6022,1436,7458,0
2019/03,653,19/03/2019,2,SP 254R dal ponte sul fiume Savio alla SS 16,7781,00,7608,173,6277,1504,7781,0
2019/03,653,20/03/2019,3,SP 254R dal ponte sul fiume Savio alla SS 16,8321,00,8115,206,6704,1617,8321,0
2019/03,653,21/03/2019,4,SP 254R dal ponte sul fiume Savio alla SS 16,9457,00,9207,250,7578,1879,9457,0
2019/03,653,22/03/2019,5,SP 254R dal ponte sul fiume Savio alla SS 16,9485,00,9238,247,7126,2359,9485,0
2019/03,653,23/03/2019,6,SP 254R dal ponte sul fiume Savio alla SS 16,11614,00,11534,80,8543,3071,0,11614
2019/03,653,24/03/2019,7,SP 254R dal ponte sul fiume Savio alla SS 16,12717,00,12665,52,10042,2675,0,12717
2019/03,653,25/03/2019,1,SP 254R dal ponte sul fiume Savio alla SS 16,8450,00,8188,262,6916,1534,8450,0
2019/03,653,26/03/2019,2,SP 254R dal ponte sul fiume Savio alla SS 16,8189,00,7977,212,6605,1584,8189,0
2019/03,653,27/03/2019,3,SP 254R dal ponte sul fiume Savio alla SS 16,8452,00,8263,189,6798,1654,8452,0
2019/03,653,28/03/2019,4,SP 254R dal ponte sul fiume Savio alla SS 16,9143,00,8894,249,7283,1860,9143,0
2019/03,654,15/03/2019,5,SP 7IBisR dal bivio SSPP 32/33ter alla SS 16,13220,00,12783,437,10229,2991,13220,0
2019/03,654,16/03/2019,6,SP 7IBisR dal bivio SSPP 32/33ter alla SS 16,13484,00,13339,145,9742,3742,0,13484
2019/03,654,17/03/2019,7,SP 7IBisR dal bivio SSPP 32/33ter alla SS 16,14298,00,14247,51,11318,2980,0,14298
2019/03,654,18/03/2019,1,SP 7IBisR dal bivio SSPP 32/33ter alla SS 16,11402,00,10908,494,9406,1996,11402,0
2019/03,654,19/03/2019,2,SP 7IBisR dal bivio SSPP 32/33ter alla SS 16,11450,00,11030,420,9128,2322,11450,0
2019/03,654,20/03/2019,3,SP 7IBisR dal bivio SSPP 32/33ter alla SS 16,12313,00,11834,479,9797,2516,12313,0
2019/03,654,21/03/2019,4,SP 7IBisR dal bivio SSPP 32/33ter alla SS 16,12454,00,11970,484,9676,2778,12454,0
2019/03,654,22/03/2019,5,SP 7IBisR dal bivio SSPP 32/33ter alla SS 16,13706,00,13204,502,10362,3344,13706,0
2019/03,654,23/03/2019,6,SP 7IBisR dal bivio SSPP 32/33ter alla SS 16,14496,00,14314,182,10323,4173,0,14496
2019/03,654,24/03/2019,7,SP 7IBisR dal bivio SSPP 32/33ter alla SS 16,15445,00,15339,106,11904,3541,0,15445
2019/03,654,25/03/2019,1,SP 7IBisR dal bivio SSPP 32/33ter alla SS 16,11802,00,11314,488,9460,2342,11802,0
2019/03,654,26/03/2019,2,SP 7IBisR dal bivio SSPP 32/33ter alla SS 16,11562,00,11099,463,9264,2298,11562,0
2019/03,654,27/03/2019,3,SP 7IBisR dal bivio SSPP 32/33ter alla SS 16,12150,00,11689,461,9686,2464,12150,0
2019/03,654,28/03/2019,4,SP 7IBisR dal bivio SSPP 32/33ter alla SS 16,12755,00,12295,460,10048,2707,12755,0
2019/03,655,15/03/2019,5,SP 253R dal bivio SP 302R allo svincolo A 14dir a Fornace Zarattini,18240,00,17392,848,14166,4074,18240,0
2019/03,655,16/03/2019,6,SP 253R dal bivio SP 302R allo svincolo A 14dir a Fornace Zarattini,15627,00,15418,209,11407,4220,0,15627
2019/03,655,17/03/2019,7,SP 253R dal bivio SP 302R allo svincolo A 14dir a Fornace Zarattini,12177,00,12123,54,9045,3132,0,12177
2019/03,655,18/03/2019,1,SP 253R dal bivio SP 302R allo svincolo A 14dir a Fornace Zarattini,15139,00,14385,754,11839,3300,15139,0
2019/03,655,19/03/2019,2,SP 253R dal bivio SP 302R allo svincolo A 14dir a Fornace Zarattini,17959,00,17072,887,14482,3477,17959,0
2019/03,655,20/03/2019,3,SP 253R dal bivio SP 302R allo svincolo A 14dir a Fornace Zarattini,18170,00,17296,874,14248,3922,18170,0
2019/03,655,21/03/2019,4,SP 253R dal bivio SP 302R allo svincolo A 14dir a Fornace Zarattini,17655,00,16759,896,14070,3585,17655,0
2019/03,655,22/03/2019,5,SP 253R dal bivio SP 302R allo svincolo A 14dir a Fornace Zarattini,18469,00,17545,924,14367,4102,18469,0
2019/03,655,23/03/2019,6,SP 253R dal bivio SP 302R allo svincolo A 14dir a Fornace Zarattini,15378,00,15157,221,11251,4127,0,15378
2019/03,655,24/03/2019,7,SP 253R dal bivio SP 302R allo svincolo A 14dir a Fornace Zarattini,13041,00,12983,58,10048,2993,0,13041
2019/03,655,25/03/2019,1,SP 253R dal bivio SP 302R allo svincolo A 14dir a Fornace Zarattini,17410,00,16506,904,13909,3501,17410,0
2019/03,655,26/03/2019,2,SP 253R dal bivio SP 302R allo svincolo A 14dir a Fornace Zarattini,18052,00,17195,857,14480,3572,18052,0
2019/03,655,27/03/2019,3,SP 253R dal bivio SP 302R allo svincolo A 14dir a Fornace Zarattini,18798,00,17844,954,14954,3844,18798,0
2019/03,655,28/03/2019,4,SP 253R dal bivio SP 302R allo svincolo A 14dir a Fornace Zarattini,18749,00,17798,951,14716,4033,18749,0
2019/03,660,15/03/2019,5,SP 25 tra intersezione con SS 64 e confine provinciale,,,,,,,,
2019/03,660,16/03/2019,6,SP 25 tra intersezione con SS 64 e confine provinciale,,,,,,,,
2019/03,660,17/03/2019,7,SP 25 tra intersezione con SS 64 e confine provinciale,,,,,,,,
2019/03,660,18/03/2019,1,SP 25 tra intersezione con SS 64 e confine provinciale,,,,,,,,
2019/03,660,19/03/2019,2,SP 25 tra intersezione con SS 64 e confine provinciale,,,,,,,,
2019/03,660,20/03/2019,3,SP 25 tra intersezione con SS 64 e confine provinciale,,,,,,,,
2019/03,660,21/03/2019,4,SP 25 tra intersezione con SS 64 e confine provinciale,,,,,,,,
2019/03,660,22/03/2019,5,SP 25 tra intersezione con SS 64 e confine provinciale,,,,,,,,
2019/03,660,23/03/2019,6,SP 25 tra intersezione con SS 64 e confine provinciale,,,,,,,,
2019/03,660,24/03/2019,7,SP 25 tra intersezione con SS 64 e confine provinciale,,,,,,,,
2019/03,660,25/03/2019,1,SP 25 tra intersezione con SS 64 e confine provinciale,,,,,,,,
2019/03,660,26/03/2019,2,SP 25 tra intersezione con SS 64 e confine provinciale,,,,,,,,
2019/03,660,27/03/2019,3,SP 25 tra intersezione con SS 64 e confine provinciale,,,,,,,,
2019/03,660,28/03/2019,4,SP 25 tra intersezione con SS 64 e confine provinciale,,,,,,,,
2019/03,661,15/03/2019,5,SP 15 tra Tresigallo e Massa Fiscaglia,3956,10,3833,122,3005,951,3956,0
2019/03,661,16/03/2019,6,SP 15 tra Tresigallo e Massa Fiscaglia,3550,10,3506,43,2638,912,0,3550
2019/03,661,17/03/2019,7,SP 15 tra Tresigallo e Massa Fiscaglia,4666,00,4649,17,3695,971,0,4666
2019/03,661,18/03/2019,1,SP 15 tra Tresigallo e Massa Fiscaglia,3610,00,3504,106,2818,792,3610,0
2019/03,661,19/03/2019,2,SP 15 tra Tresigallo e Massa Fiscaglia,3620,20,3497,121,2878,742,3620,0
2019/03,661,20/03/2019,3,SP 15 tra Tresigallo e Massa Fiscaglia,3782,00,3649,133,2980,802,3782,0
2019/03,661,21/03/2019,4,SP 15 tra Tresigallo e Massa Fiscaglia,3876,20,3741,133,3084,792,3876,0
2019/03,661,22/03/2019,5,SP 15 tra Tresigallo e Massa Fiscaglia,4015,00,3874,141,3096,919,4015,0
2019/03,661,23/03/2019,6,SP 15 tra Tresigallo e Massa Fiscaglia,3734,00,3686,48,2767,967,0,3734
2019/03,661,24/03/2019,7,SP 15 tra Tresigallo e Massa Fiscaglia,5861,00,5838,23,4519,1342,0,5861
2019/03,661,25/03/2019,1,SP 15 tra Tresigallo e Massa Fiscaglia,3766,10,3653,112,3020,746,3766,0
2019/03,661,26/03/2019,2,SP 15 tra Tresigallo e Massa Fiscaglia,3741,00,3596,145,2992,749,3741,0
2019/03,661,27/03/2019,3,SP 15 tra Tresigallo e Massa Fiscaglia,3858,00,3747,111,3079,779,3858,0
2019/03,661,28/03/2019,4,SP 15 tra Tresigallo e Massa Fiscaglia,3952,10,3831,120,3149,803,3952,0
2019/03,662,15/03/2019,5,SP 2 tra intersezione SP 14 e Copparo,14392,00,13795,597,11301,3091,14392,0
2019/03,662,16/03/2019,6,SP 2 tra intersezione SP 14 e Copparo,11395,00,11226,169,8530,2865,0,11395
2019/03,662,17/03/2019,7,SP 2 tra intersezione SP 14 e Copparo,8286,10,8248,37,6049,2237,0,8286
2019/03,662,18/03/2019,1,SP 2 tra intersezione SP 14 e Copparo,13508,00,12976,532,10975,2533,13508,0
2019/03,662,19/03/2019,2,SP 2 tra intersezione SP 14 e Copparo,13733,00,13164,569,10997,2736,13733,0
2019/03,662,20/03/2019,3,SP 2 tra intersezione SP 14 e Copparo,13680,00,13071,609,10897,2783,13680,0
2019/03,662,21/03/2019,4,SP 2 tra intersezione SP 14 e Copparo,13871,00,13236,635,10903,2968,13871,0
2019/03,662,22/03/2019,5,SP 2 tra intersezione SP 14 e Copparo,14265,10,13676,588,11298,2967,14265,0
2019/03,662,23/03/2019,6,SP 2 tra intersezione SP 14 e Copparo,11329,10,11183,145,8463,2866,0,11329
2019/03,662,24/03/2019,7,SP 2 tra intersezione SP 14 e Copparo,8477,00,8438,39,5890,2587,0,8477
2019/03,662,25/03/2019,1,SP 2 tra intersezione SP 14 e Copparo,13507,00,12875,632,10891,2616,13507,0
2019/03,662,26/03/2019,2,SP 2 tra intersezione SP 14 e Copparo,13624,20,13006,616,10967,2657,13624,0
2019/03,662,27/03/2019,3,SP 2 tra intersezione SP 14 e Copparo,14020,00,13339,681,11203,2817,14020,0
2019/03,662,28/03/2019,4,SP 2 tra intersezione SP 14 e Copparo,13871,00,13207,664,10947,2924,13871,0
2019/03,663,15/03/2019,5,SP 60 tra intersezione SP 68 e SP62,3515,00,3025,490,2704,811,3515,0
2019/03,663,16/03/2019,6,SP 60 tra intersezione SP 68 e SP62,3047,00,2918,129,2224,823,0,3047
2019/03,663,17/03/2019,7,SP 60 tra intersezione SP 68 e SP62,3754,00,3729,25,2972,782,0,3754
2019/03,663,18/03/2019,1,SP 60 tra intersezione SP 68 e SP62,3216,00,2723,493,2554,662,3216,0
2019/03,663,19/03/2019,2,SP 60 tra intersezione SP 68 e SP62,3153,00,2610,543,2487,666,3153,0
2019/03,663,20/03/2019,3,SP 60 tra intersezione SP 68 e SP62,3245,00,2769,476,2565,680,3245,0
2019/03,663,21/03/2019,4,SP 60 tra intersezione SP 68 e SP62,3271,00,2723,548,2568,703,3271,0
2019/03,663,22/03/2019,5,SP 60 tra intersezione SP 68 e SP62,3590,00,3048,542,2826,764,3590,0
2019/03,663,23/03/2019,6,SP 60 tra intersezione SP 68 e SP62,3175,10,3045,129,2403,772,0,3175
2019/03,663,24/03/2019,7,SP 60 tra intersezione SP 68 e SP62,4348,00,4312,36,3421,927,0,4348
2019/03,663,25/03/2019,1,SP 60 tra intersezione SP 68 e SP62,3376,00,2838,538,2660,716,3376,0
2019/03,663,26/03/2019,2,SP 60 tra intersezione SP 68 e SP62,3411,00,2891,520,2735,676,3411,0
2019/03,663,27/03/2019,3,SP 60 tra intersezione SP 68 e SP62,3338,10,2812,525,2631,707,3338,0
2019/03,663,28/03/2019,4,SP 60 tra intersezione SP 68 e SP62,3415,00,2887,528,2728,687,3415,0
2019/03,665,15/03/2019,5,SP 1 tra intersezione SP7 a Piacenza,13017,10,12250,766,10163,2854,13017,0
2019/03,665,16/03/2019,6,SP 1 tra intersezione SP7 a Piacenza,10547,10,10379,167,7765,2782,0,10547
2019/03,665,17/03/2019,7,SP 1 tra intersezione SP7 a Piacenza,7991,10,7943,47,5847,2144,0,7991
2019/03,665,18/03/2019,1,SP 1 tra intersezione SP7 a Piacenza,12169,00,11432,737,9827,2342,12169,0
2019/03,665,19/03/2019,2,SP 1 tra intersezione SP7 a Piacenza,12929,00,12148,781,10298,2631,12929,0
2019/03,665,20/03/2019,3,SP 1 tra intersezione SP7 a Piacenza,12850,00,12116,734,10237,2613,12850,0
2019/03,665,21/03/2019,4,SP 1 tra intersezione SP7 a Piacenza,12790,10,12022,767,10143,2647,12790,0
2019/03,665,22/03/2019,5,SP 1 tra intersezione SP7 a Piacenza,12858,10,12189,668,10069,2789,12858,0
2019/03,665,23/03/2019,6,SP 1 tra intersezione SP7 a Piacenza,10130,00,9977,153,7410,2720,0,10130
2019/03,665,24/03/2019,7,SP 1 tra intersezione SP7 a Piacenza,8036,00,7993,43,5909,2127,0,8036
2019/03,665,25/03/2019,1,SP 1 tra intersezione SP7 a Piacenza,12228,00,11502,726,9800,2428,12228,0
2019/03,665,26/03/2019,2,SP 1 tra intersezione SP7 a Piacenza,12713,00,11968,745,10261,2452,12713,0
2019/03,665,27/03/2019,3,SP 1 tra intersezione SP7 a Piacenza,12669,00,11859,810,10140,2529,12669,0
2019/03,665,28/03/2019,4,SP 1 tra intersezione SP7 a Piacenza,12666,00,11893,773,10045,2621,12666,0
2019/03,666,15/03/2019,5,SP 3 tra via Monda e via Caminate,8152,10,7688,463,6348,1804,8152,0
2019/03,666,16/03/2019,6,SP 3 tra via Monda e via Caminate,6695,00,6577,118,4897,1798,0,6695
2019/03,666,17/03/2019,7,SP 3 tra via Monda e via Caminate,5858,10,5845,12,4451,1407,0,5858
2019/03,666,18/03/2019,1,SP 3 tra via Monda e via Caminate,7535,10,7101,433,6082,1453,7535,0
2019/03,666,19/03/2019,2,SP 3 tra via Monda e via Caminate,7741,00,7266,475,6181,1560,7741,0
2019/03,666,20/03/2019,3,SP 3 tra via Monda e via Caminate,7867,10,7380,486,6211,1656,7867,0
2019/03,666,21/03/2019,4,SP 3 tra via Monda e via Caminate,8273,00,7768,505,6555,1718,8273,0
2019/03,666,22/03/2019,5,SP 3 tra via Monda e via Caminate,8121,10,7620,500,6359,1762,8121,0
2019/03,666,23/03/2019,6,SP 3 tra via Monda e via Caminate,6870,10,6755,114,4977,1893,0,6870
2019/03,666,24/03/2019,7,SP 3 tra via Monda e via Caminate,6131,00,6116,15,4609,1522,0,6131
2019/03,666,25/03/2019,1,SP 3 tra via Monda e via Caminate,7843,10,7352,490,6269,1574,7843,0
2019/03,666,26/03/2019,2,SP 3 tra via Monda e via Caminate,7869,00,7388,481,6260,1609,7869,0
2019/03,666,27/03/2019,3,SP 3 tra via Monda e via Caminate,8161,10,7616,544,6545,1616,8161,0
2019/03,666,28/03/2019,4,SP 3 tra via Monda e via Caminate,8443,00,7889,554,6633,1810,8443,0
2019/03,670,15/03/2019,5,SP 114 dalla rotatoria SP 114/viale Parisoli alla rotatoria SP467,17631,00,16770,861,13912,3719,17631,0
2019/03,670,16/03/2019,6,SP 114 dalla rotatoria SP 114/viale Parisoli alla rotatoria SP467,14014,00,13850,164,10319,3695,0,14014
2019/03,670,17/03/2019,7,SP 114 dalla rotatoria SP 114/viale Parisoli alla rotatoria SP467,10353,00,10302,51,7398,2955,0,10353
2019/03,670,18/03/2019,1,SP 114 dalla rotatoria SP 114/viale Parisoli alla rotatoria SP467,17208,10,16383,824,14127,3081,17208,0
2019/03,670,19/03/2019,2,SP 114 dalla rotatoria SP 114/viale Parisoli alla rotatoria SP467,17268,00,16419,849,14099,3169,17268,0
2019/03,670,20/03/2019,3,SP 114 dalla rotatoria SP 114/viale Parisoli alla rotatoria SP467,17871,00,16960,911,14375,3496,17871,0
2019/03,670,21/03/2019,4,SP 114 dalla rotatoria SP 114/viale Parisoli alla rotatoria SP467,17509,00,16601,908,14042,3467,17509,0
2019/03,670,22/03/2019,5,SP 114 dalla rotatoria SP 114/viale Parisoli alla rotatoria SP467,17893,10,17004,888,14152,3741,17893,0
2019/03,670,23/03/2019,6,SP 114 dalla rotatoria SP 114/viale Parisoli alla rotatoria SP467,13597,10,13418,178,9851,3746,0,13597
2019/03,670,24/03/2019,7,SP 114 dalla rotatoria SP 114/viale Parisoli alla rotatoria SP467,10291,10,10241,49,7151,3140,0,10291
2019/03,670,25/03/2019,1,SP 114 dalla rotatoria SP 114/viale Parisoli alla rotatoria SP467,17246,00,16415,831,14036,3210,17246,0
2019/03,670,26/03/2019,2,SP 114 dalla rotatoria SP 114/viale Parisoli alla rotatoria SP467,17232,10,16340,891,14043,3189,17232,0
2019/03,670,27/03/2019,3,SP 114 dalla rotatoria SP 114/viale Parisoli alla rotatoria SP467,17732,00,16782,950,14169,3563,17732,0
2019/03,670,28/03/2019,4,SP 114 dalla rotatoria SP 114/viale Parisoli alla rotatoria SP467,17322,00,16391,931,13799,3523,17322,0
2019/03,6,29/03/2019,5,SS 12 tra Fiumalbo e Abetone,2110,00,2068,42,1605,505,2110,0
2019/03,6,30/03/2019,6,SS 12 tra Fiumalbo e Abetone,3005,00,2987,18,2316,689,0,3005
2019/03,6,31/03/2019,7,SS 12 tra Fiumalbo e Abetone,2899,00,2894,5,2340,559,0,2899
2019/03,7,29/03/2019,5,SS 64 tra Porretta Terme e Sambuca Pistoiese,7335,00,7118,217,5833,1502,7335,0
2019/03,7,30/03/2019,6,SS 64 tra Porretta Terme e Sambuca Pistoiese,7876,30,7789,84,6354,1522,0,7876
2019/03,7,31/03/2019,7,SS 64 tra Porretta Terme e Sambuca Pistoiese,6206,00,6173,33,4821,1385,0,6206
2019/03,9,29/03/2019,5,SS 67 tra Rocca San Casciano e Portico San Benedetto,1339,00,1267,72,1054,285,1339,0
2019/03,9,30/03/2019,6,SS 67 tra Rocca San Casciano e Portico San Benedetto,1267,00,1245,22,1002,265,0,1267
2019/03,9,31/03/2019,7,SS 67 tra Rocca San Casciano e Portico San Benedetto,1604,00,1594,10,1292,312,0,1604
2019/03,12,29/03/2019,5,SS 16 al Confine regionale (Marche),16585,00,15880,705,12701,3884,16585,0
2019/03,12,30/03/2019,6,SS 16 al Confine regionale (Marche),16005,00,15713,292,11554,4451,0,16005
2019/03,12,31/03/2019,7,SS 16 al Confine regionale (Marche),14346,00,14275,71,10155,4191,0,14346
2019/03,16,29/03/2019,5,SP 69 in località Pilastri al Confine regionale,1794,00,1603,191,1449,345,1794,0
2019/03,16,30/03/2019,6,SP 69 in località Pilastri al Confine regionale,1455,00,1392,63,1060,395,0,1455
2019/03,16,31/03/2019,7,SP 69 in località Pilastri al Confine regionale,1450,00,1432,18,1014,436,0,1450
2019/03,17,29/03/2019,5,SS 12 al Confine regionale (Lombardia),11497,00,10399,1098,8708,2789,11497,0
2019/03,17,30/03/2019,6,SS 12 al Confine regionale (Lombardia),9604,00,9380,224,6761,2843,0,9604
2019/03,17,31/03/2019,7,SS 12 al Confine regionale (Lombardia),6807,00,6750,57,4641,2166,0,6807
2019/03,19,29/03/2019,5,SP 343R tra Colorno e Casalmaggiore,1089,00,992,97,909,180,1089,0
2019/03,19,30/03/2019,6,SP 343R tra Colorno e Casalmaggiore,841,00,826,15,701,140,0,841
2019/03,19,31/03/2019,7,SP 343R tra Colorno e Casalmaggiore,591,00,579,12,481,110,0,591
2019/03,25,29/03/2019,5,SS 9 tra San Prospero (Case Crostolo) e Sant'Ilario d'Enza,34325,70,31859,2459,24770,9555,34325,0
2019/03,25,30/03/2019,6,SS 9 tra San Prospero (Case Crostolo) e Sant'Ilario d'Enza,33059,00,32457,602,22664,10395,0,33059
2019/03,25,31/03/2019,7,SS 9 tra San Prospero (Case Crostolo) e Sant'Ilario d'Enza,25669,00,25492,177,16802,8867,0,25669
2019/03,29,29/03/2019,5,SS 9 tra Modena e Rubiera,25962,20,23454,2506,18636,7326,25962,0
2019/03,29,30/03/2019,6,SS 9 tra Modena e Rubiera,24861,00,24359,502,16724,8137,0,24861
2019/03,29,31/03/2019,7,SS 9 tra Modena e Rubiera,21495,10,21360,134,14282,7213,0,21495
2019/03,52,29/03/2019,5,SP 253 tra Sesto Imolese e Medicina,6718,00,6008,710,5147,1571,6718,0
2019/03,52,30/03/2019,6,SP 253 tra Sesto Imolese e Medicina,5345,00,5173,172,3928,1417,0,5345
2019/03,52,31/03/2019,7,SP 253 tra Sesto Imolese e Medicina,5072,00,5016,56,3478,1594,0,5072
2019/03,53,29/03/2019,5,SS 309 a San Giuseppe di Comacchio,11189,00,7722,3467,8487,2702,11189,0
2019/03,53,30/03/2019,6,SS 309 a San Giuseppe di Comacchio,9474,00,8572,902,6891,2583,0,9474
2019/03,53,31/03/2019,7,SS 309 a San Giuseppe di Comacchio,11032,00,10681,351,7999,3033,0,11032
2019/03,95,29/03/2019,5,SP 10R tra Castel San Giovanni e Sarmato,,,,,,,,
2019/03,95,30/03/2019,6,SP 10R tra Castel San Giovanni e Sarmato,,,,,,,,
2019/03,95,31/03/2019,7,SP 10R tra Castel San Giovanni e Sarmato,,,,,,,,
2019/03,98,29/03/2019,5,SP 302R tra Brisighella e Marradi,3453,00,3326,127,2606,847,3453,0
2019/03,98,30/03/2019,6,SP 302R tra Brisighella e Marradi,3274,00,3238,36,2478,796,0,3274
2019/03,98,31/03/2019,7,SP 302R tra Brisighella e Marradi,3678,10,3669,8,2931,747,0,3678
2019/03,100,29/03/2019,5,SP 258R tra Villa Verucchio ed ex Confine regionale (località Dogana),16302,00,14901,1401,12765,3537,16302,0
2019/03,100,30/03/2019,6,SP 258R tra Villa Verucchio ed ex Confine regionale (località Dogana),14667,00,14330,337,11176,3491,0,14667
2019/03,100,31/03/2019,7,SP 258R tra Villa Verucchio ed ex Confine regionale (località Dogana),14001,00,13914,87,10467,3534,0,14001
2019/03,104,29/03/2019,5,SP 10 nuovo ponte sul Po tra innesto variante Zibello e confine regionale (Lombardia),5605,00,4351,1254,4423,1182,5605,0
2019/03,104,30/03/2019,6,SP 10 nuovo ponte sul Po tra innesto variante Zibello e confine regionale (Lombardia),4392,00,4099,293,3360,1032,0,4392
2019/03,104,31/03/2019,7,SP 10 nuovo ponte sul Po tra innesto variante Zibello e confine regionale (Lombardia),4216,00,4149,67,3076,1140,0,4216
2019/03,107,29/03/2019,5,SP 85 tra Rubiera e bivio SP 13MO (c/o Campogalliano),9792,00,8730,1062,7509,2283,9792,0
2019/03,107,30/03/2019,6,SP 85 tra Rubiera e bivio SP 13MO (c/o Campogalliano),8344,10,8140,203,5982,2362,0,8344
2019/03,107,31/03/2019,7,SP 85 tra Rubiera e bivio SP 13MO (c/o Campogalliano),7051,10,7006,44,4980,2071,0,7051
2019/03,108,29/03/2019,5,SP 412R tra Castel San Giovanni (Casello A 21) e ponte fiume Po,13144,150,12721,408,9735,3409,13144,0
2019/03,108,30/03/2019,6,SP 412R tra Castel San Giovanni (Casello A 21) e ponte fiume Po,12215,50,12075,135,9277,2938,0,12215
2019/03,108,31/03/2019,7,SP 412R tra Castel San Giovanni (Casello A 21) e ponte fiume Po,11956,00,11913,43,8995,2961,0,11956
2019/03,112,29/03/2019,5,SP 111 tra Boretto e Viadana sul ponte Po,22932,40,19899,3029,17243,5689,22932,0
2019/03,112,30/03/2019,6,SP 111 tra Boretto e Viadana sul ponte Po,20043,40,19438,601,14701,5342,0,20043
2019/03,112,31/03/2019,7,SP 111 tra Boretto e Viadana sul ponte Po,16362,20,16136,224,11276,5086,0,16362
2019/03,115,29/03/2019,5,SP 68 ad Ariano Polesine al Confine regionale (Veneto),3041,00,2714,327,2290,751,3041,0
2019/03,115,30/03/2019,6,SP 68 ad Ariano Polesine al Confine regionale (Veneto),2755,00,2679,76,2088,667,0,2755
2019/03,115,31/03/2019,7,SP 68 ad Ariano Polesine al Confine regionale (Veneto),2559,00,2528,31,1741,818,0,2559
2019/03,116,29/03/2019,5,SP 138 tra SPiero in Bagno (E 45) e Bagno di Romagna,6031,10,5750,280,4834,1197,6031,0
2019/03,116,30/03/2019,6,SP 138 tra SPiero in Bagno (E 45) e Bagno di Romagna,6071,00,5958,113,4597,1474,0,6071
2019/03,116,31/03/2019,7,SP 138 tra SPiero in Bagno (E 45) e Bagno di Romagna,6238,10,6210,27,4704,1534,0,6238
2019/03,117,29/03/2019,5,SS 63 tra Collagna e Sassalbo (Passo del Cerreto),639,10,602,36,547,92,639,0
2019/03,117,30/03/2019,6,SS 63 tra Collagna e Sassalbo (Passo del Cerreto),767,10,748,18,648,119,0,767
2019/03,117,31/03/2019,7,SS 63 tra Collagna e Sassalbo (Passo del Cerreto),1143,00,1139,4,929,214,0,1143
2019/03,123,29/03/2019,5,SP 28 tra Piacenza (Tangenziale Sud) e Gossolengo,18684,00,18162,522,14537,4147,18684,0
2019/03,123,30/03/2019,6,SP 28 tra Piacenza (Tangenziale Sud) e Gossolengo,17646,00,17422,224,13732,3914,0,17646
2019/03,123,31/03/2019,7,SP 28 tra Piacenza (Tangenziale Sud) e Gossolengo,13644,10,13600,43,10014,3630,0,13644
2019/03,124,29/03/2019,5,SS 45 tra Piacenza e Settima,18827,10,17917,909,14191,4636,18827,0
2019/03,124,30/03/2019,6,SS 45 tra Piacenza e Settima,17819,00,17543,276,13080,4739,0,17819
2019/03,124,31/03/2019,7,SS 45 tra Piacenza e Settima,16528,10,16467,60,11951,4577,0,16528
2019/03,125,29/03/2019,5,SP 654R tra Piacenza (Tangenziale Sud) e Turro,25835,20,24613,1220,20190,5645,25835,0
2019/03,125,30/03/2019,6,SP 654R tra Piacenza (Tangenziale Sud) e Turro,20426,00,20114,312,15348,5078,0,20426
2019/03,125,31/03/2019,7,SP 654R tra Piacenza (Tangenziale Sud) e Turro,15894,00,15772,122,11566,4328,0,15894
2019/03,126,29/03/2019,5,SP 6 tra Piacenza (Tangenziale Sud) e bivio SP 42/ponte fiume Nure in località San Giorgio Piacentino,17656,10,16903,752,13473,4183,17656,0
2019/03,126,30/03/2019,6,SP 6 tra Piacenza (Tangenziale Sud) e bivio SP 42/ponte fiume Nure in località San Giorgio Piacentino,16415,10,16154,260,11867,4548,0,16415
2019/03,126,31/03/2019,7,SP 6 tra Piacenza (Tangenziale Sud) e bivio SP 42/ponte fiume Nure in località San Giorgio Piacentino,13032,20,12978,52,9307,3725,0,13032
2019/03,127,29/03/2019,5,SS 9 tra Piacenza e Pontenure,26814,10,24831,1982,20337,6477,26814,0
2019/03,127,30/03/2019,6,SS 9 tra Piacenza e Pontenure,22027,00,21399,628,15961,6066,0,22027
2019/03,127,31/03/2019,7,SS 9 tra Piacenza e Pontenure,15784,00,15647,137,10818,4966,0,15784
2019/03,128,29/03/2019,5,SP 10R tra Piacenza (Casello A 1/A 21) e il bivio SP 10R e SP 587R,17889,00,15977,1912,12938,4951,17889,0
2019/03,128,30/03/2019,6,SP 10R tra Piacenza (Casello A 1/A 21) e il bivio SP 10R e SP 587R,14376,00,13909,467,10075,4301,0,14376
2019/03,128,31/03/2019,7,SP 10R tra Piacenza (Casello A 1/A 21) e il bivio SP 10R e SP 587R,11165,00,11098,67,7631,3534,0,11165
2019/03,129,29/03/2019,5,SS 9Var tra Parma e ponte fiume Taro (Tangenziale nord di Parma),,,,,,,,
2019/03,129,30/03/2019,6,SS 9Var tra Parma e ponte fiume Taro (Tangenziale nord di Parma),,,,,,,,
2019/03,129,31/03/2019,7,SS 9Var tra Parma e ponte fiume Taro (Tangenziale nord di Parma),,,,,,,,
2019/03,130,29/03/2019,5,SS 62 tra Parma e Collecchio,24426,10,23018,1407,18614,5812,24426,0
2019/03,130,30/03/2019,6,SS 62 tra Parma e Collecchio,21399,00,21039,360,15384,6015,0,21399
2019/03,130,31/03/2019,7,SS 62 tra Parma e Collecchio,17472,00,17393,79,12020,5452,0,17472
2019/03,131,29/03/2019,5,SP 665R tra Parma e Corcagnano,22358,30,21223,1132,16984,5374,22358,0
2019/03,131,30/03/2019,6,SP 665R tra Parma e Corcagnano,19934,30,19635,296,14363,5571,0,19934
2019/03,131,31/03/2019,7,SP 665R tra Parma e Corcagnano,15915,10,15828,86,11212,4703,0,15915
2019/03,132,29/03/2019,5,SP 513R tra Parma e Pilastrello,24110,00,22984,1126,18565,5545,24110,0
2019/03,132,30/03/2019,6,SP 513R tra Parma e Pilastrello,19809,00,19526,283,14531,5278,0,19809
2019/03,132,31/03/2019,7,SP 513R tra Parma e Pilastrello,16005,00,15942,63,11353,4652,0,16005
2019/03,133,29/03/2019,5,SP 62R tra Parma (viadotto A 1) e Sorbolo,21607,10,19162,2444,16187,5420,21607,0
2019/03,133,30/03/2019,6,SP 62R tra Parma (viadotto A 1) e Sorbolo,19375,10,18900,474,14007,5368,0,19375
2019/03,133,31/03/2019,7,SP 62R tra Parma (viadotto A 1) e Sorbolo,16333,00,16217,116,11000,5333,0,16333
2019/03,135,29/03/2019,5,SP 10 tra Parma (Tangenziale) e Viarolo,,,,,,,,
2019/03,135,30/03/2019,6,SP 10 tra Parma (Tangenziale) e Viarolo,,,,,,,,
2019/03,135,31/03/2019,7,SP 10 tra Parma (Tangenziale) e Viarolo,,,,,,,,
2019/03,137,29/03/2019,5,SP 28 tra Reggio Emilia (Tangenziale) e Cavriago,23250,00,22610,640,17982,5268,23250,0
2019/03,137,30/03/2019,6,SP 28 tra Reggio Emilia (Tangenziale) e Cavriago,17492,00,17222,270,13643,3849,0,17492
2019/03,137,31/03/2019,7,SP 28 tra Reggio Emilia (Tangenziale) e Cavriago,12172,00,12122,50,9516,2656,0,12172
2019/03,138,29/03/2019,5,SS 63 tra Reggio Emilia e Puianello,12908,10,12486,421,9391,3517,12908,0
2019/03,138,30/03/2019,6,SS 63 tra Reggio Emilia e Puianello,13907,00,13728,179,9958,3949,0,13907
2019/03,138,31/03/2019,7,SS 63 tra Reggio Emilia e Puianello,12278,20,12218,58,8859,3419,0,12278
2019/03,139,29/03/2019,5,SP 467R tra Fogliano e località Pratissolo (c/o Scandiano),19341,10,18427,913,14948,4393,19341,0
2019/03,139,30/03/2019,6,SP 467R tra Fogliano e località Pratissolo (c/o Scandiano),16003,00,15825,178,11250,4753,0,16003
2019/03,139,31/03/2019,7,SP 467R tra Fogliano e località Pratissolo (c/o Scandiano),11252,00,11186,66,7497,3755,0,11252
2019/03,140,29/03/2019,5,SS 9 tra Masone e Rubiera,24967,30,22397,2567,16980,7987,24967,0
2019/03,140,30/03/2019,6,SS 9 tra Masone e Rubiera,25987,40,25344,639,17284,8703,0,25987
2019/03,140,31/03/2019,7,SS 9 tra Masone e Rubiera,20991,00,20825,166,13696,7295,0,20991
2019/03,143,29/03/2019,5,SP 63R tra Sesso e Cadelbosco di Sopra (bivio SP 358R),27514,00,26025,1489,20823,6691,27514,0
2019/03,143,30/03/2019,6,SP 63R tra Sesso e Cadelbosco di Sopra (bivio SP 358R),23706,30,23335,368,17008,6698,0,23706
2019/03,143,31/03/2019,7,SP 63R tra Sesso e Cadelbosco di Sopra (bivio SP 358R),17759,20,17638,119,11801,5958,0,17759
2019/03,146,29/03/2019,5,SS 12 tra Montale e Modena,23040,00,21740,1300,17239,5801,23040,0
2019/03,146,30/03/2019,6,SS 12 tra Montale e Modena,20829,00,20475,354,14457,6372,0,20829
2019/03,146,31/03/2019,7,SS 12 tra Montale e Modena,17220,30,17113,104,12217,5003,0,17220
2019/03,147,29/03/2019,5,SP 623 tra Modena Sud/casello A 1 e Spilamberto,20521,10,17268,3252,15294,5227,20521,0
2019/03,147,30/03/2019,6,SP 623 tra Modena Sud/casello A 1 e Spilamberto,16789,00,16190,599,11599,5190,0,16789
2019/03,147,31/03/2019,7,SP 623 tra Modena Sud/casello A 1 e Spilamberto,15842,00,15639,203,11169,4673,0,15842
2019/03,149,29/03/2019,5,SP 255 tra Modena e Navicello,38426,490,35223,3154,28471,9955,38426,0
2019/03,149,30/03/2019,6,SP 255 tra Modena e Navicello,31516,20,30784,730,21666,9850,0,31516
2019/03,149,31/03/2019,7,SP 255 tra Modena e Navicello,23210,10,23043,166,15392,7818,0,23210
2019/03,150,29/03/2019,5,SS 12 tra Modena e Bastiglia,25754,30,23761,1990,19247,6507,25754,0
2019/03,150,30/03/2019,6,SS 12 tra Modena e Bastiglia,21138,00,20752,386,14172,6966,0,21138
2019/03,150,31/03/2019,7,SS 12 tra Modena e Bastiglia,16645,00,16580,65,10949,5696,0,16645
2019/03,151,29/03/2019,5,SP 413 tra Modena e Ganaceto,25389,00,23927,1462,18494,6895,25389,0
2019/03,151,30/03/2019,6,SP 413 tra Modena e Ganaceto,23173,00,22798,375,15865,7308,0,23173
2019/03,151,31/03/2019,7,SP 413 tra Modena e Ganaceto,17563,00,17473,90,11609,5954,0,17563
2019/03,152,29/03/2019,5,SP 569 tra Innesto tangenziale Bologna e uscita Zola Predosa (Gesso/Rivabella),69666,30,66489,3174,52755,16911,69666,0
2019/03,152,30/03/2019,6,SP 569 tra Innesto tangenziale Bologna e uscita Zola Predosa (Gesso/Rivabella),62493,00,61888,605,46312,16181,0,62493
2019/03,152,31/03/2019,7,SP 569 tra Innesto tangenziale Bologna e uscita Zola Predosa (Gesso/Rivabella),53905,00,53662,243,39258,14647,0,53905
2019/03,153,29/03/2019,5,Via Porrettana (ex SS 64) tra Bologna e Pontecchio Marconi,12360,10,12114,245,9243,3117,12360,0
2019/03,153,30/03/2019,6,Via Porrettana (ex SS 64) tra Bologna e Pontecchio Marconi,11691,00,11579,112,8624,3067,0,11691
2019/03,153,31/03/2019,7,Via Porrettana (ex SS 64) tra Bologna e Pontecchio Marconi,9029,00,8992,37,6461,2568,0,9029
2019/03,154,29/03/2019,5,Tra Rastignano e Pian di Macina (SP85 Fondo Valle Savena),12995,10,12716,278,10028,2967,12995,0
2019/03,154,30/03/2019,6,Tra Rastignano e Pian di Macina (SP85 Fondo Valle Savena),11228,10,11159,68,8409,2819,0,11228
2019/03,154,31/03/2019,7,Tra Rastignano e Pian di Macina (SP85 Fondo Valle Savena),10228,30,10200,25,7593,2635,0,10228
2019/03,155,29/03/2019,5,Via Emilia tra San Lazzaro e Idice,15719,20,15226,491,12033,3686,15719,0
2019/03,155,30/03/2019,6,Via Emilia tra San Lazzaro e Idice,14552,30,14279,270,10736,3816,0,14552
2019/03,155,31/03/2019,7,Via Emilia tra San Lazzaro e Idice,11336,00,11254,82,7790,3546,0,11336
2019/03,157,29/03/2019,5,Via San Donato (ex SP 5) tra Granarolo dell'Emilia e Quarto Inferiore,12585,10,12284,300,9597,2988,12585,0
2019/03,157,30/03/2019,6,Via San Donato (ex SP 5) tra Granarolo dell'Emilia e Quarto Inferiore,11326,00,11198,128,8483,2843,0,11326
2019/03,157,31/03/2019,7,Via San Donato (ex SP 5) tra Granarolo dell'Emilia e Quarto Inferiore,8587,00,8546,41,6077,2510,0,8587
2019/03,158,29/03/2019,5,SS 64 tra Bologna e Lovoleto,12507,30,11778,726,9404,3103,12507,0
2019/03,158,30/03/2019,6,SS 64 tra Bologna e Lovoleto,9613,00,9438,175,6811,2802,0,9613
2019/03,158,31/03/2019,7,SS 64 tra Bologna e Lovoleto,8352,00,8278,74,5941,2411,0,8352
2019/03,160,29/03/2019,5,SP 18 tra Bargellino e Calderara di Reno (c/o Variante SP18),19247,10,17538,1708,14909,4338,19247,0
2019/03,160,30/03/2019,6,SP 18 tra Bargellino e Calderara di Reno (c/o Variante SP18),13534,00,13138,396,9653,3881,0,13534
2019/03,160,31/03/2019,7,SP 18 tra Bargellino e Calderara di Reno (c/o Variante SP18),9566,00,9515,51,6662,2904,0,9566
2019/03,161,29/03/2019,5,SP 568 da Tavernelle all'intersezione della SP3,19921,00,18895,1026,14500,5421,19921,0
2019/03,161,30/03/2019,6,SP 568 da Tavernelle all'intersezione della SP3,17516,00,17238,278,11924,5592,0,17516
2019/03,161,31/03/2019,7,SP 568 da Tavernelle all'intersezione della SP3,15098,00,15028,70,10093,5005,0,15098
2019/03,162,29/03/2019,5,SS 9 località Cavazzona,18769,20,17128,1639,12625,6144,18769,0
2019/03,162,30/03/2019,6,SS 9 località Cavazzona,16429,20,15894,533,10524,5905,0,16429
2019/03,162,31/03/2019,7,SS 9 località Cavazzona,13666,10,13561,104,8501,5165,0,13666
2019/03,170,29/03/2019,5,SS 67 tra Rovere e Forlì,10050,00,9565,485,7818,2232,10050,0
2019/03,170,30/03/2019,6,SS 67 tra Rovere e Forlì,8712,00,8520,192,6570,2142,0,8712
2019/03,170,31/03/2019,7,SS 67 tra Rovere e Forlì,7266,00,7211,55,5419,1847,0,7266
2019/03,171,29/03/2019,5,SP 56 tra Forlì e bivio SS67 (Castrocaro Terme),7795,00,7597,198,5907,1888,7795,0
2019/03,171,30/03/2019,6,SP 56 tra Forlì e bivio SS67 (Castrocaro Terme),7400,10,7338,61,5480,1920,0,7400
2019/03,171,31/03/2019,7,SP 56 tra Forlì e bivio SS67 (Castrocaro Terme),6027,00,6003,24,4526,1501,0,6027
2019/03,173,29/03/2019,5,SP 4 tra Ronco (SS9) e bivio SP 72 (Para),8751,00,8284,467,6864,1887,8751,0
2019/03,173,30/03/2019,6,SP 4 tra Ronco (SS9) e bivio SP 72 (Para),6357,10,6197,159,4671,1686,0,6357
2019/03,173,31/03/2019,7,SP 4 tra Ronco (SS9) e bivio SP 72 (Para),4968,00,4924,44,3515,1453,0,4968
2019/03,174,29/03/2019,5,SS 9 tra Ronco e Forlimpopoli,,,,,,,,
2019/03,174,30/03/2019,6,SS 9 tra Ronco e Forlimpopoli,,,,,,,,
2019/03,174,31/03/2019,7,SS 9 tra Ronco e Forlimpopoli,,,,,,,,
2019/03,176,29/03/2019,5,SP 2 in località La Caserma al Confine Provinciale,9812,00,9011,801,7539,2273,9812,0
2019/03,176,30/03/2019,6,SP 2 in località La Caserma al Confine Provinciale,10469,00,10234,235,7585,2884,0,10469
2019/03,176,31/03/2019,7,SP 2 in località La Caserma al Confine Provinciale,13646,00,13598,48,10393,3253,0,13646
2019/03,177,29/03/2019,5,NSA 313 - Prosecuzione tangenziale di Bologna complanare sud alla A 14 nel tratto San Lazzaro/Idice,17578,20,16749,827,12988,4590,17578,0
2019/03,177,30/03/2019,6,NSA 313 - Prosecuzione tangenziale di Bologna complanare sud alla A 14 nel tratto San Lazzaro/Idice,13775,00,13581,194,9473,4302,0,13775
2019/03,177,31/03/2019,7,NSA 313 - Prosecuzione tangenziale di Bologna complanare sud alla A 14 nel tratto San Lazzaro/Idice,11471,10,11396,74,7373,4098,0,11471
2019/03,182,29/03/2019,5,SP 258R tra Rimini e A 14,17630,10,16924,705,13221,4409,17630,0
2019/03,182,30/03/2019,6,SP 258R tra Rimini e A 14,16557,10,16290,266,11710,4847,0,16557
2019/03,182,31/03/2019,7,SP 258R tra Rimini e A 14,14329,10,14260,68,10013,4316,0,14329
2019/03,186,29/03/2019,5,SS 16 tra Rimini e Igea Marina-Viserba,30299,20,28811,1486,22935,7364,30299,0
2019/03,186,30/03/2019,6,SS 16 tra Rimini e Igea Marina-Viserba,29054,10,28520,533,20790,8264,0,29054
2019/03,186,31/03/2019,7,SS 16 tra Rimini e Igea Marina-Viserba,25743,10,25567,175,18112,7631,0,25743
2019/03,188,29/03/2019,5,SS 9 tra Rimini e Santa Giustina,29701,20,28562,1137,22533,7168,29701,0
2019/03,188,30/03/2019,6,SS 9 tra Rimini e Santa Giustina,24647,20,24100,545,17169,7478,0,24647
2019/03,188,31/03/2019,7,SS 9 tra Rimini e Santa Giustina,19011,10,18865,145,12825,6186,0,19011
2019/03,215,29/03/2019,5,SP 3_1 tra accesso interporto Bologna e viadotto A 13,30283,100,23147,7126,22033,8250,30283,0
2019/03,215,30/03/2019,6,SP 3_1 tra accesso interporto Bologna e viadotto A 13,16614,20,14893,1719,11274,5340,0,16614
2019/03,215,31/03/2019,7,SP 3_1 tra accesso interporto Bologna e viadotto A 13,12587,00,12438,149,8975,3612,0,12587
2019/03,218,29/03/2019,5,SP 10 tra Polesine e Roccabianca su variante Zibello,2835,10,2456,378,2197,638,2835,0
2019/03,218,30/03/2019,6,SP 10 tra Polesine e Roccabianca su variante Zibello,2543,00,2416,127,1907,636,0,2543
2019/03,218,31/03/2019,7,SP 10 tra Polesine e Roccabianca su variante Zibello,2685,00,2655,30,2115,570,0,2685
2019/03,220,29/03/2019,5,SS 9 tra Fiorenzuola d'Arda e Fidenza al confine provinciale,15499,1180,13590,1791,11900,3599,15499,0
2019/03,220,30/03/2019,6,SS 9 tra Fiorenzuola d'Arda e Fidenza al confine provinciale,,,,,,,,
2019/03,220,31/03/2019,7,SS 9 tra Fiorenzuola d'Arda e Fidenza al confine provinciale,,,,,,,,
2019/03,222,29/03/2019,5,SP 359R tra Fidenza e Salsomaggiore Terme,17924,110,17434,479,13061,4863,17924,0
2019/03,222,30/03/2019,6,SP 359R tra Fidenza e Salsomaggiore Terme,16698,10,16443,254,11767,4931,0,16698
2019/03,222,31/03/2019,7,SP 359R tra Fidenza e Salsomaggiore Terme,13448,00,13378,70,9298,4150,0,13448
2019/03,223,29/03/2019,5,SP 357R tra SS 9 e Noceto,11614,00,10247,1367,8983,2631,11614,0
2019/03,223,30/03/2019,6,SP 357R tra SS 9 e Noceto,9289,00,8987,302,6787,2502,0,9289
2019/03,223,31/03/2019,7,SP 357R tra SS 9 e Noceto,7052,00,6956,96,4978,2074,0,7052
2019/03,226,29/03/2019,5,SP 32 dal bivio SP 16 (per Langhirano) al bivio SP 665R,12792,10,11887,904,9948,2844,12792,0
2019/03,226,30/03/2019,6,SP 32 dal bivio SP 16 (per Langhirano) al bivio SP 665R,10173,10,9927,245,7499,2674,0,10173
2019/03,226,31/03/2019,7,SP 32 dal bivio SP 16 (per Langhirano) al bivio SP 665R,8502,10,8397,104,6238,2264,0,8502
2019/03,227,29/03/2019,5,SP 34 da Colorno al bivio SP 60 (al confine provinciale),6452,00,6202,250,5051,1401,6452,0
2019/03,227,30/03/2019,6,SP 34 da Colorno al bivio SP 60 (al confine provinciale),5570,00,5470,100,4086,1484,0,5570
2019/03,227,31/03/2019,7,SP 34 da Colorno al bivio SP 60 (al confine provinciale),3941,00,3917,24,2806,1135,0,3941
2019/03,228,29/03/2019,5,SP 62R tra Brescello (bivio SP 41) e Sorbolo (bivio SP 20),12293,00,10255,2038,9451,2842,12293,0
2019/03,228,30/03/2019,6,SP 62R tra Brescello (bivio SP 41) e Sorbolo (bivio SP 20),10767,10,10404,362,8068,2699,0,10767
2019/03,228,31/03/2019,7,SP 62R tra Brescello (bivio SP 41) e Sorbolo (bivio SP 20),9743,00,9636,107,6726,3017,0,9743
2019/03,229,29/03/2019,5,SP 111 tra bivio SP 1 (a nord di Poviglio) e Boretto (innesto variante),,,,,,,,
2019/03,229,30/03/2019,6,SP 111 tra bivio SP 1 (a nord di Poviglio) e Boretto (innesto variante),,,,,,,,
2019/03,229,31/03/2019,7,SP 111 tra bivio SP 1 (a nord di Poviglio) e Boretto (innesto variante),,,,,,,,
2019/03,230,29/03/2019,5,SP 62RVar Cispadana da Boretto (bivio Variante SP 358R) a Gualtieri (bivio SP 63R),12902,00,10133,2769,9946,2956,12902,0
2019/03,230,30/03/2019,6,SP 62RVar Cispadana da Boretto (bivio Variante SP 358R) a Gualtieri (bivio SP 63R),9844,00,9390,454,7349,2495,0,9844
2019/03,230,31/03/2019,7,SP 62RVar Cispadana da Boretto (bivio Variante SP 358R) a Gualtieri (bivio SP 63R),9054,10,8911,142,6361,2693,0,9054
2019/03,231,29/03/2019,5,SP 63R tra la località Santa Vittoria (c/o bivio SP 81) e la Cispadana,7644,00,7083,561,6031,1613,7644,0
2019/03,231,30/03/2019,6,SP 63R tra la località Santa Vittoria (c/o bivio SP 81) e la Cispadana,6634,00,6499,135,4973,1661,0,6634
2019/03,231,31/03/2019,7,SP 63R tra la località Santa Vittoria (c/o bivio SP 81) e la Cispadana,5359,00,5334,25,3719,1640,0,5359
2019/03,236,29/03/2019,5,SP 468 tra Casumaro e Reno Centese,5892,00,5254,638,4580,1312,5892,0
2019/03,236,30/03/2019,6,SP 468 tra Casumaro e Reno Centese,5099,00,4961,138,3770,1329,0,5099
2019/03,236,31/03/2019,7,SP 468 tra Casumaro e Reno Centese,4240,00,4213,27,2968,1272,0,4240
2019/03,237,29/03/2019,5,SP 23 tra Quattro Castella e la Variante di Montecavolo (c/o bivio SP 21),16534,00,15645,889,12712,3822,16534,0
2019/03,237,30/03/2019,6,SP 23 tra Quattro Castella e la Variante di Montecavolo (c/o bivio SP 21),14130,00,13919,211,10295,3835,0,14130
2019/03,237,31/03/2019,7,SP 23 tra Quattro Castella e la Variante di Montecavolo (c/o bivio SP 21),12148,00,12094,54,8949,3199,0,12148
2019/03,238,29/03/2019,5,SP 37 fra Albinea e Scandiano (bivio SP 7),12484,00,11774,710,9605,2879,12484,0
2019/03,238,30/03/2019,6,SP 37 fra Albinea e Scandiano (bivio SP 7),10027,00,9868,159,7271,2756,0,10027
2019/03,238,31/03/2019,7,SP 37 fra Albinea e Scandiano (bivio SP 7),8341,00,8284,57,5941,2400,0,8341
2019/03,239,29/03/2019,5,SP 486R fra Sassuolo e Castellarano,29428,40,25662,3762,22995,6433,29428,0
2019/03,239,30/03/2019,6,SP 486R fra Sassuolo e Castellarano,21926,00,21392,534,15870,6056,0,21926
2019/03,239,31/03/2019,7,SP 486R fra Sassuolo e Castellarano,18305,10,18182,122,12945,5360,0,18305
2019/03,242,29/03/2019,5,SS 12 tra Maranello e Pavullo nel Frignano,16723,00,15228,1495,12438,4285,16723,0
2019/03,242,30/03/2019,6,SS 12 tra Maranello e Pavullo nel Frignano,16178,00,15869,309,11742,4436,0,16178
2019/03,242,31/03/2019,7,SS 12 tra Maranello e Pavullo nel Frignano,15700,20,15629,69,11583,4117,0,15700
2019/03,243,29/03/2019,5,SP 27 tra Ponte Samoggia e Muffa,11563,00,10833,730,8861,2702,11563,0
2019/03,243,30/03/2019,6,SP 27 tra Ponte Samoggia e Muffa,9097,00,8905,192,6684,2413,0,9097
2019/03,243,31/03/2019,7,SP 27 tra Ponte Samoggia e Muffa,7095,10,7048,46,5069,2026,0,7095
2019/03,244,29/03/2019,5,SP 569 tra Pragatto e innesto variante Ponte Ronca,9603,00,9197,406,7385,2218,9603,0
2019/03,244,30/03/2019,6,SP 569 tra Pragatto e innesto variante Ponte Ronca,9384,10,9229,154,7163,2221,0,9384
2019/03,244,31/03/2019,7,SP 569 tra Pragatto e innesto variante Ponte Ronca,8106,00,8073,33,6198,1908,0,8106
2019/03,245,29/03/2019,5,SP 569 da intersezione Pedemontana a Savignano sul Panaro,8163,00,7671,492,6006,2157,8163,0
2019/03,245,30/03/2019,6,SP 569 da intersezione Pedemontana a Savignano sul Panaro,8278,20,8144,132,6162,2116,0,8278
2019/03,245,31/03/2019,7,SP 569 da intersezione Pedemontana a Savignano sul Panaro,7476,00,7419,57,5443,2033,0,7476
2019/03,246,29/03/2019,5,SP 255 da Decima a San Giovanni in Persiceto,15499,10,14480,1018,11652,3847,15499,0
2019/03,246,30/03/2019,6,SP 255 da Decima a San Giovanni in Persiceto,12249,10,12034,214,8539,3710,0,12249
2019/03,246,31/03/2019,7,SP 255 da Decima a San Giovanni in Persiceto,9175,00,9125,50,6069,3106,0,9175
2019/03,247,29/03/2019,5,SP 255 fra Nonantola e Sant'Agata Bolognese,11189,00,9666,1523,8385,2804,11189,0
2019/03,247,30/03/2019,6,SP 255 fra Nonantola e Sant'Agata Bolognese,7983,00,7704,279,5370,2613,0,7983
2019/03,247,31/03/2019,7,SP 255 fra Nonantola e Sant'Agata Bolognese,6564,00,6504,60,4372,2192,0,6564
2019/03,251,29/03/2019,5,SP 610 tra Imola e Casalfiumanese in località Ca' Miseria,13859,10,13106,752,10535,3324,13859,0
2019/03,251,30/03/2019,6,SP 610 tra Imola e Casalfiumanese in località Ca' Miseria,12900,30,12695,202,9577,3323,0,12900
2019/03,251,31/03/2019,7,SP 610 tra Imola e Casalfiumanese in località Ca' Miseria,10887,00,10832,55,8155,2732,0,10887
2019/03,252,29/03/2019,5,SP 3_2 tra Budrio e bivio SP 29 per Medicina,10011,10,9116,894,7761,2250,10011,0
2019/03,252,30/03/2019,6,SP 3_2 tra Budrio e bivio SP 29 per Medicina,7548,00,7405,143,5614,1934,0,7548
2019/03,252,31/03/2019,7,SP 3_2 tra Budrio e bivio SP 29 per Medicina,6769,00,6725,44,4782,1987,0,6769
2019/03,254,29/03/2019,5,SS 9 tra Ozzano Emilia e Castel San Pietro,17343,00,16730,613,13073,4270,17343,0
2019/03,254,30/03/2019,6,SS 9 tra Ozzano Emilia e Castel San Pietro,14790,00,14516,274,10580,4210,0,14790
2019/03,254,31/03/2019,7,SS 9 tra Ozzano Emilia e Castel San Pietro,12375,20,12309,64,8648,3727,0,12375
2019/03,255,29/03/2019,5,SS 9 tra Castel San Pietro e Imola,20883,00,20123,760,15774,5109,20883,0
2019/03,255,30/03/2019,6,SS 9 tra Castel San Pietro e Imola,18725,20,18469,254,13881,4844,0,18725
2019/03,255,31/03/2019,7,SS 9 tra Castel San Pietro e Imola,15143,20,15044,97,10883,4260,0,15143
2019/03,256,29/03/2019,5,SP 302R tra Faenza (bivio SP 66) e Brisighella,9138,00,8775,363,6841,2297,9138,0
2019/03,256,30/03/2019,6,SP 302R tra Faenza (bivio SP 66) e Brisighella,9096,20,8969,125,6793,2303,0,9096
2019/03,256,31/03/2019,7,SP 302R tra Faenza (bivio SP 66) e Brisighella,8628,10,8596,31,6774,1854,0,8628
2019/03,257,29/03/2019,5,SP 302R tra Faenza e il bivio SP 4 (a sud di Russi),6568,00,6365,203,4947,1621,6568,0
2019/03,257,30/03/2019,6,SP 302R tra Faenza e il bivio SP 4 (a sud di Russi),6151,00,6043,108,4440,1711,0,6151
2019/03,257,31/03/2019,7,SP 302R tra Faenza e il bivio SP 4 (a sud di Russi),5188,00,5162,26,3676,1512,0,5188
2019/03,258,29/03/2019,5,SS 9 tra Forlimpopoli e Cesena,26125,10,23881,2243,19591,6534,26125,0
2019/03,258,30/03/2019,6,SS 9 tra Forlimpopoli e Cesena,21388,30,20632,753,15009,6379,0,21388
2019/03,258,31/03/2019,7,SS 9 tra Forlimpopoli e Cesena,17882,00,17665,217,12325,5557,0,17882
2019/03,259,29/03/2019,5,SP 7 in località Calabrina al Confine Provinciale,8374,00,7967,407,6134,2240,8374,0
2019/03,259,30/03/2019,6,SP 7 in località Calabrina al Confine Provinciale,9834,00,9685,149,6605,3229,0,9834
2019/03,259,31/03/2019,7,SP 7 in località Calabrina al Confine Provinciale,9760,00,9682,78,6841,2919,0,9760
2019/03,260,29/03/2019,5,SP 8 tra Cesena e A 14,12378,00,12044,334,9608,2770,12378,0
2019/03,260,30/03/2019,6,SP 8 tra Cesena e A 14,11691,10,11562,128,8610,3081,0,11691
2019/03,260,31/03/2019,7,SP 8 tra Cesena e A 14,10671,00,10648,23,7883,2788,0,10671
2019/03,261,29/03/2019,5,SS 9 tra Cesena e Savignano sul Rubicone,29831,00,27539,2292,22850,6981,29831,0
2019/03,261,30/03/2019,6,SS 9 tra Cesena e Savignano sul Rubicone,23011,00,22133,878,16263,6748,0,23011
2019/03,261,31/03/2019,7,SS 9 tra Cesena e Savignano sul Rubicone,16481,20,16306,173,11007,5474,0,16481
2019/03,262,29/03/2019,5,SS 9 tra Savignano sul Rubicone e Santarcangelo di Romagna,,,,,,,,
2019/03,262,30/03/2019,6,SS 9 tra Savignano sul Rubicone e Santarcangelo di Romagna,,,,,,,,
2019/03,262,31/03/2019,7,SS 9 tra Savignano sul Rubicone e Santarcangelo di Romagna,,,,,,,,
2019/03,263,29/03/2019,5,Via Adriatica (ex SS 16) tra Riccione e Misano Adriatico,18095,00,17633,462,13504,4591,18095,0
2019/03,263,30/03/2019,6,Via Adriatica (ex SS 16) tra Riccione e Misano Adriatico,17969,00,17771,198,12268,5701,0,17969
2019/03,263,31/03/2019,7,Via Adriatica (ex SS 16) tra Riccione e Misano Adriatico,16994,10,16910,83,11715,5279,0,16994
2019/03,269,29/03/2019,5,SS 12 a Medolla,21353,10,19355,1997,16530,4823,21353,0
2019/03,269,30/03/2019,6,SS 12 a Medolla,15906,00,15566,340,11250,4656,0,15906
2019/03,269,31/03/2019,7,SS 12 a Medolla,12436,00,12360,76,8481,3955,0,12436
2019/03,275,29/03/2019,5,SP 5 dall'intersezione SP 3 a intersezione per Ca' de Fabbri,11641,00,11145,496,9029,2612,11641,0
2019/03,275,30/03/2019,6,SP 5 dall'intersezione SP 3 a intersezione per Ca' de Fabbri,8764,00,8598,166,6396,2368,0,8764
2019/03,275,31/03/2019,7,SP 5 dall'intersezione SP 3 a intersezione per Ca' de Fabbri,6664,00,6622,42,4699,1965,0,6664
2019/03,276,29/03/2019,5,SP 3_2 tra intersezione SP 5 e ponte torrente Idice,13130,00,12021,1109,10174,2956,13130,0
2019/03,276,30/03/2019,6,SP 3_2 tra intersezione SP 5 e ponte torrente Idice,8470,00,8255,215,6108,2362,0,8470
2019/03,276,31/03/2019,7,SP 3_2 tra intersezione SP 5 e ponte torrente Idice,7448,00,7400,48,5206,2242,0,7448
2019/03,277,29/03/2019,5,SP 6 tra Budrio e San Martino in Argine,8105,00,7641,464,6186,1919,8105,0
2019/03,277,30/03/2019,6,SP 6 tra Budrio e San Martino in Argine,6346,00,6189,157,4630,1716,0,6346
2019/03,277,31/03/2019,7,SP 6 tra Budrio e San Martino in Argine,4948,10,4910,37,3497,1451,0,4948
2019/03,278,29/03/2019,5,SP 6 tra Budrio e bivio SP 253,14732,00,13987,745,11365,3367,14732,0
2019/03,278,30/03/2019,6,SP 6 tra Budrio e bivio SP 253,11668,00,11475,193,8562,3106,0,11668
2019/03,278,31/03/2019,7,SP 6 tra Budrio e bivio SP 253,8430,00,8383,47,5875,2555,0,8430
2019/03,279,29/03/2019,5,SP 31 dal bivio SP 28 per Castenaso a Ponte Rizzoli,15027,00,14028,999,12195,2832,15027,0
2019/03,279,30/03/2019,6,SP 31 dal bivio SP 28 per Castenaso a Ponte Rizzoli,10379,00,10173,206,7916,2463,0,10379
2019/03,279,31/03/2019,7,SP 31 dal bivio SP 28 per Castenaso a Ponte Rizzoli,8338,10,8276,61,6047,2291,0,8338
2019/03,280,29/03/2019,5,SP 26 tra Gesso e Ponte Rivabella,22283,00,21761,522,16771,5512,22283,0
2019/03,280,30/03/2019,6,SP 26 tra Gesso e Ponte Rivabella,18934,10,18753,180,13546,5388,0,18934
2019/03,280,31/03/2019,7,SP 26 tra Gesso e Ponte Rivabella,15761,00,15706,55,11317,4444,0,15761
2019/03,281,29/03/2019,5,SP 78_1 tra Bazzano e Intersezione SP 27 a Monteveglio,7243,20,7002,239,5572,1671,7243,0
2019/03,281,30/03/2019,6,SP 78_1 tra Bazzano e Intersezione SP 27 a Monteveglio,7025,30,6920,102,5240,1785,0,7025
2019/03,281,31/03/2019,7,SP 78_1 tra Bazzano e Intersezione SP 27 a Monteveglio,5361,00,5324,37,3943,1418,0,5361
2019/03,282,29/03/2019,5,SS 9 tra Anzola dell'Emilia e Bologna,25026,00,22730,2296,18325,6701,25026,0
2019/03,282,30/03/2019,6,SS 9 tra Anzola dell'Emilia e Bologna,18227,00,17619,608,12724,5503,0,18227
2019/03,282,31/03/2019,7,SS 9 tra Anzola dell'Emilia e Bologna,14724,00,14614,110,9752,4972,0,14724
2019/03,287,29/03/2019,5,SP 6 fra Cento e Pilastrello,8347,20,7861,484,6376,1971,8347,0
2019/03,287,30/03/2019,6,SP 6 fra Cento e Pilastrello,7388,10,7265,122,5393,1995,0,7388
2019/03,287,31/03/2019,7,SP 6 fra Cento e Pilastrello,5531,00,5508,23,3790,1741,0,5531
2019/03,288,29/03/2019,5,SP 42 fra Pieve di Cento e Castello d'Argile,19798,20,18878,918,14799,4999,19798,0
2019/03,288,30/03/2019,6,SP 42 fra Pieve di Cento e Castello d'Argile,14802,00,14585,217,10366,4436,0,14802
2019/03,288,31/03/2019,7,SP 42 fra Pieve di Cento e Castello d'Argile,11550,00,11484,66,7930,3620,0,11550
2019/03,289,29/03/2019,5,SP 66 fra Cento e Sant'Agostino,15559,10,14783,775,12152,3407,15559,0
2019/03,289,30/03/2019,6,SP 66 fra Cento e Sant'Agostino,13399,00,13182,217,9714,3685,0,13399
2019/03,289,31/03/2019,7,SP 66 fra Cento e Sant'Agostino,10169,00,10114,55,6946,3223,0,10169
2019/03,290,29/03/2019,5,SP 11 fra Pieve di Cento e San Pietro in Casale,6840,00,6437,403,5210,1630,6840,0
2019/03,290,30/03/2019,6,SP 11 fra Pieve di Cento e San Pietro in Casale,5879,00,5758,121,4018,1861,0,5879
2019/03,290,31/03/2019,7,SP 11 fra Pieve di Cento e San Pietro in Casale,4258,00,4235,23,2820,1438,0,4258
2019/03,291,29/03/2019,5,SP 4 tra San Pietro in Casale e San Vincenzo/San Venanzio,11128,00,10683,445,8212,2916,11128,0
2019/03,291,30/03/2019,6,SP 4 tra San Pietro in Casale e San Vincenzo/San Venanzio,9266,00,9158,108,6756,2510,0,9266
2019/03,291,31/03/2019,7,SP 4 tra San Pietro in Casale e San Vincenzo/San Venanzio,6769,10,6727,41,4829,1940,0,6769
2019/03,292,29/03/2019,5,SP 4 tra San Giorgio di Piano e Intersezione SP 11 c/o San Pietro in Casale,18835,00,18159,676,13905,4930,18835,0
2019/03,292,30/03/2019,6,SP 4 tra San Giorgio di Piano e Intersezione SP 11 c/o San Pietro in Casale,15291,10,15107,183,10868,4423,0,15291
2019/03,292,31/03/2019,7,SP 4 tra San Giorgio di Piano e Intersezione SP 11 c/o San Pietro in Casale,10913,00,10858,55,7543,3370,0,10913
2019/03,295,29/03/2019,5,SP 9 fra Colorno e Torrile centro abitato di Bezze,8145,10,7600,544,6579,1566,8145,0
2019/03,295,30/03/2019,6,SP 9 fra Colorno e Torrile centro abitato di Bezze,5811,00,5632,179,4385,1426,0,5811
2019/03,295,31/03/2019,7,SP 9 fra Colorno e Torrile centro abitato di Bezze,3707,00,3625,82,2683,1024,0,3707
2019/03,298,29/03/2019,5,SP 588R da Castione Marchesi (A 1) a Busseto,3223,00,3040,183,2500,723,3223,0
2019/03,298,30/03/2019,6,SP 588R da Castione Marchesi (A 1) a Busseto,2667,00,2609,58,1934,733,0,2667
2019/03,298,31/03/2019,7,SP 588R da Castione Marchesi (A 1) a Busseto,2391,00,2365,26,1707,684,0,2391
2019/03,300,29/03/2019,5,SP 462R fra Fiorenzuola d'Arda e Cortemaggiore,9213,10,8073,1139,7201,2012,9213,0
2019/03,300,30/03/2019,6,SP 462R fra Fiorenzuola d'Arda e Cortemaggiore,6951,10,6571,379,5132,1819,0,6951
2019/03,300,31/03/2019,7,SP 462R fra Fiorenzuola d'Arda e Cortemaggiore,6179,00,6114,65,4592,1587,0,6179
2019/03,301,29/03/2019,5,SP 4 tra Fiorenzuola d'Arda (Tg Sud) e Castell'Arquato,9210,00,8564,646,7043,2167,9210,0
2019/03,301,30/03/2019,6,SP 4 tra Fiorenzuola d'Arda (Tg Sud) e Castell'Arquato,8365,00,8240,125,6212,2153,0,8365
2019/03,301,31/03/2019,7,SP 4 tra Fiorenzuola d'Arda (Tg Sud) e Castell'Arquato,7327,00,7310,17,5427,1900,0,7327
2019/03,302,29/03/2019,5,SP 12 da Fidenza (Casello A 1) a Soragna,8498,00,7542,956,6664,1834,8498,0
2019/03,302,30/03/2019,6,SP 12 da Fidenza (Casello A 1) a Soragna,7884,00,7643,241,5845,2039,0,7884
2019/03,302,31/03/2019,7,SP 12 da Fidenza (Casello A 1) a Soragna,7012,00,6937,75,5030,1982,0,7012
2019/03,303,29/03/2019,5,SP 11 fra Borgonovo e Gragnano,10255,00,9668,587,7842,2413,10255,0
2019/03,303,30/03/2019,6,SP 11 fra Borgonovo e Gragnano,8909,00,8729,180,6518,2391,0,8909
2019/03,303,31/03/2019,7,SP 11 fra Borgonovo e Gragnano,7387,00,7356,31,5334,2053,0,7387
2019/03,304,29/03/2019,5,SP 42 fra Podenzano e bivio SP 6/ponte fiume Nure in località San Giorgio Piacentino,7663,00,7150,513,5828,1835,7663,0
2019/03,304,30/03/2019,6,SP 42 fra Podenzano e bivio SP 6/ponte fiume Nure in località San Giorgio Piacentino,6129,00,6035,94,4466,1663,0,6129
2019/03,304,31/03/2019,7,SP 42 fra Podenzano e bivio SP 6/ponte fiume Nure in località San Giorgio Piacentino,5614,00,5590,24,4168,1446,0,5614
2019/03,305,29/03/2019,5,SP 6Bis fra Carpaneto e Castell'Arquato,4973,00,4543,430,3704,1269,4973,0
2019/03,305,30/03/2019,6,SP 6Bis fra Carpaneto e Castell'Arquato,4867,00,4737,130,3506,1361,0,4867
2019/03,305,31/03/2019,7,SP 6Bis fra Carpaneto e Castell'Arquato,4837,00,4800,37,3685,1152,0,4837
2019/03,306,29/03/2019,5,SP 654R fra Ponte dell'Olio e Bettola,4805,00,4632,173,3675,1130,4805,0
2019/03,306,30/03/2019,6,SP 654R fra Ponte dell'Olio e Bettola,5009,10,4903,105,3784,1225,0,5009
2019/03,306,31/03/2019,7,SP 654R fra Ponte dell'Olio e Bettola,5268,00,5237,31,3932,1336,0,5268
2019/03,307,29/03/2019,5,SS 45 tra Rivergaro e Perino,5092,00,4802,290,3822,1270,5092,0
2019/03,307,30/03/2019,6,SS 45 tra Rivergaro e Perino,6045,00,5932,113,4756,1289,0,6045
2019/03,307,31/03/2019,7,SS 45 tra Rivergaro e Perino,7321,00,7286,35,5786,1535,0,7321
2019/03,308,29/03/2019,5,SP 412R fra Pianello Val Tidone e Borgonovo Val Tidone,7371,00,7020,351,5680,1691,7371,0
2019/03,308,30/03/2019,6,SP 412R fra Pianello Val Tidone e Borgonovo Val Tidone,7432,00,7280,152,5730,1702,0,7432
2019/03,308,31/03/2019,7,SP 412R fra Pianello Val Tidone e Borgonovo Val Tidone,6631,00,6604,27,5136,1495,0,6631
2019/03,309,29/03/2019,5,SP 10R fra Castelvetro Piacentino e Monticelli d'Ongina,12427,10,11854,572,9624,2803,12427,0
2019/03,309,30/03/2019,6,SP 10R fra Castelvetro Piacentino e Monticelli d'Ongina,11500,20,11254,244,8337,3163,0,11500
2019/03,309,31/03/2019,7,SP 10R fra Castelvetro Piacentino e Monticelli d'Ongina,9839,00,9779,60,7261,2578,0,9839
2019/03,311,29/03/2019,5,SP 62RVar tra la località San Giacomo (bivio SP 42) ed SP 2 (c/o Tagliata),13015,10,10362,2652,10143,2872,13015,0
2019/03,311,30/03/2019,6,SP 62RVar tra la località San Giacomo (bivio SP 42) ed SP 2 (c/o Tagliata),10077,10,9630,446,7620,2457,0,10077
2019/03,311,31/03/2019,7,SP 62RVar tra la località San Giacomo (bivio SP 42) ed SP 2 (c/o Tagliata),9154,00,9020,134,6552,2602,0,9154
2019/03,312,29/03/2019,5,SP 42 fra Novellara e San Giacomo (SP 62R),14936,00,13642,1294,11371,3565,14936,0
2019/03,312,30/03/2019,6,SP 42 fra Novellara e San Giacomo (SP 62R),12650,00,12400,250,8938,3712,0,12650
2019/03,312,31/03/2019,7,SP 42 fra Novellara e San Giacomo (SP 62R),11701,00,11622,79,7937,3764,0,11701
2019/03,314,29/03/2019,5,SP 2 fra Reggiolo (bivio SP 2) e località Villarotta (SP 84),9909,00,9426,483,7646,2263,9909,0
2019/03,314,30/03/2019,6,SP 2 fra Reggiolo (bivio SP 2) e località Villarotta (SP 84),8592,00,8437,155,6333,2259,0,8592
2019/03,314,31/03/2019,7,SP 2 fra Reggiolo (bivio SP 2) e località Villarotta (SP 84),7444,00,7401,43,5147,2297,0,7444
2019/03,318,29/03/2019,5,SP 51 fra Sassuolo (bivio SP 467R) e Rubiera,12076,20,9083,2991,9406,2670,12076,0
2019/03,318,30/03/2019,6,SP 51 fra Sassuolo (bivio SP 467R) e Rubiera,8601,00,8326,275,5858,2743,0,8601
2019/03,318,31/03/2019,7,SP 51 fra Sassuolo (bivio SP 467R) e Rubiera,6826,00,6761,65,4615,2211,0,6826
2019/03,319,29/03/2019,5,SP 15 tra Sassuolo e Magreta,,,,,,,,
2019/03,319,30/03/2019,6,SP 15 tra Sassuolo e Magreta,,,,,,,,
2019/03,319,31/03/2019,7,SP 15 tra Sassuolo e Magreta,,,,,,,,
2019/03,321,29/03/2019,5,SP 467 tra SP 486 e confine provinciale,,,,,,,,
2019/03,321,30/03/2019,6,SP 467 tra SP 486 e confine provinciale,,,,,,,,
2019/03,321,31/03/2019,7,SP 467 tra SP 486 e confine provinciale,,,,,,,,
2019/03,323,29/03/2019,5,SP 467 fra SP 3 e SS 12,28389,00,24396,3993,21889,6500,28389,0
2019/03,323,30/03/2019,6,SP 467 fra SP 3 e SS 12,18799,00,18202,597,13355,5444,0,18799
2019/03,323,31/03/2019,7,SP 467 fra SP 3 e SS 12,14749,10,14631,117,10457,4292,0,14749
2019/03,328,29/03/2019,5,SP 486 tra Modena e Baggiovara,26114,00,25562,552,19855,6259,26114,0
2019/03,328,30/03/2019,6,SP 486 tra Modena e Baggiovara,23462,20,23207,253,16581,6881,0,23462
2019/03,328,31/03/2019,7,SP 486 tra Modena e Baggiovara,16111,00,15995,116,10680,5431,0,16111
2019/03,331,29/03/2019,5,SP 325 tra Casello A 1 (Sasso Marconi) e Vado,8057,00,7700,357,6008,2049,8057,0
2019/03,331,30/03/2019,6,SP 325 tra Casello A 1 (Sasso Marconi) e Vado,7059,10,6957,101,5245,1814,0,7059
2019/03,331,31/03/2019,7,SP 325 tra Casello A 1 (Sasso Marconi) e Vado,5950,00,5922,28,4277,1673,0,5950
2019/03,332,29/03/2019,5,SP 306R fra Castel Bolognese e Riolo Terme,8958,00,8440,518,6817,2141,8958,0
2019/03,332,30/03/2019,6,SP 306R fra Castel Bolognese e Riolo Terme,8287,30,8118,166,6134,2153,0,8287
2019/03,332,31/03/2019,7,SP 306R fra Castel Bolognese e Riolo Terme,6966,00,6928,38,5070,1896,0,6966
2019/03,333,29/03/2019,5,SS 9 tra Castel Bolognese e Faenza,24779,00,23719,1060,17844,6935,24779,0
2019/03,333,30/03/2019,6,SS 9 tra Castel Bolognese e Faenza,22214,00,21882,332,14775,7439,0,22214
2019/03,333,31/03/2019,7,SS 9 tra Castel Bolognese e Faenza,17619,10,17555,63,11562,6057,0,17619
2019/03,334,29/03/2019,5,SP 8 dal Casello A 1 (Faenza) a Cotignola,16029,00,15136,893,12239,3790,16029,0
2019/03,334,30/03/2019,6,SP 8 dal Casello A 1 (Faenza) a Cotignola,14148,00,13933,215,10119,4029,0,14148
2019/03,334,31/03/2019,7,SP 8 dal Casello A 1 (Faenza) a Cotignola,12665,00,12624,41,9280,3385,0,12665
2019/03,335,29/03/2019,5,SP 7 tra l'A 14 (bivio SP 29) e l'A 14dir (Barbiano),8253,00,7638,615,6438,1815,8253,0
2019/03,335,30/03/2019,6,SP 7 tra l'A 14 (bivio SP 29) e l'A 14dir (Barbiano),6419,00,6294,125,4593,1826,0,6419
2019/03,335,31/03/2019,7,SP 7 tra l'A 14 (bivio SP 29) e l'A 14dir (Barbiano),5496,00,5460,36,3824,1672,0,5496
2019/03,336,29/03/2019,5,SP 253R tra Lugo (ponte fiume Senio) e Bagnacavallo,12085,00,11358,727,9461,2624,12085,0
2019/03,336,30/03/2019,6,SP 253R tra Lugo (ponte fiume Senio) e Bagnacavallo,10123,00,9951,172,7549,2574,0,10123
2019/03,336,31/03/2019,7,SP 253R tra Lugo (ponte fiume Senio) e Bagnacavallo,7619,00,7578,41,5427,2192,0,7619
2019/03,337,29/03/2019,5,SP 14 fra Lugo (bivio SSPP 41/46) e Fusignano,12667,00,12041,626,10073,2594,12667,0
2019/03,337,30/03/2019,6,SP 14 fra Lugo (bivio SSPP 41/46) e Fusignano,10420,10,10230,189,7735,2685,0,10420
2019/03,337,31/03/2019,7,SP 14 fra Lugo (bivio SSPP 41/46) e Fusignano,7527,00,7498,29,5370,2157,0,7527
2019/03,339,29/03/2019,5,SP 3 tra San Lorenzo in Noceto e Predappio,6490,10,6244,245,4699,1791,6490,0
2019/03,339,30/03/2019,6,SP 3 tra San Lorenzo in Noceto e Predappio,7301,00,7195,106,5398,1903,0,7301
2019/03,339,31/03/2019,7,SP 3 tra San Lorenzo in Noceto e Predappio,6453,00,6420,33,4943,1510,0,6453
2019/03,340,29/03/2019,5,SP 72 tra San Martino in Strada e bivio ex SS 310R (Meldola),10726,00,10299,427,8230,2496,10726,0
2019/03,340,30/03/2019,6,SP 72 tra San Martino in Strada e bivio ex SS 310R (Meldola),8860,00,8683,177,6380,2480,0,8860
2019/03,340,31/03/2019,7,SP 72 tra San Martino in Strada e bivio ex SS 310R (Meldola),7497,00,7466,31,5338,2159,0,7497
2019/03,342,29/03/2019,5,SP 33 in località Gatteo,19223,10,17501,1721,14984,4239,19223,0
2019/03,342,30/03/2019,6,SP 33 in località Gatteo,15843,00,15345,498,11525,4318,0,15843
2019/03,342,31/03/2019,7,SP 33 in località Gatteo,12614,00,12510,104,8872,3742,0,12614
2019/03,343,29/03/2019,5,SP 4 tra Galeata e Santa Sofia,6025,00,5673,352,4593,1432,6025,0
2019/03,343,30/03/2019,6,SP 4 tra Galeata e Santa Sofia,5567,10,5369,197,4099,1468,0,5567
2019/03,343,31/03/2019,7,SP 4 tra Galeata e Santa Sofia,5340,00,5297,43,4089,1251,0,5340
2019/03,344,29/03/2019,5,SS 3Bis/E 45 tra Borello e Mercato Saraceno,18652,20,17381,1269,14298,4354,18652,0
2019/03,344,30/03/2019,6,SS 3Bis/E 45 tra Borello e Mercato Saraceno,16821,00,16400,421,12664,4157,0,16821
2019/03,344,31/03/2019,7,SS 3Bis/E 45 tra Borello e Mercato Saraceno,18960,00,18704,256,14063,4897,0,18960
2019/03,348,29/03/2019,5,SP 10 dal bivio con SP 89 (San Mauro Pascoli) c/o A 14  al bivio SS 16 (San Mauro Mare),,,,,,,,
2019/03,348,30/03/2019,6,SP 10 dal bivio con SP 89 (San Mauro Pascoli) c/o A 14  al bivio SS 16 (San Mauro Mare),,,,,,,,
2019/03,348,31/03/2019,7,SP 10 dal bivio con SP 89 (San Mauro Pascoli) c/o A 14  al bivio SS 16 (San Mauro Mare),,,,,,,,
2019/03,349,29/03/2019,5,SS 16 tra Cervia e Cesenatico,23775,00,21370,2405,17939,5836,23775,0
2019/03,349,30/03/2019,6,SS 16 tra Cervia e Cesenatico,23855,10,23237,617,16413,7442,0,23855
2019/03,349,31/03/2019,7,SS 16 tra Cervia e Cesenatico,26134,20,25923,209,18795,7339,0,26134
2019/03,350,29/03/2019,5,SP 41 tra Rimini (viadotto A 14) e bivio SP 49 (località Ospedaletto),9634,10,9294,339,7454,2180,9634,0
2019/03,350,30/03/2019,6,SP 41 tra Rimini (viadotto A 14) e bivio SP 49 (località Ospedaletto),8855,00,8706,149,6574,2281,0,8855
2019/03,350,31/03/2019,7,SP 41 tra Rimini (viadotto A 14) e bivio SP 49 (località Ospedaletto),6860,00,6831,29,4791,2069,0,6860
2019/03,351,29/03/2019,5,SS 72 tra Rimini e  San Marino,,,,,,,,
2019/03,351,30/03/2019,6,SS 72 tra Rimini e  San Marino,,,,,,,,
2019/03,351,31/03/2019,7,SS 72 tra Rimini e  San Marino,,,,,,,,
2019/03,354,29/03/2019,5,SP 31 tra Viadotto A 14 e Coriano,13259,20,12864,393,10167,3092,13259,0
2019/03,354,30/03/2019,6,SP 31 tra Viadotto A 14 e Coriano,11969,10,11817,151,8591,3378,0,11969
2019/03,354,31/03/2019,7,SP 31 tra Viadotto A 14 e Coriano,9512,10,9467,44,6509,3003,0,9512
2019/03,355,29/03/2019,5,SP 17V tra San Giovanni in Marignano e Morciano di Romagna (variante),16333,00,15611,722,12617,3716,16333,0
2019/03,355,30/03/2019,6,SP 17V tra San Giovanni in Marignano e Morciano di Romagna (variante),14046,00,13858,188,10446,3600,0,14046
2019/03,355,31/03/2019,7,SP 17V tra San Giovanni in Marignano e Morciano di Romagna (variante),11484,00,11432,52,8282,3202,0,11484
2019/03,356,29/03/2019,5,SP 2 fra Reggiolo c/o bivio variante nord e confine regionale,8389,00,7397,992,6425,1964,8389,0
2019/03,356,30/03/2019,6,SP 2 fra Reggiolo c/o bivio variante nord e confine regionale,7913,00,7701,212,5901,2012,0,7913
2019/03,356,31/03/2019,7,SP 2 fra Reggiolo c/o bivio variante nord e confine regionale,5964,00,5879,85,4369,1595,0,5964
2019/03,357,29/03/2019,5,SP 306R fra Casola Valsenio e bivio SP 65 c/o località Isola,3527,10,3254,272,2795,732,3527,0
2019/03,357,30/03/2019,6,SP 306R fra Casola Valsenio e bivio SP 65 c/o località Isola,3335,10,3241,93,2510,825,0,3335
2019/03,357,31/03/2019,7,SP 306R fra Casola Valsenio e bivio SP 65 c/o località Isola,3309,00,3292,17,2575,734,0,3309
2019/03,376,29/03/2019,5,SP 68 tra Portomaggiore e la Superstrada Ferrara-Mare,3578,00,3401,177,2832,746,3578,0
2019/03,376,30/03/2019,6,SP 68 tra Portomaggiore e la Superstrada Ferrara-Mare,3020,00,2945,75,2262,758,0,3020
2019/03,376,31/03/2019,7,SP 68 tra Portomaggiore e la Superstrada Ferrara-Mare,2678,00,2665,13,1992,686,0,2678
2019/03,377,29/03/2019,5,SP 18 tra Bondeno e il confine regionale (Lombardia),5367,00,4930,437,4135,1232,5367,0
2019/03,377,30/03/2019,6,SP 18 tra Bondeno e il confine regionale (Lombardia),4612,00,4493,119,3391,1221,0,4612
2019/03,377,31/03/2019,7,SP 18 tra Bondeno e il confine regionale (Lombardia),3891,00,3871,20,2740,1151,0,3891
2019/03,383,29/03/2019,5,SS 722 Tangenziale nord di Reggio Emilia,34853,110,30834,4008,26583,8270,34853,0
2019/03,383,30/03/2019,6,SS 722 Tangenziale nord di Reggio Emilia,27571,00,26706,865,19552,8019,0,27571
2019/03,383,31/03/2019,7,SS 722 Tangenziale nord di Reggio Emilia,20690,20,20454,234,14062,6628,0,20690
2019/03,385,29/03/2019,5,SP 10R fra Castel San Giovanni e Confine regionale (Lombardia),13501,00,11983,1518,10084,3417,13501,0
2019/03,385,30/03/2019,6,SP 10R fra Castel San Giovanni e Confine regionale (Lombardia),11029,00,10666,363,7980,3049,0,11029
2019/03,385,31/03/2019,7,SP 10R fra Castel San Giovanni e Confine regionale (Lombardia),9047,00,8938,109,6429,2618,0,9047
2019/03,388,29/03/2019,5,SP 31 fra bivio SP 12 in località Castelnuovo Fogliani e il confine provinciale,4911,00,4731,180,3781,1130,4911,0
2019/03,388,30/03/2019,6,SP 31 fra bivio SP 12 in località Castelnuovo Fogliani e il confine provinciale,5098,10,5019,78,3688,1410,0,5098
2019/03,388,31/03/2019,7,SP 31 fra bivio SP 12 in località Castelnuovo Fogliani e il confine provinciale,4841,00,4821,20,3640,1201,0,4841
2019/03,389,29/03/2019,5,SP 588R fra Villanova d’Arda e confine provinciale,4620,00,4212,408,3571,1049,4620,0
2019/03,389,30/03/2019,6,SP 588R fra Villanova d’Arda e confine provinciale,4168,00,4051,117,3113,1055,0,4168
2019/03,389,31/03/2019,7,SP 588R fra Villanova d’Arda e confine provinciale,4175,10,4129,45,3186,989,0,4175
2019/03,390,29/03/2019,5,SP 462R dal bivio SP 10R in località Monticelli a Cortemaggiore,3264,00,3083,181,2523,741,3264,0
2019/03,390,30/03/2019,6,SP 462R dal bivio SP 10R in località Monticelli a Cortemaggiore,2921,00,2854,67,2140,781,0,2921
2019/03,390,31/03/2019,7,SP 462R dal bivio SP 10R in località Monticelli a Cortemaggiore,2825,00,2807,18,2142,683,0,2825
2019/03,391,29/03/2019,5,SP 10R fra Castelvetro Piacentino e confine regionale (Lombardia),22541,00,21931,610,16690,5851,22541,0
2019/03,391,30/03/2019,6,SP 10R fra Castelvetro Piacentino e confine regionale (Lombardia),22139,00,21894,245,15553,6586,0,22139
2019/03,391,31/03/2019,7,SP 10R fra Castelvetro Piacentino e confine regionale (Lombardia),18285,30,18185,97,12775,5510,0,18285
2019/03,393,29/03/2019,5,SP 10R fra Caorso e Roncaglia,12340,00,10818,1522,9278,3062,12340,0
2019/03,393,30/03/2019,6,SP 10R fra Caorso e Roncaglia,9128,10,8765,362,6480,2648,0,9128
2019/03,393,31/03/2019,7,SP 10R fra Caorso e Roncaglia,7321,00,7264,57,5171,2150,0,7321
2019/03,394,29/03/2019,5,SP 523R da Roccamurata (bivio SP 308R) a Borgo Val di Taro,5178,10,4732,445,4004,1174,5178,0
2019/03,394,30/03/2019,6,SP 523R da Roccamurata (bivio SP 308R) a Borgo Val di Taro,4499,10,4405,93,3472,1027,0,4499
2019/03,394,31/03/2019,7,SP 523R da Roccamurata (bivio SP 308R) a Borgo Val di Taro,4292,00,4258,34,3172,1120,0,4292
2019/03,395,29/03/2019,5,SP 308R da Fornovo di Taro (bivio SS 62) a Solignano,4679,00,4426,253,3614,1065,4679,0
2019/03,395,30/03/2019,6,SP 308R da Fornovo di Taro (bivio SS 62) a Solignano,4137,00,4053,84,3182,955,0,4137
2019/03,395,31/03/2019,7,SP 308R da Fornovo di Taro (bivio SS 62) a Solignano,4199,00,4184,15,3035,1164,0,4199
2019/03,396,29/03/2019,5,SP 28 fra Fornovo di Taro e Varano de Melegari centro abitato Viazzano,8470,00,8071,399,6659,1811,8470,0
2019/03,396,30/03/2019,6,SP 28 fra Fornovo di Taro e Varano de Melegari centro abitato Viazzano,7307,00,7177,130,5678,1629,0,7307
2019/03,396,31/03/2019,7,SP 28 fra Fornovo di Taro e Varano de Melegari centro abitato Viazzano,6714,00,6658,56,4994,1720,0,6714
2019/03,397,29/03/2019,5,SP 12 fra casello A 1 e Fidenza,,,,,,,,
2019/03,397,30/03/2019,6,SP 12 fra casello A 1 e Fidenza,,,,,,,,
2019/03,397,31/03/2019,7,SP 12 fra casello A 1 e Fidenza,,,,,,,,
2019/03,398,29/03/2019,5,SP 11 tra Fontevivo e Cispadana (tangenziale),,,,,,,,
2019/03,398,30/03/2019,6,SP 11 tra Fontevivo e Cispadana (tangenziale),,,,,,,,
2019/03,398,31/03/2019,7,SP 11 tra Fontevivo e Cispadana (tangenziale),,,,,,,,
2019/03,399,29/03/2019,5,SP 43 tra Trecasali (bivio SP 8) e Torrile,4210,00,3751,459,3256,954,4210,0
2019/03,399,30/03/2019,6,SP 43 tra Trecasali (bivio SP 8) e Torrile,2872,10,2717,154,2106,766,0,2872
2019/03,399,31/03/2019,7,SP 43 tra Trecasali (bivio SP 8) e Torrile,2087,00,2022,65,1487,600,0,2087
2019/03,400,29/03/2019,5,SP 10 da San Secondo Parmense al bivio per Roccabianca centro abitato Pizzo,8468,00,7311,1157,6641,1827,8468,0
2019/03,400,30/03/2019,6,SP 10 da San Secondo Parmense al bivio per Roccabianca centro abitato Pizzo,6966,00,6636,330,5367,1599,0,6966
2019/03,400,31/03/2019,7,SP 10 da San Secondo Parmense al bivio per Roccabianca centro abitato Pizzo,5423,00,5317,106,3818,1605,0,5423
2019/03,401,29/03/2019,5,SP 513R fra Traversetolo e confine provinciale,8044,20,7326,716,6350,1694,8044,0
2019/03,401,30/03/2019,6,SP 513R fra Traversetolo e confine provinciale,6774,10,6593,180,5142,1632,0,6774
2019/03,401,31/03/2019,7,SP 513R fra Traversetolo e confine provinciale,7389,20,7346,41,5878,1511,0,7389
2019/03,402,29/03/2019,5,SP 18 da Pilastrello (bivio SP 513R) al bivio per la Pedemontana,16414,00,15905,509,12894,3520,16414,0
2019/03,402,30/03/2019,6,SP 18 da Pilastrello (bivio SP 513R) al bivio per la Pedemontana,13084,00,12948,136,9841,3243,0,13084
2019/03,402,31/03/2019,7,SP 18 da Pilastrello (bivio SP 513R) al bivio per la Pedemontana,9422,00,9385,37,6602,2820,0,9422
2019/03,403,29/03/2019,5,SP 72 tra Parma e Mezzani,10083,00,9442,641,8221,1862,10083,0
2019/03,403,30/03/2019,6,SP 72 tra Parma e Mezzani,6340,00,6257,83,4734,1606,0,6340
2019/03,403,31/03/2019,7,SP 72 tra Parma e Mezzani,4450,00,4418,32,3163,1287,0,4450
2019/03,404,29/03/2019,5,exSP 32 (via Dante Alighieri) da Felino a Pilastro,7695,00,7492,203,5918,1777,7695,0
2019/03,404,30/03/2019,6,exSP 32 (via Dante Alighieri) da Felino a Pilastro,6980,30,6887,90,5194,1786,0,6980
2019/03,404,31/03/2019,7,exSP 32 (via Dante Alighieri) da Felino a Pilastro,5063,40,5022,37,3673,1390,0,5063
2019/03,405,29/03/2019,5,SP 15 fra SS62 e Sala Baganza,11639,00,10720,919,9159,2480,11639,0
2019/03,405,30/03/2019,6,SP 15 fra SS62 e Sala Baganza,9101,00,8892,209,6733,2368,0,9101
2019/03,405,31/03/2019,7,SP 15 fra SS62 e Sala Baganza,6950,00,6920,30,5088,1862,0,6950
2019/03,410,29/03/2019,5,SP 54 fra Pomposa e Codigoro,4931,00,4630,301,3884,1047,4931,0
2019/03,410,30/03/2019,6,SP 54 fra Pomposa e Codigoro,4482,00,4391,91,3345,1137,0,4482
2019/03,410,31/03/2019,7,SP 54 fra Pomposa e Codigoro,4266,00,4255,11,3136,1130,0,4266
2019/03,411,29/03/2019,5,SP 53 fra Codigoro e Marozzo,5651,00,5536,115,4499,1152,5651,0
2019/03,411,30/03/2019,6,SP 53 fra Codigoro e Marozzo,4450,00,4392,58,3348,1102,0,4450
2019/03,411,31/03/2019,7,SP 53 fra Codigoro e Marozzo,3382,00,3381,1,2284,1098,0,3382
2019/03,425,29/03/2019,5,SS 67 tra Dovadola e Rocca San Casciano,3918,00,3715,203,3060,858,3918,0
2019/03,425,30/03/2019,6,SS 67 tra Dovadola e Rocca San Casciano,3736,00,3667,69,2929,807,0,3736
2019/03,425,31/03/2019,7,SS 67 tra Dovadola e Rocca San Casciano,3572,00,3552,20,2831,741,0,3572
2019/03,426,29/03/2019,5,SS 63 tra Casina e Vezzano sul Crostolo,15437,00,14938,499,11484,3953,15437,0
2019/03,426,30/03/2019,6,SS 63 tra Casina e Vezzano sul Crostolo,15413,00,15206,207,11349,4064,0,15413
2019/03,426,31/03/2019,7,SS 63 tra Casina e Vezzano sul Crostolo,14068,00,13983,85,10303,3765,0,14068
2019/03,428,29/03/2019,5,SP 19 fra Colombaia (bivio SP 76) e il Bivio SP 486R al confine provinciale,4057,00,3635,422,3061,996,4057,0
2019/03,428,30/03/2019,6,SP 19 fra Colombaia (bivio SP 76) e il Bivio SP 486R al confine provinciale,3489,00,3431,58,2654,835,0,3489
2019/03,428,31/03/2019,7,SP 19 fra Colombaia (bivio SP 76) e il Bivio SP 486R al confine provinciale,3583,00,3550,33,2672,911,0,3583
2019/03,429,29/03/2019,5,SP 12 fra San Polo d'Enza e Montecchio Emilia (variante a sud abitato),8728,00,7839,889,6801,1927,8728,0
2019/03,429,30/03/2019,6,SP 12 fra San Polo d'Enza e Montecchio Emilia (variante a sud abitato),7322,10,7114,207,5583,1739,0,7322
2019/03,429,31/03/2019,7,SP 12 fra San Polo d'Enza e Montecchio Emilia (variante a sud abitato),6472,10,6338,133,4690,1782,0,6472
2019/03,430,29/03/2019,5,SP 28 tra Montecchio Emilia e bivio circonvallazione,12006,00,11296,710,9523,2483,12006,0
2019/03,430,30/03/2019,6,SP 28 tra Montecchio Emilia e bivio circonvallazione,8856,00,8695,161,6528,2328,0,8856
2019/03,430,31/03/2019,7,SP 28 tra Montecchio Emilia e bivio circonvallazione,6327,00,6268,59,4362,1965,0,6327
2019/03,431,29/03/2019,5,SP 12 fra Sant'Ilario d'Enza (variante a sud) e Montecchio Emilia,7319,00,7021,298,5743,1576,7319,0
2019/03,431,30/03/2019,6,SP 12 fra Sant'Ilario d'Enza (variante a sud) e Montecchio Emilia,7058,00,6970,88,5526,1532,0,7058
2019/03,431,31/03/2019,7,SP 12 fra Sant'Ilario d'Enza (variante a sud) e Montecchio Emilia,4977,10,4956,20,3731,1246,0,4977
2019/03,432,29/03/2019,5,SP 67 fra Calerno e Montecchio Emilia,11512,10,10170,1341,9052,2460,11512,0
2019/03,432,30/03/2019,6,SP 67 fra Calerno e Montecchio Emilia,7986,00,7729,257,5903,2083,0,7986
2019/03,432,31/03/2019,7,SP 67 fra Calerno e Montecchio Emilia,7247,00,7091,156,5151,2096,0,7247
2019/03,434,29/03/2019,5,Via San Nicola (ex SP 39) tra bivio per Taneto a Caprara,3542,00,3470,72,2732,810,3542,0
2019/03,434,30/03/2019,6,Via San Nicola (ex SP 39) tra bivio per Taneto a Caprara,3060,00,3023,37,2273,787,0,3060
2019/03,434,31/03/2019,7,Via San Nicola (ex SP 39) tra bivio per Taneto a Caprara,2220,00,2204,16,1582,638,0,2220
2019/03,435,29/03/2019,5,SP 37Bis dalla località Selbagnone al bivio SP 72 (Meldola),8258,10,7806,451,6233,2025,8258,0
2019/03,435,30/03/2019,6,SP 37Bis dalla località Selbagnone al bivio SP 72 (Meldola),7368,40,7190,174,5136,2232,0,7368
2019/03,435,31/03/2019,7,SP 37Bis dalla località Selbagnone al bivio SP 72 (Meldola),6635,10,6591,43,4722,1913,0,6635
2019/03,436,29/03/2019,5,SP 26 da Santa Sofia a San Piero in Bagno,1000,00,942,58,764,236,1000,0
2019/03,436,30/03/2019,6,SP 26 da Santa Sofia a San Piero in Bagno,961,00,936,25,715,246,0,961
2019/03,436,31/03/2019,7,SP 26 da Santa Sofia a San Piero in Bagno,1096,00,1093,3,833,263,0,1096
2019/03,437,29/03/2019,5,SP 13 tra SS 9 (Santarcangelo di Romagna) e SP 92 (località Camerano),7325,00,6269,1056,5721,1604,7325,0
2019/03,437,30/03/2019,6,SP 13 tra SS 9 (Santarcangelo di Romagna) e SP 92 (località Camerano),5995,10,5780,214,4435,1560,0,5995
2019/03,437,31/03/2019,7,SP 13 tra SS 9 (Santarcangelo di Romagna) e SP 92 (località Camerano),4745,00,4710,35,3447,1298,0,4745
2019/03,438,29/03/2019,5,SP 14 tra Colombare (bivio SP 14Ter) e bivio SP 258R,8698,00,7976,722,6809,1889,8698,0
2019/03,438,30/03/2019,6,SP 14 tra Colombare (bivio SP 14Ter) e bivio SP 258R,7285,10,7166,118,5405,1880,0,7285
2019/03,438,31/03/2019,7,SP 14 tra Colombare (bivio SP 14Ter) e bivio SP 258R,7036,00,7009,27,5155,1881,0,7036
2019/03,439,29/03/2019,5,SP 49 da Santarcangelo di Romagna alla località Posta (bivio SP 258R),13563,00,12649,914,10514,3049,13563,0
2019/03,439,30/03/2019,6,SP 49 da Santarcangelo di Romagna alla località Posta (bivio SP 258R),11463,00,11223,240,8270,3193,0,11463
2019/03,439,31/03/2019,7,SP 49 da Santarcangelo di Romagna alla località Posta (bivio SP 258R),9346,00,9293,53,6604,2742,0,9346
2019/03,440,29/03/2019,5,SP 35 tra bivio SP 50 (località Cella) e Sant'Andrea in Casale,13107,00,12734,373,10002,3105,13107,0
2019/03,440,30/03/2019,6,SP 35 tra bivio SP 50 (località Cella) e Sant'Andrea in Casale,12486,00,12325,161,8988,3498,0,12486
2019/03,440,31/03/2019,7,SP 35 tra bivio SP 50 (località Cella) e Sant'Andrea in Casale,10008,10,9981,26,6915,3093,0,10008
2019/03,441,29/03/2019,5,SP 58 tra San Giovanni in Marignano e il confine regionale (Marche),9645,20,9163,480,7387,2258,9645,0
2019/03,441,30/03/2019,6,SP 58 tra San Giovanni in Marignano e il confine regionale (Marche),8318,10,8191,126,5937,2381,0,8318
2019/03,441,31/03/2019,7,SP 58 tra San Giovanni in Marignano e il confine regionale (Marche),6935,00,6924,11,4592,2343,0,6935
2019/03,442,29/03/2019,5,SP 118 tra Casemurate (bivio SP 254R) e il confine provinciale,3784,00,3447,337,2879,905,3784,0
2019/03,442,30/03/2019,6,SP 118 tra Casemurate (bivio SP 254R) e il confine provinciale,3099,10,2985,113,2239,860,0,3099
2019/03,442,31/03/2019,7,SP 118 tra Casemurate (bivio SP 254R) e il confine provinciale,3083,00,3030,53,2217,866,0,3083
2019/03,443,29/03/2019,5,SP 16 tra Faenza e il confine provinciale,5970,00,5691,279,4549,1421,5970,0
2019/03,443,30/03/2019,6,SP 16 tra Faenza e il confine provinciale,5635,00,5539,96,4226,1409,0,5635
2019/03,443,31/03/2019,7,SP 16 tra Faenza e il confine provinciale,4996,00,4970,26,3722,1274,0,4996
2019/03,444,29/03/2019,5,SP 5 fra Russi e San Pancrazio,,,,,,,,
2019/03,444,30/03/2019,6,SP 5 fra Russi e San Pancrazio,,,,,,,,
2019/03,444,31/03/2019,7,SP 5 fra Russi e San Pancrazio,,,,,,,,
2019/03,445,29/03/2019,5,SP 610R fra SP 253R e Conselice,6076,20,5263,811,4658,1418,6076,0
2019/03,445,30/03/2019,6,SP 610R fra SP 253R e Conselice,4821,00,4630,191,3504,1317,0,4821
2019/03,445,31/03/2019,7,SP 610R fra SP 253R e Conselice,4109,00,4053,56,2979,1130,0,4109
2019/03,446,29/03/2019,5,SP 13 in località Santa Maria di Fabriago,9644,00,8997,647,7566,2078,9644,0
2019/03,446,30/03/2019,6,SP 13 in località Santa Maria di Fabriago,7561,00,7404,157,5604,1957,0,7561
2019/03,446,31/03/2019,7,SP 13 in località Santa Maria di Fabriago,5973,00,5940,33,4145,1828,0,5973
2019/03,447,29/03/2019,5,SP 28 in località Molinazzo (Comune di Gossolengo),6203,00,5962,241,4779,1424,6203,0
2019/03,447,30/03/2019,6,SP 28 in località Molinazzo (Comune di Gossolengo),6038,00,5951,87,4513,1525,0,6038
2019/03,447,31/03/2019,7,SP 28 in località Molinazzo (Comune di Gossolengo),6054,00,6032,22,4615,1439,0,6054
2019/03,448,29/03/2019,5,SP 5 fra Reggiolo e intersezione SP 45 per Fabbrico,8128,00,7332,796,6117,2011,8128,0
2019/03,448,30/03/2019,6,SP 5 fra Reggiolo e intersezione SP 45 per Fabbrico,7268,00,7061,207,5245,2023,0,7268
2019/03,448,31/03/2019,7,SP 5 fra Reggiolo e intersezione SP 45 per Fabbrico,5825,00,5781,44,4083,1742,0,5825
2019/03,449,29/03/2019,5,SP 111 fra via Emilia e la variante Asse Val d'Enza,13733,00,11531,2202,10815,2918,13733,0
2019/03,449,30/03/2019,6,SP 111 fra via Emilia e la variante Asse Val d'Enza,8840,00,8411,429,6408,2432,0,8840
2019/03,449,31/03/2019,7,SP 111 fra via Emilia e la variante Asse Val d'Enza,8393,00,8197,196,5896,2497,0,8393
2019/03,450,29/03/2019,5,SP 35 sul Ponte Po,9395,40,8323,1068,7120,2275,9395,0
2019/03,450,30/03/2019,6,SP 35 sul Ponte Po,8325,00,8186,139,5916,2409,0,8325
2019/03,450,31/03/2019,7,SP 35 sul Ponte Po,7011,00,6978,33,4762,2249,0,7011
2019/03,451,29/03/2019,5,SP 62RVar sulla variante di Luzzara (c/o Codisotto),14090,00,10860,3230,10830,3260,14090,0
2019/03,451,30/03/2019,6,SP 62RVar sulla variante di Luzzara (c/o Codisotto),10479,00,10056,423,7652,2827,0,10479
2019/03,451,31/03/2019,7,SP 62RVar sulla variante di Luzzara (c/o Codisotto),9948,00,9811,137,6885,3063,0,9948
2019/03,452,29/03/2019,5,SP 3 sulla variante tra Bagnolo in Piano e il casello A 1 di Reggio Emilia,13692,10,12383,1308,10468,3224,13692,0
2019/03,452,30/03/2019,6,SP 3 sulla variante tra Bagnolo in Piano e il casello A 1 di Reggio Emilia,11250,00,10967,283,8095,3155,0,11250
2019/03,452,31/03/2019,7,SP 3 sulla variante tra Bagnolo in Piano e il casello A 1 di Reggio Emilia,10193,00,10105,88,6978,3215,0,10193
2019/03,453,29/03/2019,5,Asse viario Modena-Sassuolo tra Modena e Baggiovara,57544,20,51441,6101,44315,13229,57544,0
2019/03,453,30/03/2019,6,Asse viario Modena-Sassuolo tra Modena e Baggiovara,43467,00,42526,941,30351,13116,0,43467
2019/03,453,31/03/2019,7,Asse viario Modena-Sassuolo tra Modena e Baggiovara,34307,00,33980,327,22989,11318,0,34307
2019/03,504,29/03/2019,5,SP 7 dalla località Ca de' Mandorli al bivio per Castel de Britti,11951,00,11619,332,9050,2901,11951,0
2019/03,504,30/03/2019,6,SP 7 dalla località Ca de' Mandorli al bivio per Castel de Britti,11112,00,10980,132,8250,2862,0,11112
2019/03,504,31/03/2019,7,SP 7 dalla località Ca de' Mandorli al bivio per Castel de Britti,9548,00,9494,54,7017,2531,0,9548
2019/03,505,29/03/2019,5,SP 610 tra casello A 1 (Imola) e bivio SP 51 per Castel Guelfo di Bologna,13896,30,11701,2192,10544,3352,13896,0
2019/03,505,30/03/2019,6,SP 610 tra casello A 1 (Imola) e bivio SP 51 per Castel Guelfo di Bologna,10389,00,9993,396,7237,3152,0,10389
2019/03,505,31/03/2019,7,SP 610 tra casello A 1 (Imola) e bivio SP 51 per Castel Guelfo di Bologna,8833,00,8666,167,5973,2860,0,8833
2019/03,600,29/03/2019,5,SP 19 tra SP31 e Medicina,8169,10,7278,890,6516,1653,8169,0
2019/03,600,30/03/2019,6,SP 19 tra SP31 e Medicina,6431,20,6285,144,4876,1555,0,6431
2019/03,600,31/03/2019,7,SP 19 tra SP31 e Medicina,6058,20,6007,49,4454,1604,0,6058
2019/03,601,29/03/2019,5,SP 21 da Castel San Pietro al bivio SP 35 (c/o Sassoleone),3560,00,3414,146,2680,880,3560,0
2019/03,601,30/03/2019,6,SP 21 da Castel San Pietro al bivio SP 35 (c/o Sassoleone),3687,00,3643,44,2901,786,0,3687
2019/03,601,31/03/2019,7,SP 21 da Castel San Pietro al bivio SP 35 (c/o Sassoleone),3366,10,3343,22,2560,806,0,3366
2019/03,602,29/03/2019,5,SP 9_1 da Crevalcore alla località Caselle,1746,00,1668,78,1310,436,1746,0
2019/03,602,30/03/2019,6,SP 9_1 da Crevalcore alla località Caselle,1586,10,1565,20,1195,391,0,1586
2019/03,602,31/03/2019,7,SP 9_1 da Crevalcore alla località Caselle,1323,10,1317,5,978,345,0,1323
2019/03,603,29/03/2019,5,SP 10 dalla località Decima ai confini provinciali di Bologna e Ferrara,4243,00,4069,174,3137,1106,4243,0
2019/03,603,30/03/2019,6,SP 10 dalla località Decima ai confini provinciali di Bologna e Ferrara,3479,10,3411,67,2383,1096,0,3479
2019/03,603,31/03/2019,7,SP 10 dalla località Decima ai confini provinciali di Bologna e Ferrara,2837,00,2828,9,1903,934,0,2837
2019/03,604,29/03/2019,5,SP 37 da Sasso Marconi alla intersezione SP 58,5482,10,5257,224,4514,968,5482,0
2019/03,604,30/03/2019,6,SP 37 da Sasso Marconi alla intersezione SP 58,4430,00,4384,46,3492,938,0,4430
2019/03,604,31/03/2019,7,SP 37 da Sasso Marconi alla intersezione SP 58,4128,00,4118,10,3165,963,0,4128
2019/03,605,29/03/2019,5,SP 324 da Silla alla intersezione SP 623,8170,20,7833,335,6407,1763,8170,0
2019/03,605,30/03/2019,6,SP 324 da Silla alla intersezione SP 623,6738,00,6645,93,5021,1717,0,6738
2019/03,605,31/03/2019,7,SP 324 da Silla alla intersezione SP 623,5615,00,5576,39,4179,1436,0,5615
2019/03,606,29/03/2019,5,SP 70 Cispadana in località Sant'Agostino/San Carlo,6388,10,5942,445,5052,1336,6388,0
2019/03,606,30/03/2019,6,SP 70 Cispadana in località Sant'Agostino/San Carlo,4910,00,4839,71,3560,1350,0,4910
2019/03,606,31/03/2019,7,SP 70 Cispadana in località Sant'Agostino/San Carlo,4608,00,4596,12,3100,1508,0,4608
2019/03,607,29/03/2019,5,SP 1 da Villafranca di Forlì al confine provinciale,4512,00,4225,287,3469,1043,4512,0
2019/03,607,30/03/2019,6,SP 1 da Villafranca di Forlì al confine provinciale,3474,00,3409,65,2451,1023,0,3474
2019/03,607,31/03/2019,7,SP 1 da Villafranca di Forlì al confine provinciale,3207,00,3193,14,2272,935,0,3207
2019/03,608,29/03/2019,5,SP 140 da Diegaro (SS 9) a Pievesestina (E 45),14568,50,13089,1474,11190,3378,14568,0
2019/03,608,30/03/2019,6,SP 140 da Diegaro (SS 9) a Pievesestina (E 45),10900,00,10402,498,7805,3095,0,10900
2019/03,608,31/03/2019,7,SP 140 da Diegaro (SS 9) a Pievesestina (E 45),8678,00,8536,142,5947,2731,0,8678
2019/03,609,29/03/2019,5,SP 4 dal bivio SP22 (per SS 12) al bivio SP 26 (per Pavullo nel Frignano),4302,00,3901,401,3192,1110,4302,0
2019/03,609,30/03/2019,6,SP 4 dal bivio SP22 (per SS 12) al bivio SP 26 (per Pavullo nel Frignano),5184,10,5083,100,3940,1244,0,5184
2019/03,609,31/03/2019,7,SP 4 dal bivio SP22 (per SS 12) al bivio SP 26 (per Pavullo nel Frignano),6274,00,6235,39,4944,1330,0,6274
2019/03,610,29/03/2019,5,SP 11 da Soragna a Roncole Verdi,4035,00,3724,311,3131,904,4035,0
2019/03,610,30/03/2019,6,SP 11 da Soragna a Roncole Verdi,3398,00,3305,93,2521,877,0,3398
2019/03,610,31/03/2019,7,SP 11 da Soragna a Roncole Verdi,3032,00,2994,38,2201,831,0,3032
2019/03,611,29/03/2019,5,SP 357R da Fornovo di Taro al bivio SP 93 per Fidenza,,,,,,,,
2019/03,611,30/03/2019,6,SP 357R da Fornovo di Taro al bivio SP 93 per Fidenza,,,,,,,,
2019/03,611,31/03/2019,7,SP 357R da Fornovo di Taro al bivio SP 93 per Fidenza,,,,,,,,
2019/03,612,29/03/2019,5,SP 665R dalla località Pilastro a Langhirano,18769,30,17561,1205,14628,4141,18769,0
2019/03,612,30/03/2019,6,SP 665R dalla località Pilastro a Langhirano,15716,00,15457,259,11581,4135,0,15716
2019/03,612,31/03/2019,7,SP 665R dalla località Pilastro a Langhirano,13619,00,13540,79,9820,3799,0,13619
2019/03,613,29/03/2019,5,SP 16 dalla località Basilicanova al bivio SP 32 centro abitato Mamiano,7368,00,7056,312,5544,1824,7368,0
2019/03,613,30/03/2019,6,SP 16 dalla località Basilicanova al bivio SP 32 centro abitato Mamiano,6464,00,6334,130,4707,1757,0,6464
2019/03,613,31/03/2019,7,SP 16 dalla località Basilicanova al bivio SP 32 centro abitato Mamiano,4845,00,4795,50,3405,1440,0,4845
2019/03,614,29/03/2019,5,SP 587R dal bivio SP 10R alla A 21Dir,7853,00,7182,671,6155,1698,7853,0
2019/03,614,30/03/2019,6,SP 587R dal bivio SP 10R alla A 21Dir,6014,00,5783,231,4486,1528,0,6014
2019/03,614,31/03/2019,7,SP 587R dal bivio SP 10R alla A 21Dir,4558,00,4504,54,3283,1275,0,4558
2019/03,615,29/03/2019,5,Piazzale Milano (ex SS 9) c/o ponte fiume Po,26626,120,26058,556,19023,7603,26626,0
2019/03,615,30/03/2019,6,Piazzale Milano (ex SS 9) c/o ponte fiume Po,27614,110,27258,345,19674,7940,0,27614
2019/03,615,31/03/2019,7,Piazzale Milano (ex SS 9) c/o ponte fiume Po,23281,20,23164,115,15856,7425,0,23281
2019/03,616,29/03/2019,5,SP 588R dal casello A 21 di Castelvetro Piacentino a Villanova d'Arda,4448,00,4102,346,3462,986,4448,0
2019/03,616,30/03/2019,6,SP 588R dal casello A 21 di Castelvetro Piacentino a Villanova d'Arda,4336,00,4250,86,3205,1131,0,4336
2019/03,616,31/03/2019,7,SP 588R dal casello A 21 di Castelvetro Piacentino a Villanova d'Arda,4311,00,4279,32,3294,1017,0,4311
2019/03,617,29/03/2019,5,SP 7 dalla intersezione tangenziale sud/ovest di Piacenza a San Nicolò,8282,40,7805,473,6549,1733,8282,0
2019/03,617,30/03/2019,6,SP 7 dalla intersezione tangenziale sud/ovest di Piacenza a San Nicolò,7698,20,7519,177,5753,1945,0,7698
2019/03,617,31/03/2019,7,SP 7 dalla intersezione tangenziale sud/ovest di Piacenza a San Nicolò,5881,00,5864,17,4318,1563,0,5881
2019/03,618,29/03/2019,5,SP 253R fra Bagnacavallo (A14 Dir) e Godo (bivio SP 302R),7979,00,7418,561,6240,1739,7979,0
2019/03,618,30/03/2019,6,SP 253R fra Bagnacavallo (A14 Dir) e Godo (bivio SP 302R),6641,20,6511,128,4897,1744,0,6641
2019/03,618,31/03/2019,7,SP 253R fra Bagnacavallo (A14 Dir) e Godo (bivio SP 302R),4926,00,4897,29,3489,1437,0,4926
2019/03,619,29/03/2019,5,SP 8 da Bagnacavallo al bivio SS 16,,,,,,,,
2019/03,619,30/03/2019,6,SP 8 da Bagnacavallo al bivio SS 16,,,,,,,,
2019/03,619,31/03/2019,7,SP 8 da Bagnacavallo al bivio SS 16,,,,,,,,
2019/03,620,29/03/2019,5,SP 113 sulla variante di San Martino in Rio/Correggio c/o le località Prato/Gazzata,9490,00,8254,1236,7405,2085,9490,0
2019/03,620,30/03/2019,6,SP 113 sulla variante di San Martino in Rio/Correggio c/o le località Prato/Gazzata,6294,00,6095,199,4439,1855,0,6294
2019/03,620,31/03/2019,7,SP 113 sulla variante di San Martino in Rio/Correggio c/o le località Prato/Gazzata,4960,00,4905,55,3382,1578,0,4960
2019/03,621,29/03/2019,5,SP 513R a nord di Vetto,2251,10,2103,147,1688,563,2251,0
2019/03,621,30/03/2019,6,SP 513R a nord di Vetto,2287,00,2225,62,1789,498,0,2287
2019/03,621,31/03/2019,7,SP 513R a nord di Vetto,2793,00,2781,12,2207,586,0,2793
2019/03,622,29/03/2019,5,SP 468R tra Correggio e il confine provinciale,,,,,,,,
2019/03,622,30/03/2019,6,SP 468R tra Correggio e il confine provinciale,,,,,,,,
2019/03,622,31/03/2019,7,SP 468R tra Correggio e il confine provinciale,,,,,,,,
2019/03,623,29/03/2019,5,SP 30 tra Campagnola Emilia e il confine provinciale,16408,10,15222,1185,12595,3813,16408,0
2019/03,623,30/03/2019,6,SP 30 tra Campagnola Emilia e il confine provinciale,13809,10,13521,287,9871,3938,0,13809
2019/03,623,31/03/2019,7,SP 30 tra Campagnola Emilia e il confine provinciale,11071,00,10998,73,7561,3510,0,11071
2019/03,624,29/03/2019,5,SP 23 tra Rivalta e la variante di Montecavolo,12167,00,11771,396,9170,2997,12167,0
2019/03,624,30/03/2019,6,SP 23 tra Rivalta e la variante di Montecavolo,11666,00,11531,135,8312,3354,0,11666
2019/03,624,31/03/2019,7,SP 23 tra Rivalta e la variante di Montecavolo,9117,10,9091,25,6466,2651,0,9117
2019/03,625,29/03/2019,5,SP 14 da Poggio Berni (bivio SP 73) a Sant'Arcangelo di Romagna,,,,,,,,
2019/03,625,30/03/2019,6,SP 14 da Poggio Berni (bivio SP 73) a Sant'Arcangelo di Romagna,,,,,,,,
2019/03,625,31/03/2019,7,SP 14 da Poggio Berni (bivio SP 73) a Sant'Arcangelo di Romagna,,,,,,,,
2019/03,626,29/03/2019,5,SP 18 da San Clemente al bivio SP 132 (località Osteria Nuova),8386,00,7977,409,6553,1833,8386,0
2019/03,626,30/03/2019,6,SP 18 da San Clemente al bivio SP 132 (località Osteria Nuova),7782,00,7620,162,5861,1921,0,7782
2019/03,626,31/03/2019,7,SP 18 da San Clemente al bivio SP 132 (località Osteria Nuova),6488,00,6460,28,4659,1829,0,6488
2019/03,627,29/03/2019,5,SS 64 variante di Riola di Vergato,8812,00,8302,510,6891,1921,8812,0
2019/03,627,30/03/2019,6,SS 64 variante di Riola di Vergato,8640,00,8489,151,6696,1944,0,8640
2019/03,627,31/03/2019,7,SS 64 variante di Riola di Vergato,7996,10,7950,45,6001,1995,0,7996
2019/03,629,29/03/2019,5,SS 727 (tg Forli') tra intersezione SS 9 e l'intersezione SS 67,18148,20,16993,1153,13875,4273,18148,0
2019/03,629,30/03/2019,6,SS 727 (tg Forli') tra intersezione SS 9 e l'intersezione SS 67,12533,00,12217,316,9069,3464,0,12533
2019/03,629,31/03/2019,7,SS 727 (tg Forli') tra intersezione SS 9 e l'intersezione SS 67,10448,00,10360,88,7326,3122,0,10448
2019/03,630,29/03/2019,5,SS 726 (tg Cesena) tra intersezione ex SS 71BIS e l'intersezione SP 304R,,,,,,,,
2019/03,630,30/03/2019,6,SS 726 (tg Cesena) tra intersezione ex SS 71BIS e l'intersezione SP 304R,,,,,,,,
2019/03,630,31/03/2019,7,SS 726 (tg Cesena) tra intersezione ex SS 71BIS e l'intersezione SP 304R,,,,,,,,
2019/03,631,29/03/2019,5,SS 3Bis/E 45 tra Sarsina e San Piero in Bagno,,,,,,,,
2019/03,631,30/03/2019,6,SS 3Bis/E 45 tra Sarsina e San Piero in Bagno,,,,,,,,
2019/03,631,31/03/2019,7,SS 3Bis/E 45 tra Sarsina e San Piero in Bagno,,,,,,,,
2019/03,632,29/03/2019,5,SS 724Dir/tangenziale complanare sud alla A 1 in direzione Reggio Emilia - tra intersezione Modena/Sassuolo e intersezione SS 12,8113,00,7775,338,6506,1607,8113,0
2019/03,632,30/03/2019,6,SS 724Dir/tangenziale complanare sud alla A 1 in direzione Reggio Emilia - tra intersezione Modena/Sassuolo e intersezione SS 12,6723,00,6620,103,4843,1880,0,6723
2019/03,632,31/03/2019,7,SS 724Dir/tangenziale complanare sud alla A 1 in direzione Reggio Emilia - tra intersezione Modena/Sassuolo e intersezione SS 12,5356,00,5330,26,3734,1622,0,5356
2019/03,633,29/03/2019,5,SS 724Dir/tangenziale complanare sud alla A 1 in direzione Bologna - tra intersezione Modena/Sassuolo e intersezione SS12,8305,00,7810,495,6261,2044,8305,0
2019/03,633,30/03/2019,6,SS 724Dir/tangenziale complanare sud alla A 1 in direzione Bologna - tra intersezione Modena/Sassuolo e intersezione SS12,6710,00,6588,122,4610,2100,0,6710
2019/03,633,31/03/2019,7,SS 724Dir/tangenziale complanare sud alla A 1 in direzione Bologna - tra intersezione Modena/Sassuolo e intersezione SS12,5098,00,5067,31,3481,1617,0,5098
2019/03,634,29/03/2019,5,SS 12 tra Pavullo e intersezione SP 31,,,,,,,,
2019/03,634,30/03/2019,6,SS 12 tra Pavullo e intersezione SP 31,,,,,,,,
2019/03,634,31/03/2019,7,SS 12 tra Pavullo e intersezione SP 31,,,,,,,,
2019/03,635,29/03/2019,5,SS 725 (tg sud Piacenza) tra intersezione SS 45 e l'intersezione SP 6,50245,10,46559,3685,39588,10657,50245,0
2019/03,635,30/03/2019,6,SS 725 (tg sud Piacenza) tra intersezione SS 45 e l'intersezione SP 6,41634,10,40626,1007,31694,9940,0,41634
2019/03,635,31/03/2019,7,SS 725 (tg sud Piacenza) tra intersezione SS 45 e l'intersezione SP 6,33571,00,33288,283,24687,8884,0,33571
2019/03,636,29/03/2019,5,SS 9Var tra la tangenziale nord di Parma (intersezione SP 343R) e l'intersezione SP 62R,61150,110,57312,3827,47551,13599,61150,0
2019/03,636,30/03/2019,6,SS 9Var tra la tangenziale nord di Parma (intersezione SP 343R) e l'intersezione SP 62R,51883,20,50862,1019,38144,13739,0,51883
2019/03,636,31/03/2019,7,SS 9Var tra la tangenziale nord di Parma (intersezione SP 343R) e l'intersezione SP 62R,39563,00,39188,375,27774,11789,0,39563
2019/03,637,29/03/2019,5,SS 62 tra Fornovo di Taro e Collecchio,15429,00,14433,996,11885,3544,15429,0
2019/03,637,30/03/2019,6,SS 62 tra Fornovo di Taro e Collecchio,13294,30,13023,268,10007,3287,0,13294
2019/03,637,31/03/2019,7,SS 62 tra Fornovo di Taro e Collecchio,12264,10,12193,70,8576,3688,0,12264
2019/03,638,29/03/2019,5,SS 9 tra la tangenziale nord di Reggio Emilia e Sant'Ilario d'Enza,22139,10,20366,1772,15617,6522,22139,0
2019/03,638,30/03/2019,6,SS 9 tra la tangenziale nord di Reggio Emilia e Sant'Ilario d'Enza,20305,00,19780,525,13529,6776,0,20305
2019/03,638,31/03/2019,7,SS 9 tra la tangenziale nord di Reggio Emilia e Sant'Ilario d'Enza,15850,10,15687,162,10287,5563,0,15850
2019/03,639,29/03/2019,5,SS 63 località Casina (variante abitato),7231,00,6915,316,5289,1942,7231,0
2019/03,639,30/03/2019,6,SS 63 località Casina (variante abitato),7156,10,6999,156,5382,1774,0,7156
2019/03,639,31/03/2019,7,SS 63 località Casina (variante abitato),6941,00,6886,55,5011,1930,0,6941
2019/03,651,29/03/2019,5,SS 9 da Imola a Castelbolognese (al confine provinciale),17989,00,17134,855,13115,4874,17989,0
2019/03,651,30/03/2019,6,SS 9 da Imola a Castelbolognese (al confine provinciale),16821,00,16603,218,11462,5359,0,16821
2019/03,651,31/03/2019,7,SS 9 da Imola a Castelbolognese (al confine provinciale),13787,00,13708,79,9227,4560,0,13787
2019/03,652,29/03/2019,5,SS 16 dal bivio SP 610R ad Argenta,13403,00,12047,1356,10452,2951,13403,0
2019/03,652,30/03/2019,6,SS 16 dal bivio SP 610R ad Argenta,11144,00,10794,350,8451,2693,0,11144
2019/03,652,31/03/2019,7,SS 16 dal bivio SP 610R ad Argenta,10335,00,10200,135,7241,3094,0,10335
2019/03,653,29/03/2019,5,SP 254R dal ponte sul fiume Savio alla SS 16,9251,00,9024,227,7102,2149,9251,0
2019/03,653,30/03/2019,6,SP 254R dal ponte sul fiume Savio alla SS 16,10729,00,10641,88,7820,2909,0,10729
2019/03,653,31/03/2019,7,SP 254R dal ponte sul fiume Savio alla SS 16,12227,00,12193,34,9187,3040,0,12227
2019/03,654,29/03/2019,5,SP 7IBisR dal bivio SSPP 32/33ter alla SS 16,13330,00,12899,431,10156,3174,13330,0
2019/03,654,30/03/2019,6,SP 7IBisR dal bivio SSPP 32/33ter alla SS 16,14242,00,14081,161,9929,4313,0,14242
2019/03,654,31/03/2019,7,SP 7IBisR dal bivio SSPP 32/33ter alla SS 16,15337,00,15260,77,11397,3940,0,15337
2019/03,655,29/03/2019,5,SP 253R dal bivio SP 302R allo svincolo A 14dir a Fornace Zarattini,18297,00,17429,868,14152,4145,18297,0
2019/03,655,30/03/2019,6,SP 253R dal bivio SP 302R allo svincolo A 14dir a Fornace Zarattini,15079,00,14852,227,10853,4226,0,15079
2019/03,655,31/03/2019,7,SP 253R dal bivio SP 302R allo svincolo A 14dir a Fornace Zarattini,11725,00,11642,83,8324,3401,0,11725
2019/03,660,29/03/2019,5,SP 25 tra intersezione con SS 64 e confine provinciale,,,,,,,,
2019/03,660,30/03/2019,6,SP 25 tra intersezione con SS 64 e confine provinciale,,,,,,,,
2019/03,660,31/03/2019,7,SP 25 tra intersezione con SS 64 e confine provinciale,,,,,,,,
2019/03,661,29/03/2019,5,SP 15 tra Tresigallo e Massa Fiscaglia,3918,10,3806,111,3057,861,3918,0
2019/03,661,30/03/2019,6,SP 15 tra Tresigallo e Massa Fiscaglia,3348,00,3305,43,2512,836,0,3348
2019/03,661,31/03/2019,7,SP 15 tra Tresigallo e Massa Fiscaglia,3976,00,3954,22,2992,984,0,3976
2019/03,662,29/03/2019,5,SP 2 tra intersezione SP 14 e Copparo,14166,00,13523,643,11220,2946,14166,0
2019/03,662,30/03/2019,6,SP 2 tra intersezione SP 14 e Copparo,11059,00,10906,153,8135,2924,0,11059
2019/03,662,31/03/2019,7,SP 2 tra intersezione SP 14 e Copparo,8136,00,8104,32,5661,2475,0,8136
2019/03,663,29/03/2019,5,SP 60 tra intersezione SP 68 e SP62,3681,00,3146,535,2846,835,3681,0
2019/03,663,30/03/2019,6,SP 60 tra intersezione SP 68 e SP62,3064,00,2944,120,2294,770,0,3064
2019/03,663,31/03/2019,7,SP 60 tra intersezione SP 68 e SP62,4235,00,4203,32,3299,936,0,4235
2019/03,665,29/03/2019,5,SP 1 tra intersezione SP7 a Piacenza,13591,00,12793,798,10608,2983,13591,0
2019/03,665,30/03/2019,6,SP 1 tra intersezione SP7 a Piacenza,10427,00,10225,202,7558,2869,0,10427
2019/03,665,31/03/2019,7,SP 1 tra intersezione SP7 a Piacenza,7630,00,7595,35,5367,2263,0,7630
2019/03,666,29/03/2019,5,SP 3 tra via Monda e via Caminate,6240,10,5911,328,4516,1724,6240,0
2019/03,666,30/03/2019,6,SP 3 tra via Monda e via Caminate,6669,00,6563,106,4915,1754,0,6669
2019/03,666,31/03/2019,7,SP 3 tra via Monda e via Caminate,5696,00,5667,29,4153,1543,0,5696
2019/03,670,29/03/2019,5,SP 114 dalla rotatoria SP 114/viale Parisoli alla rotatoria SP467,17859,10,16889,969,14099,3760,17859,0
2019/03,670,30/03/2019,6,SP 114 dalla rotatoria SP 114/viale Parisoli alla rotatoria SP467,13348,00,13165,183,9665,3683,0,13348
2019/03,670,31/03/2019,7,SP 114 dalla rotatoria SP 114/viale Parisoli alla rotatoria SP467,9486,00,9419,67,6463,3023,0,9486


